page_len,page_tag_num,page_tech_num,page_domain_type_num,page_like_req_domain_num,page_unlike_req_domain_num,page_hidden_tag_num,page_have_copyright,page_have_redirect
36451,48,1,0,0,0,0,0,0
0,0,0,0,0,0,0,0,0
0,0,0,0,0,0,0,0,0
36090,163,0,3,0,3,0,0,0
43671,223,0,12,10,2,0,0,0
0,0,0,0,0,0,0,0,0
0,0,0,0,0,0,0,0,0
0,0,0,0,0,0,0,0,0
11167,82,0,6,1,5,0,1,0
0,0,0,0,0,0,0,0,0
0,0,0,0,0,0,0,0,0
2695,48,0,1,1,0,0,0,0
37143,51,1,2,0,2,2,0,0
716908,599,1,29,0,29,3,1,0
356692,1378,0,136,100,36,0,1,0
0,0,0,0,0,0,0,0,0
391379,249,6,4,2,2,0,1,0
21290,93,8,0,0,0,4,1,0
36595,124,2,7,4,3,1,0,0
0,0,0,0,0,0,0,0,0
40012,126,1,1,1,0,0,1,0
47937,76,2,1,1,0,3,1,0
0,0,0,0,0,0,0,0,0
0,0,0,0,0,0,0,0,0
0,0,0,0,0,0,0,0,0
0,0,0,0,0,0,0,0,0
0,0,0,0,0,0,0,0,0
0,0,0,0,0,0,0,0,0
32940,173,6,13,10,3,2,0,0
0,0,0,0,0,0,0,0,0
0,0,0,0,0,0,0,0,0
27324,150,1,11,10,1,2,1,1
0,0,0,0,0,0,0,0,0
1059221,101,4,5,5,0,3,1,0
22262,106,1,11,10,1,2,0,0
0,0,0,0,0,0,0,0,0
0,0,0,0,0,0,0,0,0
0,0,0,0,0,0,0,0,0
121584,548,2,9,3,6,39,1,0
48562,142,3,6,3,3,2,0,0
0,0,0,0,0,0,0,0,0
271585,172,6,0,0,0,0,1,0
45570,68,0,1,0,1,0,0,0
45588,68,0,1,0,1,0,0,0
23080,214,5,27,11,16,2,0,0
23041,214,5,27,11,16,2,0,0
20101,59,4,1,1,0,0,0,0
20101,59,4,1,1,0,0,0,0
173872,1817,3,478,476,2,7,1,0
0,0,0,0,0,0,0,0,0
77933,498,2,8,1,7,3,1,0
43671,223,0,12,10,2,0,0,0
0,0,0,0,0,0,0,0,0
0,0,0,0,0,0,0,0,0
9054,79,1,0,0,0,0,0,0
3903,27,1,0,0,0,0,0,0
0,0,0,0,0,0,0,0,0
3938,26,1,0,0,0,0,0,0
7596,60,2,3,2,1,0,0,0
0,0,0,0,0,0,0,0,0
1479820,171,0,11,3,8,1,1,0
77826,101,1,4,2,2,0,0,0
1952,33,0,0,0,0,2,0,0
116135,251,1,6,6,0,1,1,0
116135,251,1,6,6,0,1,1,0
0,0,0,0,0,0,0,0,0
796090,445,1,82,21,61,1,1,0
62234,77,0,0,0,0,0,0,0
295801,318,3,13,13,0,8,1,0
94289,34,1,3,3,0,1,1,0
96249,44,4,0,0,0,2,1,0
0,0,0,0,0,0,0,0,0
0,0,0,0,0,0,0,0,0
0,0,0,0,0,0,0,0,0
64907,203,3,8,4,4,3,1,0
1059955,101,4,5,5,0,3,1,0
151156,174,1,13,12,1,0,1,0
24597,183,5,1,0,1,2,1,0
0,0,0,0,0,0,0,0,0
6644,34,1,1,1,0,3,0,0
0,0,0,0,0,0,0,0,0
4948,61,5,9,7,2,0,0,0
4949,61,5,9,7,2,0,0,0
0,0,0,0,0,0,0,0,0
284585,180,6,1,1,0,0,1,0
75708,175,0,13,12,1,3,1,0
0,0,0,0,0,0,0,0,0
0,0,0,0,0,0,0,0,0
0,0,0,0,0,0,0,0,0
0,0,0,0,0,0,0,0,0
0,0,0,0,0,0,0,0,0
0,0,0,0,0,0,0,0,0
0,0,0,0,0,0,0,0,0
0,0,0,0,0,0,0,0,0
68877,76,1,9,0,9,1,0,0
68877,76,1,9,0,9,1,0,0
68877,76,1,9,0,9,1,0,0
0,0,0,0,0,0,0,0,0
239780,403,2,25,18,7,17,0,0
0,0,0,0,0,0,0,0,0
0,0,0,0,0,0,0,0,0
0,0,0,0,0,0,0,0,0
0,0,0,0,0,0,0,0,0
8156,23,1,0,0,0,0,0,0
0,0,0,0,0,0,0,0,0
0,0,0,0,0,0,0,0,0
0,0,0,0,0,0,0,0,0
0,0,0,0,0,0,0,0,0
253300,1704,10,411,343,68,9,1,0
0,0,0,0,0,0,0,0,0
0,0,0,0,0,0,0,0,0
45473,642,4,163,26,137,3,1,0
81559,148,2,21,4,17,6,0,0
78076,141,2,21,0,21,6,0,0
78076,141,2,21,0,21,6,0,0
36426,48,1,0,0,0,0,0,0
0,0,0,0,0,0,0,0,0
0,0,0,0,0,0,0,0,0
0,0,0,0,0,0,0,0,0
0,0,0,0,0,0,0,0,0
0,0,0,0,0,0,0,0,0
24887,82,1,7,3,4,3,0,0
0,0,0,0,0,0,0,0,0
2035,52,0,4,4,0,0,1,0
0,0,0,0,0,0,0,0,0
0,0,0,0,0,0,0,0,0
0,0,0,0,0,0,0,0,0
151156,174,1,13,12,1,0,1,0
151156,174,1,13,12,1,0,1,0
0,0,0,0,0,0,0,0,0
0,0,0,0,0,0,0,0,0
0,0,0,0,0,0,0,0,0
0,0,0,0,0,0,0,0,0
0,0,0,0,0,0,0,0,0
0,0,0,0,0,0,0,0,0
0,0,0,0,0,0,0,0,0
0,0,0,0,0,0,0,0,0
0,0,0,0,0,0,0,0,0
0,0,0,0,0,0,0,0,0
0,0,0,0,0,0,0,0,0
0,0,0,0,0,0,0,0,0
0,0,0,0,0,0,0,0,0
0,0,0,0,0,0,0,0,0
0,0,0,0,0,0,0,0,0
0,0,0,0,0,0,0,0,0
0,0,0,0,0,0,0,0,0
80078,178,3,5,2,3,3,1,0
0,0,0,0,0,0,0,0,0
21473,528,1,2,2,0,0,0,0
42966,231,5,46,25,21,4,1,0
0,0,0,0,0,0,0,0,0
0,0,0,0,0,0,0,0,0
0,0,0,0,0,0,0,0,0
0,0,0,0,0,0,0,0,0
19608,145,1,3,3,0,21,0,0
0,0,0,0,0,0,0,0,0
35856,169,6,4,1,3,1,0,0
0,0,0,0,0,0,0,0,0
185362,535,4,2,1,1,7,0,0
165631,475,4,2,1,1,7,0,0
0,0,0,0,0,0,0,0,0
0,0,0,0,0,0,0,0,0
0,0,0,0,0,0,0,0,0
0,0,0,0,0,0,0,0,0
0,0,0,0,0,0,0,0,0
0,0,0,0,0,0,0,0,0
0,0,0,0,0,0,0,0,0
0,0,0,0,0,0,0,0,0
0,0,0,0,0,0,0,0,0
215894,1690,6,183,183,0,107,0,0
20708,191,1,13,3,10,0,0,0
6032,40,0,3,1,2,0,1,0
151156,174,1,13,12,1,0,1,0
0,0,0,0,0,0,0,0,0
1777,32,1,0,0,0,0,1,0
208198,273,0,17,4,13,0,1,0
0,0,0,0,0,0,0,0,0
4108,26,1,0,0,0,0,0,0
79405,176,0,13,13,0,5,1,0
0,0,0,0,0,0,0,0,0
959804,1081,0,185,183,2,6,0,0
292702,192,6,1,1,0,0,1,0
0,0,0,0,0,0,0,0,0
24545,163,0,20,16,4,9,0,0
47012,207,2,1,1,0,1,1,0
2868,42,2,2,1,1,0,1,0
0,0,0,0,0,0,0,0,0
97817,69,4,4,4,0,3,1,0
6626,392,0,2,2,0,0,0,0
6626,392,0,2,2,0,0,0,0
108978,76,1,5,5,0,1,0,0
33432,173,6,14,12,2,1,0,0
302278,195,6,1,1,0,0,1,0
4949,61,5,9,7,2,0,0,0
4949,61,5,9,7,2,0,0,0
40020,126,1,1,1,0,0,1,0
253273,1704,10,411,343,68,9,1,0
1089669,108,2,6,6,0,1,1,0
0,0,0,0,0,0,0,0,0
40028,126,1,1,1,0,0,1,0
0,0,0,0,0,0,0,0,0
0,0,0,0,0,0,0,0,0
0,0,0,0,0,0,0,0,0
0,0,0,0,0,0,0,0,0
64878,203,3,7,4,3,3,1,0
72896,63,1,0,0,0,1,0,0
0,0,0,0,0,0,0,0,0
44049,196,3,6,3,3,4,1,0
44049,196,3,6,3,3,4,1,0
0,0,0,0,0,0,0,0,0
0,0,0,0,0,0,0,0,0
113365,173,0,3,3,0,4,0,0
0,0,0,0,0,0,0,0,0
0,0,0,0,0,0,0,0,0
35817,172,6,3,1,2,1,0,0
0,0,0,0,0,0,0,0,0
0,0,0,0,0,0,0,0,0
0,0,0,0,0,0,0,0,0
0,0,0,0,0,0,0,0,0
67338,258,3,18,14,4,8,1,0
0,0,0,0,0,0,0,0,0
0,0,0,0,0,0,0,0,0
0,0,0,0,0,0,0,0,0
0,0,0,0,0,0,0,0,0
0,0,0,0,0,0,0,0,0
0,0,0,0,0,0,0,0,0
0,0,0,0,0,0,0,0,0
0,0,0,0,0,0,0,0,0
0,0,0,0,0,0,0,0,0
0,0,0,0,0,0,0,0,0
0,0,0,0,0,0,0,0,0
0,0,0,0,0,0,0,0,0
0,0,0,0,0,0,0,0,0
0,0,0,0,0,0,0,0,0
0,0,0,0,0,0,0,0,0
0,0,0,0,0,0,0,0,0
0,0,0,0,0,0,0,0,0
0,0,0,0,0,0,0,0,0
0,0,0,0,0,0,0,0,0
0,0,0,0,0,0,0,0,0
0,0,0,0,0,0,0,0,0
0,0,0,0,0,0,0,0,0
822,8,0,0,0,0,0,0,0
822,8,0,0,0,0,0,0,0
2678,42,0,1,1,0,0,0,0
0,0,0,0,0,0,0,0,0
0,0,0,0,0,0,0,0,0
0,0,0,0,0,0,0,0,0
0,0,0,0,0,0,0,0,0
0,0,0,0,0,0,0,0,0
13915,182,4,16,5,11,0,0,0
320713,193,6,1,1,0,0,1,0
0,0,0,0,0,0,0,0,0
0,0,0,0,0,0,0,0,0
0,0,0,0,0,0,0,0,0
16077,72,4,0,0,0,0,1,0
123911,1595,3,210,173,37,10,1,0
0,0,0,0,0,0,0,0,0
20772,158,0,1,0,1,0,1,0
917111,223,0,7,6,1,3,1,0
76008,171,0,13,12,1,4,1,0
1440935,155,0,15,0,15,2,1,0
0,0,0,0,0,0,0,0,0
0,0,0,0,0,0,0,0,0
0,0,0,0,0,0,0,0,0
0,0,0,0,0,0,0,0,0
0,0,0,0,0,0,0,0,0
0,0,0,0,0,0,0,0,0
2871,42,2,2,1,1,0,1,0
70412,50,4,0,0,0,1,0,0
77747,186,0,15,14,1,6,1,0
210857,277,0,18,4,14,0,1,0
0,0,0,0,0,0,0,0,0
0,0,0,0,0,0,0,0,0
2864,42,2,2,1,1,0,1,0
0,0,0,0,0,0,0,0,0
0,0,0,0,0,0,0,0,0
0,0,0,0,0,0,0,0,0
0,0,0,0,0,0,0,0,0
0,0,0,0,0,0,0,0,0
0,0,0,0,0,0,0,0,0
0,0,0,0,0,0,0,0,0
0,0,0,0,0,0,0,0,0
0,0,0,0,0,0,0,0,0
0,0,0,0,0,0,0,0,0
0,0,0,0,0,0,0,0,0
0,0,0,0,0,0,0,0,0
0,0,0,0,0,0,0,0,0
0,0,0,0,0,0,0,0,0
0,0,0,0,0,0,0,0,0
0,0,0,0,0,0,0,0,0
0,0,0,0,0,0,0,0,0
0,0,0,0,0,0,0,0,0
0,0,0,0,0,0,0,0,0
0,0,0,0,0,0,0,0,0
0,0,0,0,0,0,0,0,0
0,0,0,0,0,0,0,0,0
0,0,0,0,0,0,0,0,0
0,0,0,0,0,0,0,0,0
0,0,0,0,0,0,0,0,0
0,0,0,0,0,0,0,0,0
128634,145,6,1,0,1,3,0,0
1515,28,0,0,0,0,0,0,0
1504,28,0,0,0,0,0,0,0
0,0,0,0,0,0,0,0,0
0,0,0,0,0,0,0,0,0
0,0,0,0,0,0,0,0,0
0,0,0,0,0,0,0,0,0
0,0,0,0,0,0,0,0,0
0,0,0,0,0,0,0,0,0
0,0,0,0,0,0,0,0,0
0,0,0,0,0,0,0,0,0
707093,540,0,4,0,4,2,1,1
1026998,1127,2,108,0,108,2,0,0
28670,164,6,4,1,3,1,0,0
0,0,0,0,0,0,0,0,0
0,0,0,0,0,0,0,0,0
21473,528,1,2,2,0,0,0,0
282661,184,6,1,1,0,0,1,0
0,0,0,0,0,0,0,0,0
0,0,0,0,0,0,0,0,0
0,0,0,0,0,0,0,0,0
0,0,0,0,0,0,0,0,0
70424,50,4,0,0,0,1,0,0
6035,40,0,3,2,1,0,1,0
245070,345,3,14,12,2,8,0,0
0,0,0,0,0,0,0,0,0
0,0,0,0,0,0,0,0,0
0,0,0,0,0,0,0,0,0
0,0,0,0,0,0,0,0,0
0,0,0,0,0,0,0,0,0
0,0,0,0,0,0,0,0,0
0,0,0,0,0,0,0,0,0
0,0,0,0,0,0,0,0,0
0,0,0,0,0,0,0,0,0
0,0,0,0,0,0,0,0,0
3918,95,3,2,2,0,0,0,0
0,0,0,0,0,0,0,0,0
0,0,0,0,0,0,0,0,0
0,0,0,0,0,0,0,0,0
0,0,0,0,0,0,0,0,0
0,0,0,0,0,0,0,0,0
0,0,0,0,0,0,0,0,0
0,0,0,0,0,0,0,0,0
0,0,0,0,0,0,0,0,0
0,0,0,0,0,0,0,0,0
157456,455,3,14,2,12,2,0,0
52146,135,4,4,2,2,2,0,0
0,0,0,0,0,0,0,0,0
0,0,0,0,0,0,0,0,0
10787,98,0,4,0,4,4,0,0
0,0,0,0,0,0,0,0,0
0,0,0,0,0,0,0,0,0
0,0,0,0,0,0,0,0,0
23542,128,2,4,2,2,1,0,0
23542,128,2,4,2,2,1,0,0
0,0,0,0,0,0,0,0,0
0,0,0,0,0,0,0,0,0
0,0,0,0,0,0,0,0,0
0,0,0,0,0,0,0,0,0
0,0,0,0,0,0,0,0,0
345188,209,0,7,6,1,7,1,0
3259,38,2,0,0,0,1,0,0
0,0,0,0,0,0,0,0,0
70426,50,4,0,0,0,1,0,0
0,0,0,0,0,0,0,0,0
0,0,0,0,0,0,0,0,0
48795,386,1,33,0,33,2,0,0
48714,386,1,33,0,33,2,0,0
0,0,0,0,0,0,0,0,0
0,0,0,0,0,0,0,0,0
0,0,0,0,0,0,0,0,0
371859,912,5,70,44,26,12,1,0
0,0,0,0,0,0,0,0,0
496479,2381,4,75,17,58,7,1,0
0,0,0,0,0,0,0,0,0
0,0,0,0,0,0,0,0,0
0,0,0,0,0,0,0,0,0
2875,25,0,0,0,0,0,0,0
2875,25,0,0,0,0,0,0,0
2455770,3996,1,422,416,6,10,1,0
49560,226,2,2,0,2,1,1,0
0,0,0,0,0,0,0,0,0
0,0,0,0,0,0,0,0,0
0,0,0,0,0,0,0,0,0
0,0,0,0,0,0,0,0,0
15589,86,0,15,1,14,0,1,0
0,0,0,0,0,0,0,0,0
0,0,0,0,0,0,0,0,0
0,0,0,0,0,0,0,0,0
0,0,0,0,0,0,0,0,0
0,0,0,0,0,0,0,0,0
0,0,0,0,0,0,0,0,0
764073,7891,9,91,16,75,14,0,0
0,0,0,0,0,0,0,0,0
0,0,0,0,0,0,0,0,0
4547,35,0,2,0,2,0,0,0
0,0,0,0,0,0,0,0,0
682615,953,1,6,2,4,1,0,0
0,0,0,0,0,0,0,0,0
176261,962,1,164,10,154,2,1,0
176261,962,1,164,10,154,2,1,0
165130,1409,1,264,5,259,2,0,0
153442,1205,15,135,118,17,3,1,0
0,0,0,0,0,0,0,0,0
0,0,0,0,0,0,0,0,0
0,0,0,0,0,0,0,0,0
0,0,0,0,0,0,0,0,0
0,0,0,0,0,0,0,0,0
0,0,0,0,0,0,0,0,0
0,0,0,0,0,0,0,0,0
10849,33,1,0,0,0,1,0,0
0,0,0,0,0,0,0,0,0
246639,1070,1,256,222,34,3,0,0
246639,1070,1,256,223,33,3,0,0
0,0,0,0,0,0,0,0,0
0,0,0,0,0,0,0,0,0
0,0,0,0,0,0,0,0,0
22434,147,1,1,0,1,0,1,0
22434,147,1,1,0,1,0,1,0
0,0,0,0,0,0,0,0,0
0,0,0,0,0,0,0,0,0
0,0,0,0,0,0,0,0,0
0,0,0,0,0,0,0,0,0
19934,125,1,1,0,1,0,1,0
19934,125,1,1,0,1,0,1,0
19934,125,1,1,0,1,0,1,0
19934,125,1,1,0,1,0,1,0
0,0,0,0,0,0,0,0,0
0,0,0,0,0,0,0,0,0
0,0,0,0,0,0,0,0,0
0,0,0,0,0,0,0,0,0
0,0,0,0,0,0,0,0,0
0,0,0,0,0,0,0,0,0
59074,752,0,233,1,232,0,1,0
59074,752,0,233,1,232,0,1,0
0,0,0,0,0,0,0,0,0
0,0,0,0,0,0,0,0,0
0,0,0,0,0,0,0,0,0
0,0,0,0,0,0,0,0,0
19934,125,1,1,0,1,0,1,0
19934,125,1,1,0,1,0,1,0
0,0,0,0,0,0,0,0,0
0,0,0,0,0,0,0,0,0
0,0,0,0,0,0,0,0,0
0,0,0,0,0,0,0,0,0
0,0,0,0,0,0,0,0,0
0,0,0,0,0,0,0,0,0
0,0,0,0,0,0,0,0,0
0,0,0,0,0,0,0,0,0
0,0,0,0,0,0,0,0,0
0,0,0,0,0,0,0,0,0
0,0,0,0,0,0,0,0,0
0,0,0,0,0,0,0,0,0
0,0,0,0,0,0,0,0,0
0,0,0,0,0,0,0,0,0
0,0,0,0,0,0,0,0,0
0,0,0,0,0,0,0,0,0
0,0,0,0,0,0,0,0,0
0,0,0,0,0,0,0,0,0
0,0,0,0,0,0,0,0,0
0,0,0,0,0,0,0,0,0
0,0,0,0,0,0,0,0,0
0,0,0,0,0,0,0,0,0
867687,60,4,3,3,0,2,1,0
867687,60,4,3,3,0,2,1,0
0,0,0,0,0,0,0,0,0
0,0,0,0,0,0,0,0,0
0,0,0,0,0,0,0,0,0
0,0,0,0,0,0,0,0,0
0,0,0,0,0,0,0,0,0
0,0,0,0,0,0,0,0,0
0,0,0,0,0,0,0,0,0
0,0,0,0,0,0,0,0,0
0,0,0,0,0,0,0,0,0
15007,200,1,46,44,2,2,1,0
707762,540,0,4,0,4,2,1,1
0,0,0,0,0,0,0,0,0
0,0,0,0,0,0,0,0,0
0,0,0,0,0,0,0,0,0
867687,60,4,3,3,0,2,1,0
0,0,0,0,0,0,0,0,0
0,0,0,0,0,0,0,0,0
0,0,0,0,0,0,0,0,0
0,0,0,0,0,0,0,0,0
0,0,0,0,0,0,0,0,0
0,0,0,0,0,0,0,0,0
0,0,0,0,0,0,0,0,0
0,0,0,0,0,0,0,0,0
15007,200,1,46,44,2,2,1,0
15007,200,1,46,44,2,2,1,0
15007,200,1,46,44,2,2,1,0
0,0,0,0,0,0,0,0,0
0,0,0,0,0,0,0,0,0
15007,200,1,46,44,2,2,1,0
15007,200,1,46,44,2,2,1,0
15007,200,1,46,44,2,2,1,0
15007,200,1,46,44,2,2,1,0
0,0,0,0,0,0,0,0,0
0,0,0,0,0,0,0,0,0
0,0,0,0,0,0,0,0,0
0,0,0,0,0,0,0,0,0
0,0,0,0,0,0,0,0,0
0,0,0,0,0,0,0,0,0
0,0,0,0,0,0,0,0,0
0,0,0,0,0,0,0,0,0
0,0,0,0,0,0,0,0,0
0,0,0,0,0,0,0,0,0
0,0,0,0,0,0,0,0,0
0,0,0,0,0,0,0,0,0
0,0,0,0,0,0,0,0,0
0,0,0,0,0,0,0,0,0
0,0,0,0,0,0,0,0,0
0,0,0,0,0,0,0,0,0
0,0,0,0,0,0,0,0,0
0,0,0,0,0,0,0,0,0
0,0,0,0,0,0,0,0,0
409789,68,4,0,0,0,2,0,0
0,0,0,0,0,0,0,0,0
0,0,0,0,0,0,0,0,0
0,0,0,0,0,0,0,0,0
0,0,0,0,0,0,0,0,0
409789,68,4,0,0,0,2,0,0
409789,68,4,0,0,0,2,0,0
0,0,0,0,0,0,0,0,0
409789,68,4,0,0,0,2,0,0
0,0,0,0,0,0,0,0,0
0,0,0,0,0,0,0,0,0
0,0,0,0,0,0,0,0,0
0,0,0,0,0,0,0,0,0
93474,1242,0,224,223,1,7,1,0
6189,66,4,0,0,0,2,0,0
0,0,0,0,0,0,0,0,0
0,0,0,0,0,0,0,0,0
0,0,0,0,0,0,0,0,0
80994,1041,0,29,29,0,5,1,0
0,0,0,0,0,0,0,0,0
39452,368,3,99,98,1,14,1,0
0,0,0,0,0,0,0,0,0
0,0,0,0,0,0,0,0,0
0,0,0,0,0,0,0,0,0
0,0,0,0,0,0,0,0,0
0,0,0,0,0,0,0,0,0
0,0,0,0,0,0,0,0,0
0,0,0,0,0,0,0,0,0
0,0,0,0,0,0,0,0,0
0,0,0,0,0,0,0,0,0
112435,84,1,4,1,3,0,0,0
0,0,0,0,0,0,0,0,0
0,0,0,0,0,0,0,0,0
0,0,0,0,0,0,0,0,0
10150,74,2,4,4,0,0,0,0
0,0,0,0,0,0,0,0,0
0,0,0,0,0,0,0,0,0
0,0,0,0,0,0,0,0,0
0,0,0,0,0,0,0,0,0
47933,76,2,1,1,0,3,1,0
0,0,0,0,0,0,0,0,0
243756,115,4,6,6,0,3,1,0
93181,453,5,58,52,6,14,1,0
233269,64,4,3,3,0,2,1,0
135994,42,4,1,1,0,2,0,0
0,0,0,0,0,0,0,0,0
84868,79,1,8,0,8,0,1,0
75690,170,0,13,12,1,5,1,0
214997,437,1,39,10,29,18,1,0
0,0,0,0,0,0,0,0,0
0,0,0,0,0,0,0,0,0
0,0,0,0,0,0,0,0,0
0,0,0,0,0,0,0,0,0
0,0,0,0,0,0,0,0,0
0,0,0,0,0,0,0,0,0
0,0,0,0,0,0,0,0,0
0,0,0,0,0,0,0,0,0
718061,480,5,33,9,24,5,0,0
0,0,0,0,0,0,0,0,0
7338,23,1,0,0,0,0,0,0
15451,217,1,3,2,1,2,0,0
15451,217,1,3,2,1,2,0,0
15450,217,1,3,2,1,2,0,0
0,0,0,0,0,0,0,0,0
239792,403,2,25,18,7,17,0,0
239776,403,2,25,18,7,17,0,0
239803,403,2,25,18,7,17,0,0
0,0,0,0,0,0,0,0,0
0,0,0,0,0,0,0,0,0
0,0,0,0,0,0,0,0,0
138519,704,4,158,143,15,2,0,0
0,0,0,0,0,0,0,0,0
0,0,0,0,0,0,0,0,0
0,0,0,0,0,0,0,0,0
0,0,0,0,0,0,0,0,0
0,0,0,0,0,0,0,0,0
49866,711,4,163,0,163,3,1,0
68877,76,1,9,0,9,1,0,0
0,0,0,0,0,0,0,0,0
0,0,0,0,0,0,0,0,0
81559,148,2,21,0,21,6,0,0
0,0,0,0,0,0,0,0,0
0,0,0,0,0,0,0,0,0
81559,148,2,21,0,21,6,0,0
0,0,0,0,0,0,0,0,0
81559,148,2,21,0,21,6,0,0
0,0,0,0,0,0,0,0,0
469623,114,4,5,5,0,0,1,0
9697,85,4,6,6,0,0,1,0
51479,135,1,14,14,0,0,1,0
4953,61,5,9,7,2,0,0,0
4957,61,5,9,7,2,0,0,0
4949,61,5,9,7,2,0,0,0
4947,61,5,9,7,2,0,0,0
4949,61,5,9,7,2,0,0,0
4952,61,5,9,7,2,0,0,0
4950,61,5,9,7,2,0,0,0
4947,61,5,9,7,2,0,0,0
4953,61,5,9,7,2,0,0,0
4949,61,5,9,7,2,0,0,0
4950,61,5,9,7,2,0,0,0
4950,61,5,9,7,2,0,0,0
4947,61,5,9,7,2,0,0,0
4950,61,5,9,7,2,0,0,0
70424,50,4,0,0,0,1,0,0
4950,61,5,9,7,2,0,0,0
0,0,0,0,0,0,0,0,0
0,0,0,0,0,0,0,0,0
0,0,0,0,0,0,0,0,0
0,0,0,0,0,0,0,0,0
0,0,0,0,0,0,0,0,0
68877,76,1,9,0,9,1,0,0
68877,76,1,9,0,9,1,0,0
68877,76,1,9,0,9,1,0,0
68877,76,1,9,4,5,1,0,0
0,0,0,0,0,0,0,0,0
0,0,0,0,0,0,0,0,0
0,0,0,0,0,0,0,0,0
0,0,0,0,0,0,0,0,0
0,0,0,0,0,0,0,0,0
0,0,0,0,0,0,0,0,0
707424,540,0,4,0,4,2,1,1
0,0,0,0,0,0,0,0,0
0,0,0,0,0,0,0,0,0
0,0,0,0,0,0,0,0,0
369012,913,5,70,44,26,12,1,0
241708,1052,1,109,105,4,15,1,0
368926,912,5,70,44,26,12,1,0
0,0,0,0,0,0,0,0,0
0,0,0,0,0,0,0,0,0
496054,2382,4,75,17,58,7,1,0
0,0,0,0,0,0,0,0,0
0,0,0,0,0,0,0,0,0
0,0,0,0,0,0,0,0,0
166888,478,4,4,3,1,8,0,0
166367,476,4,4,3,1,8,0,0
0,0,0,0,0,0,0,0,0
0,0,0,0,0,0,0,0,0
0,0,0,0,0,0,0,0,0
681,37,0,6,6,0,0,0,0
59300,734,3,125,96,29,2,0,0
679828,2022,4,458,38,420,0,0,0
4644,39,1,0,0,0,0,0,0
0,0,0,0,0,0,0,0,0
0,0,0,0,0,0,0,0,0
667268,4196,5,1191,756,435,10,0,0
135994,42,4,1,1,0,2,0,0
0,0,0,0,0,0,0,0,0
0,0,0,0,0,0,0,0,0
707898,540,0,4,0,4,2,1,1
0,0,0,0,0,0,0,0,0
46710,203,2,1,1,0,1,1,0
0,0,0,0,0,0,0,0,0
46050,159,2,2,1,1,0,1,0
31102,167,5,10,4,6,1,0,0
0,0,0,0,0,0,0,0,0
2867,42,2,2,1,1,0,1,0
0,0,0,0,0,0,0,0,0
1959,33,0,0,0,0,2,0,0
0,0,0,0,0,0,0,0,0
11000,82,0,7,6,1,0,1,0
51521,135,1,14,14,0,0,1,0
703963,540,0,4,4,0,2,1,1
4676,30,2,1,0,1,0,0,0
600373,60,0,1,1,0,0,1,0
0,0,0,0,0,0,0,0,0
0,0,0,0,0,0,0,0,0
0,0,0,0,0,0,0,0,0
0,0,0,0,0,0,0,0,0
179434,79,1,8,0,8,1,1,0
484162,103,0,7,0,7,1,0,0
282479,263,7,6,6,0,0,1,0
0,0,0,0,0,0,0,0,0
0,0,0,0,0,0,0,0,0
0,0,0,0,0,0,0,0,0
0,0,0,0,0,0,0,0,0
19608,145,1,3,3,0,21,0,0
0,0,0,0,0,0,0,0,0
0,0,0,0,0,0,0,0,0
143140,605,6,4,0,4,8,0,0
290947,208,6,5,1,4,0,1,0
0,0,0,0,0,0,0,0,0
16482,115,3,10,10,0,3,0,0
16482,115,3,10,10,0,3,0,0
75476,378,8,32,5,27,12,1,0
60446,379,8,32,5,27,13,1,0
0,0,0,0,0,0,0,0,0
0,0,0,0,0,0,0,0,0
0,0,0,0,0,0,0,0,0
573306,631,4,36,10,26,2,1,0
573306,631,4,36,10,26,2,1,0
0,0,0,0,0,0,0,0,0
0,0,0,0,0,0,0,0,0
2847,42,2,2,1,1,0,1,0
0,0,0,0,0,0,0,0,0
0,0,0,0,0,0,0,0,0
20169,53,4,2,1,1,0,0,0
0,0,0,0,0,0,0,0,0
0,0,0,0,0,0,0,0,0
70424,50,4,0,0,0,1,0,0
0,0,0,0,0,0,0,0,0
0,0,0,0,0,0,0,0,0
0,0,0,0,0,0,0,0,0
80994,1041,0,29,29,0,5,1,0
80994,1041,0,29,29,0,5,1,0
0,0,0,0,0,0,0,0,0
848729,7089,7,34,26,8,10,0,0
66417,229,3,9,6,3,7,1,0
0,0,0,0,0,0,0,0,0
0,0,0,0,0,0,0,0,0
0,0,0,0,0,0,0,0,0
21681,389,3,47,4,43,1,0,0
0,0,0,0,0,0,0,0,0
0,0,0,0,0,0,0,0,0
5177,48,3,0,0,0,0,0,0
0,0,0,0,0,0,0,0,0
0,0,0,0,0,0,0,0,0
72283,401,1,39,37,2,0,0,0
0,0,0,0,0,0,0,0,0
0,0,0,0,0,0,0,0,0
0,0,0,0,0,0,0,0,0
0,0,0,0,0,0,0,0,0
0,0,0,0,0,0,0,0,0
7352,125,0,21,21,0,0,1,0
11714,81,0,6,6,0,0,1,0
0,0,0,0,0,0,0,0,0
731777,74,3,2,1,1,2,1,0
3358,61,1,7,7,0,0,1,0
0,0,0,0,0,0,0,0,0
103664,132,4,4,1,3,1,1,0
0,0,0,0,0,0,0,0,0
0,0,0,0,0,0,0,0,0
703430,540,0,4,4,0,2,1,1
11796,66,2,4,4,0,1,0,0
0,0,0,0,0,0,0,0,0
0,0,0,0,0,0,0,0,0
0,0,0,0,0,0,0,0,0
0,0,0,0,0,0,0,0,0
80900,207,0,3,3,0,4,0,0
10673,20,1,0,0,0,1,0,0
10669,20,1,0,0,0,1,0,0
0,0,0,0,0,0,0,0,0
0,0,0,0,0,0,0,0,0
379727,67,0,5,2,3,1,0,0
379727,67,0,5,2,3,1,0,0
0,0,0,0,0,0,0,0,0
70301,49,4,0,0,0,1,0,0
0,0,0,0,0,0,0,0,0
70414,50,4,0,0,0,1,0,0
0,0,0,0,0,0,0,0,0
0,0,0,0,0,0,0,0,0
167464,499,4,2,1,1,7,0,0
0,0,0,0,0,0,0,0,0
0,0,0,0,0,0,0,0,0
3993,96,0,0,0,0,0,1,0
70424,50,4,0,0,0,1,0,0
0,0,0,0,0,0,0,0,0
0,0,0,0,0,0,0,0,0
0,0,0,0,0,0,0,0,0
0,0,0,0,0,0,0,0,0
70424,50,4,0,0,0,1,0,0
0,0,0,0,0,0,0,0,0
0,0,0,0,0,0,0,0,0
0,0,0,0,0,0,0,0,0
3079,42,0,0,0,0,0,0,0
15838,68,2,2,0,2,0,0,0
15838,68,2,2,0,2,0,0,0
39,3,0,0,0,0,0,0,0
88,3,0,0,0,0,0,0,0
0,0,0,0,0,0,0,0,0
0,0,0,0,0,0,0,0,0
0,0,0,0,0,0,0,0,0
0,0,0,0,0,0,0,0,0
0,0,0,0,0,0,0,0,0
0,0,0,0,0,0,0,0,0
0,0,0,0,0,0,0,0,0
0,0,0,0,0,0,0,0,0
0,0,0,0,0,0,0,0,0
0,0,0,0,0,0,0,0,0
0,0,0,0,0,0,0,0,0
61921,298,1,6,4,2,0,0,0
0,0,0,0,0,0,0,0,0
0,0,0,0,0,0,0,0,0
0,0,0,0,0,0,0,0,0
0,0,0,0,0,0,0,0,0
0,0,0,0,0,0,0,0,0
0,0,0,0,0,0,0,0,0
0,0,0,0,0,0,0,0,0
0,0,0,0,0,0,0,0,0
0,0,0,0,0,0,0,0,0
0,0,0,0,0,0,0,0,0
78972,388,9,32,7,25,29,1,0
0,0,0,0,0,0,0,0,0
0,0,0,0,0,0,0,0,0
0,0,0,0,0,0,0,0,0
0,0,0,0,0,0,0,0,0
0,0,0,0,0,0,0,0,0
0,0,0,0,0,0,0,0,0
0,0,0,0,0,0,0,0,0
0,0,0,0,0,0,0,0,0
0,0,0,0,0,0,0,0,0
0,0,0,0,0,0,0,0,0
0,0,0,0,0,0,0,0,0
125904,2024,0,229,229,0,0,1,0
125904,2024,0,229,229,0,0,1,0
0,0,0,0,0,0,0,0,0
0,0,0,0,0,0,0,0,0
0,0,0,0,0,0,0,0,0
0,0,0,0,0,0,0,0,0
0,0,0,0,0,0,0,0,0
0,0,0,0,0,0,0,0,0
0,0,0,0,0,0,0,0,0
0,0,0,0,0,0,0,0,0
0,0,0,0,0,0,0,0,0
0,0,0,0,0,0,0,0,0
0,0,0,0,0,0,0,0,0
0,0,0,0,0,0,0,0,0
0,0,0,0,0,0,0,0,0
0,0,0,0,0,0,0,0,0
0,0,0,0,0,0,0,0,0
0,0,0,0,0,0,0,0,0
0,0,0,0,0,0,0,0,0
0,0,0,0,0,0,0,0,0
0,0,0,0,0,0,0,0,0
0,0,0,0,0,0,0,0,0
0,0,0,0,0,0,0,0,0
0,0,0,0,0,0,0,0,0
0,0,0,0,0,0,0,0,0
0,0,0,0,0,0,0,0,0
0,0,0,0,0,0,0,0,0
0,0,0,0,0,0,0,0,0
59074,752,0,233,1,232,0,1,0
59074,752,0,233,1,232,0,1,0
0,0,0,0,0,0,0,0,0
0,0,0,0,0,0,0,0,0
0,0,0,0,0,0,0,0,0
0,0,0,0,0,0,0,0,0
0,0,0,0,0,0,0,0,0
0,0,0,0,0,0,0,0,0
0,0,0,0,0,0,0,0,0
0,0,0,0,0,0,0,0,0
0,0,0,0,0,0,0,0,0
0,0,0,0,0,0,0,0,0
0,0,0,0,0,0,0,0,0
64369,236,0,46,25,21,0,1,1
67102,238,0,46,25,21,0,1,1
0,0,0,0,0,0,0,0,0
614055,71,4,4,4,0,3,1,0
614055,71,4,4,4,0,3,1,0
0,0,0,0,0,0,0,0,0
0,0,0,0,0,0,0,0,0
0,0,0,0,0,0,0,0,0
0,0,0,0,0,0,0,0,0
0,0,0,0,0,0,0,0,0
0,0,0,0,0,0,0,0,0
0,0,0,0,0,0,0,0,0
0,0,0,0,0,0,0,0,0
0,0,0,0,0,0,0,0,0
0,0,0,0,0,0,0,0,0
0,0,0,0,0,0,0,0,0
0,0,0,0,0,0,0,0,0
0,0,0,0,0,0,0,0,0
0,0,0,0,0,0,0,0,0
125904,2024,0,229,229,0,0,1,0
125904,2024,0,229,229,0,0,1,0
1672,27,0,1,0,1,0,0,0
1672,27,0,1,0,1,0,0,0
0,0,0,0,0,0,0,0,0
0,0,0,0,0,0,0,0,0
0,0,0,0,0,0,0,0,0
0,0,0,0,0,0,0,0,0
4971,92,2,1,0,1,0,0,0
4971,92,2,1,0,1,0,0,0
0,0,0,0,0,0,0,0,0
0,0,0,0,0,0,0,0,0
0,0,0,0,0,0,0,0,0
0,0,0,0,0,0,0,0,0
77131,385,8,32,7,25,18,1,0
0,0,0,0,0,0,0,0,0
703677,540,0,4,4,0,2,1,1
0,0,0,0,0,0,0,0,0
0,0,0,0,0,0,0,0,0
61452,384,8,32,5,27,29,1,0
0,0,0,0,0,0,0,0,0
0,0,0,0,0,0,0,0,0
0,0,0,0,0,0,0,0,0
0,0,0,0,0,0,0,0,0
0,0,0,0,0,0,0,0,0
0,0,0,0,0,0,0,0,0
0,0,0,0,0,0,0,0,0
0,0,0,0,0,0,0,0,0
0,0,0,0,0,0,0,0,0
655881,28,1,0,0,0,0,0,0
0,0,0,0,0,0,0,0,0
0,0,0,0,0,0,0,0,0
0,0,0,0,0,0,0,0,0
0,0,0,0,0,0,0,0,0
0,0,0,0,0,0,0,0,0
0,0,0,0,0,0,0,0,0
0,0,0,0,0,0,0,0,0
0,0,0,0,0,0,0,0,0
0,0,0,0,0,0,0,0,0
0,0,0,0,0,0,0,0,0
0,0,0,0,0,0,0,0,0
0,0,0,0,0,0,0,0,0
0,0,0,0,0,0,0,0,0
0,0,0,0,0,0,0,0,0
0,0,0,0,0,0,0,0,0
0,0,0,0,0,0,0,0,0
0,0,0,0,0,0,0,0,0
0,0,0,0,0,0,0,0,0
0,0,0,0,0,0,0,0,0
0,0,0,0,0,0,0,0,0
0,0,0,0,0,0,0,0,0
0,0,0,0,0,0,0,0,0
0,0,0,0,0,0,0,0,0
0,0,0,0,0,0,0,0,0
0,0,0,0,0,0,0,0,0
0,0,0,0,0,0,0,0,0
0,0,0,0,0,0,0,0,0
0,0,0,0,0,0,0,0,0
0,0,0,0,0,0,0,0,0
0,0,0,0,0,0,0,0,0
0,0,0,0,0,0,0,0,0
0,0,0,0,0,0,0,0,0
0,0,0,0,0,0,0,0,0
0,0,0,0,0,0,0,0,0
0,0,0,0,0,0,0,0,0
0,0,0,0,0,0,0,0,0
0,0,0,0,0,0,0,0,0
0,0,0,0,0,0,0,0,0
0,0,0,0,0,0,0,0,0
0,0,0,0,0,0,0,0,0
0,0,0,0,0,0,0,0,0
0,0,0,0,0,0,0,0,0
0,0,0,0,0,0,0,0,0
0,0,0,0,0,0,0,0,0
0,0,0,0,0,0,0,0,0
0,0,0,0,0,0,0,0,0
0,0,0,0,0,0,0,0,0
0,0,0,0,0,0,0,0,0
0,0,0,0,0,0,0,0,0
0,0,0,0,0,0,0,0,0
0,0,0,0,0,0,0,0,0
0,0,0,0,0,0,0,0,0
0,0,0,0,0,0,0,0,0
0,0,0,0,0,0,0,0,0
0,0,0,0,0,0,0,0,0
0,0,0,0,0,0,0,0,0
0,0,0,0,0,0,0,0,0
0,0,0,0,0,0,0,0,0
0,0,0,0,0,0,0,0,0
0,0,0,0,0,0,0,0,0
0,0,0,0,0,0,0,0,0
0,0,0,0,0,0,0,0,0
0,0,0,0,0,0,0,0,0
0,0,0,0,0,0,0,0,0
0,0,0,0,0,0,0,0,0
0,0,0,0,0,0,0,0,0
0,0,0,0,0,0,0,0,0
0,0,0,0,0,0,0,0,0
0,0,0,0,0,0,0,0,0
0,0,0,0,0,0,0,0,0
0,0,0,0,0,0,0,0,0
0,0,0,0,0,0,0,0,0
0,0,0,0,0,0,0,0,0
0,0,0,0,0,0,0,0,0
0,0,0,0,0,0,0,0,0
0,0,0,0,0,0,0,0,0
0,0,0,0,0,0,0,0,0
0,0,0,0,0,0,0,0,0
0,0,0,0,0,0,0,0,0
0,0,0,0,0,0,0,0,0
0,0,0,0,0,0,0,0,0
0,0,0,0,0,0,0,0,0
0,0,0,0,0,0,0,0,0
0,0,0,0,0,0,0,0,0
0,0,0,0,0,0,0,0,0
0,0,0,0,0,0,0,0,0
0,0,0,0,0,0,0,0,0
0,0,0,0,0,0,0,0,0
0,0,0,0,0,0,0,0,0
0,0,0,0,0,0,0,0,0
0,0,0,0,0,0,0,0,0
0,0,0,0,0,0,0,0,0
0,0,0,0,0,0,0,0,0
4706,21,0,0,0,0,0,0,0
0,0,0,0,0,0,0,0,0
0,0,0,0,0,0,0,0,0
0,0,0,0,0,0,0,0,0
0,0,0,0,0,0,0,0,0
0,0,0,0,0,0,0,0,0
0,0,0,0,0,0,0,0,0
0,0,0,0,0,0,0,0,0
0,0,0,0,0,0,0,0,0
0,0,0,0,0,0,0,0,0
0,0,0,0,0,0,0,0,0
0,0,0,0,0,0,0,0,0
0,0,0,0,0,0,0,0,0
0,0,0,0,0,0,0,0,0
0,0,0,0,0,0,0,0,0
0,0,0,0,0,0,0,0,0
0,0,0,0,0,0,0,0,0
0,0,0,0,0,0,0,0,0
0,0,0,0,0,0,0,0,0
0,0,0,0,0,0,0,0,0
0,0,0,0,0,0,0,0,0
0,0,0,0,0,0,0,0,0
0,0,0,0,0,0,0,0,0
0,0,0,0,0,0,0,0,0
0,0,0,0,0,0,0,0,0
0,0,0,0,0,0,0,0,0
331705,58,4,3,3,0,2,1,0
0,0,0,0,0,0,0,0,0
0,0,0,0,0,0,0,0,0
0,0,0,0,0,0,0,0,0
0,0,0,0,0,0,0,0,0
0,0,0,0,0,0,0,0,0
0,0,0,0,0,0,0,0,0
0,0,0,0,0,0,0,0,0
0,0,0,0,0,0,0,0,0
0,0,0,0,0,0,0,0,0
0,0,0,0,0,0,0,0,0
0,0,0,0,0,0,0,0,0
0,0,0,0,0,0,0,0,0
0,0,0,0,0,0,0,0,0
0,0,0,0,0,0,0,0,0
0,0,0,0,0,0,0,0,0
0,0,0,0,0,0,0,0,0
0,0,0,0,0,0,0,0,0
0,0,0,0,0,0,0,0,0
0,0,0,0,0,0,0,0,0
0,0,0,0,0,0,0,0,0
0,0,0,0,0,0,0,0,0
0,0,0,0,0,0,0,0,0
0,0,0,0,0,0,0,0,0
0,0,0,0,0,0,0,0,0
0,0,0,0,0,0,0,0,0
0,0,0,0,0,0,0,0,0
0,0,0,0,0,0,0,0,0
0,0,0,0,0,0,0,0,0
0,0,0,0,0,0,0,0,0
0,0,0,0,0,0,0,0,0
0,0,0,0,0,0,0,0,0
0,0,0,0,0,0,0,0,0
0,0,0,0,0,0,0,0,0
0,0,0,0,0,0,0,0,0
0,0,0,0,0,0,0,0,0
0,0,0,0,0,0,0,0,0
0,0,0,0,0,0,0,0,0
0,0,0,0,0,0,0,0,0
0,0,0,0,0,0,0,0,0
27858,78,3,0,0,0,3,0,0
0,0,0,0,0,0,0,0,0
3778,44,0,2,0,2,1,0,0
0,0,0,0,0,0,0,0,0
0,0,0,0,0,0,0,0,0
0,0,0,0,0,0,0,0,0
0,0,0,0,0,0,0,0,0
0,0,0,0,0,0,0,0,0
0,0,0,0,0,0,0,0,0
0,0,0,0,0,0,0,0,0
0,0,0,0,0,0,0,0,0
0,0,0,0,0,0,0,0,0
0,0,0,0,0,0,0,0,0
557249,43,4,1,1,0,2,0,0
0,0,0,0,0,0,0,0,0
0,0,0,0,0,0,0,0,0
0,0,0,0,0,0,0,0,0
0,0,0,0,0,0,0,0,0
0,0,0,0,0,0,0,0,0
0,0,0,0,0,0,0,0,0
0,0,0,0,0,0,0,0,0
0,0,0,0,0,0,0,0,0
557249,43,4,1,1,0,2,0,0
0,0,0,0,0,0,0,0,0
655879,28,1,0,0,0,0,0,0
114137,434,1,19,6,13,0,0,0
655879,28,1,0,0,0,0,0,0
0,0,0,0,0,0,0,0,0
93074,238,1,16,6,10,0,0,0
93074,238,1,16,6,10,0,0,0
0,0,0,0,0,0,0,0,0
0,0,0,0,0,0,0,0,0
177509,431,7,36,28,8,8,0,0
0,0,0,0,0,0,0,0,0
0,0,0,0,0,0,0,0,0
0,0,0,0,0,0,0,0,0
0,0,0,0,0,0,0,0,0
0,0,0,0,0,0,0,0,0
0,0,0,0,0,0,0,0,0
184223,84,3,0,0,0,3,0,0
184223,84,3,0,0,0,3,0,0
0,0,0,0,0,0,0,0,0
0,0,0,0,0,0,0,0,0
0,0,0,0,0,0,0,0,0
0,0,0,0,0,0,0,0,0
0,0,0,0,0,0,0,0,0
0,0,0,0,0,0,0,0,0
0,0,0,0,0,0,0,0,0
0,0,0,0,0,0,0,0,0
0,0,0,0,0,0,0,0,0
0,0,0,0,0,0,0,0,0
5045,24,3,0,0,0,0,0,0
5045,24,3,0,0,0,0,0,0
0,0,0,0,0,0,0,0,0
0,0,0,0,0,0,0,0,0
0,0,0,0,0,0,0,0,0
0,0,0,0,0,0,0,0,0
5046,24,3,0,0,0,0,0,0
0,0,0,0,0,0,0,0,0
177508,431,7,36,28,8,8,0,0
0,0,0,0,0,0,0,0,0
0,0,0,0,0,0,0,0,0
0,0,0,0,0,0,0,0,0
0,0,0,0,0,0,0,0,0
0,0,0,0,0,0,0,0,0
0,0,0,0,0,0,0,0,0
0,0,0,0,0,0,0,0,0
0,0,0,0,0,0,0,0,0
0,0,0,0,0,0,0,0,0
0,0,0,0,0,0,0,0,0
0,0,0,0,0,0,0,0,0
0,0,0,0,0,0,0,0,0
0,0,0,0,0,0,0,0,0
0,0,0,0,0,0,0,0,0
0,0,0,0,0,0,0,0,0
0,0,0,0,0,0,0,0,0
0,0,0,0,0,0,0,0,0
0,0,0,0,0,0,0,0,0
0,0,0,0,0,0,0,0,0
0,0,0,0,0,0,0,0,0
5045,24,3,0,0,0,0,0,0
5045,24,3,0,0,0,0,0,0
0,0,0,0,0,0,0,0,0
0,0,0,0,0,0,0,0,0
0,0,0,0,0,0,0,0,0
0,0,0,0,0,0,0,0,0
0,0,0,0,0,0,0,0,0
680484,2024,4,458,38,420,0,0,0
0,0,0,0,0,0,0,0,0
0,0,0,0,0,0,0,0,0
0,0,0,0,0,0,0,0,0
0,0,0,0,0,0,0,0,0
0,0,0,0,0,0,0,0,0
0,0,0,0,0,0,0,0,0
0,0,0,0,0,0,0,0,0
0,0,0,0,0,0,0,0,0
0,0,0,0,0,0,0,0,0
47635,75,2,1,1,0,3,1,0
0,0,0,0,0,0,0,0,0
47933,76,2,1,1,0,3,1,0
0,0,0,0,0,0,0,0,0
0,0,0,0,0,0,0,0,0
0,0,0,0,0,0,0,0,0
0,0,0,0,0,0,0,0,0
395047,606,1,22,7,15,0,0,0
0,0,0,0,0,0,0,0,0
0,0,0,0,0,0,0,0,0
0,0,0,0,0,0,0,0,0
0,0,0,0,0,0,0,0,0
671199,537,0,4,4,0,2,1,1
0,0,0,0,0,0,0,0,0
0,0,0,0,0,0,0,0,0
0,0,0,0,0,0,0,0,0
0,0,0,0,0,0,0,0,0
0,0,0,0,0,0,0,0,0
0,0,0,0,0,0,0,0,0
0,0,0,0,0,0,0,0,0
0,0,0,0,0,0,0,0,0
0,0,0,0,0,0,0,0,0
0,0,0,0,0,0,0,0,0
0,0,0,0,0,0,0,0,0
0,0,0,0,0,0,0,0,0
0,0,0,0,0,0,0,0,0
0,0,0,0,0,0,0,0,0
0,0,0,0,0,0,0,0,0
0,0,0,0,0,0,0,0,0
0,0,0,0,0,0,0,0,0
0,0,0,0,0,0,0,0,0
70704,47,4,0,0,0,1,0,0
0,0,0,0,0,0,0,0,0
0,0,0,0,0,0,0,0,0
0,0,0,0,0,0,0,0,0
0,0,0,0,0,0,0,0,0
0,0,0,0,0,0,0,0,0
0,0,0,0,0,0,0,0,0
3192,37,2,4,0,4,0,0,0
0,0,0,0,0,0,0,0,0
0,0,0,0,0,0,0,0,0
0,0,0,0,0,0,0,0,0
0,0,0,0,0,0,0,0,0
0,0,0,0,0,0,0,0,0
0,0,0,0,0,0,0,0,0
0,0,0,0,0,0,0,0,0
2601555,81,4,4,4,0,4,1,0
0,0,0,0,0,0,0,0,0
0,0,0,0,0,0,0,0,0
670671,537,0,4,4,0,2,1,1
0,0,0,0,0,0,0,0,0
0,0,0,0,0,0,0,0,0
0,0,0,0,0,0,0,0,0
0,0,0,0,0,0,0,0,0
0,0,0,0,0,0,0,0,0
0,0,0,0,0,0,0,0,0
0,0,0,0,0,0,0,0,0
0,0,0,0,0,0,0,0,0
0,0,0,0,0,0,0,0,0
0,0,0,0,0,0,0,0,0
0,0,0,0,0,0,0,0,0
0,0,0,0,0,0,0,0,0
0,0,0,0,0,0,0,0,0
0,0,0,0,0,0,0,0,0
0,0,0,0,0,0,0,0,0
0,0,0,0,0,0,0,0,0
0,0,0,0,0,0,0,0,0
0,0,0,0,0,0,0,0,0
0,0,0,0,0,0,0,0,0
0,0,0,0,0,0,0,0,0
0,0,0,0,0,0,0,0,0
0,0,0,0,0,0,0,0,0
0,0,0,0,0,0,0,0,0
0,0,0,0,0,0,0,0,0
0,0,0,0,0,0,0,0,0
0,0,0,0,0,0,0,0,0
132872,58,4,5,5,0,2,1,0
0,0,0,0,0,0,0,0,0
0,0,0,0,0,0,0,0,0
0,0,0,0,0,0,0,0,0
0,0,0,0,0,0,0,0,0
0,0,0,0,0,0,0,0,0
0,0,0,0,0,0,0,0,0
0,0,0,0,0,0,0,0,0
0,0,0,0,0,0,0,0,0
0,0,0,0,0,0,0,0,0
70715,47,4,0,0,0,1,0,0
0,0,0,0,0,0,0,0,0
0,0,0,0,0,0,0,0,0
0,0,0,0,0,0,0,0,0
0,0,0,0,0,0,0,0,0
0,0,0,0,0,0,0,0,0
19137,149,1,5,5,0,0,0,0
0,0,0,0,0,0,0,0,0
0,0,0,0,0,0,0,0,0
38733,128,2,5,2,3,1,1,0
0,0,0,0,0,0,0,0,0
40024,126,1,1,1,0,0,1,0
0,0,0,0,0,0,0,0,0
0,0,0,0,0,0,0,0,0
0,0,0,0,0,0,0,0,0
0,0,0,0,0,0,0,0,0
0,0,0,0,0,0,0,0,0
0,0,0,0,0,0,0,0,0
0,0,0,0,0,0,0,0,0
62119,224,3,9,5,4,4,1,0
0,0,0,0,0,0,0,0,0
0,0,0,0,0,0,0,0,0
0,0,0,0,0,0,0,0,0
0,0,0,0,0,0,0,0,0
8115,58,4,7,1,6,0,0,0
0,0,0,0,0,0,0,0,0
0,0,0,0,0,0,0,0,0
0,0,0,0,0,0,0,0,0
0,0,0,0,0,0,0,0,0
0,0,0,0,0,0,0,0,0
0,0,0,0,0,0,0,0,0
0,0,0,0,0,0,0,0,0
0,0,0,0,0,0,0,0,0
0,0,0,0,0,0,0,0,0
0,0,0,0,0,0,0,0,0
0,0,0,0,0,0,0,0,0
0,0,0,0,0,0,0,0,0
0,0,0,0,0,0,0,0,0
0,0,0,0,0,0,0,0,0
0,0,0,0,0,0,0,0,0
0,0,0,0,0,0,0,0,0
0,0,0,0,0,0,0,0,0
0,0,0,0,0,0,0,0,0
0,0,0,0,0,0,0,0,0
66774,240,2,3,2,1,2,1,0
0,0,0,0,0,0,0,0,0
70705,47,4,0,0,0,1,0,0
0,0,0,0,0,0,0,0,0
70703,47,4,0,0,0,1,0,0
0,0,0,0,0,0,0,0,0
70715,47,4,0,0,0,1,0,0
0,0,0,0,0,0,0,0,0
0,0,0,0,0,0,0,0,0
0,0,0,0,0,0,0,0,0
670593,537,0,4,4,0,2,1,1
0,0,0,0,0,0,0,0,0
0,0,0,0,0,0,0,0,0
0,0,0,0,0,0,0,0,0
0,0,0,0,0,0,0,0,0
0,0,0,0,0,0,0,0,0
0,0,0,0,0,0,0,0,0
0,0,0,0,0,0,0,0,0
153084,1164,10,163,137,26,0,1,0
0,0,0,0,0,0,0,0,0
0,0,0,0,0,0,0,0,0
70714,47,4,0,0,0,1,0,0
0,0,0,0,0,0,0,0,0
0,0,0,0,0,0,0,0,0
0,0,0,0,0,0,0,0,0
0,0,0,0,0,0,0,0,0
0,0,0,0,0,0,0,0,0
0,0,0,0,0,0,0,0,0
0,0,0,0,0,0,0,0,0
0,0,0,0,0,0,0,0,0
0,0,0,0,0,0,0,0,0
0,0,0,0,0,0,0,0,0
0,0,0,0,0,0,0,0,0
0,0,0,0,0,0,0,0,0
0,0,0,0,0,0,0,0,0
0,0,0,0,0,0,0,0,0
0,0,0,0,0,0,0,0,0
0,0,0,0,0,0,0,0,0
0,0,0,0,0,0,0,0,0
0,0,0,0,0,0,0,0,0
17640,77,1,3,0,3,2,1,0
0,0,0,0,0,0,0,0,0
0,0,0,0,0,0,0,0,0
0,0,0,0,0,0,0,0,0
0,0,0,0,0,0,0,0,0
0,0,0,0,0,0,0,0,0
879568,16,0,0,0,0,0,0,0
70715,47,4,0,0,0,1,0,0
0,0,0,0,0,0,0,0,0
0,0,0,0,0,0,0,0,0
0,0,0,0,0,0,0,0,0
0,0,0,0,0,0,0,0,0
0,0,0,0,0,0,0,0,0
0,0,0,0,0,0,0,0,0
0,0,0,0,0,0,0,0,0
0,0,0,0,0,0,0,0,0
0,0,0,0,0,0,0,0,0
0,0,0,0,0,0,0,0,0
34287,59,2,0,0,0,0,0,0
0,0,0,0,0,0,0,0,0
0,0,0,0,0,0,0,0,0
0,0,0,0,0,0,0,0,0
0,0,0,0,0,0,0,0,0
0,0,0,0,0,0,0,0,0
0,0,0,0,0,0,0,0,0
155024,1293,0,249,241,8,2,1,0
0,0,0,0,0,0,0,0,0
11570,70,6,7,6,1,0,0,0
0,0,0,0,0,0,0,0,0
0,0,0,0,0,0,0,0,0
0,0,0,0,0,0,0,0,0
0,0,0,0,0,0,0,0,0
0,0,0,0,0,0,0,0,0
0,0,0,0,0,0,0,0,0
0,0,0,0,0,0,0,0,0
0,0,0,0,0,0,0,0,0
0,0,0,0,0,0,0,0,0
0,0,0,0,0,0,0,0,0
0,0,0,0,0,0,0,0,0
0,0,0,0,0,0,0,0,0
0,0,0,0,0,0,0,0,0
0,0,0,0,0,0,0,0,0
0,0,0,0,0,0,0,0,0
0,0,0,0,0,0,0,0,0
0,0,0,0,0,0,0,0,0
0,0,0,0,0,0,0,0,0
0,0,0,0,0,0,0,0,0
0,0,0,0,0,0,0,0,0
0,0,0,0,0,0,0,0,0
0,0,0,0,0,0,0,0,0
0,0,0,0,0,0,0,0,0
0,0,0,0,0,0,0,0,0
0,0,0,0,0,0,0,0,0
0,0,0,0,0,0,0,0,0
0,0,0,0,0,0,0,0,0
0,0,0,0,0,0,0,0,0
0,0,0,0,0,0,0,0,0
0,0,0,0,0,0,0,0,0
0,0,0,0,0,0,0,0,0
0,0,0,0,0,0,0,0,0
0,0,0,0,0,0,0,0,0
0,0,0,0,0,0,0,0,0
0,0,0,0,0,0,0,0,0
0,0,0,0,0,0,0,0,0
0,0,0,0,0,0,0,0,0
0,0,0,0,0,0,0,0,0
0,0,0,0,0,0,0,0,0
0,0,0,0,0,0,0,0,0
0,0,0,0,0,0,0,0,0
0,0,0,0,0,0,0,0,0
0,0,0,0,0,0,0,0,0
0,0,0,0,0,0,0,0,0
0,0,0,0,0,0,0,0,0
0,0,0,0,0,0,0,0,0
0,0,0,0,0,0,0,0,0
0,0,0,0,0,0,0,0,0
0,0,0,0,0,0,0,0,0
915333,704,0,28,18,10,2,1,0
915325,704,0,28,18,10,2,1,0
0,0,0,0,0,0,0,0,0
0,0,0,0,0,0,0,0,0
0,0,0,0,0,0,0,0,0
0,0,0,0,0,0,0,0,0
0,0,0,0,0,0,0,0,0
0,0,0,0,0,0,0,0,0
0,0,0,0,0,0,0,0,0
0,0,0,0,0,0,0,0,0
0,0,0,0,0,0,0,0,0
0,0,0,0,0,0,0,0,0
0,0,0,0,0,0,0,0,0
0,0,0,0,0,0,0,0,0
0,0,0,0,0,0,0,0,0
0,0,0,0,0,0,0,0,0
0,0,0,0,0,0,0,0,0
0,0,0,0,0,0,0,0,0
0,0,0,0,0,0,0,0,0
0,0,0,0,0,0,0,0,0
0,0,0,0,0,0,0,0,0
0,0,0,0,0,0,0,0,0
0,0,0,0,0,0,0,0,0
0,0,0,0,0,0,0,0,0
0,0,0,0,0,0,0,0,0
0,0,0,0,0,0,0,0,0
0,0,0,0,0,0,0,0,0
0,0,0,0,0,0,0,0,0
0,0,0,0,0,0,0,0,0
0,0,0,0,0,0,0,0,0
0,0,0,0,0,0,0,0,0
0,0,0,0,0,0,0,0,0
0,0,0,0,0,0,0,0,0
0,0,0,0,0,0,0,0,0
0,0,0,0,0,0,0,0,0
0,0,0,0,0,0,0,0,0
0,0,0,0,0,0,0,0,0
0,0,0,0,0,0,0,0,0
0,0,0,0,0,0,0,0,0
0,0,0,0,0,0,0,0,0
338027,43,4,1,1,0,2,0,0
338027,43,4,1,1,0,2,0,0
0,0,0,0,0,0,0,0,0
0,0,0,0,0,0,0,0,0
0,0,0,0,0,0,0,0,0
0,0,0,0,0,0,0,0,0
0,0,0,0,0,0,0,0,0
0,0,0,0,0,0,0,0,0
0,0,0,0,0,0,0,0,0
0,0,0,0,0,0,0,0,0
0,0,0,0,0,0,0,0,0
0,0,0,0,0,0,0,0,0
0,0,0,0,0,0,0,0,0
0,0,0,0,0,0,0,0,0
0,0,0,0,0,0,0,0,0
0,0,0,0,0,0,0,0,0
0,0,0,0,0,0,0,0,0
0,0,0,0,0,0,0,0,0
0,0,0,0,0,0,0,0,0
0,0,0,0,0,0,0,0,0
0,0,0,0,0,0,0,0,0
0,0,0,0,0,0,0,0,0
0,0,0,0,0,0,0,0,0
0,0,0,0,0,0,0,0,0
0,0,0,0,0,0,0,0,0
0,0,0,0,0,0,0,0,0
0,0,0,0,0,0,0,0,0
0,0,0,0,0,0,0,0,0
0,0,0,0,0,0,0,0,0
0,0,0,0,0,0,0,0,0
0,0,0,0,0,0,0,0,0
25086,67,2,1,1,0,2,0,0
0,0,0,0,0,0,0,0,0
0,0,0,0,0,0,0,0,0
0,0,0,0,0,0,0,0,0
33622,46,2,0,0,0,2,0,0
33622,46,2,0,0,0,2,0,0
0,0,0,0,0,0,0,0,0
0,0,0,0,0,0,0,0,0
0,0,0,0,0,0,0,0,0
0,0,0,0,0,0,0,0,0
0,0,0,0,0,0,0,0,0
0,0,0,0,0,0,0,0,0
0,0,0,0,0,0,0,0,0
25086,67,2,1,1,0,2,0,0
0,0,0,0,0,0,0,0,0
0,0,0,0,0,0,0,0,0
0,0,0,0,0,0,0,0,0
0,0,0,0,0,0,0,0,0
56544,190,8,6,0,6,1,1,0
0,0,0,0,0,0,0,0,0
25086,67,2,1,1,0,2,0,0
25086,67,2,1,1,0,2,0,0
144391,42,4,1,1,0,2,0,0
0,0,0,0,0,0,0,0,0
0,0,0,0,0,0,0,0,0
0,0,0,0,0,0,0,0,0
0,0,0,0,0,0,0,0,0
0,0,0,0,0,0,0,0,0
0,0,0,0,0,0,0,0,0
0,0,0,0,0,0,0,0,0
0,0,0,0,0,0,0,0,0
0,0,0,0,0,0,0,0,0
0,0,0,0,0,0,0,0,0
0,0,0,0,0,0,0,0,0
0,0,0,0,0,0,0,0,0
0,0,0,0,0,0,0,0,0
0,0,0,0,0,0,0,0,0
0,0,0,0,0,0,0,0,0
0,0,0,0,0,0,0,0,0
0,0,0,0,0,0,0,0,0
0,0,0,0,0,0,0,0,0
0,0,0,0,0,0,0,0,0
0,0,0,0,0,0,0,0,0
0,0,0,0,0,0,0,0,0
5055,24,3,0,0,0,0,0,0
5055,24,3,0,0,0,0,0,0
5055,24,3,0,0,0,0,0,0
0,0,0,0,0,0,0,0,0
0,0,0,0,0,0,0,0,0
5055,24,3,0,0,0,0,0,0
0,0,0,0,0,0,0,0,0
13130,29,1,0,0,0,3,0,0
0,0,0,0,0,0,0,0,0
0,0,0,0,0,0,0,0,0
0,0,0,0,0,0,0,0,0
0,0,0,0,0,0,0,0,0
0,0,0,0,0,0,0,0,0
0,0,0,0,0,0,0,0,0
13130,29,1,0,0,0,3,0,0
0,0,0,0,0,0,0,0,0
0,0,0,0,0,0,0,0,0
13130,29,1,0,0,0,3,0,0
13130,29,1,0,0,0,3,0,0
0,0,0,0,0,0,0,0,0
0,0,0,0,0,0,0,0,0
0,0,0,0,0,0,0,0,0
0,0,0,0,0,0,0,0,0
13154,86,0,3,3,0,0,0,0
0,0,0,0,0,0,0,0,0
0,0,0,0,0,0,0,0,0
0,0,0,0,0,0,0,0,0
0,0,0,0,0,0,0,0,0
0,0,0,0,0,0,0,0,0
0,0,0,0,0,0,0,0,0
0,0,0,0,0,0,0,0,0
0,0,0,0,0,0,0,0,0
0,0,0,0,0,0,0,0,0
0,0,0,0,0,0,0,0,0
0,0,0,0,0,0,0,0,0
232807,61,4,3,3,0,2,1,0
0,0,0,0,0,0,0,0,0
0,0,0,0,0,0,0,0,0
0,0,0,0,0,0,0,0,0
0,0,0,0,0,0,0,0,0
0,0,0,0,0,0,0,0,0
0,0,0,0,0,0,0,0,0
0,0,0,0,0,0,0,0,0
0,0,0,0,0,0,0,0,0
0,0,0,0,0,0,0,0,0
0,0,0,0,0,0,0,0,0
0,0,0,0,0,0,0,0,0
8402,52,3,0,0,0,4,0,0
8402,52,3,0,0,0,4,0,0
0,0,0,0,0,0,0,0,0
0,0,0,0,0,0,0,0,0
0,0,0,0,0,0,0,0,0
0,0,0,0,0,0,0,0,0
0,0,0,0,0,0,0,0,0
0,0,0,0,0,0,0,0,0
0,0,0,0,0,0,0,0,0
0,0,0,0,0,0,0,0,0
0,0,0,0,0,0,0,0,0
16042,72,4,0,0,0,0,1,0
5048,24,3,0,0,0,0,0,0
194533,66,4,0,0,0,2,1,0
0,0,0,0,0,0,0,0,0
0,0,0,0,0,0,0,0,0
0,0,0,0,0,0,0,0,0
0,0,0,0,0,0,0,0,0
0,0,0,0,0,0,0,0,0
194533,66,4,0,0,0,2,1,0
0,0,0,0,0,0,0,0,0
0,0,0,0,0,0,0,0,0
0,0,0,0,0,0,0,0,0
5048,24,3,0,0,0,0,0,0
0,0,0,0,0,0,0,0,0
0,0,0,0,0,0,0,0,0
0,0,0,0,0,0,0,0,0
27860,78,3,0,0,0,3,0,0
0,0,0,0,0,0,0,0,0
0,0,0,0,0,0,0,0,0
0,0,0,0,0,0,0,0,0
0,0,0,0,0,0,0,0,0
0,0,0,0,0,0,0,0,0
0,0,0,0,0,0,0,0,0
0,0,0,0,0,0,0,0,0
8402,52,3,0,0,0,4,0,0
0,0,0,0,0,0,0,0,0
0,0,0,0,0,0,0,0,0
0,0,0,0,0,0,0,0,0
0,0,0,0,0,0,0,0,0
0,0,0,0,0,0,0,0,0
0,0,0,0,0,0,0,0,0
0,0,0,0,0,0,0,0,0
0,0,0,0,0,0,0,0,0
0,0,0,0,0,0,0,0,0
0,0,0,0,0,0,0,0,0
0,0,0,0,0,0,0,0,0
0,0,0,0,0,0,0,0,0
0,0,0,0,0,0,0,0,0
0,0,0,0,0,0,0,0,0
0,0,0,0,0,0,0,0,0
8402,52,3,0,0,0,4,0,0
0,0,0,0,0,0,0,0,0
0,0,0,0,0,0,0,0,0
0,0,0,0,0,0,0,0,0
0,0,0,0,0,0,0,0,0
0,0,0,0,0,0,0,0,0
0,0,0,0,0,0,0,0,0
0,0,0,0,0,0,0,0,0
0,0,0,0,0,0,0,0,0
0,0,0,0,0,0,0,0,0
0,0,0,0,0,0,0,0,0
0,0,0,0,0,0,0,0,0
16042,72,4,0,0,0,0,1,0
0,0,0,0,0,0,0,0,0
0,0,0,0,0,0,0,0,0
5048,24,3,0,0,0,0,0,0
5048,24,3,0,0,0,0,0,0
0,0,0,0,0,0,0,0,0
0,0,0,0,0,0,0,0,0
0,0,0,0,0,0,0,0,0
0,0,0,0,0,0,0,0,0
0,0,0,0,0,0,0,0,0
0,0,0,0,0,0,0,0,0
0,0,0,0,0,0,0,0,0
0,0,0,0,0,0,0,0,0
0,0,0,0,0,0,0,0,0
0,0,0,0,0,0,0,0,0
0,0,0,0,0,0,0,0,0
0,0,0,0,0,0,0,0,0
0,0,0,0,0,0,0,0,0
0,0,0,0,0,0,0,0,0
0,0,0,0,0,0,0,0,0
0,0,0,0,0,0,0,0,0
0,0,0,0,0,0,0,0,0
0,0,0,0,0,0,0,0,0
0,0,0,0,0,0,0,0,0
0,0,0,0,0,0,0,0,0
0,0,0,0,0,0,0,0,0
23880,221,0,52,3,49,1,1,0
0,0,0,0,0,0,0,0,0
0,0,0,0,0,0,0,0,0
28595,47,4,0,0,0,0,0,0
0,0,0,0,0,0,0,0,0
0,0,0,0,0,0,0,0,0
0,0,0,0,0,0,0,0,0
70886,47,4,0,0,0,1,0,0
0,0,0,0,0,0,0,0,0
0,0,0,0,0,0,0,0,0
0,0,0,0,0,0,0,0,0
0,0,0,0,0,0,0,0,0
0,0,0,0,0,0,0,0,0
0,0,0,0,0,0,0,0,0
0,0,0,0,0,0,0,0,0
0,0,0,0,0,0,0,0,0
0,0,0,0,0,0,0,0,0
0,0,0,0,0,0,0,0,0
0,0,0,0,0,0,0,0,0
0,0,0,0,0,0,0,0,0
10790,79,0,4,4,0,0,0,0
0,0,0,0,0,0,0,0,0
10790,79,0,4,4,0,0,0,0
10790,79,0,4,4,0,0,0,0
0,0,0,0,0,0,0,0,0
48013,76,2,1,1,0,3,1,0
0,0,0,0,0,0,0,0,0
96467,133,4,26,18,8,2,1,0
0,0,0,0,0,0,0,0,0
0,0,0,0,0,0,0,0,0
0,0,0,0,0,0,0,0,0
0,0,0,0,0,0,0,0,0
1059922,101,4,5,5,0,3,1,0
1059922,101,4,5,5,0,3,1,0
93181,453,5,58,52,6,14,1,0
0,0,0,0,0,0,0,0,0
0,0,0,0,0,0,0,0,0
0,0,0,0,0,0,0,0,0
84868,79,1,8,0,8,0,1,0
0,0,0,0,0,0,0,0,0
0,0,0,0,0,0,0,0,0
0,0,0,0,0,0,0,0,0
0,0,0,0,0,0,0,0,0
0,0,0,0,0,0,0,0,0
0,0,0,0,0,0,0,0,0
721146,2773,7,670,12,658,1,1,0
0,0,0,0,0,0,0,0,0
0,0,0,0,0,0,0,0,0
0,0,0,0,0,0,0,0,0
0,0,0,0,0,0,0,0,0
0,0,0,0,0,0,0,0,0
0,0,0,0,0,0,0,0,0
0,0,0,0,0,0,0,0,0
0,0,0,0,0,0,0,0,0
5920,30,0,6,0,6,0,0,0
0,0,0,0,0,0,0,0,0
0,0,0,0,0,0,0,0,0
0,0,0,0,0,0,0,0,0
0,0,0,0,0,0,0,0,0
0,0,0,0,0,0,0,0,0
0,0,0,0,0,0,0,0,0
0,0,0,0,0,0,0,0,0
0,0,0,0,0,0,0,0,0
0,0,0,0,0,0,0,0,0
0,0,0,0,0,0,0,0,0
0,0,0,0,0,0,0,0,0
0,0,0,0,0,0,0,0,0
774121,85,0,1,0,1,1,1,0
0,0,0,0,0,0,0,0,0
0,0,0,0,0,0,0,0,0
0,0,0,0,0,0,0,0,0
0,0,0,0,0,0,0,0,0
0,0,0,0,0,0,0,0,0
0,0,0,0,0,0,0,0,0
0,0,0,0,0,0,0,0,0
0,0,0,0,0,0,0,0,0
0,0,0,0,0,0,0,0,0
0,0,0,0,0,0,0,0,0
0,0,0,0,0,0,0,0,0
0,0,0,0,0,0,0,0,0
0,0,0,0,0,0,0,0,0
0,0,0,0,0,0,0,0,0
0,0,0,0,0,0,0,0,0
0,0,0,0,0,0,0,0,0
0,0,0,0,0,0,0,0,0
15451,217,1,3,2,1,2,0,0
0,0,0,0,0,0,0,0,0
0,0,0,0,0,0,0,0,0
0,0,0,0,0,0,0,0,0
0,0,0,0,0,0,0,0,0
15450,217,1,3,2,1,2,0,0
0,0,0,0,0,0,0,0,0
0,0,0,0,0,0,0,0,0
0,0,0,0,0,0,0,0,0
0,0,0,0,0,0,0,0,0
0,0,0,0,0,0,0,0,0
0,0,0,0,0,0,0,0,0
0,0,0,0,0,0,0,0,0
0,0,0,0,0,0,0,0,0
0,0,0,0,0,0,0,0,0
0,0,0,0,0,0,0,0,0
0,0,0,0,0,0,0,0,0
0,0,0,0,0,0,0,0,0
0,0,0,0,0,0,0,0,0
0,0,0,0,0,0,0,0,0
0,0,0,0,0,0,0,0,0
0,0,0,0,0,0,0,0,0
0,0,0,0,0,0,0,0,0
0,0,0,0,0,0,0,0,0
0,0,0,0,0,0,0,0,0
0,0,0,0,0,0,0,0,0
0,0,0,0,0,0,0,0,0
0,0,0,0,0,0,0,0,0
0,0,0,0,0,0,0,0,0
0,0,0,0,0,0,0,0,0
0,0,0,0,0,0,0,0,0
0,0,0,0,0,0,0,0,0
0,0,0,0,0,0,0,0,0
0,0,0,0,0,0,0,0,0
0,0,0,0,0,0,0,0,0
0,0,0,0,0,0,0,0,0
0,0,0,0,0,0,0,0,0
0,0,0,0,0,0,0,0,0
0,0,0,0,0,0,0,0,0
0,0,0,0,0,0,0,0,0
0,0,0,0,0,0,0,0,0
0,0,0,0,0,0,0,0,0
0,0,0,0,0,0,0,0,0
0,0,0,0,0,0,0,0,0
0,0,0,0,0,0,0,0,0
0,0,0,0,0,0,0,0,0
0,0,0,0,0,0,0,0,0
0,0,0,0,0,0,0,0,0
23199,56,0,9,4,5,0,0,0
0,0,0,0,0,0,0,0,0
0,0,0,0,0,0,0,0,0
0,0,0,0,0,0,0,0,0
0,0,0,0,0,0,0,0,0
0,0,0,0,0,0,0,0,0
0,0,0,0,0,0,0,0,0
0,0,0,0,0,0,0,0,0
0,0,0,0,0,0,0,0,0
0,0,0,0,0,0,0,0,0
0,0,0,0,0,0,0,0,0
0,0,0,0,0,0,0,0,0
0,0,0,0,0,0,0,0,0
0,0,0,0,0,0,0,0,0
0,0,0,0,0,0,0,0,0
0,0,0,0,0,0,0,0,0
78076,141,2,21,0,21,6,0,0
0,0,0,0,0,0,0,0,0
0,0,0,0,0,0,0,0,0
0,0,0,0,0,0,0,0,0
0,0,0,0,0,0,0,0,0
0,0,0,0,0,0,0,0,0
0,0,0,0,0,0,0,0,0
0,0,0,0,0,0,0,0,0
0,0,0,0,0,0,0,0,0
123333,92,5,0,0,0,0,0,0
0,0,0,0,0,0,0,0,0
0,0,0,0,0,0,0,0,0
0,0,0,0,0,0,0,0,0
0,0,0,0,0,0,0,0,0
0,0,0,0,0,0,0,0,0
0,0,0,0,0,0,0,0,0
77746,101,1,4,2,2,0,0,0
0,0,0,0,0,0,0,0,0
0,0,0,0,0,0,0,0,0
0,0,0,0,0,0,0,0,0
0,0,0,0,0,0,0,0,0
0,0,0,0,0,0,0,0,0
0,0,0,0,0,0,0,0,0
0,0,0,0,0,0,0,0,0
0,0,0,0,0,0,0,0,0
0,0,0,0,0,0,0,0,0
0,0,0,0,0,0,0,0,0
0,0,0,0,0,0,0,0,0
0,0,0,0,0,0,0,0,0
0,0,0,0,0,0,0,0,0
0,0,0,0,0,0,0,0,0
0,0,0,0,0,0,0,0,0
0,0,0,0,0,0,0,0,0
675868,537,0,4,0,4,2,1,1
0,0,0,0,0,0,0,0,0
0,0,0,0,0,0,0,0,0
190592,973,15,96,81,15,1,1,0
0,0,0,0,0,0,0,0,0
0,0,0,0,0,0,0,0,0
0,0,0,0,0,0,0,0,0
0,0,0,0,0,0,0,0,0
0,0,0,0,0,0,0,0,0
165056,477,4,2,1,1,7,1,0
0,0,0,0,0,0,0,0,0
166730,493,4,6,3,3,8,0,0
0,0,0,0,0,0,0,0,0
165614,478,4,2,2,0,7,0,0
167153,493,4,6,3,3,8,0,0
0,0,0,0,0,0,0,0,0
0,0,0,0,0,0,0,0,0
0,0,0,0,0,0,0,0,0
0,0,0,0,0,0,0,0,0
0,0,0,0,0,0,0,0,0
0,0,0,0,0,0,0,0,0
0,0,0,0,0,0,0,0,0
70886,47,4,0,0,0,1,0,0
0,0,0,0,0,0,0,0,0
0,0,0,0,0,0,0,0,0
0,0,0,0,0,0,0,0,0
0,0,0,0,0,0,0,0,0
0,0,0,0,0,0,0,0,0
0,0,0,0,0,0,0,0,0
0,0,0,0,0,0,0,0,0
0,0,0,0,0,0,0,0,0
0,0,0,0,0,0,0,0,0
0,0,0,0,0,0,0,0,0
0,0,0,0,0,0,0,0,0
0,0,0,0,0,0,0,0,0
0,0,0,0,0,0,0,0,0
0,0,0,0,0,0,0,0,0
0,0,0,0,0,0,0,0,0
0,0,0,0,0,0,0,0,0
0,0,0,0,0,0,0,0,0
0,0,0,0,0,0,0,0,0
0,0,0,0,0,0,0,0,0
0,0,0,0,0,0,0,0,0
0,0,0,0,0,0,0,0,0
0,0,0,0,0,0,0,0,0
0,0,0,0,0,0,0,0,0
0,0,0,0,0,0,0,0,0
0,0,0,0,0,0,0,0,0
0,0,0,0,0,0,0,0,0
0,0,0,0,0,0,0,0,0
0,0,0,0,0,0,0,0,0
0,0,0,0,0,0,0,0,0
0,0,0,0,0,0,0,0,0
0,0,0,0,0,0,0,0,0
0,0,0,0,0,0,0,0,0
0,0,0,0,0,0,0,0,0
0,0,0,0,0,0,0,0,0
0,0,0,0,0,0,0,0,0
194723,1006,12,131,26,105,2,1,0
170998,660,4,4,3,1,8,0,0
13743,46,0,9,9,0,0,1,0
0,0,0,0,0,0,0,0,0
0,0,0,0,0,0,0,0,0
0,0,0,0,0,0,0,0,0
0,0,0,0,0,0,0,0,0
0,0,0,0,0,0,0,0,0
0,0,0,0,0,0,0,0,0
0,0,0,0,0,0,0,0,0
0,0,0,0,0,0,0,0,0
0,0,0,0,0,0,0,0,0
0,0,0,0,0,0,0,0,0
0,0,0,0,0,0,0,0,0
0,0,0,0,0,0,0,0,0
0,0,0,0,0,0,0,0,0
0,0,0,0,0,0,0,0,0
0,0,0,0,0,0,0,0,0
0,0,0,0,0,0,0,0,0
0,0,0,0,0,0,0,0,0
0,0,0,0,0,0,0,0,0
0,0,0,0,0,0,0,0,0
0,0,0,0,0,0,0,0,0
165634,477,4,4,3,1,8,0,0
0,0,0,0,0,0,0,0,0
0,0,0,0,0,0,0,0,0
0,0,0,0,0,0,0,0,0
0,0,0,0,0,0,0,0,0
0,0,0,0,0,0,0,0,0
0,0,0,0,0,0,0,0,0
0,0,0,0,0,0,0,0,0
0,0,0,0,0,0,0,0,0
0,0,0,0,0,0,0,0,0
38733,128,2,5,2,3,1,1,0
0,0,0,0,0,0,0,0,0
48017,76,2,1,1,0,3,1,0
0,0,0,0,0,0,0,0,0
0,0,0,0,0,0,0,0,0
0,0,0,0,0,0,0,0,0
0,0,0,0,0,0,0,0,0
0,0,0,0,0,0,0,0,0
0,0,0,0,0,0,0,0,0
0,0,0,0,0,0,0,0,0
0,0,0,0,0,0,0,0,0
0,0,0,0,0,0,0,0,0
0,0,0,0,0,0,0,0,0
0,0,0,0,0,0,0,0,0
0,0,0,0,0,0,0,0,0
0,0,0,0,0,0,0,0,0
0,0,0,0,0,0,0,0,0
0,0,0,0,0,0,0,0,0
671137,537,0,4,4,0,2,1,1
0,0,0,0,0,0,0,0,0
0,0,0,0,0,0,0,0,0
0,0,0,0,0,0,0,0,0
0,0,0,0,0,0,0,0,0
0,0,0,0,0,0,0,0,0
0,0,0,0,0,0,0,0,0
0,0,0,0,0,0,0,0,0
0,0,0,0,0,0,0,0,0
0,0,0,0,0,0,0,0,0
70884,47,4,0,0,0,1,0,0
70884,47,4,0,0,0,1,0,0
70886,47,4,0,0,0,1,0,0
70886,47,4,0,0,0,1,0,0
0,0,0,0,0,0,0,0,0
0,0,0,0,0,0,0,0,0
0,0,0,0,0,0,0,0,0
0,0,0,0,0,0,0,0,0
0,0,0,0,0,0,0,0,0
0,0,0,0,0,0,0,0,0
0,0,0,0,0,0,0,0,0
16472,279,3,5,4,1,1,0,0
0,0,0,0,0,0,0,0,0
0,0,0,0,0,0,0,0,0
0,0,0,0,0,0,0,0,0
0,0,0,0,0,0,0,0,0
0,0,0,0,0,0,0,0,0
0,0,0,0,0,0,0,0,0
0,0,0,0,0,0,0,0,0
9538,28,1,2,2,0,0,0,0
0,0,0,0,0,0,0,0,0
0,0,0,0,0,0,0,0,0
0,0,0,0,0,0,0,0,0
0,0,0,0,0,0,0,0,0
0,0,0,0,0,0,0,0,0
0,0,0,0,0,0,0,0,0
0,0,0,0,0,0,0,0,0
0,0,0,0,0,0,0,0,0
0,0,0,0,0,0,0,0,0
0,0,0,0,0,0,0,0,0
0,0,0,0,0,0,0,0,0
0,0,0,0,0,0,0,0,0
0,0,0,0,0,0,0,0,0
0,0,0,0,0,0,0,0,0
0,0,0,0,0,0,0,0,0
0,0,0,0,0,0,0,0,0
0,0,0,0,0,0,0,0,0
0,0,0,0,0,0,0,0,0
0,0,0,0,0,0,0,0,0
0,0,0,0,0,0,0,0,0
0,0,0,0,0,0,0,0,0
0,0,0,0,0,0,0,0,0
0,0,0,0,0,0,0,0,0
0,0,0,0,0,0,0,0,0
0,0,0,0,0,0,0,0,0
0,0,0,0,0,0,0,0,0
0,0,0,0,0,0,0,0,0
0,0,0,0,0,0,0,0,0
0,0,0,0,0,0,0,0,0
0,0,0,0,0,0,0,0,0
0,0,0,0,0,0,0,0,0
0,0,0,0,0,0,0,0,0
0,0,0,0,0,0,0,0,0
0,0,0,0,0,0,0,0,0
0,0,0,0,0,0,0,0,0
0,0,0,0,0,0,0,0,0
0,0,0,0,0,0,0,0,0
0,0,0,0,0,0,0,0,0
0,0,0,0,0,0,0,0,0
0,0,0,0,0,0,0,0,0
0,0,0,0,0,0,0,0,0
0,0,0,0,0,0,0,0,0
248208,666,9,98,24,74,10,1,0
0,0,0,0,0,0,0,0,0
0,0,0,0,0,0,0,0,0
0,0,0,0,0,0,0,0,0
0,0,0,0,0,0,0,0,0
0,0,0,0,0,0,0,0,0
0,0,0,0,0,0,0,0,0
0,0,0,0,0,0,0,0,0
0,0,0,0,0,0,0,0,0
0,0,0,0,0,0,0,0,0
0,0,0,0,0,0,0,0,0
0,0,0,0,0,0,0,0,0
0,0,0,0,0,0,0,0,0
5098,39,5,1,1,0,0,0,0
0,0,0,0,0,0,0,0,0
0,0,0,0,0,0,0,0,0
0,0,0,0,0,0,0,0,0
8073,140,7,26,6,20,1,1,0
8073,140,7,26,6,20,1,1,0
8073,140,7,26,6,20,1,1,0
7764,138,7,26,6,20,0,1,0
8073,140,7,26,6,20,1,1,0
8073,140,7,26,8,18,1,1,0
0,0,0,0,0,0,0,0,0
2458,50,1,5,5,0,0,1,0
0,0,0,0,0,0,0,0,0
0,0,0,0,0,0,0,0,0
0,0,0,0,0,0,0,0,0
0,0,0,0,0,0,0,0,0
0,0,0,0,0,0,0,0,0
0,0,0,0,0,0,0,0,0
0,0,0,0,0,0,0,0,0
0,0,0,0,0,0,0,0,0
0,0,0,0,0,0,0,0,0
0,0,0,0,0,0,0,0,0
0,0,0,0,0,0,0,0,0
0,0,0,0,0,0,0,0,0
0,0,0,0,0,0,0,0,0
0,0,0,0,0,0,0,0,0
0,0,0,0,0,0,0,0,0
0,0,0,0,0,0,0,0,0
46918,209,5,34,28,6,0,0,0
61809,44,4,0,0,0,1,0,0
0,0,0,0,0,0,0,0,0
0,0,0,0,0,0,0,0,0
0,0,0,0,0,0,0,0,0
0,0,0,0,0,0,0,0,0
0,0,0,0,0,0,0,0,0
0,0,0,0,0,0,0,0,0
0,0,0,0,0,0,0,0,0
0,0,0,0,0,0,0,0,0
0,0,0,0,0,0,0,0,0
0,0,0,0,0,0,0,0,0
0,0,0,0,0,0,0,0,0
0,0,0,0,0,0,0,0,0
0,0,0,0,0,0,0,0,0
0,0,0,0,0,0,0,0,0
0,0,0,0,0,0,0,0,0
0,0,0,0,0,0,0,0,0
0,0,0,0,0,0,0,0,0
0,0,0,0,0,0,0,0,0
0,0,0,0,0,0,0,0,0
0,0,0,0,0,0,0,0,0
0,0,0,0,0,0,0,0,0
0,0,0,0,0,0,0,0,0
8965,51,2,0,0,0,2,0,0
0,0,0,0,0,0,0,0,0
9494,80,1,0,0,0,0,0,0
0,0,0,0,0,0,0,0,0
0,0,0,0,0,0,0,0,0
0,0,0,0,0,0,0,0,0
0,0,0,0,0,0,0,0,0
0,0,0,0,0,0,0,0,0
0,0,0,0,0,0,0,0,0
0,0,0,0,0,0,0,0,0
0,0,0,0,0,0,0,0,0
0,0,0,0,0,0,0,0,0
0,0,0,0,0,0,0,0,0
0,0,0,0,0,0,0,0,0
0,0,0,0,0,0,0,0,0
0,0,0,0,0,0,0,0,0
0,0,0,0,0,0,0,0,0
0,0,0,0,0,0,0,0,0
0,0,0,0,0,0,0,0,0
0,0,0,0,0,0,0,0,0
0,0,0,0,0,0,0,0,0
0,0,0,0,0,0,0,0,0
0,0,0,0,0,0,0,0,0
0,0,0,0,0,0,0,0,0
0,0,0,0,0,0,0,0,0
0,0,0,0,0,0,0,0,0
0,0,0,0,0,0,0,0,0
0,0,0,0,0,0,0,0,0
0,0,0,0,0,0,0,0,0
0,0,0,0,0,0,0,0,0
0,0,0,0,0,0,0,0,0
0,0,0,0,0,0,0,0,0
0,0,0,0,0,0,0,0,0
0,0,0,0,0,0,0,0,0
0,0,0,0,0,0,0,0,0
0,0,0,0,0,0,0,0,0
0,0,0,0,0,0,0,0,0
0,0,0,0,0,0,0,0,0
0,0,0,0,0,0,0,0,0
0,0,0,0,0,0,0,0,0
36096,167,2,5,4,1,18,0,0
0,0,0,0,0,0,0,0,0
0,0,0,0,0,0,0,0,0
0,0,0,0,0,0,0,0,0
0,0,0,0,0,0,0,0,0
0,0,0,0,0,0,0,0,0
0,0,0,0,0,0,0,0,0
0,0,0,0,0,0,0,0,0
0,0,0,0,0,0,0,0,0
0,0,0,0,0,0,0,0,0
0,0,0,0,0,0,0,0,0
0,0,0,0,0,0,0,0,0
0,0,0,0,0,0,0,0,0
0,0,0,0,0,0,0,0,0
0,0,0,0,0,0,0,0,0
0,0,0,0,0,0,0,0,0
0,0,0,0,0,0,0,0,0
0,0,0,0,0,0,0,0,0
0,0,0,0,0,0,0,0,0
0,0,0,0,0,0,0,0,0
0,0,0,0,0,0,0,0,0
0,0,0,0,0,0,0,0,0
0,0,0,0,0,0,0,0,0
0,0,0,0,0,0,0,0,0
0,0,0,0,0,0,0,0,0
0,0,0,0,0,0,0,0,0
0,0,0,0,0,0,0,0,0
0,0,0,0,0,0,0,0,0
0,0,0,0,0,0,0,0,0
0,0,0,0,0,0,0,0,0
0,0,0,0,0,0,0,0,0
0,0,0,0,0,0,0,0,0
0,0,0,0,0,0,0,0,0
0,0,0,0,0,0,0,0,0
0,0,0,0,0,0,0,0,0
0,0,0,0,0,0,0,0,0
0,0,0,0,0,0,0,0,0
0,0,0,0,0,0,0,0,0
0,0,0,0,0,0,0,0,0
0,0,0,0,0,0,0,0,0
0,0,0,0,0,0,0,0,0
0,0,0,0,0,0,0,0,0
0,0,0,0,0,0,0,0,0
0,0,0,0,0,0,0,0,0
0,0,0,0,0,0,0,0,0
0,0,0,0,0,0,0,0,0
0,0,0,0,0,0,0,0,0
0,0,0,0,0,0,0,0,0
0,0,0,0,0,0,0,0,0
0,0,0,0,0,0,0,0,0
0,0,0,0,0,0,0,0,0
0,0,0,0,0,0,0,0,0
0,0,0,0,0,0,0,0,0
0,0,0,0,0,0,0,0,0
0,0,0,0,0,0,0,0,0
0,0,0,0,0,0,0,0,0
0,0,0,0,0,0,0,0,0
0,0,0,0,0,0,0,0,0
0,0,0,0,0,0,0,0,0
0,0,0,0,0,0,0,0,0
0,0,0,0,0,0,0,0,0
145945,1051,2,153,21,132,3,0,0
0,0,0,0,0,0,0,0,0
0,0,0,0,0,0,0,0,0
0,0,0,0,0,0,0,0,0
0,0,0,0,0,0,0,0,0
80297,176,0,14,13,1,5,1,0
0,0,0,0,0,0,0,0,0
0,0,0,0,0,0,0,0,0
69864,46,4,0,0,0,1,0,0
0,0,0,0,0,0,0,0,0
0,0,0,0,0,0,0,0,0
0,0,0,0,0,0,0,0,0
107893,948,7,227,35,192,6,1,0
0,0,0,0,0,0,0,0,0
0,0,0,0,0,0,0,0,0
0,0,0,0,0,0,0,0,0
0,0,0,0,0,0,0,0,0
0,0,0,0,0,0,0,0,0
0,0,0,0,0,0,0,0,0
0,0,0,0,0,0,0,0,0
0,0,0,0,0,0,0,0,0
0,0,0,0,0,0,0,0,0
0,0,0,0,0,0,0,0,0
0,0,0,0,0,0,0,0,0
0,0,0,0,0,0,0,0,0
0,0,0,0,0,0,0,0,0
0,0,0,0,0,0,0,0,0
0,0,0,0,0,0,0,0,0
0,0,0,0,0,0,0,0,0
0,0,0,0,0,0,0,0,0
0,0,0,0,0,0,0,0,0
0,0,0,0,0,0,0,0,0
0,0,0,0,0,0,0,0,0
0,0,0,0,0,0,0,0,0
0,0,0,0,0,0,0,0,0
0,0,0,0,0,0,0,0,0
0,0,0,0,0,0,0,0,0
0,0,0,0,0,0,0,0,0
222282,92,1,4,1,3,2,0,0
0,0,0,0,0,0,0,0,0
0,0,0,0,0,0,0,0,0
0,0,0,0,0,0,0,0,0
0,0,0,0,0,0,0,0,0
0,0,0,0,0,0,0,0,0
0,0,0,0,0,0,0,0,0
0,0,0,0,0,0,0,0,0
0,0,0,0,0,0,0,0,0
0,0,0,0,0,0,0,0,0
0,0,0,0,0,0,0,0,0
0,0,0,0,0,0,0,0,0
0,0,0,0,0,0,0,0,0
0,0,0,0,0,0,0,0,0
0,0,0,0,0,0,0,0,0
0,0,0,0,0,0,0,0,0
0,0,0,0,0,0,0,0,0
0,0,0,0,0,0,0,0,0
0,0,0,0,0,0,0,0,0
12199,51,3,0,0,0,2,0,0
12199,51,3,0,0,0,2,0,0
0,0,0,0,0,0,0,0,0
0,0,0,0,0,0,0,0,0
12199,51,3,0,0,0,2,0,0
12199,51,3,0,0,0,2,0,0
0,0,0,0,0,0,0,0,0
0,0,0,0,0,0,0,0,0
12199,51,3,0,0,0,2,0,0
245156,207,4,47,45,2,0,1,0
0,0,0,0,0,0,0,0,0
0,0,0,0,0,0,0,0,0
245156,207,4,47,45,2,0,1,0
245156,207,4,47,45,2,0,1,0
0,0,0,0,0,0,0,0,0
0,0,0,0,0,0,0,0,0
0,0,0,0,0,0,0,0,0
0,0,0,0,0,0,0,0,0
245156,207,4,47,45,2,0,1,0
665875,62,4,3,3,0,2,1,0
665875,62,4,3,3,0,2,1,0
245156,207,4,47,45,2,0,1,0
0,0,0,0,0,0,0,0,0
0,0,0,0,0,0,0,0,0
665715,62,4,3,3,0,2,1,0
665715,62,4,3,3,0,2,1,0
0,0,0,0,0,0,0,0,0
0,0,0,0,0,0,0,0,0
0,0,0,0,0,0,0,0,0
136005,42,4,1,1,0,2,0,0
136005,42,4,1,1,0,2,0,0
0,0,0,0,0,0,0,0,0
0,0,0,0,0,0,0,0,0
0,0,0,0,0,0,0,0,0
0,0,0,0,0,0,0,0,0
0,0,0,0,0,0,0,0,0
0,0,0,0,0,0,0,0,0
19143,103,4,6,6,0,3,0,0
19143,103,4,6,6,0,3,0,0
19143,103,4,6,6,0,3,0,0
0,0,0,0,0,0,0,0,0
0,0,0,0,0,0,0,0,0
665715,62,4,3,3,0,2,1,0
665715,62,4,3,3,0,2,1,0
0,0,0,0,0,0,0,0,0
0,0,0,0,0,0,0,0,0
0,0,0,0,0,0,0,0,0
0,0,0,0,0,0,0,0,0
0,0,0,0,0,0,0,0,0
665715,62,4,3,3,0,2,1,0
665715,62,4,3,3,0,2,1,0
0,0,0,0,0,0,0,0,0
0,0,0,0,0,0,0,0,0
0,0,0,0,0,0,0,0,0
0,0,0,0,0,0,0,0,0
665715,62,4,3,3,0,2,1,0
0,0,0,0,0,0,0,0,0
0,0,0,0,0,0,0,0,0
0,0,0,0,0,0,0,0,0
0,0,0,0,0,0,0,0,0
665875,62,4,3,3,0,2,1,0
665875,62,4,3,3,0,2,1,0
0,0,0,0,0,0,0,0,0
136005,42,4,1,1,0,2,0,0
0,0,0,0,0,0,0,0,0
0,0,0,0,0,0,0,0,0
0,0,0,0,0,0,0,0,0
0,0,0,0,0,0,0,0,0
0,0,0,0,0,0,0,0,0
0,0,0,0,0,0,0,0,0
0,0,0,0,0,0,0,0,0
0,0,0,0,0,0,0,0,0
0,0,0,0,0,0,0,0,0
0,0,0,0,0,0,0,0,0
0,0,0,0,0,0,0,0,0
0,0,0,0,0,0,0,0,0
0,0,0,0,0,0,0,0,0
0,0,0,0,0,0,0,0,0
0,0,0,0,0,0,0,0,0
0,0,0,0,0,0,0,0,0
0,0,0,0,0,0,0,0,0
0,0,0,0,0,0,0,0,0
0,0,0,0,0,0,0,0,0
0,0,0,0,0,0,0,0,0
0,0,0,0,0,0,0,0,0
0,0,0,0,0,0,0,0,0
0,0,0,0,0,0,0,0,0
0,0,0,0,0,0,0,0,0
0,0,0,0,0,0,0,0,0
0,0,0,0,0,0,0,0,0
0,0,0,0,0,0,0,0,0
0,0,0,0,0,0,0,0,0
0,0,0,0,0,0,0,0,0
0,0,0,0,0,0,0,0,0
0,0,0,0,0,0,0,0,0
0,0,0,0,0,0,0,0,0
337630,58,1,6,3,3,0,0,0
0,0,0,0,0,0,0,0,0
0,0,0,0,0,0,0,0,0
0,0,0,0,0,0,0,0,0
0,0,0,0,0,0,0,0,0
0,0,0,0,0,0,0,0,0
0,0,0,0,0,0,0,0,0
0,0,0,0,0,0,0,0,0
0,0,0,0,0,0,0,0,0
0,0,0,0,0,0,0,0,0
0,0,0,0,0,0,0,0,0
135972,42,4,1,1,0,2,0,0
0,0,0,0,0,0,0,0,0
0,0,0,0,0,0,0,0,0
361,6,0,0,0,0,0,0,0
0,0,0,0,0,0,0,0,0
0,0,0,0,0,0,0,0,0
0,0,0,0,0,0,0,0,0
0,0,0,0,0,0,0,0,0
6818,50,0,2,2,0,0,1,0
0,0,0,0,0,0,0,0,0
0,0,0,0,0,0,0,0,0
0,0,0,0,0,0,0,0,0
840,26,0,0,0,0,0,0,0
0,0,0,0,0,0,0,0,0
0,0,0,0,0,0,0,0,0
0,0,0,0,0,0,0,0,0
0,0,0,0,0,0,0,0,0
0,0,0,0,0,0,0,0,0
0,0,0,0,0,0,0,0,0
0,0,0,0,0,0,0,0,0
0,0,0,0,0,0,0,0,0
0,0,0,0,0,0,0,0,0
0,0,0,0,0,0,0,0,0
0,0,0,0,0,0,0,0,0
0,0,0,0,0,0,0,0,0
0,0,0,0,0,0,0,0,0
0,0,0,0,0,0,0,0,0
0,0,0,0,0,0,0,0,0
0,0,0,0,0,0,0,0,0
0,0,0,0,0,0,0,0,0
0,0,0,0,0,0,0,0,0
0,0,0,0,0,0,0,0,0
0,0,0,0,0,0,0,0,0
0,0,0,0,0,0,0,0,0
0,0,0,0,0,0,0,0,0
107900,948,7,227,40,187,6,1,0
0,0,0,0,0,0,0,0,0
0,0,0,0,0,0,0,0,0
0,0,0,0,0,0,0,0,0
0,0,0,0,0,0,0,0,0
0,0,0,0,0,0,0,0,0
0,0,0,0,0,0,0,0,0
0,0,0,0,0,0,0,0,0
0,0,0,0,0,0,0,0,0
0,0,0,0,0,0,0,0,0
0,0,0,0,0,0,0,0,0
0,0,0,0,0,0,0,0,0
0,0,0,0,0,0,0,0,0
0,0,0,0,0,0,0,0,0
0,0,0,0,0,0,0,0,0
0,0,0,0,0,0,0,0,0
0,0,0,0,0,0,0,0,0
0,0,0,0,0,0,0,0,0
0,0,0,0,0,0,0,0,0
0,0,0,0,0,0,0,0,0
0,0,0,0,0,0,0,0,0
0,0,0,0,0,0,0,0,0
0,0,0,0,0,0,0,0,0
0,0,0,0,0,0,0,0,0
0,0,0,0,0,0,0,0,0
0,0,0,0,0,0,0,0,0
0,0,0,0,0,0,0,0,0
0,0,0,0,0,0,0,0,0
54046,221,3,7,4,3,3,1,0
0,0,0,0,0,0,0,0,0
0,0,0,0,0,0,0,0,0
0,0,0,0,0,0,0,0,0
0,0,0,0,0,0,0,0,0
0,0,0,0,0,0,0,0,0
0,0,0,0,0,0,0,0,0
0,0,0,0,0,0,0,0,0
0,0,0,0,0,0,0,0,0
0,0,0,0,0,0,0,0,0
0,0,0,0,0,0,0,0,0
0,0,0,0,0,0,0,0,0
0,0,0,0,0,0,0,0,0
0,0,0,0,0,0,0,0,0
0,0,0,0,0,0,0,0,0
0,0,0,0,0,0,0,0,0
0,0,0,0,0,0,0,0,0
0,0,0,0,0,0,0,0,0
177901,431,7,36,28,8,8,0,0
0,0,0,0,0,0,0,0,0
0,0,0,0,0,0,0,0,0
0,0,0,0,0,0,0,0,0
0,0,0,0,0,0,0,0,0
0,0,0,0,0,0,0,0,0
0,0,0,0,0,0,0,0,0
0,0,0,0,0,0,0,0,0
0,0,0,0,0,0,0,0,0
0,0,0,0,0,0,0,0,0
0,0,0,0,0,0,0,0,0
0,0,0,0,0,0,0,0,0
0,0,0,0,0,0,0,0,0
0,0,0,0,0,0,0,0,0
107895,948,7,227,32,195,6,1,0
0,0,0,0,0,0,0,0,0
0,0,0,0,0,0,0,0,0
0,0,0,0,0,0,0,0,0
0,0,0,0,0,0,0,0,0
0,0,0,0,0,0,0,0,0
0,0,0,0,0,0,0,0,0
0,0,0,0,0,0,0,0,0
0,0,0,0,0,0,0,0,0
0,0,0,0,0,0,0,0,0
0,0,0,0,0,0,0,0,0
0,0,0,0,0,0,0,0,0
0,0,0,0,0,0,0,0,0
0,0,0,0,0,0,0,0,0
0,0,0,0,0,0,0,0,0
0,0,0,0,0,0,0,0,0
0,0,0,0,0,0,0,0,0
0,0,0,0,0,0,0,0,0
0,0,0,0,0,0,0,0,0
0,0,0,0,0,0,0,0,0
166352,486,4,6,3,3,8,0,0
166865,473,4,2,1,1,7,0,0
165480,477,4,4,3,1,8,0,0
164755,471,4,2,1,1,7,0,0
163414,466,4,2,1,1,7,0,0
173373,1135,5,4,3,1,8,1,0
163787,475,4,4,1,3,7,0,0
0,0,0,0,0,0,0,0,0
164116,471,4,2,1,1,7,0,0
164613,476,4,2,1,1,7,0,0
165418,477,4,4,3,1,8,0,0
166984,491,4,6,3,3,8,0,0
163560,471,4,2,1,1,7,0,0
164665,473,4,2,1,1,7,0,0
175384,1209,5,4,3,1,11,1,0
165203,480,4,4,3,1,8,0,0
166188,591,4,2,1,1,7,0,0
0,0,0,0,0,0,0,0,0
168024,611,4,4,3,1,8,1,0
0,0,0,0,0,0,0,0,0
164652,470,4,2,1,1,7,0,0
176001,1295,5,4,3,1,11,1,0
164467,475,4,2,1,1,7,0,0
0,0,0,0,0,0,0,0,0
164404,474,4,2,1,1,7,0,0
0,0,0,0,0,0,0,0,0
0,0,0,0,0,0,0,0,0
0,0,0,0,0,0,0,0,0
0,0,0,0,0,0,0,0,0
164388,476,4,6,3,3,8,0,0
0,0,0,0,0,0,0,0,0
167948,482,4,4,3,1,8,0,0
166486,479,4,4,3,1,8,0,0
0,0,0,0,0,0,0,0,0
0,0,0,0,0,0,0,0,0
163986,475,4,4,1,3,7,0,0
0,0,0,0,0,0,0,0,0
164292,475,4,4,3,1,8,0,0
0,0,0,0,0,0,0,0,0
165680,478,4,4,3,1,8,0,0
0,0,0,0,0,0,0,0,0
164469,477,4,4,3,1,8,0,0
164154,471,4,4,3,1,8,0,0
163420,468,4,2,1,1,7,0,0
0,0,0,0,0,0,0,0,0
164368,475,4,4,3,1,8,0,0
0,0,0,0,0,0,0,0,0
164177,475,4,4,3,1,8,0,0
165118,473,4,2,1,1,7,0,0
163095,469,4,4,1,3,7,0,0
164321,467,4,2,1,1,7,0,0
163985,473,4,4,1,3,7,0,0
0,0,0,0,0,0,0,0,0
0,0,0,0,0,0,0,0,0
166090,477,4,4,3,1,8,0,0
166184,478,4,4,3,1,8,0,0
164020,473,4,4,1,3,7,0,0
165458,481,4,6,3,3,8,0,0
0,0,0,0,0,0,0,0,0
164594,480,4,4,1,3,7,0,0
0,0,0,0,0,0,0,0,0
0,0,0,0,0,0,0,0,0
0,0,0,0,0,0,0,0,0
164391,476,4,4,1,3,7,0,0
0,0,0,0,0,0,0,0,0
163656,470,4,2,1,1,7,0,0
163134,470,4,2,1,1,7,0,0
164019,475,4,2,1,1,7,0,0
165817,478,4,4,3,1,8,0,0
162799,466,4,2,1,1,7,0,0
0,0,0,0,0,0,0,0,0
0,0,0,0,0,0,0,0,0
0,0,0,0,0,0,0,0,0
0,0,0,0,0,0,0,0,0
0,0,0,0,0,0,0,0,0
0,0,0,0,0,0,0,0,0
0,0,0,0,0,0,0,0,0
163401,472,4,2,1,1,7,0,0
0,0,0,0,0,0,0,0,0
0,0,0,0,0,0,0,0,0
0,0,0,0,0,0,0,0,0
0,0,0,0,0,0,0,0,0
0,0,0,0,0,0,0,0,0
0,0,0,0,0,0,0,0,0
0,0,0,0,0,0,0,0,0
0,0,0,0,0,0,0,0,0
0,0,0,0,0,0,0,0,0
0,0,0,0,0,0,0,0,0
0,0,0,0,0,0,0,0,0
0,0,0,0,0,0,0,0,0
0,0,0,0,0,0,0,0,0
0,0,0,0,0,0,0,0,0
0,0,0,0,0,0,0,0,0
0,0,0,0,0,0,0,0,0
0,0,0,0,0,0,0,0,0
0,0,0,0,0,0,0,0,0
0,0,0,0,0,0,0,0,0
0,0,0,0,0,0,0,0,0
0,0,0,0,0,0,0,0,0
0,0,0,0,0,0,0,0,0
0,0,0,0,0,0,0,0,0
0,0,0,0,0,0,0,0,0
0,0,0,0,0,0,0,0,0
168958,666,4,2,1,1,7,0,0
165591,478,4,4,3,1,8,0,0
169752,798,4,2,1,1,7,0,0
0,0,0,0,0,0,0,0,0
169086,696,4,2,1,1,7,0,0
170019,772,4,2,1,1,7,0,0
0,0,0,0,0,0,0,0,0
169371,674,4,2,1,1,7,0,0
0,0,0,0,0,0,0,0,0
0,0,0,0,0,0,0,0,0
0,0,0,0,0,0,0,0,0
166194,481,4,4,3,1,8,0,0
0,0,0,0,0,0,0,0,0
168331,592,4,2,1,1,7,0,0
166015,478,4,4,3,1,8,0,0
169210,733,4,2,1,1,7,0,0
168511,612,4,2,1,1,7,0,0
0,0,0,0,0,0,0,0,0
164205,466,4,2,1,1,7,0,0
170101,832,4,2,1,1,7,0,0
169324,737,4,2,1,1,7,0,0
168721,664,4,2,1,1,7,0,0
169426,737,4,2,1,1,7,0,0
169222,714,4,2,1,1,7,0,0
0,0,0,0,0,0,0,0,0
169183,698,4,2,1,1,7,0,0
0,0,0,0,0,0,0,0,0
169413,738,4,2,1,1,7,0,0
166698,481,4,4,3,1,8,0,0
0,0,0,0,0,0,0,0,0
0,0,0,0,0,0,0,0,0
0,0,0,0,0,0,0,0,0
164576,473,4,4,1,3,7,0,0
0,0,0,0,0,0,0,0,0
168387,509,4,2,1,1,7,0,0
0,0,0,0,0,0,0,0,0
0,0,0,0,0,0,0,0,0
0,0,0,0,0,0,0,0,0
0,0,0,0,0,0,0,0,0
0,0,0,0,0,0,0,0,0
0,0,0,0,0,0,0,0,0
163316,470,4,2,1,1,7,0,0
0,0,0,0,0,0,0,0,0
165578,477,4,4,3,1,8,0,0
0,0,0,0,0,0,0,0,0
0,0,0,0,0,0,0,0,0
175444,878,4,4,3,1,8,0,0
0,0,0,0,0,0,0,0,0
0,0,0,0,0,0,0,0,0
164640,470,4,2,1,1,7,0,0
0,0,0,0,0,0,0,0,0
0,0,0,0,0,0,0,0,0
167339,501,4,6,3,3,8,0,0
0,0,0,0,0,0,0,0,0
0,0,0,0,0,0,0,0,0
3766,44,0,2,0,2,1,0,0
165285,470,4,2,1,1,7,0,0
0,0,0,0,0,0,0,0,0
165212,466,4,2,1,1,7,0,0
165445,477,4,4,3,1,8,0,0
0,0,0,0,0,0,0,0,0
0,0,0,0,0,0,0,0,0
0,0,0,0,0,0,0,0,0
166778,485,4,4,3,1,9,0,0
0,0,0,0,0,0,0,0,0
0,0,0,0,0,0,0,0,0
0,0,0,0,0,0,0,0,0
0,0,0,0,0,0,0,0,0
0,0,0,0,0,0,0,0,0
0,0,0,0,0,0,0,0,0
0,0,0,0,0,0,0,0,0
570385,2069,4,245,13,232,19,1,0
0,0,0,0,0,0,0,0,0
0,0,0,0,0,0,0,0,0
0,0,0,0,0,0,0,0,0
167106,576,4,4,3,1,8,1,0
166099,492,4,4,3,1,8,1,0
0,0,0,0,0,0,0,0,0
0,0,0,0,0,0,0,0,0
0,0,0,0,0,0,0,0,0
0,0,0,0,0,0,0,0,0
0,0,0,0,0,0,0,0,0
0,0,0,0,0,0,0,0,0
0,0,0,0,0,0,0,0,0
0,0,0,0,0,0,0,0,0
0,0,0,0,0,0,0,0,0
0,0,0,0,0,0,0,0,0
0,0,0,0,0,0,0,0,0
0,0,0,0,0,0,0,0,0
0,0,0,0,0,0,0,0,0
0,0,0,0,0,0,0,0,0
16244,57,0,2,1,1,0,1,0
0,0,0,0,0,0,0,0,0
0,0,0,0,0,0,0,0,0
70700,88,0,1,0,1,0,0,0
0,0,0,0,0,0,0,0,0
0,0,0,0,0,0,0,0,0
0,0,0,0,0,0,0,0,0
0,0,0,0,0,0,0,0,0
0,0,0,0,0,0,0,0,0
0,0,0,0,0,0,0,0,0
9495,42,1,1,1,0,0,0,0
0,0,0,0,0,0,0,0,0
0,0,0,0,0,0,0,0,0
0,0,0,0,0,0,0,0,0
0,0,0,0,0,0,0,0,0
0,0,0,0,0,0,0,0,0
0,0,0,0,0,0,0,0,0
0,0,0,0,0,0,0,0,0
0,0,0,0,0,0,0,0,0
0,0,0,0,0,0,0,0,0
0,0,0,0,0,0,0,0,0
0,0,0,0,0,0,0,0,0
0,0,0,0,0,0,0,0,0
0,0,0,0,0,0,0,0,0
0,0,0,0,0,0,0,0,0
0,0,0,0,0,0,0,0,0
0,0,0,0,0,0,0,0,0
0,0,0,0,0,0,0,0,0
0,0,0,0,0,0,0,0,0
0,0,0,0,0,0,0,0,0
0,0,0,0,0,0,0,0,0
0,0,0,0,0,0,0,0,0
0,0,0,0,0,0,0,0,0
0,0,0,0,0,0,0,0,0
0,0,0,0,0,0,0,0,0
0,0,0,0,0,0,0,0,0
0,0,0,0,0,0,0,0,0
0,0,0,0,0,0,0,0,0
0,0,0,0,0,0,0,0,0
0,0,0,0,0,0,0,0,0
0,0,0,0,0,0,0,0,0
0,0,0,0,0,0,0,0,0
0,0,0,0,0,0,0,0,0
0,0,0,0,0,0,0,0,0
0,0,0,0,0,0,0,0,0
0,0,0,0,0,0,0,0,0
0,0,0,0,0,0,0,0,0
0,0,0,0,0,0,0,0,0
0,0,0,0,0,0,0,0,0
0,0,0,0,0,0,0,0,0
0,0,0,0,0,0,0,0,0
0,0,0,0,0,0,0,0,0
0,0,0,0,0,0,0,0,0
0,0,0,0,0,0,0,0,0
0,0,0,0,0,0,0,0,0
0,0,0,0,0,0,0,0,0
0,0,0,0,0,0,0,0,0
0,0,0,0,0,0,0,0,0
0,0,0,0,0,0,0,0,0
0,0,0,0,0,0,0,0,0
0,0,0,0,0,0,0,0,0
0,0,0,0,0,0,0,0,0
0,0,0,0,0,0,0,0,0
0,0,0,0,0,0,0,0,0
0,0,0,0,0,0,0,0,0
0,0,0,0,0,0,0,0,0
0,0,0,0,0,0,0,0,0
0,0,0,0,0,0,0,0,0
0,0,0,0,0,0,0,0,0
0,0,0,0,0,0,0,0,0
0,0,0,0,0,0,0,0,0
0,0,0,0,0,0,0,0,0
0,0,0,0,0,0,0,0,0
0,0,0,0,0,0,0,0,0
0,0,0,0,0,0,0,0,0
0,0,0,0,0,0,0,0,0
0,0,0,0,0,0,0,0,0
0,0,0,0,0,0,0,0,0
0,0,0,0,0,0,0,0,0
0,0,0,0,0,0,0,0,0
0,0,0,0,0,0,0,0,0
0,0,0,0,0,0,0,0,0
0,0,0,0,0,0,0,0,0
0,0,0,0,0,0,0,0,0
0,0,0,0,0,0,0,0,0
0,0,0,0,0,0,0,0,0
0,0,0,0,0,0,0,0,0
0,0,0,0,0,0,0,0,0
0,0,0,0,0,0,0,0,0
0,0,0,0,0,0,0,0,0
0,0,0,0,0,0,0,0,0
0,0,0,0,0,0,0,0,0
0,0,0,0,0,0,0,0,0
0,0,0,0,0,0,0,0,0
0,0,0,0,0,0,0,0,0
0,0,0,0,0,0,0,0,0
0,0,0,0,0,0,0,0,0
0,0,0,0,0,0,0,0,0
0,0,0,0,0,0,0,0,0
124881,204,2,50,49,1,0,1,0
0,0,0,0,0,0,0,0,0
0,0,0,0,0,0,0,0,0
0,0,0,0,0,0,0,0,0
0,0,0,0,0,0,0,0,0
124881,204,2,50,49,1,0,1,0
0,0,0,0,0,0,0,0,0
0,0,0,0,0,0,0,0,0
0,0,0,0,0,0,0,0,0
0,0,0,0,0,0,0,0,0
0,0,0,0,0,0,0,0,0
0,0,0,0,0,0,0,0,0
125190,204,2,50,49,1,0,1,0
546109,160,1,9,9,0,4,1,0
0,0,0,0,0,0,0,0,0
422672,63,6,1,1,0,2,0,0
422672,63,6,1,1,0,2,0,0
0,0,0,0,0,0,0,0,0
125190,204,2,50,49,1,0,1,0
0,0,0,0,0,0,0,0,0
0,0,0,0,0,0,0,0,0
0,0,0,0,0,0,0,0,0
422672,63,6,1,1,0,2,0,0
422672,63,6,1,1,0,2,0,0
422672,63,6,1,1,0,2,0,0
422672,63,6,1,1,0,2,0,0
422672,63,6,1,1,0,2,0,0
0,0,0,0,0,0,0,0,0
546117,160,1,9,9,0,4,1,0
0,0,0,0,0,0,0,0,0
546109,160,1,9,9,0,4,1,0
0,0,0,0,0,0,0,0,0
0,0,0,0,0,0,0,0,0
0,0,0,0,0,0,0,0,0
0,0,0,0,0,0,0,0,0
0,0,0,0,0,0,0,0,0
0,0,0,0,0,0,0,0,0
0,0,0,0,0,0,0,0,0
0,0,0,0,0,0,0,0,0
0,0,0,0,0,0,0,0,0
0,0,0,0,0,0,0,0,0
0,0,0,0,0,0,0,0,0
0,0,0,0,0,0,0,0,0
0,0,0,0,0,0,0,0,0
0,0,0,0,0,0,0,0,0
0,0,0,0,0,0,0,0,0
0,0,0,0,0,0,0,0,0
0,0,0,0,0,0,0,0,0
0,0,0,0,0,0,0,0,0
0,0,0,0,0,0,0,0,0
0,0,0,0,0,0,0,0,0
0,0,0,0,0,0,0,0,0
0,0,0,0,0,0,0,0,0
0,0,0,0,0,0,0,0,0
0,0,0,0,0,0,0,0,0
0,0,0,0,0,0,0,0,0
0,0,0,0,0,0,0,0,0
0,0,0,0,0,0,0,0,0
0,0,0,0,0,0,0,0,0
0,0,0,0,0,0,0,0,0
0,0,0,0,0,0,0,0,0
0,0,0,0,0,0,0,0,0
0,0,0,0,0,0,0,0,0
0,0,0,0,0,0,0,0,0
0,0,0,0,0,0,0,0,0
0,0,0,0,0,0,0,0,0
0,0,0,0,0,0,0,0,0
0,0,0,0,0,0,0,0,0
0,0,0,0,0,0,0,0,0
0,0,0,0,0,0,0,0,0
0,0,0,0,0,0,0,0,0
0,0,0,0,0,0,0,0,0
0,0,0,0,0,0,0,0,0
0,0,0,0,0,0,0,0,0
0,0,0,0,0,0,0,0,0
0,0,0,0,0,0,0,0,0
0,0,0,0,0,0,0,0,0
0,0,0,0,0,0,0,0,0
0,0,0,0,0,0,0,0,0
0,0,0,0,0,0,0,0,0
0,0,0,0,0,0,0,0,0
0,0,0,0,0,0,0,0,0
0,0,0,0,0,0,0,0,0
0,0,0,0,0,0,0,0,0
0,0,0,0,0,0,0,0,0
0,0,0,0,0,0,0,0,0
0,0,0,0,0,0,0,0,0
0,0,0,0,0,0,0,0,0
0,0,0,0,0,0,0,0,0
0,0,0,0,0,0,0,0,0
0,0,0,0,0,0,0,0,0
0,0,0,0,0,0,0,0,0
0,0,0,0,0,0,0,0,0
0,0,0,0,0,0,0,0,0
0,0,0,0,0,0,0,0,0
0,0,0,0,0,0,0,0,0
0,0,0,0,0,0,0,0,0
0,0,0,0,0,0,0,0,0
0,0,0,0,0,0,0,0,0
0,0,0,0,0,0,0,0,0
0,0,0,0,0,0,0,0,0
0,0,0,0,0,0,0,0,0
0,0,0,0,0,0,0,0,0
0,0,0,0,0,0,0,0,0
0,0,0,0,0,0,0,0,0
0,0,0,0,0,0,0,0,0
0,0,0,0,0,0,0,0,0
0,0,0,0,0,0,0,0,0
0,0,0,0,0,0,0,0,0
0,0,0,0,0,0,0,0,0
51328,53,3,0,0,0,0,1,0
51328,53,3,0,0,0,0,1,0
0,0,0,0,0,0,0,0,0
0,0,0,0,0,0,0,0,0
0,0,0,0,0,0,0,0,0
0,0,0,0,0,0,0,0,0
415619,62,4,3,3,0,2,1,0
415619,62,4,3,3,0,2,1,0
0,0,0,0,0,0,0,0,0
0,0,0,0,0,0,0,0,0
0,0,0,0,0,0,0,0,0
0,0,0,0,0,0,0,0,0
0,0,0,0,0,0,0,0,0
0,0,0,0,0,0,0,0,0
0,0,0,0,0,0,0,0,0
0,0,0,0,0,0,0,0,0
0,0,0,0,0,0,0,0,0
0,0,0,0,0,0,0,0,0
0,0,0,0,0,0,0,0,0
0,0,0,0,0,0,0,0,0
0,0,0,0,0,0,0,0,0
0,0,0,0,0,0,0,0,0
0,0,0,0,0,0,0,0,0
0,0,0,0,0,0,0,0,0
0,0,0,0,0,0,0,0,0
0,0,0,0,0,0,0,0,0
0,0,0,0,0,0,0,0,0
0,0,0,0,0,0,0,0,0
0,0,0,0,0,0,0,0,0
0,0,0,0,0,0,0,0,0
0,0,0,0,0,0,0,0,0
0,0,0,0,0,0,0,0,0
0,0,0,0,0,0,0,0,0
0,0,0,0,0,0,0,0,0
0,0,0,0,0,0,0,0,0
0,0,0,0,0,0,0,0,0
0,0,0,0,0,0,0,0,0
0,0,0,0,0,0,0,0,0
0,0,0,0,0,0,0,0,0
0,0,0,0,0,0,0,0,0
0,0,0,0,0,0,0,0,0
0,0,0,0,0,0,0,0,0
0,0,0,0,0,0,0,0,0
0,0,0,0,0,0,0,0,0
0,0,0,0,0,0,0,0,0
0,0,0,0,0,0,0,0,0
0,0,0,0,0,0,0,0,0
0,0,0,0,0,0,0,0,0
0,0,0,0,0,0,0,0,0
0,0,0,0,0,0,0,0,0
0,0,0,0,0,0,0,0,0
0,0,0,0,0,0,0,0,0
0,0,0,0,0,0,0,0,0
0,0,0,0,0,0,0,0,0
101834,151,4,4,4,0,2,1,0
0,0,0,0,0,0,0,0,0
0,0,0,0,0,0,0,0,0
0,0,0,0,0,0,0,0,0
0,0,0,0,0,0,0,0,0
0,0,0,0,0,0,0,0,0
0,0,0,0,0,0,0,0,0
0,0,0,0,0,0,0,0,0
0,0,0,0,0,0,0,0,0
0,0,0,0,0,0,0,0,0
0,0,0,0,0,0,0,0,0
0,0,0,0,0,0,0,0,0
0,0,0,0,0,0,0,0,0
0,0,0,0,0,0,0,0,0
0,0,0,0,0,0,0,0,0
0,0,0,0,0,0,0,0,0
0,0,0,0,0,0,0,0,0
0,0,0,0,0,0,0,0,0
0,0,0,0,0,0,0,0,0
0,0,0,0,0,0,0,0,0
0,0,0,0,0,0,0,0,0
0,0,0,0,0,0,0,0,0
0,0,0,0,0,0,0,0,0
0,0,0,0,0,0,0,0,0
0,0,0,0,0,0,0,0,0
0,0,0,0,0,0,0,0,0
0,0,0,0,0,0,0,0,0
0,0,0,0,0,0,0,0,0
0,0,0,0,0,0,0,0,0
0,0,0,0,0,0,0,0,0
0,0,0,0,0,0,0,0,0
0,0,0,0,0,0,0,0,0
0,0,0,0,0,0,0,0,0
0,0,0,0,0,0,0,0,0
0,0,0,0,0,0,0,0,0
0,0,0,0,0,0,0,0,0
0,0,0,0,0,0,0,0,0
0,0,0,0,0,0,0,0,0
0,0,0,0,0,0,0,0,0
415619,62,4,3,3,0,2,1,0
415619,62,4,3,3,0,2,1,0
415619,62,4,3,3,0,2,1,0
415619,62,4,3,3,0,2,1,0
415619,62,4,3,3,0,2,1,0
0,0,0,0,0,0,0,0,0
0,0,0,0,0,0,0,0,0
0,0,0,0,0,0,0,0,0
51328,53,3,0,0,0,0,1,0
0,0,0,0,0,0,0,0,0
51328,53,3,0,0,0,0,1,0
0,0,0,0,0,0,0,0,0
0,0,0,0,0,0,0,0,0
51328,53,3,0,0,0,0,1,0
0,0,0,0,0,0,0,0,0
0,0,0,0,0,0,0,0,0
0,0,0,0,0,0,0,0,0
0,0,0,0,0,0,0,0,0
0,0,0,0,0,0,0,0,0
0,0,0,0,0,0,0,0,0
0,0,0,0,0,0,0,0,0
0,0,0,0,0,0,0,0,0
0,0,0,0,0,0,0,0,0
420901,62,4,3,3,0,2,1,0
420901,62,4,3,3,0,2,1,0
0,0,0,0,0,0,0,0,0
0,0,0,0,0,0,0,0,0
0,0,0,0,0,0,0,0,0
0,0,0,0,0,0,0,0,0
0,0,0,0,0,0,0,0,0
0,0,0,0,0,0,0,0,0
0,0,0,0,0,0,0,0,0
0,0,0,0,0,0,0,0,0
0,0,0,0,0,0,0,0,0
0,0,0,0,0,0,0,0,0
0,0,0,0,0,0,0,0,0
0,0,0,0,0,0,0,0,0
0,0,0,0,0,0,0,0,0
0,0,0,0,0,0,0,0,0
0,0,0,0,0,0,0,0,0
0,0,0,0,0,0,0,0,0
0,0,0,0,0,0,0,0,0
0,0,0,0,0,0,0,0,0
0,0,0,0,0,0,0,0,0
0,0,0,0,0,0,0,0,0
0,0,0,0,0,0,0,0,0
0,0,0,0,0,0,0,0,0
0,0,0,0,0,0,0,0,0
0,0,0,0,0,0,0,0,0
35188,113,3,13,3,10,1,0,0
35188,113,3,13,3,10,1,0,0
0,0,0,0,0,0,0,0,0
0,0,0,0,0,0,0,0,0
0,0,0,0,0,0,0,0,0
0,0,0,0,0,0,0,0,0
0,0,0,0,0,0,0,0,0
0,0,0,0,0,0,0,0,0
0,0,0,0,0,0,0,0,0
0,0,0,0,0,0,0,0,0
0,0,0,0,0,0,0,0,0
0,0,0,0,0,0,0,0,0
0,0,0,0,0,0,0,0,0
0,0,0,0,0,0,0,0,0
0,0,0,0,0,0,0,0,0
0,0,0,0,0,0,0,0,0
0,0,0,0,0,0,0,0,0
0,0,0,0,0,0,0,0,0
0,0,0,0,0,0,0,0,0
0,0,0,0,0,0,0,0,0
0,0,0,0,0,0,0,0,0
0,0,0,0,0,0,0,0,0
0,0,0,0,0,0,0,0,0
0,0,0,0,0,0,0,0,0
0,0,0,0,0,0,0,0,0
0,0,0,0,0,0,0,0,0
0,0,0,0,0,0,0,0,0
0,0,0,0,0,0,0,0,0
0,0,0,0,0,0,0,0,0
0,0,0,0,0,0,0,0,0
0,0,0,0,0,0,0,0,0
0,0,0,0,0,0,0,0,0
0,0,0,0,0,0,0,0,0
0,0,0,0,0,0,0,0,0
225347,71,3,2,1,1,2,1,0
17640,77,1,3,0,3,2,1,0
84271,28,2,0,0,0,0,0,0
0,0,0,0,0,0,0,0,0
0,0,0,0,0,0,0,0,0
0,0,0,0,0,0,0,0,0
0,0,0,0,0,0,0,0,0
0,0,0,0,0,0,0,0,0
0,0,0,0,0,0,0,0,0
0,0,0,0,0,0,0,0,0
0,0,0,0,0,0,0,0,0
0,0,0,0,0,0,0,0,0
0,0,0,0,0,0,0,0,0
0,0,0,0,0,0,0,0,0
48009,76,2,1,1,0,3,1,0
11911,56,0,2,1,1,0,0,0
271496,265,1,7,2,5,0,1,0
0,0,0,0,0,0,0,0,0
0,0,0,0,0,0,0,0,0
0,0,0,0,0,0,0,0,0
0,0,0,0,0,0,0,0,0
0,0,0,0,0,0,0,0,0
0,0,0,0,0,0,0,0,0
0,0,0,0,0,0,0,0,0
0,0,0,0,0,0,0,0,0
0,0,0,0,0,0,0,0,0
0,0,0,0,0,0,0,0,0
0,0,0,0,0,0,0,0,0
0,0,0,0,0,0,0,0,0
0,0,0,0,0,0,0,0,0
0,0,0,0,0,0,0,0,0
239796,403,2,25,18,7,17,0,0
0,0,0,0,0,0,0,0,0
0,0,0,0,0,0,0,0,0
0,0,0,0,0,0,0,0,0
0,0,0,0,0,0,0,0,0
0,0,0,0,0,0,0,0,0
0,0,0,0,0,0,0,0,0
0,0,0,0,0,0,0,0,0
0,0,0,0,0,0,0,0,0
0,0,0,0,0,0,0,0,0
0,0,0,0,0,0,0,0,0
0,0,0,0,0,0,0,0,0
0,0,0,0,0,0,0,0,0
0,0,0,0,0,0,0,0,0
0,0,0,0,0,0,0,0,0
0,0,0,0,0,0,0,0,0
0,0,0,0,0,0,0,0,0
0,0,0,0,0,0,0,0,0
0,0,0,0,0,0,0,0,0
0,0,0,0,0,0,0,0,0
0,0,0,0,0,0,0,0,0
0,0,0,0,0,0,0,0,0
0,0,0,0,0,0,0,0,0
0,0,0,0,0,0,0,0,0
0,0,0,0,0,0,0,0,0
0,0,0,0,0,0,0,0,0
0,0,0,0,0,0,0,0,0
0,0,0,0,0,0,0,0,0
0,0,0,0,0,0,0,0,0
0,0,0,0,0,0,0,0,0
0,0,0,0,0,0,0,0,0
635476,155,1,5,3,2,3,1,0
0,0,0,0,0,0,0,0,0
0,0,0,0,0,0,0,0,0
0,0,0,0,0,0,0,0,0
0,0,0,0,0,0,0,0,0
164679,478,4,4,3,1,8,0,0
0,0,0,0,0,0,0,0,0
0,0,0,0,0,0,0,0,0
0,0,0,0,0,0,0,0,0
0,0,0,0,0,0,0,0,0
0,0,0,0,0,0,0,0,0
0,0,0,0,0,0,0,0,0
0,0,0,0,0,0,0,0,0
0,0,0,0,0,0,0,0,0
0,0,0,0,0,0,0,0,0
0,0,0,0,0,0,0,0,0
0,0,0,0,0,0,0,0,0
0,0,0,0,0,0,0,0,0
61703,290,1,6,4,2,0,0,0
0,0,0,0,0,0,0,0,0
0,0,0,0,0,0,0,0,0
0,0,0,0,0,0,0,0,0
0,0,0,0,0,0,0,0,0
0,0,0,0,0,0,0,0,0
0,0,0,0,0,0,0,0,0
0,0,0,0,0,0,0,0,0
0,0,0,0,0,0,0,0,0
0,0,0,0,0,0,0,0,0
0,0,0,0,0,0,0,0,0
0,0,0,0,0,0,0,0,0
0,0,0,0,0,0,0,0,0
0,0,0,0,0,0,0,0,0
0,0,0,0,0,0,0,0,0
0,0,0,0,0,0,0,0,0
0,0,0,0,0,0,0,0,0
0,0,0,0,0,0,0,0,0
0,0,0,0,0,0,0,0,0
0,0,0,0,0,0,0,0,0
0,0,0,0,0,0,0,0,0
0,0,0,0,0,0,0,0,0
0,0,0,0,0,0,0,0,0
0,0,0,0,0,0,0,0,0
0,0,0,0,0,0,0,0,0
0,0,0,0,0,0,0,0,0
203143,675,4,20,1,19,7,0,0
0,0,0,0,0,0,0,0,0
0,0,0,0,0,0,0,0,0
0,0,0,0,0,0,0,0,0
0,0,0,0,0,0,0,0,0
0,0,0,0,0,0,0,0,0
0,0,0,0,0,0,0,0,0
0,0,0,0,0,0,0,0,0
0,0,0,0,0,0,0,0,0
241815,104,4,5,5,0,2,1,0
0,0,0,0,0,0,0,0,0
0,0,0,0,0,0,0,0,0
0,0,0,0,0,0,0,0,0
0,0,0,0,0,0,0,0,0
0,0,0,0,0,0,0,0,0
0,0,0,0,0,0,0,0,0
0,0,0,0,0,0,0,0,0
0,0,0,0,0,0,0,0,0
0,0,0,0,0,0,0,0,0
0,0,0,0,0,0,0,0,0
0,0,0,0,0,0,0,0,0
0,0,0,0,0,0,0,0,0
0,0,0,0,0,0,0,0,0
0,0,0,0,0,0,0,0,0
0,0,0,0,0,0,0,0,0
0,0,0,0,0,0,0,0,0
0,0,0,0,0,0,0,0,0
0,0,0,0,0,0,0,0,0
0,0,0,0,0,0,0,0,0
0,0,0,0,0,0,0,0,0
0,0,0,0,0,0,0,0,0
0,0,0,0,0,0,0,0,0
0,0,0,0,0,0,0,0,0
0,0,0,0,0,0,0,0,0
0,0,0,0,0,0,0,0,0
0,0,0,0,0,0,0,0,0
0,0,0,0,0,0,0,0,0
0,0,0,0,0,0,0,0,0
0,0,0,0,0,0,0,0,0
0,0,0,0,0,0,0,0,0
159259,686,10,92,86,6,2,1,0
0,0,0,0,0,0,0,0,0
0,0,0,0,0,0,0,0,0
0,0,0,0,0,0,0,0,0
0,0,0,0,0,0,0,0,0
0,0,0,0,0,0,0,0,0
0,0,0,0,0,0,0,0,0
0,0,0,0,0,0,0,0,0
0,0,0,0,0,0,0,0,0
0,0,0,0,0,0,0,0,0
0,0,0,0,0,0,0,0,0
0,0,0,0,0,0,0,0,0
0,0,0,0,0,0,0,0,0
0,0,0,0,0,0,0,0,0
0,0,0,0,0,0,0,0,0
0,0,0,0,0,0,0,0,0
0,0,0,0,0,0,0,0,0
0,0,0,0,0,0,0,0,0
0,0,0,0,0,0,0,0,0
0,0,0,0,0,0,0,0,0
0,0,0,0,0,0,0,0,0
283561,184,6,1,1,0,0,1,0
0,0,0,0,0,0,0,0,0
0,0,0,0,0,0,0,0,0
0,0,0,0,0,0,0,0,0
0,0,0,0,0,0,0,0,0
0,0,0,0,0,0,0,0,0
0,0,0,0,0,0,0,0,0
0,0,0,0,0,0,0,0,0
0,0,0,0,0,0,0,0,0
0,0,0,0,0,0,0,0,0
0,0,0,0,0,0,0,0,0
0,0,0,0,0,0,0,0,0
0,0,0,0,0,0,0,0,0
0,0,0,0,0,0,0,0,0
0,0,0,0,0,0,0,0,0
0,0,0,0,0,0,0,0,0
0,0,0,0,0,0,0,0,0
0,0,0,0,0,0,0,0,0
0,0,0,0,0,0,0,0,0
0,0,0,0,0,0,0,0,0
0,0,0,0,0,0,0,0,0
0,0,0,0,0,0,0,0,0
0,0,0,0,0,0,0,0,0
0,0,0,0,0,0,0,0,0
0,0,0,0,0,0,0,0,0
0,0,0,0,0,0,0,0,0
0,0,0,0,0,0,0,0,0
0,0,0,0,0,0,0,0,0
0,0,0,0,0,0,0,0,0
0,0,0,0,0,0,0,0,0
0,0,0,0,0,0,0,0,0
0,0,0,0,0,0,0,0,0
0,0,0,0,0,0,0,0,0
0,0,0,0,0,0,0,0,0
0,0,0,0,0,0,0,0,0
0,0,0,0,0,0,0,0,0
0,0,0,0,0,0,0,0,0
0,0,0,0,0,0,0,0,0
0,0,0,0,0,0,0,0,0
0,0,0,0,0,0,0,0,0
0,0,0,0,0,0,0,0,0
0,0,0,0,0,0,0,0,0
0,0,0,0,0,0,0,0,0
0,0,0,0,0,0,0,0,0
125056,204,2,50,49,1,0,1,0
125056,204,2,50,49,1,0,1,0
0,0,0,0,0,0,0,0,0
0,0,0,0,0,0,0,0,0
0,0,0,0,0,0,0,0,0
0,0,0,0,0,0,0,0,0
0,0,0,0,0,0,0,0,0
0,0,0,0,0,0,0,0,0
0,0,0,0,0,0,0,0,0
0,0,0,0,0,0,0,0,0
0,0,0,0,0,0,0,0,0
0,0,0,0,0,0,0,0,0
0,0,0,0,0,0,0,0,0
0,0,0,0,0,0,0,0,0
0,0,0,0,0,0,0,0,0
0,0,0,0,0,0,0,0,0
0,0,0,0,0,0,0,0,0
0,0,0,0,0,0,0,0,0
0,0,0,0,0,0,0,0,0
0,0,0,0,0,0,0,0,0
0,0,0,0,0,0,0,0,0
0,0,0,0,0,0,0,0,0
0,0,0,0,0,0,0,0,0
0,0,0,0,0,0,0,0,0
0,0,0,0,0,0,0,0,0
0,0,0,0,0,0,0,0,0
0,0,0,0,0,0,0,0,0
0,0,0,0,0,0,0,0,0
25086,67,2,1,1,0,2,0,0
0,0,0,0,0,0,0,0,0
0,0,0,0,0,0,0,0,0
0,0,0,0,0,0,0,0,0
0,0,0,0,0,0,0,0,0
0,0,0,0,0,0,0,0,0
0,0,0,0,0,0,0,0,0
0,0,0,0,0,0,0,0,0
9943,33,1,0,0,0,2,0,0
25086,67,2,1,1,0,2,0,0
25086,67,2,1,1,0,2,0,0
0,0,0,0,0,0,0,0,0
0,0,0,0,0,0,0,0,0
0,0,0,0,0,0,0,0,0
3829,44,0,2,0,2,1,0,0
9943,33,1,0,0,0,2,0,0
0,0,0,0,0,0,0,0,0
0,0,0,0,0,0,0,0,0
0,0,0,0,0,0,0,0,0
9943,33,1,0,0,0,2,0,0
9943,33,1,0,0,0,2,0,0
0,0,0,0,0,0,0,0,0
0,0,0,0,0,0,0,0,0
0,0,0,0,0,0,0,0,0
0,0,0,0,0,0,0,0,0
0,0,0,0,0,0,0,0,0
0,0,0,0,0,0,0,0,0
232881,64,4,3,3,0,2,1,0
0,0,0,0,0,0,0,0,0
0,0,0,0,0,0,0,0,0
0,0,0,0,0,0,0,0,0
232881,64,4,3,3,0,2,1,0
232881,64,4,3,3,0,2,1,0
0,0,0,0,0,0,0,0,0
0,0,0,0,0,0,0,0,0
232881,64,4,3,3,0,2,1,0
0,0,0,0,0,0,0,0,0
0,0,0,0,0,0,0,0,0
0,0,0,0,0,0,0,0,0
0,0,0,0,0,0,0,0,0
0,0,0,0,0,0,0,0,0
0,0,0,0,0,0,0,0,0
0,0,0,0,0,0,0,0,0
0,0,0,0,0,0,0,0,0
243613,152,4,4,4,0,1,1,0
0,0,0,0,0,0,0,0,0
243595,152,4,4,4,0,1,1,0
243595,152,4,4,4,0,1,1,0
243595,152,4,4,4,0,1,1,0
0,0,0,0,0,0,0,0,0
0,0,0,0,0,0,0,0,0
0,0,0,0,0,0,0,0,0
0,0,0,0,0,0,0,0,0
0,0,0,0,0,0,0,0,0
1519539,86,4,4,4,0,4,1,0
1519539,86,4,4,4,0,4,1,0
0,0,0,0,0,0,0,0,0
0,0,0,0,0,0,0,0,0
1519539,86,4,4,4,0,4,1,0
1431153,85,4,4,4,0,4,1,0
1519383,85,4,4,4,0,4,1,0
1519539,86,4,4,4,0,4,1,0
1519383,85,4,4,4,0,4,1,0
1431153,85,4,4,4,0,4,1,0
1430997,84,4,4,4,0,4,1,0
0,0,0,0,0,0,0,0,0
1519383,85,4,4,4,0,4,1,0
1430997,84,4,4,4,0,4,1,0
0,0,0,0,0,0,0,0,0
0,0,0,0,0,0,0,0,0
0,0,0,0,0,0,0,0,0
0,0,0,0,0,0,0,0,0
0,0,0,0,0,0,0,0,0
0,0,0,0,0,0,0,0,0
0,0,0,0,0,0,0,0,0
0,0,0,0,0,0,0,0,0
0,0,0,0,0,0,0,0,0
0,0,0,0,0,0,0,0,0
0,0,0,0,0,0,0,0,0
0,0,0,0,0,0,0,0,0
0,0,0,0,0,0,0,0,0
0,0,0,0,0,0,0,0,0
0,0,0,0,0,0,0,0,0
0,0,0,0,0,0,0,0,0
0,0,0,0,0,0,0,0,0
0,0,0,0,0,0,0,0,0
3835,44,0,2,0,2,1,0,0
0,0,0,0,0,0,0,0,0
0,0,0,0,0,0,0,0,0
0,0,0,0,0,0,0,0,0
0,0,0,0,0,0,0,0,0
25087,67,2,1,1,0,2,0,0
0,0,0,0,0,0,0,0,0
0,0,0,0,0,0,0,0,0
0,0,0,0,0,0,0,0,0
0,0,0,0,0,0,0,0,0
0,0,0,0,0,0,0,0,0
25087,67,2,1,1,0,2,0,0
0,0,0,0,0,0,0,0,0
0,0,0,0,0,0,0,0,0
0,0,0,0,0,0,0,0,0
0,0,0,0,0,0,0,0,0
0,0,0,0,0,0,0,0,0
0,0,0,0,0,0,0,0,0
0,0,0,0,0,0,0,0,0
0,0,0,0,0,0,0,0,0
0,0,0,0,0,0,0,0,0
0,0,0,0,0,0,0,0,0
0,0,0,0,0,0,0,0,0
0,0,0,0,0,0,0,0,0
0,0,0,0,0,0,0,0,0
0,0,0,0,0,0,0,0,0
0,0,0,0,0,0,0,0,0
0,0,0,0,0,0,0,0,0
0,0,0,0,0,0,0,0,0
0,0,0,0,0,0,0,0,0
0,0,0,0,0,0,0,0,0
0,0,0,0,0,0,0,0,0
0,0,0,0,0,0,0,0,0
51332,53,3,0,0,0,0,1,0
51332,53,3,0,0,0,0,1,0
0,0,0,0,0,0,0,0,0
0,0,0,0,0,0,0,0,0
0,0,0,0,0,0,0,0,0
0,0,0,0,0,0,0,0,0
0,0,0,0,0,0,0,0,0
0,0,0,0,0,0,0,0,0
0,0,0,0,0,0,0,0,0
0,0,0,0,0,0,0,0,0
0,0,0,0,0,0,0,0,0
0,0,0,0,0,0,0,0,0
0,0,0,0,0,0,0,0,0
0,0,0,0,0,0,0,0,0
0,0,0,0,0,0,0,0,0
0,0,0,0,0,0,0,0,0
0,0,0,0,0,0,0,0,0
0,0,0,0,0,0,0,0,0
0,0,0,0,0,0,0,0,0
0,0,0,0,0,0,0,0,0
0,0,0,0,0,0,0,0,0
0,0,0,0,0,0,0,0,0
0,0,0,0,0,0,0,0,0
0,0,0,0,0,0,0,0,0
0,0,0,0,0,0,0,0,0
0,0,0,0,0,0,0,0,0
0,0,0,0,0,0,0,0,0
0,0,0,0,0,0,0,0,0
0,0,0,0,0,0,0,0,0
0,0,0,0,0,0,0,0,0
0,0,0,0,0,0,0,0,0
7909,93,3,0,0,0,0,0,0
0,0,0,0,0,0,0,0,0
0,0,0,0,0,0,0,0,0
0,0,0,0,0,0,0,0,0
0,0,0,0,0,0,0,0,0
0,0,0,0,0,0,0,0,0
0,0,0,0,0,0,0,0,0
0,0,0,0,0,0,0,0,0
0,0,0,0,0,0,0,0,0
0,0,0,0,0,0,0,0,0
0,0,0,0,0,0,0,0,0
0,0,0,0,0,0,0,0,0
0,0,0,0,0,0,0,0,0
0,0,0,0,0,0,0,0,0
0,0,0,0,0,0,0,0,0
0,0,0,0,0,0,0,0,0
0,0,0,0,0,0,0,0,0
0,0,0,0,0,0,0,0,0
0,0,0,0,0,0,0,0,0
35881,272,7,43,15,28,2,1,0
0,0,0,0,0,0,0,0,0
30048,51,2,0,0,0,2,0,0
36585,221,2,49,3,46,0,1,0
0,0,0,0,0,0,0,0,0
0,0,0,0,0,0,0,0,0
0,0,0,0,0,0,0,0,0
160893,54,3,0,0,0,0,0,0
0,0,0,0,0,0,0,0,0
0,0,0,0,0,0,0,0,0
0,0,0,0,0,0,0,0,0
0,0,0,0,0,0,0,0,0
0,0,0,0,0,0,0,0,0
70253,47,4,0,0,0,1,0,0
0,0,0,0,0,0,0,0,0
0,0,0,0,0,0,0,0,0
77782,101,1,4,2,2,0,0,0
0,0,0,0,0,0,0,0,0
0,0,0,0,0,0,0,0,0
0,0,0,0,0,0,0,0,0
0,0,0,0,0,0,0,0,0
0,0,0,0,0,0,0,0,0
47618,75,2,1,1,0,3,1,0
0,0,0,0,0,0,0,0,0
0,0,0,0,0,0,0,0,0
102664,76,4,6,6,0,5,1,0
0,0,0,0,0,0,0,0,0
0,0,0,0,0,0,0,0,0
0,0,0,0,0,0,0,0,0
0,0,0,0,0,0,0,0,0
0,0,0,0,0,0,0,0,0
0,0,0,0,0,0,0,0,0
0,0,0,0,0,0,0,0,0
0,0,0,0,0,0,0,0,0
0,0,0,0,0,0,0,0,0
0,0,0,0,0,0,0,0,0
0,0,0,0,0,0,0,0,0
0,0,0,0,0,0,0,0,0
0,0,0,0,0,0,0,0,0
0,0,0,0,0,0,0,0,0
0,0,0,0,0,0,0,0,0
0,0,0,0,0,0,0,0,0
0,0,0,0,0,0,0,0,0
0,0,0,0,0,0,0,0,0
0,0,0,0,0,0,0,0,0
0,0,0,0,0,0,0,0,0
0,0,0,0,0,0,0,0,0
0,0,0,0,0,0,0,0,0
0,0,0,0,0,0,0,0,0
94776,54,0,0,0,0,0,0,0
0,0,0,0,0,0,0,0,0
0,0,0,0,0,0,0,0,0
0,0,0,0,0,0,0,0,0
0,0,0,0,0,0,0,0,0
0,0,0,0,0,0,0,0,0
0,0,0,0,0,0,0,0,0
0,0,0,0,0,0,0,0,0
0,0,0,0,0,0,0,0,0
0,0,0,0,0,0,0,0,0
0,0,0,0,0,0,0,0,0
0,0,0,0,0,0,0,0,0
0,0,0,0,0,0,0,0,0
0,0,0,0,0,0,0,0,0
0,0,0,0,0,0,0,0,0
0,0,0,0,0,0,0,0,0
0,0,0,0,0,0,0,0,0
0,0,0,0,0,0,0,0,0
0,0,0,0,0,0,0,0,0
0,0,0,0,0,0,0,0,0
0,0,0,0,0,0,0,0,0
0,0,0,0,0,0,0,0,0
0,0,0,0,0,0,0,0,0
0,0,0,0,0,0,0,0,0
0,0,0,0,0,0,0,0,0
0,0,0,0,0,0,0,0,0
0,0,0,0,0,0,0,0,0
0,0,0,0,0,0,0,0,0
112471,84,1,4,1,3,0,0,0
0,0,0,0,0,0,0,0,0
0,0,0,0,0,0,0,0,0
0,0,0,0,0,0,0,0,0
0,0,0,0,0,0,0,0,0
0,0,0,0,0,0,0,0,0
0,0,0,0,0,0,0,0,0
0,0,0,0,0,0,0,0,0
0,0,0,0,0,0,0,0,0
0,0,0,0,0,0,0,0,0
0,0,0,0,0,0,0,0,0
0,0,0,0,0,0,0,0,0
0,0,0,0,0,0,0,0,0
0,0,0,0,0,0,0,0,0
0,0,0,0,0,0,0,0,0
0,0,0,0,0,0,0,0,0
0,0,0,0,0,0,0,0,0
0,0,0,0,0,0,0,0,0
0,0,0,0,0,0,0,0,0
0,0,0,0,0,0,0,0,0
0,0,0,0,0,0,0,0,0
0,0,0,0,0,0,0,0,0
0,0,0,0,0,0,0,0,0
263222,52,0,4,3,1,0,1,0
263222,52,0,4,3,1,0,1,0
263144,52,0,4,3,1,0,1,0
0,0,0,0,0,0,0,0,0
0,0,0,0,0,0,0,0,0
0,0,0,0,0,0,0,0,0
0,0,0,0,0,0,0,0,0
176789,1944,3,197,170,27,5,0,0
0,0,0,0,0,0,0,0,0
0,0,0,0,0,0,0,0,0
0,0,0,0,0,0,0,0,0
0,0,0,0,0,0,0,0,0
0,0,0,0,0,0,0,0,0
0,0,0,0,0,0,0,0,0
0,0,0,0,0,0,0,0,0
0,0,0,0,0,0,0,0,0
0,0,0,0,0,0,0,0,0
58443,904,9,121,63,58,5,1,0
58443,904,9,121,63,58,5,1,0
0,0,0,0,0,0,0,0,0
0,0,0,0,0,0,0,0,0
0,0,0,0,0,0,0,0,0
0,0,0,0,0,0,0,0,0
0,0,0,0,0,0,0,0,0
0,0,0,0,0,0,0,0,0
0,0,0,0,0,0,0,0,0
0,0,0,0,0,0,0,0,0
0,0,0,0,0,0,0,0,0
27677,293,2,19,13,6,0,0,0
0,0,0,0,0,0,0,0,0
0,0,0,0,0,0,0,0,0
0,0,0,0,0,0,0,0,0
0,0,0,0,0,0,0,0,0
0,0,0,0,0,0,0,0,0
0,0,0,0,0,0,0,0,0
0,0,0,0,0,0,0,0,0
0,0,0,0,0,0,0,0,0
0,0,0,0,0,0,0,0,0
0,0,0,0,0,0,0,0,0
0,0,0,0,0,0,0,0,0
0,0,0,0,0,0,0,0,0
0,0,0,0,0,0,0,0,0
0,0,0,0,0,0,0,0,0
0,0,0,0,0,0,0,0,0
0,0,0,0,0,0,0,0,0
0,0,0,0,0,0,0,0,0
0,0,0,0,0,0,0,0,0
0,0,0,0,0,0,0,0,0
0,0,0,0,0,0,0,0,0
80520,98,2,1,1,0,0,0,0
70255,47,4,0,0,0,1,0,0
0,0,0,0,0,0,0,0,0
0,0,0,0,0,0,0,0,0
0,0,0,0,0,0,0,0,0
0,0,0,0,0,0,0,0,0
0,0,0,0,0,0,0,0,0
0,0,0,0,0,0,0,0,0
0,0,0,0,0,0,0,0,0
70241,47,4,0,0,0,1,0,0
0,0,0,0,0,0,0,0,0
0,0,0,0,0,0,0,0,0
0,0,0,0,0,0,0,0,0
0,0,0,0,0,0,0,0,0
0,0,0,0,0,0,0,0,0
0,0,0,0,0,0,0,0,0
0,0,0,0,0,0,0,0,0
0,0,0,0,0,0,0,0,0
0,0,0,0,0,0,0,0,0
0,0,0,0,0,0,0,0,0
245517,1285,4,25,20,5,0,1,0
0,0,0,0,0,0,0,0,0
10720,83,1,2,2,0,0,0,0
0,0,0,0,0,0,0,0,0
0,0,0,0,0,0,0,0,0
0,0,0,0,0,0,0,0,0
0,0,0,0,0,0,0,0,0
0,0,0,0,0,0,0,0,0
0,0,0,0,0,0,0,0,0
0,0,0,0,0,0,0,0,0
0,0,0,0,0,0,0,0,0
236741,809,2,24,20,4,36,1,0
0,0,0,0,0,0,0,0,0
0,0,0,0,0,0,0,0,0
0,0,0,0,0,0,0,0,0
0,0,0,0,0,0,0,0,0
180288,348,3,21,7,14,22,1,0
9495,42,1,1,1,0,0,0,0
0,0,0,0,0,0,0,0,0
0,0,0,0,0,0,0,0,0
0,0,0,0,0,0,0,0,0
0,0,0,0,0,0,0,0,0
0,0,0,0,0,0,0,0,0
0,0,0,0,0,0,0,0,0
0,0,0,0,0,0,0,0,0
0,0,0,0,0,0,0,0,0
0,0,0,0,0,0,0,0,0
0,0,0,0,0,0,0,0,0
0,0,0,0,0,0,0,0,0
0,0,0,0,0,0,0,0,0
0,0,0,0,0,0,0,0,0
0,0,0,0,0,0,0,0,0
70253,47,4,0,0,0,1,0,0
0,0,0,0,0,0,0,0,0
0,0,0,0,0,0,0,0,0
150548,194,3,2,1,1,5,0,0
0,0,0,0,0,0,0,0,0
0,0,0,0,0,0,0,0,0
0,0,0,0,0,0,0,0,0
70255,47,4,0,0,0,1,0,0
0,0,0,0,0,0,0,0,0
0,0,0,0,0,0,0,0,0
0,0,0,0,0,0,0,0,0
0,0,0,0,0,0,0,0,0
0,0,0,0,0,0,0,0,0
0,0,0,0,0,0,0,0,0
0,0,0,0,0,0,0,0,0
0,0,0,0,0,0,0,0,0
0,0,0,0,0,0,0,0,0
0,0,0,0,0,0,0,0,0
70241,47,4,0,0,0,1,0,0
0,0,0,0,0,0,0,0,0
0,0,0,0,0,0,0,0,0
0,0,0,0,0,0,0,0,0
0,0,0,0,0,0,0,0,0
0,0,0,0,0,0,0,0,0
0,0,0,0,0,0,0,0,0
0,0,0,0,0,0,0,0,0
0,0,0,0,0,0,0,0,0
0,0,0,0,0,0,0,0,0
0,0,0,0,0,0,0,0,0
0,0,0,0,0,0,0,0,0
0,0,0,0,0,0,0,0,0
0,0,0,0,0,0,0,0,0
0,0,0,0,0,0,0,0,0
0,0,0,0,0,0,0,0,0
0,0,0,0,0,0,0,0,0
0,0,0,0,0,0,0,0,0
0,0,0,0,0,0,0,0,0
0,0,0,0,0,0,0,0,0
0,0,0,0,0,0,0,0,0
0,0,0,0,0,0,0,0,0
0,0,0,0,0,0,0,0,0
0,0,0,0,0,0,0,0,0
0,0,0,0,0,0,0,0,0
0,0,0,0,0,0,0,0,0
0,0,0,0,0,0,0,0,0
89857,610,8,136,136,0,4,1,0
0,0,0,0,0,0,0,0,0
0,0,0,0,0,0,0,0,0
0,0,0,0,0,0,0,0,0
0,0,0,0,0,0,0,0,0
0,0,0,0,0,0,0,0,0
0,0,0,0,0,0,0,0,0
0,0,0,0,0,0,0,0,0
0,0,0,0,0,0,0,0,0
0,0,0,0,0,0,0,0,0
0,0,0,0,0,0,0,0,0
0,0,0,0,0,0,0,0,0
0,0,0,0,0,0,0,0,0
0,0,0,0,0,0,0,0,0
0,0,0,0,0,0,0,0,0
0,0,0,0,0,0,0,0,0
0,0,0,0,0,0,0,0,0
0,0,0,0,0,0,0,0,0
0,0,0,0,0,0,0,0,0
0,0,0,0,0,0,0,0,0
0,0,0,0,0,0,0,0,0
0,0,0,0,0,0,0,0,0
0,0,0,0,0,0,0,0,0
0,0,0,0,0,0,0,0,0
0,0,0,0,0,0,0,0,0
0,0,0,0,0,0,0,0,0
0,0,0,0,0,0,0,0,0
0,0,0,0,0,0,0,0,0
0,0,0,0,0,0,0,0,0
0,0,0,0,0,0,0,0,0
0,0,0,0,0,0,0,0,0
0,0,0,0,0,0,0,0,0
0,0,0,0,0,0,0,0,0
0,0,0,0,0,0,0,0,0
0,0,0,0,0,0,0,0,0
0,0,0,0,0,0,0,0,0
0,0,0,0,0,0,0,0,0
0,0,0,0,0,0,0,0,0
0,0,0,0,0,0,0,0,0
0,0,0,0,0,0,0,0,0
0,0,0,0,0,0,0,0,0
0,0,0,0,0,0,0,0,0
0,0,0,0,0,0,0,0,0
0,0,0,0,0,0,0,0,0
0,0,0,0,0,0,0,0,0
0,0,0,0,0,0,0,0,0
0,0,0,0,0,0,0,0,0
0,0,0,0,0,0,0,0,0
0,0,0,0,0,0,0,0,0
0,0,0,0,0,0,0,0,0
0,0,0,0,0,0,0,0,0
0,0,0,0,0,0,0,0,0
0,0,0,0,0,0,0,0,0
0,0,0,0,0,0,0,0,0
0,0,0,0,0,0,0,0,0
0,0,0,0,0,0,0,0,0
0,0,0,0,0,0,0,0,0
0,0,0,0,0,0,0,0,0
0,0,0,0,0,0,0,0,0
0,0,0,0,0,0,0,0,0
0,0,0,0,0,0,0,0,0
0,0,0,0,0,0,0,0,0
0,0,0,0,0,0,0,0,0
0,0,0,0,0,0,0,0,0
0,0,0,0,0,0,0,0,0
0,0,0,0,0,0,0,0,0
0,0,0,0,0,0,0,0,0
9879,48,0,1,0,1,0,0,0
9879,48,0,1,0,1,0,0,0
0,0,0,0,0,0,0,0,0
0,0,0,0,0,0,0,0,0
0,0,0,0,0,0,0,0,0
0,0,0,0,0,0,0,0,0
0,0,0,0,0,0,0,0,0
0,0,0,0,0,0,0,0,0
0,0,0,0,0,0,0,0,0
671497,540,0,4,4,0,2,1,1
0,0,0,0,0,0,0,0,0
0,0,0,0,0,0,0,0,0
0,0,0,0,0,0,0,0,0
0,0,0,0,0,0,0,0,0
6330,64,2,6,4,2,0,1,0
0,0,0,0,0,0,0,0,0
0,0,0,0,0,0,0,0,0
172590,499,4,2,1,1,7,0,0
0,0,0,0,0,0,0,0,0
0,0,0,0,0,0,0,0,0
0,0,0,0,0,0,0,0,0
0,0,0,0,0,0,0,0,0
0,0,0,0,0,0,0,0,0
0,0,0,0,0,0,0,0,0
0,0,0,0,0,0,0,0,0
0,0,0,0,0,0,0,0,0
0,0,0,0,0,0,0,0,0
0,0,0,0,0,0,0,0,0
0,0,0,0,0,0,0,0,0
0,0,0,0,0,0,0,0,0
0,0,0,0,0,0,0,0,0
0,0,0,0,0,0,0,0,0
0,0,0,0,0,0,0,0,0
0,0,0,0,0,0,0,0,0
0,0,0,0,0,0,0,0,0
0,0,0,0,0,0,0,0,0
0,0,0,0,0,0,0,0,0
0,0,0,0,0,0,0,0,0
0,0,0,0,0,0,0,0,0
0,0,0,0,0,0,0,0,0
0,0,0,0,0,0,0,0,0
0,0,0,0,0,0,0,0,0
0,0,0,0,0,0,0,0,0
0,0,0,0,0,0,0,0,0
0,0,0,0,0,0,0,0,0
0,0,0,0,0,0,0,0,0
0,0,0,0,0,0,0,0,0
0,0,0,0,0,0,0,0,0
0,0,0,0,0,0,0,0,0
0,0,0,0,0,0,0,0,0
0,0,0,0,0,0,0,0,0
0,0,0,0,0,0,0,0,0
0,0,0,0,0,0,0,0,0
0,0,0,0,0,0,0,0,0
0,0,0,0,0,0,0,0,0
0,0,0,0,0,0,0,0,0
0,0,0,0,0,0,0,0,0
0,0,0,0,0,0,0,0,0
0,0,0,0,0,0,0,0,0
0,0,0,0,0,0,0,0,0
0,0,0,0,0,0,0,0,0
0,0,0,0,0,0,0,0,0
0,0,0,0,0,0,0,0,0
0,0,0,0,0,0,0,0,0
0,0,0,0,0,0,0,0,0
0,0,0,0,0,0,0,0,0
0,0,0,0,0,0,0,0,0
0,0,0,0,0,0,0,0,0
0,0,0,0,0,0,0,0,0
0,0,0,0,0,0,0,0,0
0,0,0,0,0,0,0,0,0
0,0,0,0,0,0,0,0,0
0,0,0,0,0,0,0,0,0
0,0,0,0,0,0,0,0,0
0,0,0,0,0,0,0,0,0
0,0,0,0,0,0,0,0,0
0,0,0,0,0,0,0,0,0
0,0,0,0,0,0,0,0,0
0,0,0,0,0,0,0,0,0
0,0,0,0,0,0,0,0,0
0,0,0,0,0,0,0,0,0
0,0,0,0,0,0,0,0,0
0,0,0,0,0,0,0,0,0
0,0,0,0,0,0,0,0,0
0,0,0,0,0,0,0,0,0
0,0,0,0,0,0,0,0,0
0,0,0,0,0,0,0,0,0
0,0,0,0,0,0,0,0,0
0,0,0,0,0,0,0,0,0
0,0,0,0,0,0,0,0,0
0,0,0,0,0,0,0,0,0
0,0,0,0,0,0,0,0,0
0,0,0,0,0,0,0,0,0
0,0,0,0,0,0,0,0,0
0,0,0,0,0,0,0,0,0
0,0,0,0,0,0,0,0,0
0,0,0,0,0,0,0,0,0
0,0,0,0,0,0,0,0,0
0,0,0,0,0,0,0,0,0
0,0,0,0,0,0,0,0,0
0,0,0,0,0,0,0,0,0
0,0,0,0,0,0,0,0,0
0,0,0,0,0,0,0,0,0
0,0,0,0,0,0,0,0,0
0,0,0,0,0,0,0,0,0
0,0,0,0,0,0,0,0,0
0,0,0,0,0,0,0,0,0
0,0,0,0,0,0,0,0,0
0,0,0,0,0,0,0,0,0
0,0,0,0,0,0,0,0,0
0,0,0,0,0,0,0,0,0
0,0,0,0,0,0,0,0,0
0,0,0,0,0,0,0,0,0
0,0,0,0,0,0,0,0,0
0,0,0,0,0,0,0,0,0
0,0,0,0,0,0,0,0,0
0,0,0,0,0,0,0,0,0
0,0,0,0,0,0,0,0,0
0,0,0,0,0,0,0,0,0
0,0,0,0,0,0,0,0,0
0,0,0,0,0,0,0,0,0
0,0,0,0,0,0,0,0,0
0,0,0,0,0,0,0,0,0
0,0,0,0,0,0,0,0,0
0,0,0,0,0,0,0,0,0
0,0,0,0,0,0,0,0,0
0,0,0,0,0,0,0,0,0
0,0,0,0,0,0,0,0,0
0,0,0,0,0,0,0,0,0
0,0,0,0,0,0,0,0,0
0,0,0,0,0,0,0,0,0
0,0,0,0,0,0,0,0,0
0,0,0,0,0,0,0,0,0
0,0,0,0,0,0,0,0,0
0,0,0,0,0,0,0,0,0
0,0,0,0,0,0,0,0,0
0,0,0,0,0,0,0,0,0
0,0,0,0,0,0,0,0,0
0,0,0,0,0,0,0,0,0
0,0,0,0,0,0,0,0,0
0,0,0,0,0,0,0,0,0
0,0,0,0,0,0,0,0,0
0,0,0,0,0,0,0,0,0
0,0,0,0,0,0,0,0,0
0,0,0,0,0,0,0,0,0
0,0,0,0,0,0,0,0,0
0,0,0,0,0,0,0,0,0
178959,39,3,0,0,0,2,0,0
178959,39,3,0,0,0,2,0,0
0,0,0,0,0,0,0,0,0
0,0,0,0,0,0,0,0,0
27852,78,3,0,0,0,3,0,0
0,0,0,0,0,0,0,0,0
0,0,0,0,0,0,0,0,0
0,0,0,0,0,0,0,0,0
0,0,0,0,0,0,0,0,0
0,0,0,0,0,0,0,0,0
0,0,0,0,0,0,0,0,0
0,0,0,0,0,0,0,0,0
0,0,0,0,0,0,0,0,0
0,0,0,0,0,0,0,0,0
0,0,0,0,0,0,0,0,0
0,0,0,0,0,0,0,0,0
0,0,0,0,0,0,0,0,0
0,0,0,0,0,0,0,0,0
0,0,0,0,0,0,0,0,0
219126,1790,4,298,32,266,10,1,0
219207,1789,4,298,32,266,10,1,0
219121,1790,4,298,32,266,10,1,0
219092,1790,4,298,32,266,10,1,0
0,0,0,0,0,0,0,0,0
0,0,0,0,0,0,0,0,0
0,0,0,0,0,0,0,0,0
0,0,0,0,0,0,0,0,0
220322,1796,4,298,32,266,14,1,0
220231,1795,4,298,32,266,14,1,0
0,0,0,0,0,0,0,0,0
0,0,0,0,0,0,0,0,0
0,0,0,0,0,0,0,0,0
0,0,0,0,0,0,0,0,0
0,0,0,0,0,0,0,0,0
0,0,0,0,0,0,0,0,0
0,0,0,0,0,0,0,0,0
220330,1796,4,298,32,266,14,1,0
0,0,0,0,0,0,0,0,0
0,0,0,0,0,0,0,0,0
0,0,0,0,0,0,0,0,0
0,0,0,0,0,0,0,0,0
0,0,0,0,0,0,0,0,0
0,0,0,0,0,0,0,0,0
0,0,0,0,0,0,0,0,0
0,0,0,0,0,0,0,0,0
0,0,0,0,0,0,0,0,0
0,0,0,0,0,0,0,0,0
0,0,0,0,0,0,0,0,0
17678,210,1,51,50,1,0,1,0
0,0,0,0,0,0,0,0,0
0,0,0,0,0,0,0,0,0
0,0,0,0,0,0,0,0,0
17678,210,1,51,50,1,0,1,0
0,0,0,0,0,0,0,0,0
0,0,0,0,0,0,0,0,0
0,0,0,0,0,0,0,0,0
0,0,0,0,0,0,0,0,0
0,0,0,0,0,0,0,0,0
0,0,0,0,0,0,0,0,0
0,0,0,0,0,0,0,0,0
0,0,0,0,0,0,0,0,0
0,0,0,0,0,0,0,0,0
0,0,0,0,0,0,0,0,0
0,0,0,0,0,0,0,0,0
0,0,0,0,0,0,0,0,0
0,0,0,0,0,0,0,0,0
0,0,0,0,0,0,0,0,0
0,0,0,0,0,0,0,0,0
0,0,0,0,0,0,0,0,0
0,0,0,0,0,0,0,0,0
0,0,0,0,0,0,0,0,0
0,0,0,0,0,0,0,0,0
0,0,0,0,0,0,0,0,0
0,0,0,0,0,0,0,0,0
0,0,0,0,0,0,0,0,0
0,0,0,0,0,0,0,0,0
0,0,0,0,0,0,0,0,0
0,0,0,0,0,0,0,0,0
0,0,0,0,0,0,0,0,0
0,0,0,0,0,0,0,0,0
0,0,0,0,0,0,0,0,0
0,0,0,0,0,0,0,0,0
0,0,0,0,0,0,0,0,0
0,0,0,0,0,0,0,0,0
0,0,0,0,0,0,0,0,0
0,0,0,0,0,0,0,0,0
0,0,0,0,0,0,0,0,0
0,0,0,0,0,0,0,0,0
0,0,0,0,0,0,0,0,0
0,0,0,0,0,0,0,0,0
179837,571,4,4,3,1,8,0,0
0,0,0,0,0,0,0,0,0
0,0,0,0,0,0,0,0,0
0,0,0,0,0,0,0,0,0
0,0,0,0,0,0,0,0,0
0,0,0,0,0,0,0,0,0
0,0,0,0,0,0,0,0,0
0,0,0,0,0,0,0,0,0
0,0,0,0,0,0,0,0,0
0,0,0,0,0,0,0,0,0
0,0,0,0,0,0,0,0,0
0,0,0,0,0,0,0,0,0
0,0,0,0,0,0,0,0,0
0,0,0,0,0,0,0,0,0
0,0,0,0,0,0,0,0,0
0,0,0,0,0,0,0,0,0
0,0,0,0,0,0,0,0,0
0,0,0,0,0,0,0,0,0
0,0,0,0,0,0,0,0,0
0,0,0,0,0,0,0,0,0
0,0,0,0,0,0,0,0,0
0,0,0,0,0,0,0,0,0
0,0,0,0,0,0,0,0,0
0,0,0,0,0,0,0,0,0
0,0,0,0,0,0,0,0,0
0,0,0,0,0,0,0,0,0
0,0,0,0,0,0,0,0,0
0,0,0,0,0,0,0,0,0
0,0,0,0,0,0,0,0,0
0,0,0,0,0,0,0,0,0
0,0,0,0,0,0,0,0,0
0,0,0,0,0,0,0,0,0
0,0,0,0,0,0,0,0,0
0,0,0,0,0,0,0,0,0
0,0,0,0,0,0,0,0,0
0,0,0,0,0,0,0,0,0
0,0,0,0,0,0,0,0,0
0,0,0,0,0,0,0,0,0
0,0,0,0,0,0,0,0,0
0,0,0,0,0,0,0,0,0
0,0,0,0,0,0,0,0,0
0,0,0,0,0,0,0,0,0
0,0,0,0,0,0,0,0,0
0,0,0,0,0,0,0,0,0
0,0,0,0,0,0,0,0,0
0,0,0,0,0,0,0,0,0
0,0,0,0,0,0,0,0,0
0,0,0,0,0,0,0,0,0
0,0,0,0,0,0,0,0,0
0,0,0,0,0,0,0,0,0
0,0,0,0,0,0,0,0,0
0,0,0,0,0,0,0,0,0
0,0,0,0,0,0,0,0,0
0,0,0,0,0,0,0,0,0
0,0,0,0,0,0,0,0,0
0,0,0,0,0,0,0,0,0
0,0,0,0,0,0,0,0,0
0,0,0,0,0,0,0,0,0
0,0,0,0,0,0,0,0,0
0,0,0,0,0,0,0,0,0
0,0,0,0,0,0,0,0,0
0,0,0,0,0,0,0,0,0
0,0,0,0,0,0,0,0,0
0,0,0,0,0,0,0,0,0
0,0,0,0,0,0,0,0,0
0,0,0,0,0,0,0,0,0
0,0,0,0,0,0,0,0,0
0,0,0,0,0,0,0,0,0
0,0,0,0,0,0,0,0,0
0,0,0,0,0,0,0,0,0
0,0,0,0,0,0,0,0,0
0,0,0,0,0,0,0,0,0
0,0,0,0,0,0,0,0,0
0,0,0,0,0,0,0,0,0
0,0,0,0,0,0,0,0,0
0,0,0,0,0,0,0,0,0
0,0,0,0,0,0,0,0,0
0,0,0,0,0,0,0,0,0
0,0,0,0,0,0,0,0,0
0,0,0,0,0,0,0,0,0
0,0,0,0,0,0,0,0,0
0,0,0,0,0,0,0,0,0
0,0,0,0,0,0,0,0,0
0,0,0,0,0,0,0,0,0
0,0,0,0,0,0,0,0,0
0,0,0,0,0,0,0,0,0
0,0,0,0,0,0,0,0,0
0,0,0,0,0,0,0,0,0
0,0,0,0,0,0,0,0,0
0,0,0,0,0,0,0,0,0
0,0,0,0,0,0,0,0,0
0,0,0,0,0,0,0,0,0
0,0,0,0,0,0,0,0,0
0,0,0,0,0,0,0,0,0
0,0,0,0,0,0,0,0,0
0,0,0,0,0,0,0,0,0
0,0,0,0,0,0,0,0,0
77718,101,1,4,2,2,0,0,0
112455,84,1,4,1,3,0,0,0
0,0,0,0,0,0,0,0,0
0,0,0,0,0,0,0,0,0
0,0,0,0,0,0,0,0,0
0,0,0,0,0,0,0,0,0
0,0,0,0,0,0,0,0,0
0,0,0,0,0,0,0,0,0
1059955,101,4,5,5,0,3,1,0
0,0,0,0,0,0,0,0,0
0,0,0,0,0,0,0,0,0
0,0,0,0,0,0,0,0,0
550033,340,6,12,9,3,0,1,0
0,0,0,0,0,0,0,0,0
0,0,0,0,0,0,0,0,0
0,0,0,0,0,0,0,0,0
0,0,0,0,0,0,0,0,0
0,0,0,0,0,0,0,0,0
0,0,0,0,0,0,0,0,0
0,0,0,0,0,0,0,0,0
0,0,0,0,0,0,0,0,0
0,0,0,0,0,0,0,0,0
0,0,0,0,0,0,0,0,0
0,0,0,0,0,0,0,0,0
0,0,0,0,0,0,0,0,0
0,0,0,0,0,0,0,0,0
0,0,0,0,0,0,0,0,0
0,0,0,0,0,0,0,0,0
0,0,0,0,0,0,0,0,0
0,0,0,0,0,0,0,0,0
0,0,0,0,0,0,0,0,0
0,0,0,0,0,0,0,0,0
0,0,0,0,0,0,0,0,0
0,0,0,0,0,0,0,0,0
0,0,0,0,0,0,0,0,0
0,0,0,0,0,0,0,0,0
0,0,0,0,0,0,0,0,0
0,0,0,0,0,0,0,0,0
10941,69,5,10,10,0,0,0,0
0,0,0,0,0,0,0,0,0
0,0,0,0,0,0,0,0,0
0,0,0,0,0,0,0,0,0
0,0,0,0,0,0,0,0,0
0,0,0,0,0,0,0,0,0
0,0,0,0,0,0,0,0,0
0,0,0,0,0,0,0,0,0
0,0,0,0,0,0,0,0,0
0,0,0,0,0,0,0,0,0
0,0,0,0,0,0,0,0,0
106750,927,6,226,57,169,6,1,0
0,0,0,0,0,0,0,0,0
0,0,0,0,0,0,0,0,0
0,0,0,0,0,0,0,0,0
0,0,0,0,0,0,0,0,0
0,0,0,0,0,0,0,0,0
0,0,0,0,0,0,0,0,0
0,0,0,0,0,0,0,0,0
0,0,0,0,0,0,0,0,0
0,0,0,0,0,0,0,0,0
0,0,0,0,0,0,0,0,0
0,0,0,0,0,0,0,0,0
0,0,0,0,0,0,0,0,0
0,0,0,0,0,0,0,0,0
0,0,0,0,0,0,0,0,0
0,0,0,0,0,0,0,0,0
0,0,0,0,0,0,0,0,0
0,0,0,0,0,0,0,0,0
0,0,0,0,0,0,0,0,0
0,0,0,0,0,0,0,0,0
0,0,0,0,0,0,0,0,0
0,0,0,0,0,0,0,0,0
0,0,0,0,0,0,0,0,0
0,0,0,0,0,0,0,0,0
0,0,0,0,0,0,0,0,0
0,0,0,0,0,0,0,0,0
0,0,0,0,0,0,0,0,0
0,0,0,0,0,0,0,0,0
0,0,0,0,0,0,0,0,0
0,0,0,0,0,0,0,0,0
0,0,0,0,0,0,0,0,0
0,0,0,0,0,0,0,0,0
0,0,0,0,0,0,0,0,0
0,0,0,0,0,0,0,0,0
0,0,0,0,0,0,0,0,0
0,0,0,0,0,0,0,0,0
0,0,0,0,0,0,0,0,0
36373,201,6,16,13,3,1,0,0
0,0,0,0,0,0,0,0,0
0,0,0,0,0,0,0,0,0
167609,570,4,4,3,1,8,0,0
0,0,0,0,0,0,0,0,0
0,0,0,0,0,0,0,0,0
167820,489,5,2,1,1,10,0,0
0,0,0,0,0,0,0,0,0
0,0,0,0,0,0,0,0,0
170627,503,4,7,4,3,8,1,0
0,0,0,0,0,0,0,0,0
0,0,0,0,0,0,0,0,0
0,0,0,0,0,0,0,0,0
0,0,0,0,0,0,0,0,0
0,0,0,0,0,0,0,0,0
39857,125,1,1,1,0,0,1,0
0,0,0,0,0,0,0,0,0
0,0,0,0,0,0,0,0,0
0,0,0,0,0,0,0,0,0
0,0,0,0,0,0,0,0,0
19686,279,4,27,25,2,1,1,0
0,0,0,0,0,0,0,0,0
127602,366,5,1,0,1,5,0,0
0,0,0,0,0,0,0,0,0
186700,375,3,24,7,17,15,1,0
0,0,0,0,0,0,0,0,0
0,0,0,0,0,0,0,0,0
0,0,0,0,0,0,0,0,0
0,0,0,0,0,0,0,0,0
10908,77,2,6,5,1,0,0,0
0,0,0,0,0,0,0,0,0
0,0,0,0,0,0,0,0,0
670710,540,0,4,4,0,2,1,1
50193,136,7,16,14,2,1,0,0
0,0,0,0,0,0,0,0,0
0,0,0,0,0,0,0,0,0
0,0,0,0,0,0,0,0,0
0,0,0,0,0,0,0,0,0
0,0,0,0,0,0,0,0,0
0,0,0,0,0,0,0,0,0
7365,20,1,1,1,0,0,0,0
0,0,0,0,0,0,0,0,0
0,0,0,0,0,0,0,0,0
0,0,0,0,0,0,0,0,0
0,0,0,0,0,0,0,0,0
0,0,0,0,0,0,0,0,0
0,0,0,0,0,0,0,0,0
0,0,0,0,0,0,0,0,0
0,0,0,0,0,0,0,0,0
0,0,0,0,0,0,0,0,0
0,0,0,0,0,0,0,0,0
0,0,0,0,0,0,0,0,0
0,0,0,0,0,0,0,0,0
0,0,0,0,0,0,0,0,0
0,0,0,0,0,0,0,0,0
0,0,0,0,0,0,0,0,0
70622,47,4,0,0,0,1,0,0
0,0,0,0,0,0,0,0,0
0,0,0,0,0,0,0,0,0
0,0,0,0,0,0,0,0,0
0,0,0,0,0,0,0,0,0
0,0,0,0,0,0,0,0,0
0,0,0,0,0,0,0,0,0
69987,46,4,0,0,0,1,0,0
0,0,0,0,0,0,0,0,0
28220,43,0,0,0,0,0,1,0
0,0,0,0,0,0,0,0,0
0,0,0,0,0,0,0,0,0
0,0,0,0,0,0,0,0,0
70626,47,4,0,0,0,1,0,0
0,0,0,0,0,0,0,0,0
70620,47,4,0,0,0,1,0,0
0,0,0,0,0,0,0,0,0
0,0,0,0,0,0,0,0,0
0,0,0,0,0,0,0,0,0
0,0,0,0,0,0,0,0,0
0,0,0,0,0,0,0,0,0
0,0,0,0,0,0,0,0,0
0,0,0,0,0,0,0,0,0
0,0,0,0,0,0,0,0,0
0,0,0,0,0,0,0,0,0
0,0,0,0,0,0,0,0,0
0,0,0,0,0,0,0,0,0
0,0,0,0,0,0,0,0,0
671365,540,0,4,4,0,2,1,1
0,0,0,0,0,0,0,0,0
0,0,0,0,0,0,0,0,0
0,0,0,0,0,0,0,0,0
0,0,0,0,0,0,0,0,0
0,0,0,0,0,0,0,0,0
0,0,0,0,0,0,0,0,0
0,0,0,0,0,0,0,0,0
0,0,0,0,0,0,0,0,0
0,0,0,0,0,0,0,0,0
0,0,0,0,0,0,0,0,0
0,0,0,0,0,0,0,0,0
0,0,0,0,0,0,0,0,0
0,0,0,0,0,0,0,0,0
0,0,0,0,0,0,0,0,0
0,0,0,0,0,0,0,0,0
0,0,0,0,0,0,0,0,0
0,0,0,0,0,0,0,0,0
0,0,0,0,0,0,0,0,0
0,0,0,0,0,0,0,0,0
70627,47,4,0,0,0,1,0,0
0,0,0,0,0,0,0,0,0
0,0,0,0,0,0,0,0,0
0,0,0,0,0,0,0,0,0
0,0,0,0,0,0,0,0,0
7021,30,0,3,0,3,0,1,0
0,0,0,0,0,0,0,0,0
34450,146,5,6,4,2,1,0,0
0,0,0,0,0,0,0,0,0
0,0,0,0,0,0,0,0,0
0,0,0,0,0,0,0,0,0
0,0,0,0,0,0,0,0,0
0,0,0,0,0,0,0,0,0
0,0,0,0,0,0,0,0,0
0,0,0,0,0,0,0,0,0
0,0,0,0,0,0,0,0,0
0,0,0,0,0,0,0,0,0
0,0,0,0,0,0,0,0,0
0,0,0,0,0,0,0,0,0
89857,610,8,136,136,0,4,1,0
0,0,0,0,0,0,0,0,0
0,0,0,0,0,0,0,0,0
0,0,0,0,0,0,0,0,0
0,0,0,0,0,0,0,0,0
0,0,0,0,0,0,0,0,0
0,0,0,0,0,0,0,0,0
0,0,0,0,0,0,0,0,0
0,0,0,0,0,0,0,0,0
0,0,0,0,0,0,0,0,0
0,0,0,0,0,0,0,0,0
0,0,0,0,0,0,0,0,0
0,0,0,0,0,0,0,0,0
0,0,0,0,0,0,0,0,0
0,0,0,0,0,0,0,0,0
0,0,0,0,0,0,0,0,0
0,0,0,0,0,0,0,0,0
2474,43,0,1,1,0,0,0,0
0,0,0,0,0,0,0,0,0
0,0,0,0,0,0,0,0,0
0,0,0,0,0,0,0,0,0
0,0,0,0,0,0,0,0,0
0,0,0,0,0,0,0,0,0
0,0,0,0,0,0,0,0,0
0,0,0,0,0,0,0,0,0
0,0,0,0,0,0,0,0,0
0,0,0,0,0,0,0,0,0
133701,321,8,26,24,2,17,1,0
0,0,0,0,0,0,0,0,0
0,0,0,0,0,0,0,0,0
0,0,0,0,0,0,0,0,0
0,0,0,0,0,0,0,0,0
0,0,0,0,0,0,0,0,0
0,0,0,0,0,0,0,0,0
0,0,0,0,0,0,0,0,0
0,0,0,0,0,0,0,0,0
0,0,0,0,0,0,0,0,0
0,0,0,0,0,0,0,0,0
0,0,0,0,0,0,0,0,0
0,0,0,0,0,0,0,0,0
0,0,0,0,0,0,0,0,0
0,0,0,0,0,0,0,0,0
0,0,0,0,0,0,0,0,0
0,0,0,0,0,0,0,0,0
0,0,0,0,0,0,0,0,0
0,0,0,0,0,0,0,0,0
0,0,0,0,0,0,0,0,0
0,0,0,0,0,0,0,0,0
0,0,0,0,0,0,0,0,0
0,0,0,0,0,0,0,0,0
0,0,0,0,0,0,0,0,0
0,0,0,0,0,0,0,0,0
0,0,0,0,0,0,0,0,0
0,0,0,0,0,0,0,0,0
0,0,0,0,0,0,0,0,0
0,0,0,0,0,0,0,0,0
0,0,0,0,0,0,0,0,0
0,0,0,0,0,0,0,0,0
0,0,0,0,0,0,0,0,0
0,0,0,0,0,0,0,0,0
0,0,0,0,0,0,0,0,0
0,0,0,0,0,0,0,0,0
0,0,0,0,0,0,0,0,0
0,0,0,0,0,0,0,0,0
0,0,0,0,0,0,0,0,0
0,0,0,0,0,0,0,0,0
0,0,0,0,0,0,0,0,0
0,0,0,0,0,0,0,0,0
0,0,0,0,0,0,0,0,0
0,0,0,0,0,0,0,0,0
0,0,0,0,0,0,0,0,0
0,0,0,0,0,0,0,0,0
0,0,0,0,0,0,0,0,0
0,0,0,0,0,0,0,0,0
0,0,0,0,0,0,0,0,0
0,0,0,0,0,0,0,0,0
0,0,0,0,0,0,0,0,0
0,0,0,0,0,0,0,0,0
0,0,0,0,0,0,0,0,0
0,0,0,0,0,0,0,0,0
0,0,0,0,0,0,0,0,0
0,0,0,0,0,0,0,0,0
0,0,0,0,0,0,0,0,0
0,0,0,0,0,0,0,0,0
0,0,0,0,0,0,0,0,0
0,0,0,0,0,0,0,0,0
0,0,0,0,0,0,0,0,0
1780,22,2,1,0,1,0,0,0
0,0,0,0,0,0,0,0,0
8320,146,0,15,15,0,5,1,0
0,0,0,0,0,0,0,0,0
0,0,0,0,0,0,0,0,0
0,0,0,0,0,0,0,0,0
0,0,0,0,0,0,0,0,0
0,0,0,0,0,0,0,0,0
0,0,0,0,0,0,0,0,0
0,0,0,0,0,0,0,0,0
0,0,0,0,0,0,0,0,0
105023,65,4,9,9,0,2,1,0
105023,65,4,9,9,0,2,1,0
105023,65,4,9,9,0,2,1,0
105023,65,4,9,9,0,2,1,0
0,0,0,0,0,0,0,0,0
105023,65,4,9,9,0,2,1,0
0,0,0,0,0,0,0,0,0
0,0,0,0,0,0,0,0,0
0,0,0,0,0,0,0,0,0
0,0,0,0,0,0,0,0,0
0,0,0,0,0,0,0,0,0
0,0,0,0,0,0,0,0,0
0,0,0,0,0,0,0,0,0
0,0,0,0,0,0,0,0,0
0,0,0,0,0,0,0,0,0
0,0,0,0,0,0,0,0,0
0,0,0,0,0,0,0,0,0
43457,30,0,0,0,0,0,0,0
43457,30,0,0,0,0,0,0,0
43457,30,0,0,0,0,0,0,0
43457,30,0,0,0,0,0,0,0
0,0,0,0,0,0,0,0,0
27868,78,3,0,0,0,3,0,0
136019,42,4,1,1,0,2,0,0
0,0,0,0,0,0,0,0,0
136019,42,4,1,1,0,2,0,0
136019,42,4,1,1,0,2,0,0
0,0,0,0,0,0,0,0,0
136019,42,4,1,1,0,2,0,0
0,0,0,0,0,0,0,0,0
0,0,0,0,0,0,0,0,0
0,0,0,0,0,0,0,0,0
0,0,0,0,0,0,0,0,0
0,0,0,0,0,0,0,0,0
0,0,0,0,0,0,0,0,0
233115,64,4,3,3,0,2,1,0
0,0,0,0,0,0,0,0,0
0,0,0,0,0,0,0,0,0
0,0,0,0,0,0,0,0,0
0,0,0,0,0,0,0,0,0
0,0,0,0,0,0,0,0,0
233115,64,4,3,3,0,2,1,0
0,0,0,0,0,0,0,0,0
0,0,0,0,0,0,0,0,0
0,0,0,0,0,0,0,0,0
233115,64,4,3,3,0,2,1,0
0,0,0,0,0,0,0,0,0
0,0,0,0,0,0,0,0,0
0,0,0,0,0,0,0,0,0
0,0,0,0,0,0,0,0,0
0,0,0,0,0,0,0,0,0
285356,75,4,4,4,0,4,1,0
285356,75,4,4,4,0,4,1,0
285356,75,4,4,4,0,4,1,0
285356,75,4,4,4,0,4,1,0
0,0,0,0,0,0,0,0,0
0,0,0,0,0,0,0,0,0
0,0,0,0,0,0,0,0,0
98956,66,4,0,0,0,2,1,0
98956,66,4,0,0,0,2,1,0
0,0,0,0,0,0,0,0,0
98956,66,4,0,0,0,2,1,0
98956,66,4,0,0,0,2,1,0
98956,66,4,0,0,0,2,1,0
98956,66,4,0,0,0,2,1,0
0,0,0,0,0,0,0,0,0
98956,66,4,0,0,0,2,1,0
0,0,0,0,0,0,0,0,0
0,0,0,0,0,0,0,0,0
0,0,0,0,0,0,0,0,0
0,0,0,0,0,0,0,0,0
0,0,0,0,0,0,0,0,0
0,0,0,0,0,0,0,0,0
0,0,0,0,0,0,0,0,0
243774,152,4,4,4,0,1,1,0
0,0,0,0,0,0,0,0,0
0,0,0,0,0,0,0,0,0
0,0,0,0,0,0,0,0,0
0,0,0,0,0,0,0,0,0
0,0,0,0,0,0,0,0,0
0,0,0,0,0,0,0,0,0
0,0,0,0,0,0,0,0,0
0,0,0,0,0,0,0,0,0
0,0,0,0,0,0,0,0,0
0,0,0,0,0,0,0,0,0
0,0,0,0,0,0,0,0,0
0,0,0,0,0,0,0,0,0
243682,152,4,4,4,0,1,1,0
0,0,0,0,0,0,0,0,0
243774,152,4,4,4,0,1,1,0
0,0,0,0,0,0,0,0,0
0,0,0,0,0,0,0,0,0
0,0,0,0,0,0,0,0,0
0,0,0,0,0,0,0,0,0
0,0,0,0,0,0,0,0,0
243774,152,4,4,4,0,1,1,0
0,0,0,0,0,0,0,0,0
0,0,0,0,0,0,0,0,0
0,0,0,0,0,0,0,0,0
0,0,0,0,0,0,0,0,0
0,0,0,0,0,0,0,0,0
0,0,0,0,0,0,0,0,0
0,0,0,0,0,0,0,0,0
0,0,0,0,0,0,0,0,0
0,0,0,0,0,0,0,0,0
0,0,0,0,0,0,0,0,0
0,0,0,0,0,0,0,0,0
0,0,0,0,0,0,0,0,0
0,0,0,0,0,0,0,0,0
0,0,0,0,0,0,0,0,0
0,0,0,0,0,0,0,0,0
0,0,0,0,0,0,0,0,0
0,0,0,0,0,0,0,0,0
0,0,0,0,0,0,0,0,0
0,0,0,0,0,0,0,0,0
0,0,0,0,0,0,0,0,0
0,0,0,0,0,0,0,0,0
0,0,0,0,0,0,0,0,0
39199,128,2,4,2,2,1,1,0
0,0,0,0,0,0,0,0,0
0,0,0,0,0,0,0,0,0
0,0,0,0,0,0,0,0,0
0,0,0,0,0,0,0,0,0
0,0,0,0,0,0,0,0,0
0,0,0,0,0,0,0,0,0
0,0,0,0,0,0,0,0,0
0,0,0,0,0,0,0,0,0
0,0,0,0,0,0,0,0,0
0,0,0,0,0,0,0,0,0
0,0,0,0,0,0,0,0,0
0,0,0,0,0,0,0,0,0
0,0,0,0,0,0,0,0,0
0,0,0,0,0,0,0,0,0
0,0,0,0,0,0,0,0,0
0,0,0,0,0,0,0,0,0
0,0,0,0,0,0,0,0,0
0,0,0,0,0,0,0,0,0
0,0,0,0,0,0,0,0,0
0,0,0,0,0,0,0,0,0
0,0,0,0,0,0,0,0,0
0,0,0,0,0,0,0,0,0
0,0,0,0,0,0,0,0,0
0,0,0,0,0,0,0,0,0
0,0,0,0,0,0,0,0,0
0,0,0,0,0,0,0,0,0
0,0,0,0,0,0,0,0,0
0,0,0,0,0,0,0,0,0
0,0,0,0,0,0,0,0,0
0,0,0,0,0,0,0,0,0
0,0,0,0,0,0,0,0,0
0,0,0,0,0,0,0,0,0
106749,927,6,226,29,197,6,1,0
0,0,0,0,0,0,0,0,0
0,0,0,0,0,0,0,0,0
0,0,0,0,0,0,0,0,0
0,0,0,0,0,0,0,0,0
122949,91,5,0,0,0,0,0,0
28052,97,0,2,0,2,2,0,0
0,0,0,0,0,0,0,0,0
0,0,0,0,0,0,0,0,0
0,0,0,0,0,0,0,0,0
0,0,0,0,0,0,0,0,0
0,0,0,0,0,0,0,0,0
0,0,0,0,0,0,0,0,0
0,0,0,0,0,0,0,0,0
0,0,0,0,0,0,0,0,0
0,0,0,0,0,0,0,0,0
0,0,0,0,0,0,0,0,0
0,0,0,0,0,0,0,0,0
0,0,0,0,0,0,0,0,0
0,0,0,0,0,0,0,0,0
0,0,0,0,0,0,0,0,0
0,0,0,0,0,0,0,0,0
11595,149,4,0,0,0,0,0,0
36426,48,1,0,0,0,0,0,0
36426,48,1,0,0,0,0,0,0
0,0,0,0,0,0,0,0,0
0,0,0,0,0,0,0,0,0
0,0,0,0,0,0,0,0,0
0,0,0,0,0,0,0,0,0
0,0,0,0,0,0,0,0,0
8073,140,7,26,6,20,1,1,0
8073,140,7,26,6,20,1,1,0
0,0,0,0,0,0,0,0,0
676414,540,0,4,0,4,2,1,1
0,0,0,0,0,0,0,0,0
172251,482,4,4,1,3,7,0,0
0,0,0,0,0,0,0,0,0
0,0,0,0,0,0,0,0,0
166332,474,4,2,1,1,7,0,0
166173,473,4,2,1,1,7,0,0
165152,472,4,2,1,1,7,0,0
166190,475,4,2,1,1,7,0,0
165470,474,4,2,1,1,7,0,0
0,0,0,0,0,0,0,0,0
0,0,0,0,0,0,0,0,0
166108,474,4,2,1,1,7,0,0
0,0,0,0,0,0,0,0,0
165825,474,4,2,1,1,7,0,0
166790,473,4,2,1,1,7,0,0
0,0,0,0,0,0,0,0,0
167966,478,4,2,1,1,7,0,0
0,0,0,0,0,0,0,0,0
166034,474,4,2,1,1,7,0,0
165868,475,4,2,1,1,7,0,0
166002,475,4,2,1,1,7,0,0
0,0,0,0,0,0,0,0,0
0,0,0,0,0,0,0,0,0
164932,473,4,2,1,1,7,0,0
0,0,0,0,0,0,0,0,0
0,0,0,0,0,0,0,0,0
165582,475,4,2,1,1,7,0,0
0,0,0,0,0,0,0,0,0
0,0,0,0,0,0,0,0,0
165412,474,4,2,1,1,7,0,0
165748,479,4,2,1,1,7,0,0
166098,474,4,2,1,1,7,0,0
166279,474,4,2,1,1,7,0,0
0,0,0,0,0,0,0,0,0
0,0,0,0,0,0,0,0,0
165725,475,4,2,1,1,7,0,0
165905,475,4,2,1,1,7,0,0
0,0,0,0,0,0,0,0,0
0,0,0,0,0,0,0,0,0
165905,474,4,2,1,1,7,0,0
0,0,0,0,0,0,0,0,0
165941,474,4,2,1,1,7,0,0
165682,475,4,2,1,1,7,0,0
0,0,0,0,0,0,0,0,0
166048,475,4,2,1,1,7,0,0
0,0,0,0,0,0,0,0,0
0,0,0,0,0,0,0,0,0
0,0,0,0,0,0,0,0,0
0,0,0,0,0,0,0,0,0
0,0,0,0,0,0,0,0,0
0,0,0,0,0,0,0,0,0
0,0,0,0,0,0,0,0,0
0,0,0,0,0,0,0,0,0
164911,474,4,2,1,1,7,0,0
165952,474,4,2,1,1,7,0,0
0,0,0,0,0,0,0,0,0
0,0,0,0,0,0,0,0,0
165148,481,4,2,1,1,7,1,0
167895,592,4,4,3,1,8,1,0
0,0,0,0,0,0,0,0,0
0,0,0,0,0,0,0,0,0
0,0,0,0,0,0,0,0,0
0,0,0,0,0,0,0,0,0
0,0,0,0,0,0,0,0,0
8073,140,7,26,6,20,1,1,0
0,0,0,0,0,0,0,0,0
0,0,0,0,0,0,0,0,0
0,0,0,0,0,0,0,0,0
0,0,0,0,0,0,0,0,0
0,0,0,0,0,0,0,0,0
0,0,0,0,0,0,0,0,0
215613,163,0,25,5,20,0,1,0
0,0,0,0,0,0,0,0,0
0,0,0,0,0,0,0,0,0
0,0,0,0,0,0,0,0,0
0,0,0,0,0,0,0,0,0
0,0,0,0,0,0,0,0,0
0,0,0,0,0,0,0,0,0
0,0,0,0,0,0,0,0,0
0,0,0,0,0,0,0,0,0
0,0,0,0,0,0,0,0,0
0,0,0,0,0,0,0,0,0
361868,827,4,83,78,5,2,1,0
0,0,0,0,0,0,0,0,0
0,0,0,0,0,0,0,0,0
0,0,0,0,0,0,0,0,0
0,0,0,0,0,0,0,0,0
0,0,0,0,0,0,0,0,0
0,0,0,0,0,0,0,0,0
0,0,0,0,0,0,0,0,0
40016,126,1,1,1,0,0,1,0
0,0,0,0,0,0,0,0,0
1059868,101,4,5,5,0,3,1,0
240112,102,4,5,5,0,3,1,0
84860,79,1,8,0,8,0,1,0
8422,73,2,2,2,0,4,0,0
0,0,0,0,0,0,0,0,0
0,0,0,0,0,0,0,0,0
0,0,0,0,0,0,0,0,0
0,0,0,0,0,0,0,0,0
0,0,0,0,0,0,0,0,0
0,0,0,0,0,0,0,0,0
0,0,0,0,0,0,0,0,0
0,0,0,0,0,0,0,0,0
27127,311,4,2,0,2,7,1,0
0,0,0,0,0,0,0,0,0
0,0,0,0,0,0,0,0,0
0,0,0,0,0,0,0,0,0
0,0,0,0,0,0,0,0,0
0,0,0,0,0,0,0,0,0
0,0,0,0,0,0,0,0,0
0,0,0,0,0,0,0,0,0
0,0,0,0,0,0,0,0,0
0,0,0,0,0,0,0,0,0
0,0,0,0,0,0,0,0,0
0,0,0,0,0,0,0,0,0
0,0,0,0,0,0,0,0,0
0,0,0,0,0,0,0,0,0
0,0,0,0,0,0,0,0,0
0,0,0,0,0,0,0,0,0
0,0,0,0,0,0,0,0,0
0,0,0,0,0,0,0,0,0
0,0,0,0,0,0,0,0,0
0,0,0,0,0,0,0,0,0
0,0,0,0,0,0,0,0,0
0,0,0,0,0,0,0,0,0
0,0,0,0,0,0,0,0,0
0,0,0,0,0,0,0,0,0
0,0,0,0,0,0,0,0,0
0,0,0,0,0,0,0,0,0
0,0,0,0,0,0,0,0,0
0,0,0,0,0,0,0,0,0
0,0,0,0,0,0,0,0,0
0,0,0,0,0,0,0,0,0
0,0,0,0,0,0,0,0,0
0,0,0,0,0,0,0,0,0
0,0,0,0,0,0,0,0,0
0,0,0,0,0,0,0,0,0
0,0,0,0,0,0,0,0,0
0,0,0,0,0,0,0,0,0
0,0,0,0,0,0,0,0,0
0,0,0,0,0,0,0,0,0
0,0,0,0,0,0,0,0,0
0,0,0,0,0,0,0,0,0
0,0,0,0,0,0,0,0,0
0,0,0,0,0,0,0,0,0
0,0,0,0,0,0,0,0,0
668704,540,0,4,4,0,2,1,1
0,0,0,0,0,0,0,0,0
0,0,0,0,0,0,0,0,0
0,0,0,0,0,0,0,0,0
0,0,0,0,0,0,0,0,0
0,0,0,0,0,0,0,0,0
0,0,0,0,0,0,0,0,0
0,0,0,0,0,0,0,0,0
0,0,0,0,0,0,0,0,0
0,0,0,0,0,0,0,0,0
671211,540,0,4,4,0,2,1,1
71489,47,4,0,0,0,1,0,0
0,0,0,0,0,0,0,0,0
0,0,0,0,0,0,0,0,0
0,0,0,0,0,0,0,0,0
218611,513,9,24,0,24,8,1,0
0,0,0,0,0,0,0,0,0
0,0,0,0,0,0,0,0,0
0,0,0,0,0,0,0,0,0
0,0,0,0,0,0,0,0,0
0,0,0,0,0,0,0,0,0
0,0,0,0,0,0,0,0,0
0,0,0,0,0,0,0,0,0
71488,47,4,0,0,0,1,0,0
0,0,0,0,0,0,0,0,0
0,0,0,0,0,0,0,0,0
0,0,0,0,0,0,0,0,0
0,0,0,0,0,0,0,0,0
0,0,0,0,0,0,0,0,0
0,0,0,0,0,0,0,0,0
0,0,0,0,0,0,0,0,0
0,0,0,0,0,0,0,0,0
230323,1347,20,158,127,31,17,0,0
230129,1346,20,158,127,31,17,0,0
230132,1346,20,158,127,31,17,0,0
0,0,0,0,0,0,0,0,0
0,0,0,0,0,0,0,0,0
0,0,0,0,0,0,0,0,0
0,0,0,0,0,0,0,0,0
0,0,0,0,0,0,0,0,0
0,0,0,0,0,0,0,0,0
0,0,0,0,0,0,0,0,0
0,0,0,0,0,0,0,0,0
0,0,0,0,0,0,0,0,0
0,0,0,0,0,0,0,0,0
27127,311,4,2,0,2,7,1,0
27127,311,4,2,0,2,7,1,0
27127,311,4,2,0,2,7,1,0
0,0,0,0,0,0,0,0,0
39199,128,2,4,2,2,1,1,0
0,0,0,0,0,0,0,0,0
0,0,0,0,0,0,0,0,0
0,0,0,0,0,0,0,0,0
0,0,0,0,0,0,0,0,0
0,0,0,0,0,0,0,0,0
0,0,0,0,0,0,0,0,0
0,0,0,0,0,0,0,0,0
0,0,0,0,0,0,0,0,0
0,0,0,0,0,0,0,0,0
0,0,0,0,0,0,0,0,0
0,0,0,0,0,0,0,0,0
0,0,0,0,0,0,0,0,0
34482,217,0,51,3,48,1,1,0
0,0,0,0,0,0,0,0,0
0,0,0,0,0,0,0,0,0
0,0,0,0,0,0,0,0,0
0,0,0,0,0,0,0,0,0
0,0,0,0,0,0,0,0,0
0,0,0,0,0,0,0,0,0
0,0,0,0,0,0,0,0,0
0,0,0,0,0,0,0,0,0
242484,1309,10,93,89,4,1,1,0
0,0,0,0,0,0,0,0,0
0,0,0,0,0,0,0,0,0
0,0,0,0,0,0,0,0,0
170325,566,5,4,3,1,11,1,0
0,0,0,0,0,0,0,0,0
0,0,0,0,0,0,0,0,0
0,0,0,0,0,0,0,0,0
0,0,0,0,0,0,0,0,0
0,0,0,0,0,0,0,0,0
136495,389,8,26,24,2,32,1,0
0,0,0,0,0,0,0,0,0
0,0,0,0,0,0,0,0,0
0,0,0,0,0,0,0,0,0
0,0,0,0,0,0,0,0,0
21168,186,5,14,8,6,1,1,0
0,0,0,0,0,0,0,0,0
0,0,0,0,0,0,0,0,0
0,0,0,0,0,0,0,0,0
0,0,0,0,0,0,0,0,0
0,0,0,0,0,0,0,0,0
0,0,0,0,0,0,0,0,0
0,0,0,0,0,0,0,0,0
0,0,0,0,0,0,0,0,0
0,0,0,0,0,0,0,0,0
0,0,0,0,0,0,0,0,0
0,0,0,0,0,0,0,0,0
0,0,0,0,0,0,0,0,0
0,0,0,0,0,0,0,0,0
0,0,0,0,0,0,0,0,0
0,0,0,0,0,0,0,0,0
0,0,0,0,0,0,0,0,0
0,0,0,0,0,0,0,0,0
0,0,0,0,0,0,0,0,0
0,0,0,0,0,0,0,0,0
0,0,0,0,0,0,0,0,0
0,0,0,0,0,0,0,0,0
0,0,0,0,0,0,0,0,0
0,0,0,0,0,0,0,0,0
0,0,0,0,0,0,0,0,0
0,0,0,0,0,0,0,0,0
0,0,0,0,0,0,0,0,0
0,0,0,0,0,0,0,0,0
0,0,0,0,0,0,0,0,0
0,0,0,0,0,0,0,0,0
0,0,0,0,0,0,0,0,0
0,0,0,0,0,0,0,0,0
0,0,0,0,0,0,0,0,0
0,0,0,0,0,0,0,0,0
0,0,0,0,0,0,0,0,0
0,0,0,0,0,0,0,0,0
0,0,0,0,0,0,0,0,0
0,0,0,0,0,0,0,0,0
0,0,0,0,0,0,0,0,0
0,0,0,0,0,0,0,0,0
0,0,0,0,0,0,0,0,0
0,0,0,0,0,0,0,0,0
0,0,0,0,0,0,0,0,0
0,0,0,0,0,0,0,0,0
0,0,0,0,0,0,0,0,0
0,0,0,0,0,0,0,0,0
0,0,0,0,0,0,0,0,0
0,0,0,0,0,0,0,0,0
0,0,0,0,0,0,0,0,0
0,0,0,0,0,0,0,0,0
0,0,0,0,0,0,0,0,0
0,0,0,0,0,0,0,0,0
0,0,0,0,0,0,0,0,0
0,0,0,0,0,0,0,0,0
11764,52,3,0,0,0,2,0,0
1263,25,1,0,0,0,0,0,0
1263,25,1,0,0,0,0,0,0
0,0,0,0,0,0,0,0,0
0,0,0,0,0,0,0,0,0
6330,64,2,6,4,2,0,1,0
0,0,0,0,0,0,0,0,0
3306,29,1,1,1,0,0,0,0
0,0,0,0,0,0,0,0,0
0,0,0,0,0,0,0,0,0
0,0,0,0,0,0,0,0,0
8073,140,7,26,6,20,1,1,0
0,0,0,0,0,0,0,0,0
0,0,0,0,0,0,0,0,0
20183,53,3,0,0,0,0,0,0
20183,53,3,0,0,0,0,0,0
243738,152,4,4,4,0,1,1,0
243738,152,4,4,4,0,1,1,0
0,0,0,0,0,0,0,0,0
0,0,0,0,0,0,0,0,0
0,0,0,0,0,0,0,0,0
0,0,0,0,0,0,0,0,0
243738,152,4,4,4,0,1,1,0
243738,152,4,4,4,0,1,1,0
0,0,0,0,0,0,0,0,0
0,0,0,0,0,0,0,0,0
0,0,0,0,0,0,0,0,0
0,0,0,0,0,0,0,0,0
0,0,0,0,0,0,0,0,0
243738,152,4,4,4,0,1,1,0
0,0,0,0,0,0,0,0,0
0,0,0,0,0,0,0,0,0
0,0,0,0,0,0,0,0,0
0,0,0,0,0,0,0,0,0
0,0,0,0,0,0,0,0,0
0,0,0,0,0,0,0,0,0
0,0,0,0,0,0,0,0,0
0,0,0,0,0,0,0,0,0
0,0,0,0,0,0,0,0,0
0,0,0,0,0,0,0,0,0
0,0,0,0,0,0,0,0,0
0,0,0,0,0,0,0,0,0
182413,60,4,2,0,2,2,1,0
182413,60,4,2,0,2,2,1,0
0,0,0,0,0,0,0,0,0
0,0,0,0,0,0,0,0,0
31629,69,6,1,0,1,0,1,0
0,0,0,0,0,0,0,0,0
31629,69,6,1,0,1,0,1,0
0,0,0,0,0,0,0,0,0
0,0,0,0,0,0,0,0,0
182413,60,4,2,0,2,2,1,0
182413,60,4,2,0,2,2,1,0
182413,60,4,2,0,2,2,1,0
182413,60,4,2,0,2,2,1,0
182413,60,4,2,0,2,2,1,0
0,0,0,0,0,0,0,0,0
0,0,0,0,0,0,0,0,0
0,0,0,0,0,0,0,0,0
0,0,0,0,0,0,0,0,0
0,0,0,0,0,0,0,0,0
0,0,0,0,0,0,0,0,0
0,0,0,0,0,0,0,0,0
0,0,0,0,0,0,0,0,0
0,0,0,0,0,0,0,0,0
0,0,0,0,0,0,0,0,0
36534,51,2,0,0,0,2,0,0
0,0,0,0,0,0,0,0,0
80971,595,4,31,29,2,3,1,0
0,0,0,0,0,0,0,0,0
0,0,0,0,0,0,0,0,0
0,0,0,0,0,0,0,0,0
0,0,0,0,0,0,0,0,0
40941,54,4,1,1,0,2,1,0
0,0,0,0,0,0,0,0,0
0,0,0,0,0,0,0,0,0
0,0,0,0,0,0,0,0,0
35929,39,1,0,0,0,0,1,0
0,0,0,0,0,0,0,0,0
0,0,0,0,0,0,0,0,0
93181,453,5,58,52,6,14,1,0
0,0,0,0,0,0,0,0,0
10737,46,2,0,0,0,0,0,0
0,0,0,0,0,0,0,0,0
89036,48,4,0,0,0,0,0,0
670980,540,0,4,4,0,2,1,1
0,0,0,0,0,0,0,0,0
0,0,0,0,0,0,0,0,0
0,0,0,0,0,0,0,0,0
0,0,0,0,0,0,0,0,0
0,0,0,0,0,0,0,0,0
0,0,0,0,0,0,0,0,0
0,0,0,0,0,0,0,0,0
0,0,0,0,0,0,0,0,0
0,0,0,0,0,0,0,0,0
0,0,0,0,0,0,0,0,0
0,0,0,0,0,0,0,0,0
0,0,0,0,0,0,0,0,0
0,0,0,0,0,0,0,0,0
0,0,0,0,0,0,0,0,0
0,0,0,0,0,0,0,0,0
0,0,0,0,0,0,0,0,0
0,0,0,0,0,0,0,0,0
0,0,0,0,0,0,0,0,0
0,0,0,0,0,0,0,0,0
0,0,0,0,0,0,0,0,0
0,0,0,0,0,0,0,0,0
0,0,0,0,0,0,0,0,0
0,0,0,0,0,0,0,0,0
0,0,0,0,0,0,0,0,0
0,0,0,0,0,0,0,0,0
0,0,0,0,0,0,0,0,0
0,0,0,0,0,0,0,0,0
121618,943,3,133,121,12,1,0,0
0,0,0,0,0,0,0,0,0
0,0,0,0,0,0,0,0,0
0,0,0,0,0,0,0,0,0
0,0,0,0,0,0,0,0,0
0,0,0,0,0,0,0,0,0
0,0,0,0,0,0,0,0,0
0,0,0,0,0,0,0,0,0
0,0,0,0,0,0,0,0,0
0,0,0,0,0,0,0,0,0
0,0,0,0,0,0,0,0,0
0,0,0,0,0,0,0,0,0
0,0,0,0,0,0,0,0,0
0,0,0,0,0,0,0,0,0
0,0,0,0,0,0,0,0,0
0,0,0,0,0,0,0,0,0
0,0,0,0,0,0,0,0,0
0,0,0,0,0,0,0,0,0
0,0,0,0,0,0,0,0,0
0,0,0,0,0,0,0,0,0
0,0,0,0,0,0,0,0,0
0,0,0,0,0,0,0,0,0
0,0,0,0,0,0,0,0,0
8073,140,7,26,6,20,1,1,0
0,0,0,0,0,0,0,0,0
0,0,0,0,0,0,0,0,0
0,0,0,0,0,0,0,0,0
0,0,0,0,0,0,0,0,0
0,0,0,0,0,0,0,0,0
0,0,0,0,0,0,0,0,0
0,0,0,0,0,0,0,0,0
0,0,0,0,0,0,0,0,0
0,0,0,0,0,0,0,0,0
0,0,0,0,0,0,0,0,0
0,0,0,0,0,0,0,0,0
28618,169,5,8,8,0,8,1,0
0,0,0,0,0,0,0,0,0
0,0,0,0,0,0,0,0,0
0,0,0,0,0,0,0,0,0
8998,93,6,20,20,0,1,1,0
0,0,0,0,0,0,0,0,0
0,0,0,0,0,0,0,0,0
165534,478,4,4,3,1,8,0,0
165536,477,4,4,3,1,8,0,0
0,0,0,0,0,0,0,0,0
0,0,0,0,0,0,0,0,0
0,0,0,0,0,0,0,0,0
0,0,0,0,0,0,0,0,0
0,0,0,0,0,0,0,0,0
0,0,0,0,0,0,0,0,0
0,0,0,0,0,0,0,0,0
0,0,0,0,0,0,0,0,0
0,0,0,0,0,0,0,0,0
0,0,0,0,0,0,0,0,0
0,0,0,0,0,0,0,0,0
0,0,0,0,0,0,0,0,0
0,0,0,0,0,0,0,0,0
0,0,0,0,0,0,0,0,0
0,0,0,0,0,0,0,0,0
0,0,0,0,0,0,0,0,0
0,0,0,0,0,0,0,0,0
0,0,0,0,0,0,0,0,0
0,0,0,0,0,0,0,0,0
135098,333,8,29,24,5,17,1,0
0,0,0,0,0,0,0,0,0
3201668,55,2,1,1,0,0,1,0
0,0,0,0,0,0,0,0,0
0,0,0,0,0,0,0,0,0
0,0,0,0,0,0,0,0,0
0,0,0,0,0,0,0,0,0
0,0,0,0,0,0,0,0,0
0,0,0,0,0,0,0,0,0
0,0,0,0,0,0,0,0,0
0,0,0,0,0,0,0,0,0
0,0,0,0,0,0,0,0,0
71481,47,4,0,0,0,1,0,0
0,0,0,0,0,0,0,0,0
0,0,0,0,0,0,0,0,0
0,0,0,0,0,0,0,0,0
0,0,0,0,0,0,0,0,0
0,0,0,0,0,0,0,0,0
0,0,0,0,0,0,0,0,0
0,0,0,0,0,0,0,0,0
0,0,0,0,0,0,0,0,0
71490,47,4,0,0,0,1,0,0
0,0,0,0,0,0,0,0,0
0,0,0,0,0,0,0,0,0
20331,38,0,3,1,2,0,1,0
0,0,0,0,0,0,0,0,0
0,0,0,0,0,0,0,0,0
0,0,0,0,0,0,0,0,0
0,0,0,0,0,0,0,0,0
0,0,0,0,0,0,0,0,0
0,0,0,0,0,0,0,0,0
0,0,0,0,0,0,0,0,0
71488,47,4,0,0,0,1,0,0
0,0,0,0,0,0,0,0,0
0,0,0,0,0,0,0,0,0
0,0,0,0,0,0,0,0,0
0,0,0,0,0,0,0,0,0
0,0,0,0,0,0,0,0,0
0,0,0,0,0,0,0,0,0
0,0,0,0,0,0,0,0,0
0,0,0,0,0,0,0,0,0
0,0,0,0,0,0,0,0,0
0,0,0,0,0,0,0,0,0
0,0,0,0,0,0,0,0,0
0,0,0,0,0,0,0,0,0
0,0,0,0,0,0,0,0,0
0,0,0,0,0,0,0,0,0
0,0,0,0,0,0,0,0,0
0,0,0,0,0,0,0,0,0
0,0,0,0,0,0,0,0,0
0,0,0,0,0,0,0,0,0
0,0,0,0,0,0,0,0,0
0,0,0,0,0,0,0,0,0
0,0,0,0,0,0,0,0,0
0,0,0,0,0,0,0,0,0
0,0,0,0,0,0,0,0,0
0,0,0,0,0,0,0,0,0
0,0,0,0,0,0,0,0,0
0,0,0,0,0,0,0,0,0
0,0,0,0,0,0,0,0,0
0,0,0,0,0,0,0,0,0
0,0,0,0,0,0,0,0,0
0,0,0,0,0,0,0,0,0
0,0,0,0,0,0,0,0,0
0,0,0,0,0,0,0,0,0
743,38,0,6,6,0,0,0,0
0,0,0,0,0,0,0,0,0
0,0,0,0,0,0,0,0,0
0,0,0,0,0,0,0,0,0
0,0,0,0,0,0,0,0,0
0,0,0,0,0,0,0,0,0
0,0,0,0,0,0,0,0,0
0,0,0,0,0,0,0,0,0
0,0,0,0,0,0,0,0,0
0,0,0,0,0,0,0,0,0
0,0,0,0,0,0,0,0,0
0,0,0,0,0,0,0,0,0
0,0,0,0,0,0,0,0,0
0,0,0,0,0,0,0,0,0
0,0,0,0,0,0,0,0,0
0,0,0,0,0,0,0,0,0
0,0,0,0,0,0,0,0,0
0,0,0,0,0,0,0,0,0
0,0,0,0,0,0,0,0,0
0,0,0,0,0,0,0,0,0
0,0,0,0,0,0,0,0,0
0,0,0,0,0,0,0,0,0
0,0,0,0,0,0,0,0,0
0,0,0,0,0,0,0,0,0
0,0,0,0,0,0,0,0,0
0,0,0,0,0,0,0,0,0
0,0,0,0,0,0,0,0,0
0,0,0,0,0,0,0,0,0
0,0,0,0,0,0,0,0,0
0,0,0,0,0,0,0,0,0
0,0,0,0,0,0,0,0,0
0,0,0,0,0,0,0,0,0
0,0,0,0,0,0,0,0,0
0,0,0,0,0,0,0,0,0
0,0,0,0,0,0,0,0,0
0,0,0,0,0,0,0,0,0
0,0,0,0,0,0,0,0,0
0,0,0,0,0,0,0,0,0
0,0,0,0,0,0,0,0,0
0,0,0,0,0,0,0,0,0
0,0,0,0,0,0,0,0,0
0,0,0,0,0,0,0,0,0
0,0,0,0,0,0,0,0,0
0,0,0,0,0,0,0,0,0
0,0,0,0,0,0,0,0,0
0,0,0,0,0,0,0,0,0
0,0,0,0,0,0,0,0,0
0,0,0,0,0,0,0,0,0
0,0,0,0,0,0,0,0,0
0,0,0,0,0,0,0,0,0
0,0,0,0,0,0,0,0,0
0,0,0,0,0,0,0,0,0
0,0,0,0,0,0,0,0,0
0,0,0,0,0,0,0,0,0
0,0,0,0,0,0,0,0,0
0,0,0,0,0,0,0,0,0
0,0,0,0,0,0,0,0,0
0,0,0,0,0,0,0,0,0
0,0,0,0,0,0,0,0,0
0,0,0,0,0,0,0,0,0
0,0,0,0,0,0,0,0,0
0,0,0,0,0,0,0,0,0
0,0,0,0,0,0,0,0,0
0,0,0,0,0,0,0,0,0
0,0,0,0,0,0,0,0,0
0,0,0,0,0,0,0,0,0
0,0,0,0,0,0,0,0,0
0,0,0,0,0,0,0,0,0
0,0,0,0,0,0,0,0,0
0,0,0,0,0,0,0,0,0
0,0,0,0,0,0,0,0,0
0,0,0,0,0,0,0,0,0
0,0,0,0,0,0,0,0,0
0,0,0,0,0,0,0,0,0
0,0,0,0,0,0,0,0,0
0,0,0,0,0,0,0,0,0
0,0,0,0,0,0,0,0,0
0,0,0,0,0,0,0,0,0
0,0,0,0,0,0,0,0,0
0,0,0,0,0,0,0,0,0
0,0,0,0,0,0,0,0,0
0,0,0,0,0,0,0,0,0
0,0,0,0,0,0,0,0,0
0,0,0,0,0,0,0,0,0
0,0,0,0,0,0,0,0,0
0,0,0,0,0,0,0,0,0
0,0,0,0,0,0,0,0,0
0,0,0,0,0,0,0,0,0
8073,140,7,26,6,20,1,1,0
0,0,0,0,0,0,0,0,0
26847,33,1,0,0,0,1,1,0
0,0,0,0,0,0,0,0,0
26847,33,1,0,0,0,1,1,0
26847,33,1,0,0,0,1,1,0
26847,33,1,0,0,0,1,1,0
26847,33,1,0,0,0,1,1,0
0,0,0,0,0,0,0,0,0
0,0,0,0,0,0,0,0,0
0,0,0,0,0,0,0,0,0
0,0,0,0,0,0,0,0,0
0,0,0,0,0,0,0,0,0
0,0,0,0,0,0,0,0,0
1261665,111,2,6,6,0,1,0,0
1261665,111,2,6,6,0,1,0,0
0,0,0,0,0,0,0,0,0
1261665,111,2,6,6,0,1,0,0
1261665,111,2,6,6,0,1,0,0
1261665,111,2,6,6,0,1,0,0
1261665,111,2,6,6,0,1,0,0
0,0,0,0,0,0,0,0,0
0,0,0,0,0,0,0,0,0
1261665,111,2,6,6,0,1,0,0
0,0,0,0,0,0,0,0,0
0,0,0,0,0,0,0,0,0
0,0,0,0,0,0,0,0,0
0,0,0,0,0,0,0,0,0
0,0,0,0,0,0,0,0,0
0,0,0,0,0,0,0,0,0
0,0,0,0,0,0,0,0,0
0,0,0,0,0,0,0,0,0
0,0,0,0,0,0,0,0,0
97599,39,4,0,0,0,2,1,0
0,0,0,0,0,0,0,0,0
0,0,0,0,0,0,0,0,0
0,0,0,0,0,0,0,0,0
0,0,0,0,0,0,0,0,0
0,0,0,0,0,0,0,0,0
0,0,0,0,0,0,0,0,0
25094,67,2,1,1,0,2,0,0
0,0,0,0,0,0,0,0,0
0,0,0,0,0,0,0,0,0
0,0,0,0,0,0,0,0,0
0,0,0,0,0,0,0,0,0
0,0,0,0,0,0,0,0,0
27859,78,3,0,0,0,3,0,0
0,0,0,0,0,0,0,0,0
0,0,0,0,0,0,0,0,0
0,0,0,0,0,0,0,0,0
0,0,0,0,0,0,0,0,0
0,0,0,0,0,0,0,0,0
0,0,0,0,0,0,0,0,0
0,0,0,0,0,0,0,0,0
0,0,0,0,0,0,0,0,0
0,0,0,0,0,0,0,0,0
0,0,0,0,0,0,0,0,0
0,0,0,0,0,0,0,0,0
25094,67,2,1,1,0,2,0,0
0,0,0,0,0,0,0,0,0
0,0,0,0,0,0,0,0,0
0,0,0,0,0,0,0,0,0
0,0,0,0,0,0,0,0,0
10416,39,1,0,0,0,1,0,0
10416,39,1,0,0,0,1,0,0
0,0,0,0,0,0,0,0,0
10416,39,1,0,0,0,1,0,0
10416,39,1,0,0,0,1,0,0
10416,39,1,0,0,0,1,0,0
10416,39,1,0,0,0,1,0,0
10416,39,1,0,0,0,1,0,0
0,0,0,0,0,0,0,0,0
0,0,0,0,0,0,0,0,0
0,0,0,0,0,0,0,0,0
0,0,0,0,0,0,0,0,0
0,0,0,0,0,0,0,0,0
0,0,0,0,0,0,0,0,0
0,0,0,0,0,0,0,0,0
0,0,0,0,0,0,0,0,0
0,0,0,0,0,0,0,0,0
0,0,0,0,0,0,0,0,0
0,0,0,0,0,0,0,0,0
0,0,0,0,0,0,0,0,0
0,0,0,0,0,0,0,0,0
0,0,0,0,0,0,0,0,0
0,0,0,0,0,0,0,0,0
0,0,0,0,0,0,0,0,0
0,0,0,0,0,0,0,0,0
0,0,0,0,0,0,0,0,0
0,0,0,0,0,0,0,0,0
0,0,0,0,0,0,0,0,0
0,0,0,0,0,0,0,0,0
125220,204,2,50,49,1,0,1,0
0,0,0,0,0,0,0,0,0
0,0,0,0,0,0,0,0,0
28520,47,4,0,0,0,0,0,0
58904,900,4,163,2,161,3,1,0
0,0,0,0,0,0,0,0,0
0,0,0,0,0,0,0,0,0
0,0,0,0,0,0,0,0,0
0,0,0,0,0,0,0,0,0
0,0,0,0,0,0,0,0,0
77738,101,1,4,2,2,0,0,0
0,0,0,0,0,0,0,0,0
0,0,0,0,0,0,0,0,0
0,0,0,0,0,0,0,0,0
0,0,0,0,0,0,0,0,0
282091,263,7,6,6,0,0,1,0
0,0,0,0,0,0,0,0,0
0,0,0,0,0,0,0,0,0
0,0,0,0,0,0,0,0,0
0,0,0,0,0,0,0,0,0
0,0,0,0,0,0,0,0,0
40012,126,1,1,1,0,0,1,0
0,0,0,0,0,0,0,0,0
0,0,0,0,0,0,0,0,0
0,0,0,0,0,0,0,0,0
0,0,0,0,0,0,0,0,0
0,0,0,0,0,0,0,0,0
181314,587,4,2,1,1,7,0,0
0,0,0,0,0,0,0,0,0
0,0,0,0,0,0,0,0,0
0,0,0,0,0,0,0,0,0
0,0,0,0,0,0,0,0,0
0,0,0,0,0,0,0,0,0
0,0,0,0,0,0,0,0,0
0,0,0,0,0,0,0,0,0
0,0,0,0,0,0,0,0,0
36136,224,7,34,33,1,1,1,0
3186,19,1,0,0,0,0,0,0
0,0,0,0,0,0,0,0,0
0,0,0,0,0,0,0,0,0
0,0,0,0,0,0,0,0,0
0,0,0,0,0,0,0,0,0
0,0,0,0,0,0,0,0,0
0,0,0,0,0,0,0,0,0
0,0,0,0,0,0,0,0,0
0,0,0,0,0,0,0,0,0
0,0,0,0,0,0,0,0,0
0,0,0,0,0,0,0,0,0
0,0,0,0,0,0,0,0,0
0,0,0,0,0,0,0,0,0
0,0,0,0,0,0,0,0,0
0,0,0,0,0,0,0,0,0
106755,927,6,226,77,149,6,1,0
0,0,0,0,0,0,0,0,0
106753,927,6,226,30,196,6,1,0
0,0,0,0,0,0,0,0,0
0,0,0,0,0,0,0,0,0
0,0,0,0,0,0,0,0,0
0,0,0,0,0,0,0,0,0
0,0,0,0,0,0,0,0,0
0,0,0,0,0,0,0,0,0
0,0,0,0,0,0,0,0,0
0,0,0,0,0,0,0,0,0
0,0,0,0,0,0,0,0,0
0,0,0,0,0,0,0,0,0
0,0,0,0,0,0,0,0,0
0,0,0,0,0,0,0,0,0
0,0,0,0,0,0,0,0,0
0,0,0,0,0,0,0,0,0
0,0,0,0,0,0,0,0,0
0,0,0,0,0,0,0,0,0
0,0,0,0,0,0,0,0,0
0,0,0,0,0,0,0,0,0
0,0,0,0,0,0,0,0,0
0,0,0,0,0,0,0,0,0
0,0,0,0,0,0,0,0,0
0,0,0,0,0,0,0,0,0
0,0,0,0,0,0,0,0,0
0,0,0,0,0,0,0,0,0
0,0,0,0,0,0,0,0,0
0,0,0,0,0,0,0,0,0
0,0,0,0,0,0,0,0,0
0,0,0,0,0,0,0,0,0
0,0,0,0,0,0,0,0,0
0,0,0,0,0,0,0,0,0
0,0,0,0,0,0,0,0,0
0,0,0,0,0,0,0,0,0
71377,46,4,0,0,0,1,0,0
0,0,0,0,0,0,0,0,0
0,0,0,0,0,0,0,0,0
0,0,0,0,0,0,0,0,0
0,0,0,0,0,0,0,0,0
0,0,0,0,0,0,0,0,0
0,0,0,0,0,0,0,0,0
0,0,0,0,0,0,0,0,0
0,0,0,0,0,0,0,0,0
0,0,0,0,0,0,0,0,0
0,0,0,0,0,0,0,0,0
0,0,0,0,0,0,0,0,0
0,0,0,0,0,0,0,0,0
0,0,0,0,0,0,0,0,0
0,0,0,0,0,0,0,0,0
3943,28,1,2,2,0,0,0,0
71487,47,4,0,0,0,1,0,0
71479,47,4,0,0,0,1,0,0
0,0,0,0,0,0,0,0,0
71476,47,4,0,0,0,1,0,0
0,0,0,0,0,0,0,0,0
322822,412,9,13,0,13,9,1,0
0,0,0,0,0,0,0,0,0
0,0,0,0,0,0,0,0,0
0,0,0,0,0,0,0,0,0
0,0,0,0,0,0,0,0,0
0,0,0,0,0,0,0,0,0
0,0,0,0,0,0,0,0,0
0,0,0,0,0,0,0,0,0
0,0,0,0,0,0,0,0,0
0,0,0,0,0,0,0,0,0
0,0,0,0,0,0,0,0,0
0,0,0,0,0,0,0,0,0
0,0,0,0,0,0,0,0,0
0,0,0,0,0,0,0,0,0
0,0,0,0,0,0,0,0,0
0,0,0,0,0,0,0,0,0
0,0,0,0,0,0,0,0,0
0,0,0,0,0,0,0,0,0
0,0,0,0,0,0,0,0,0
671594,540,0,4,4,0,2,1,1
0,0,0,0,0,0,0,0,0
0,0,0,0,0,0,0,0,0
163544,470,4,2,1,1,7,0,0
0,0,0,0,0,0,0,0,0
0,0,0,0,0,0,0,0,0
0,0,0,0,0,0,0,0,0
0,0,0,0,0,0,0,0,0
0,0,0,0,0,0,0,0,0
0,0,0,0,0,0,0,0,0
0,0,0,0,0,0,0,0,0
0,0,0,0,0,0,0,0,0
0,0,0,0,0,0,0,0,0
0,0,0,0,0,0,0,0,0
0,0,0,0,0,0,0,0,0
0,0,0,0,0,0,0,0,0
0,0,0,0,0,0,0,0,0
0,0,0,0,0,0,0,0,0
0,0,0,0,0,0,0,0,0
0,0,0,0,0,0,0,0,0
0,0,0,0,0,0,0,0,0
9269,78,1,0,0,0,0,0,0
0,0,0,0,0,0,0,0,0
0,0,0,0,0,0,0,0,0
0,0,0,0,0,0,0,0,0
0,0,0,0,0,0,0,0,0
0,0,0,0,0,0,0,0,0
0,0,0,0,0,0,0,0,0
2084,37,2,1,0,1,0,0,0
0,0,0,0,0,0,0,0,0
0,0,0,0,0,0,0,0,0
0,0,0,0,0,0,0,0,0
0,0,0,0,0,0,0,0,0
0,0,0,0,0,0,0,0,0
0,0,0,0,0,0,0,0,0
0,0,0,0,0,0,0,0,0
0,0,0,0,0,0,0,0,0
0,0,0,0,0,0,0,0,0
0,0,0,0,0,0,0,0,0
47917,76,2,1,1,0,3,1,0
0,0,0,0,0,0,0,0,0
0,0,0,0,0,0,0,0,0
0,0,0,0,0,0,0,0,0
0,0,0,0,0,0,0,0,0
8073,140,7,26,6,20,1,1,0
0,0,0,0,0,0,0,0,0
0,0,0,0,0,0,0,0,0
0,0,0,0,0,0,0,0,0
0,0,0,0,0,0,0,0,0
0,0,0,0,0,0,0,0,0
0,0,0,0,0,0,0,0,0
0,0,0,0,0,0,0,0,0
0,0,0,0,0,0,0,0,0
0,0,0,0,0,0,0,0,0
0,0,0,0,0,0,0,0,0
169806,509,5,4,3,1,11,1,0
163758,471,4,2,1,1,7,0,0
0,0,0,0,0,0,0,0,0
0,0,0,0,0,0,0,0,0
0,0,0,0,0,0,0,0,0
0,0,0,0,0,0,0,0,0
0,0,0,0,0,0,0,0,0
0,0,0,0,0,0,0,0,0
0,0,0,0,0,0,0,0,0
0,0,0,0,0,0,0,0,0
0,0,0,0,0,0,0,0,0
0,0,0,0,0,0,0,0,0
0,0,0,0,0,0,0,0,0
0,0,0,0,0,0,0,0,0
0,0,0,0,0,0,0,0,0
0,0,0,0,0,0,0,0,0
0,0,0,0,0,0,0,0,0
0,0,0,0,0,0,0,0,0
0,0,0,0,0,0,0,0,0
0,0,0,0,0,0,0,0,0
0,0,0,0,0,0,0,0,0
0,0,0,0,0,0,0,0,0
0,0,0,0,0,0,0,0,0
0,0,0,0,0,0,0,0,0
0,0,0,0,0,0,0,0,0
0,0,0,0,0,0,0,0,0
0,0,0,0,0,0,0,0,0
9665,82,1,0,0,0,0,0,0
0,0,0,0,0,0,0,0,0
0,0,0,0,0,0,0,0,0
48230,562,3,120,117,3,9,0,0
164857,475,4,2,1,1,7,0,0
164857,475,4,2,1,1,7,0,0
0,0,0,0,0,0,0,0,0
0,0,0,0,0,0,0,0,0
0,0,0,0,0,0,0,0,0
0,0,0,0,0,0,0,0,0
0,0,0,0,0,0,0,0,0
0,0,0,0,0,0,0,0,0
0,0,0,0,0,0,0,0,0
0,0,0,0,0,0,0,0,0
0,0,0,0,0,0,0,0,0
0,0,0,0,0,0,0,0,0
0,0,0,0,0,0,0,0,0
0,0,0,0,0,0,0,0,0
0,0,0,0,0,0,0,0,0
0,0,0,0,0,0,0,0,0
0,0,0,0,0,0,0,0,0
0,0,0,0,0,0,0,0,0
0,0,0,0,0,0,0,0,0
71491,47,4,0,0,0,1,0,0
71477,47,4,0,0,0,1,0,0
71481,47,4,0,0,0,1,0,0
0,0,0,0,0,0,0,0,0
0,0,0,0,0,0,0,0,0
0,0,0,0,0,0,0,0,0
0,0,0,0,0,0,0,0,0
0,0,0,0,0,0,0,0,0
0,0,0,0,0,0,0,0,0
0,0,0,0,0,0,0,0,0
0,0,0,0,0,0,0,0,0
0,0,0,0,0,0,0,0,0
0,0,0,0,0,0,0,0,0
0,0,0,0,0,0,0,0,0
0,0,0,0,0,0,0,0,0
0,0,0,0,0,0,0,0,0
0,0,0,0,0,0,0,0,0
0,0,0,0,0,0,0,0,0
0,0,0,0,0,0,0,0,0
71490,47,4,0,0,0,1,0,0
0,0,0,0,0,0,0,0,0
0,0,0,0,0,0,0,0,0
0,0,0,0,0,0,0,0,0
0,0,0,0,0,0,0,0,0
0,0,0,0,0,0,0,0,0
0,0,0,0,0,0,0,0,0
0,0,0,0,0,0,0,0,0
136975,335,8,29,24,5,17,1,0
0,0,0,0,0,0,0,0,0
0,0,0,0,0,0,0,0,0
0,0,0,0,0,0,0,0,0
0,0,0,0,0,0,0,0,0
0,0,0,0,0,0,0,0,0
0,0,0,0,0,0,0,0,0
0,0,0,0,0,0,0,0,0
0,0,0,0,0,0,0,0,0
0,0,0,0,0,0,0,0,0
0,0,0,0,0,0,0,0,0
0,0,0,0,0,0,0,0,0
0,0,0,0,0,0,0,0,0
0,0,0,0,0,0,0,0,0
0,0,0,0,0,0,0,0,0
0,0,0,0,0,0,0,0,0
0,0,0,0,0,0,0,0,0
0,0,0,0,0,0,0,0,0
0,0,0,0,0,0,0,0,0
0,0,0,0,0,0,0,0,0
0,0,0,0,0,0,0,0,0
0,0,0,0,0,0,0,0,0
0,0,0,0,0,0,0,0,0
0,0,0,0,0,0,0,0,0
0,0,0,0,0,0,0,0,0
11187,150,7,25,25,0,0,1,0
0,0,0,0,0,0,0,0,0
0,0,0,0,0,0,0,0,0
0,0,0,0,0,0,0,0,0
0,0,0,0,0,0,0,0,0
0,0,0,0,0,0,0,0,0
0,0,0,0,0,0,0,0,0
0,0,0,0,0,0,0,0,0
0,0,0,0,0,0,0,0,0
0,0,0,0,0,0,0,0,0
0,0,0,0,0,0,0,0,0
0,0,0,0,0,0,0,0,0
0,0,0,0,0,0,0,0,0
0,0,0,0,0,0,0,0,0
0,0,0,0,0,0,0,0,0
0,0,0,0,0,0,0,0,0
0,0,0,0,0,0,0,0,0
0,0,0,0,0,0,0,0,0
0,0,0,0,0,0,0,0,0
0,0,0,0,0,0,0,0,0
0,0,0,0,0,0,0,0,0
0,0,0,0,0,0,0,0,0
0,0,0,0,0,0,0,0,0
0,0,0,0,0,0,0,0,0
0,0,0,0,0,0,0,0,0
0,0,0,0,0,0,0,0,0
0,0,0,0,0,0,0,0,0
0,0,0,0,0,0,0,0,0
0,0,0,0,0,0,0,0,0
0,0,0,0,0,0,0,0,0
253945,1082,1,259,221,38,3,0,0
253945,1082,1,259,225,34,3,0,0
0,0,0,0,0,0,0,0,0
0,0,0,0,0,0,0,0,0
0,0,0,0,0,0,0,0,0
0,0,0,0,0,0,0,0,0
0,0,0,0,0,0,0,0,0
0,0,0,0,0,0,0,0,0
0,0,0,0,0,0,0,0,0
207364,1068,1,259,221,38,3,0,0
207364,1068,1,259,226,33,3,0,0
0,0,0,0,0,0,0,0,0
0,0,0,0,0,0,0,0,0
0,0,0,0,0,0,0,0,0
0,0,0,0,0,0,0,0,0
0,0,0,0,0,0,0,0,0
0,0,0,0,0,0,0,0,0
0,0,0,0,0,0,0,0,0
0,0,0,0,0,0,0,0,0
0,0,0,0,0,0,0,0,0
0,0,0,0,0,0,0,0,0
0,0,0,0,0,0,0,0,0
0,0,0,0,0,0,0,0,0
0,0,0,0,0,0,0,0,0
0,0,0,0,0,0,0,0,0
0,0,0,0,0,0,0,0,0
0,0,0,0,0,0,0,0,0
0,0,0,0,0,0,0,0,0
0,0,0,0,0,0,0,0,0
0,0,0,0,0,0,0,0,0
0,0,0,0,0,0,0,0,0
0,0,0,0,0,0,0,0,0
0,0,0,0,0,0,0,0,0
0,0,0,0,0,0,0,0,0
0,0,0,0,0,0,0,0,0
0,0,0,0,0,0,0,0,0
0,0,0,0,0,0,0,0,0
0,0,0,0,0,0,0,0,0
0,0,0,0,0,0,0,0,0
0,0,0,0,0,0,0,0,0
0,0,0,0,0,0,0,0,0
0,0,0,0,0,0,0,0,0
0,0,0,0,0,0,0,0,0
0,0,0,0,0,0,0,0,0
0,0,0,0,0,0,0,0,0
0,0,0,0,0,0,0,0,0
0,0,0,0,0,0,0,0,0
0,0,0,0,0,0,0,0,0
77778,101,1,4,2,2,0,0,0
0,0,0,0,0,0,0,0,0
11764,52,3,0,0,0,2,0,0
0,0,0,0,0,0,0,0,0
537382,189,6,1,1,0,0,1,0
36364,50,2,0,0,0,2,0,0
36364,50,2,0,0,0,2,0,0
36364,50,2,0,0,0,2,0,0
0,0,0,0,0,0,0,0,0
0,0,0,0,0,0,0,0,0
0,0,0,0,0,0,0,0,0
0,0,0,0,0,0,0,0,0
0,0,0,0,0,0,0,0,0
0,0,0,0,0,0,0,0,0
36364,50,2,0,0,0,2,0,0
0,0,0,0,0,0,0,0,0
0,0,0,0,0,0,0,0,0
0,0,0,0,0,0,0,0,0
36364,50,2,0,0,0,2,0,0
104968,65,4,9,9,0,2,1,0
104968,65,4,9,9,0,2,1,0
0,0,0,0,0,0,0,0,0
0,0,0,0,0,0,0,0,0
7162,49,4,0,0,0,0,1,0
0,0,0,0,0,0,0,0,0
0,0,0,0,0,0,0,0,0
0,0,0,0,0,0,0,0,0
0,0,0,0,0,0,0,0,0
0,0,0,0,0,0,0,0,0
0,0,0,0,0,0,0,0,0
0,0,0,0,0,0,0,0,0
36372,50,2,0,0,0,2,0,0
36372,50,2,0,0,0,2,0,0
0,0,0,0,0,0,0,0,0
0,0,0,0,0,0,0,0,0
0,0,0,0,0,0,0,0,0
0,0,0,0,0,0,0,0,0
36372,50,2,0,0,0,2,0,0
36372,50,2,0,0,0,2,0,0
0,0,0,0,0,0,0,0,0
0,0,0,0,0,0,0,0,0
0,0,0,0,0,0,0,0,0
0,0,0,0,0,0,0,0,0
0,0,0,0,0,0,0,0,0
0,0,0,0,0,0,0,0,0
0,0,0,0,0,0,0,0,0
0,0,0,0,0,0,0,0,0
0,0,0,0,0,0,0,0,0
0,0,0,0,0,0,0,0,0
0,0,0,0,0,0,0,0,0
39171,479,0,80,24,56,0,0,0
0,0,0,0,0,0,0,0,0
35929,39,1,0,0,0,0,1,0
0,0,0,0,0,0,0,0,0
0,0,0,0,0,0,0,0,0
0,0,0,0,0,0,0,0,0
0,0,0,0,0,0,0,0,0
0,0,0,0,0,0,0,0,0
0,0,0,0,0,0,0,0,0
0,0,0,0,0,0,0,0,0
0,0,0,0,0,0,0,0,0
0,0,0,0,0,0,0,0,0
0,0,0,0,0,0,0,0,0
0,0,0,0,0,0,0,0,0
0,0,0,0,0,0,0,0,0
0,0,0,0,0,0,0,0,0
0,0,0,0,0,0,0,0,0
0,0,0,0,0,0,0,0,0
0,0,0,0,0,0,0,0,0
0,0,0,0,0,0,0,0,0
0,0,0,0,0,0,0,0,0
0,0,0,0,0,0,0,0,0
0,0,0,0,0,0,0,0,0
0,0,0,0,0,0,0,0,0
77822,101,1,4,2,2,0,0,0
0,0,0,0,0,0,0,0,0
0,0,0,0,0,0,0,0,0
0,0,0,0,0,0,0,0,0
0,0,0,0,0,0,0,0,0
0,0,0,0,0,0,0,0,0
0,0,0,0,0,0,0,0,0
0,0,0,0,0,0,0,0,0
0,0,0,0,0,0,0,0,0
8073,140,7,26,6,20,1,1,0
8072,140,7,26,7,19,1,1,0
8073,140,7,26,6,20,1,1,0
8073,140,7,26,6,20,1,1,0
8073,140,7,26,6,20,1,1,0
0,0,0,0,0,0,0,0,0
275730,186,6,1,1,0,0,1,0
0,0,0,0,0,0,0,0,0
0,0,0,0,0,0,0,0,0
0,0,0,0,0,0,0,0,0
0,0,0,0,0,0,0,0,0
0,0,0,0,0,0,0,0,0
21168,35,0,3,1,2,0,0,0
0,0,0,0,0,0,0,0,0
0,0,0,0,0,0,0,0,0
0,0,0,0,0,0,0,0,0
0,0,0,0,0,0,0,0,0
2852,42,2,2,1,1,0,1,0
0,0,0,0,0,0,0,0,0
0,0,0,0,0,0,0,0,0
0,0,0,0,0,0,0,0,0
0,0,0,0,0,0,0,0,0
0,0,0,0,0,0,0,0,0
0,0,0,0,0,0,0,0,0
0,0,0,0,0,0,0,0,0
0,0,0,0,0,0,0,0,0
0,0,0,0,0,0,0,0,0
0,0,0,0,0,0,0,0,0
0,0,0,0,0,0,0,0,0
164617,479,4,4,3,1,8,0,0
164352,466,4,2,1,1,7,0,0
165007,472,4,2,1,1,7,0,0
165781,479,4,4,3,1,8,0,0
164757,473,4,2,1,1,7,0,0
164531,476,4,2,1,1,7,0,0
164527,478,4,2,1,1,7,0,0
163237,470,4,2,1,1,7,0,0
0,0,0,0,0,0,0,0,0
0,0,0,0,0,0,0,0,0
0,0,0,0,0,0,0,0,0
164036,471,4,2,1,1,7,0,0
0,0,0,0,0,0,0,0,0
163734,471,4,2,1,1,7,0,0
163756,471,4,2,1,1,7,0,0
164775,477,4,4,1,3,7,0,0
170368,733,4,4,3,1,8,0,0
0,0,0,0,0,0,0,0,0
165530,477,4,4,3,1,8,0,0
0,0,0,0,0,0,0,0,0
0,0,0,0,0,0,0,0,0
164432,475,4,4,1,3,7,0,0
0,0,0,0,0,0,0,0,0
165151,478,4,4,3,1,8,0,0
0,0,0,0,0,0,0,0,0
0,0,0,0,0,0,0,0,0
0,0,0,0,0,0,0,0,0
0,0,0,0,0,0,0,0,0
0,0,0,0,0,0,0,0,0
0,0,0,0,0,0,0,0,0
0,0,0,0,0,0,0,0,0
0,0,0,0,0,0,0,0,0
0,0,0,0,0,0,0,0,0
0,0,0,0,0,0,0,0,0
0,0,0,0,0,0,0,0,0
0,0,0,0,0,0,0,0,0
4547,35,0,2,0,2,0,0,0
0,0,0,0,0,0,0,0,0
0,0,0,0,0,0,0,0,0
0,0,0,0,0,0,0,0,0
0,0,0,0,0,0,0,0,0
34341,62,2,0,0,0,0,0,0
0,0,0,0,0,0,0,0,0
0,0,0,0,0,0,0,0,0
0,0,0,0,0,0,0,0,0
673137,555,0,4,4,0,2,1,1
0,0,0,0,0,0,0,0,0
0,0,0,0,0,0,0,0,0
0,0,0,0,0,0,0,0,0
0,0,0,0,0,0,0,0,0
0,0,0,0,0,0,0,0,0
0,0,0,0,0,0,0,0,0
0,0,0,0,0,0,0,0,0
0,0,0,0,0,0,0,0,0
0,0,0,0,0,0,0,0,0
0,0,0,0,0,0,0,0,0
0,0,0,0,0,0,0,0,0
0,0,0,0,0,0,0,0,0
0,0,0,0,0,0,0,0,0
0,0,0,0,0,0,0,0,0
0,0,0,0,0,0,0,0,0
31629,69,6,1,0,1,0,1,0
31629,69,6,1,0,1,0,1,0
0,0,0,0,0,0,0,0,0
31629,69,6,1,0,1,0,1,0
31629,69,6,1,0,1,0,1,0
0,0,0,0,0,0,0,0,0
0,0,0,0,0,0,0,0,0
0,0,0,0,0,0,0,0,0
0,0,0,0,0,0,0,0,0
0,0,0,0,0,0,0,0,0
31629,69,6,1,0,1,0,1,0
0,0,0,0,0,0,0,0,0
0,0,0,0,0,0,0,0,0
0,0,0,0,0,0,0,0,0
0,0,0,0,0,0,0,0,0
0,0,0,0,0,0,0,0,0
0,0,0,0,0,0,0,0,0
0,0,0,0,0,0,0,0,0
0,0,0,0,0,0,0,0,0
0,0,0,0,0,0,0,0,0
0,0,0,0,0,0,0,0,0
0,0,0,0,0,0,0,0,0
0,0,0,0,0,0,0,0,0
0,0,0,0,0,0,0,0,0
0,0,0,0,0,0,0,0,0
0,0,0,0,0,0,0,0,0
71026,51,2,0,0,0,2,0,0
71026,51,2,0,0,0,2,0,0
71026,51,2,0,0,0,2,0,0
71026,51,2,0,0,0,2,0,0
0,0,0,0,0,0,0,0,0
71026,51,2,0,0,0,2,0,0
0,0,0,0,0,0,0,0,0
0,0,0,0,0,0,0,0,0
0,0,0,0,0,0,0,0,0
278493,185,6,1,1,0,0,1,0
0,0,0,0,0,0,0,0,0
0,0,0,0,0,0,0,0,0
0,0,0,0,0,0,0,0,0
50716,64,2,0,0,0,2,0,0
0,0,0,0,0,0,0,0,0
0,0,0,0,0,0,0,0,0
0,0,0,0,0,0,0,0,0
0,0,0,0,0,0,0,0,0
0,0,0,0,0,0,0,0,0
0,0,0,0,0,0,0,0,0
0,0,0,0,0,0,0,0,0
0,0,0,0,0,0,0,0,0
0,0,0,0,0,0,0,0,0
0,0,0,0,0,0,0,0,0
0,0,0,0,0,0,0,0,0
0,0,0,0,0,0,0,0,0
0,0,0,0,0,0,0,0,0
0,0,0,0,0,0,0,0,0
0,0,0,0,0,0,0,0,0
0,0,0,0,0,0,0,0,0
0,0,0,0,0,0,0,0,0
0,0,0,0,0,0,0,0,0
0,0,0,0,0,0,0,0,0
0,0,0,0,0,0,0,0,0
0,0,0,0,0,0,0,0,0
0,0,0,0,0,0,0,0,0
0,0,0,0,0,0,0,0,0
0,0,0,0,0,0,0,0,0
0,0,0,0,0,0,0,0,0
0,0,0,0,0,0,0,0,0
0,0,0,0,0,0,0,0,0
0,0,0,0,0,0,0,0,0
0,0,0,0,0,0,0,0,0
0,0,0,0,0,0,0,0,0
0,0,0,0,0,0,0,0,0
0,0,0,0,0,0,0,0,0
0,0,0,0,0,0,0,0,0
0,0,0,0,0,0,0,0,0
0,0,0,0,0,0,0,0,0
0,0,0,0,0,0,0,0,0
0,0,0,0,0,0,0,0,0
0,0,0,0,0,0,0,0,0
0,0,0,0,0,0,0,0,0
0,0,0,0,0,0,0,0,0
0,0,0,0,0,0,0,0,0
0,0,0,0,0,0,0,0,0
0,0,0,0,0,0,0,0,0
0,0,0,0,0,0,0,0,0
0,0,0,0,0,0,0,0,0
0,0,0,0,0,0,0,0,0
0,0,0,0,0,0,0,0,0
0,0,0,0,0,0,0,0,0
0,0,0,0,0,0,0,0,0
0,0,0,0,0,0,0,0,0
0,0,0,0,0,0,0,0,0
0,0,0,0,0,0,0,0,0
0,0,0,0,0,0,0,0,0
0,0,0,0,0,0,0,0,0
0,0,0,0,0,0,0,0,0
0,0,0,0,0,0,0,0,0
0,0,0,0,0,0,0,0,0
0,0,0,0,0,0,0,0,0
0,0,0,0,0,0,0,0,0
0,0,0,0,0,0,0,0,0
7106,92,3,4,3,1,0,0,0
0,0,0,0,0,0,0,0,0
0,0,0,0,0,0,0,0,0
181811,2014,3,201,174,27,9,0,0
7105,92,3,4,3,1,0,0,0
0,0,0,0,0,0,0,0,0
0,0,0,0,0,0,0,0,0
0,0,0,0,0,0,0,0,0
9037,53,0,1,1,0,0,1,0
0,0,0,0,0,0,0,0,0
0,0,0,0,0,0,0,0,0
0,0,0,0,0,0,0,0,0
106757,927,6,226,30,196,6,1,0
0,0,0,0,0,0,0,0,0
0,0,0,0,0,0,0,0,0
0,0,0,0,0,0,0,0,0
77822,101,1,4,2,2,0,0,0
0,0,0,0,0,0,0,0,0
0,0,0,0,0,0,0,0,0
0,0,0,0,0,0,0,0,0
905306,94,1,4,1,3,2,0,0
229612,66,5,1,1,0,1,1,0
0,0,0,0,0,0,0,0,0
0,0,0,0,0,0,0,0,0
0,0,0,0,0,0,0,0,0
0,0,0,0,0,0,0,0,0
0,0,0,0,0,0,0,0,0
0,0,0,0,0,0,0,0,0
0,0,0,0,0,0,0,0,0
0,0,0,0,0,0,0,0,0
0,0,0,0,0,0,0,0,0
0,0,0,0,0,0,0,0,0
0,0,0,0,0,0,0,0,0
0,0,0,0,0,0,0,0,0
0,0,0,0,0,0,0,0,0
0,0,0,0,0,0,0,0,0
0,0,0,0,0,0,0,0,0
0,0,0,0,0,0,0,0,0
0,0,0,0,0,0,0,0,0
33869,170,6,8,5,3,1,0,0
0,0,0,0,0,0,0,0,0
0,0,0,0,0,0,0,0,0
0,0,0,0,0,0,0,0,0
0,0,0,0,0,0,0,0,0
0,0,0,0,0,0,0,0,0
0,0,0,0,0,0,0,0,0
0,0,0,0,0,0,0,0,0
0,0,0,0,0,0,0,0,0
0,0,0,0,0,0,0,0,0
0,0,0,0,0,0,0,0,0
0,0,0,0,0,0,0,0,0
0,0,0,0,0,0,0,0,0
0,0,0,0,0,0,0,0,0
0,0,0,0,0,0,0,0,0
0,0,0,0,0,0,0,0,0
0,0,0,0,0,0,0,0,0
0,0,0,0,0,0,0,0,0
0,0,0,0,0,0,0,0,0
0,0,0,0,0,0,0,0,0
0,0,0,0,0,0,0,0,0
0,0,0,0,0,0,0,0,0
0,0,0,0,0,0,0,0,0
0,0,0,0,0,0,0,0,0
0,0,0,0,0,0,0,0,0
0,0,0,0,0,0,0,0,0
0,0,0,0,0,0,0,0,0
0,0,0,0,0,0,0,0,0
0,0,0,0,0,0,0,0,0
0,0,0,0,0,0,0,0,0
0,0,0,0,0,0,0,0,0
0,0,0,0,0,0,0,0,0
0,0,0,0,0,0,0,0,0
0,0,0,0,0,0,0,0,0
286621,210,3,7,6,1,1,1,0
0,0,0,0,0,0,0,0,0
0,0,0,0,0,0,0,0,0
0,0,0,0,0,0,0,0,0
8072,140,7,26,6,20,1,1,0
8073,140,7,26,6,20,1,1,0
8073,140,7,26,6,20,1,1,0
8073,140,7,26,6,20,1,1,0
8073,140,7,26,6,20,1,1,0
8073,140,7,26,6,20,1,1,0
0,0,0,0,0,0,0,0,0
0,0,0,0,0,0,0,0,0
163918,472,4,2,1,1,7,0,0
166253,477,4,4,1,3,7,0,0
165677,479,4,4,1,3,7,0,0
0,0,0,0,0,0,0,0,0
0,0,0,0,0,0,0,0,0
48612,145,3,6,3,3,2,0,0
0,0,0,0,0,0,0,0,0
0,0,0,0,0,0,0,0,0
0,0,0,0,0,0,0,0,0
0,0,0,0,0,0,0,0,0
0,0,0,0,0,0,0,0,0
0,0,0,0,0,0,0,0,0
0,0,0,0,0,0,0,0,0
0,0,0,0,0,0,0,0,0
0,0,0,0,0,0,0,0,0
0,0,0,0,0,0,0,0,0
0,0,0,0,0,0,0,0,0
0,0,0,0,0,0,0,0,0
0,0,0,0,0,0,0,0,0
16288,89,0,15,2,13,0,1,0
42864,152,3,7,2,5,2,1,0
16292,89,0,15,2,13,0,1,0
0,0,0,0,0,0,0,0,0
0,0,0,0,0,0,0,0,0
0,0,0,0,0,0,0,0,0
0,0,0,0,0,0,0,0,0
0,0,0,0,0,0,0,0,0
0,0,0,0,0,0,0,0,0
0,0,0,0,0,0,0,0,0
0,0,0,0,0,0,0,0,0
0,0,0,0,0,0,0,0,0
0,0,0,0,0,0,0,0,0
0,0,0,0,0,0,0,0,0
0,0,0,0,0,0,0,0,0
0,0,0,0,0,0,0,0,0
0,0,0,0,0,0,0,0,0
9082,79,1,0,0,0,0,0,0
0,0,0,0,0,0,0,0,0
0,0,0,0,0,0,0,0,0
0,0,0,0,0,0,0,0,0
0,0,0,0,0,0,0,0,0
0,0,0,0,0,0,0,0,0
0,0,0,0,0,0,0,0,0
0,0,0,0,0,0,0,0,0
0,0,0,0,0,0,0,0,0
0,0,0,0,0,0,0,0,0
0,0,0,0,0,0,0,0,0
0,0,0,0,0,0,0,0,0
0,0,0,0,0,0,0,0,0
0,0,0,0,0,0,0,0,0
0,0,0,0,0,0,0,0,0
0,0,0,0,0,0,0,0,0
0,0,0,0,0,0,0,0,0
0,0,0,0,0,0,0,0,0
0,0,0,0,0,0,0,0,0
0,0,0,0,0,0,0,0,0
0,0,0,0,0,0,0,0,0
0,0,0,0,0,0,0,0,0
0,0,0,0,0,0,0,0,0
0,0,0,0,0,0,0,0,0
0,0,0,0,0,0,0,0,0
0,0,0,0,0,0,0,0,0
0,0,0,0,0,0,0,0,0
0,0,0,0,0,0,0,0,0
0,0,0,0,0,0,0,0,0
0,0,0,0,0,0,0,0,0
0,0,0,0,0,0,0,0,0
0,0,0,0,0,0,0,0,0
0,0,0,0,0,0,0,0,0
0,0,0,0,0,0,0,0,0
0,0,0,0,0,0,0,0,0
0,0,0,0,0,0,0,0,0
0,0,0,0,0,0,0,0,0
0,0,0,0,0,0,0,0,0
0,0,0,0,0,0,0,0,0
0,0,0,0,0,0,0,0,0
0,0,0,0,0,0,0,0,0
0,0,0,0,0,0,0,0,0
0,0,0,0,0,0,0,0,0
0,0,0,0,0,0,0,0,0
0,0,0,0,0,0,0,0,0
0,0,0,0,0,0,0,0,0
0,0,0,0,0,0,0,0,0
0,0,0,0,0,0,0,0,0
0,0,0,0,0,0,0,0,0
0,0,0,0,0,0,0,0,0
0,0,0,0,0,0,0,0,0
0,0,0,0,0,0,0,0,0
0,0,0,0,0,0,0,0,0
0,0,0,0,0,0,0,0,0
0,0,0,0,0,0,0,0,0
0,0,0,0,0,0,0,0,0
0,0,0,0,0,0,0,0,0
0,0,0,0,0,0,0,0,0
0,0,0,0,0,0,0,0,0
0,0,0,0,0,0,0,0,0
0,0,0,0,0,0,0,0,0
0,0,0,0,0,0,0,0,0
0,0,0,0,0,0,0,0,0
0,0,0,0,0,0,0,0,0
0,0,0,0,0,0,0,0,0
0,0,0,0,0,0,0,0,0
0,0,0,0,0,0,0,0,0
0,0,0,0,0,0,0,0,0
137621,395,8,27,24,3,32,1,0
678726,555,0,4,0,4,2,1,1
71578,48,4,0,0,0,1,0,0
0,0,0,0,0,0,0,0,0
0,0,0,0,0,0,0,0,0
9403,31,1,0,0,0,1,0,0
0,0,0,0,0,0,0,0,0
32102,163,4,17,16,1,4,0,0
32102,163,4,17,16,1,4,0,0
32102,163,4,17,16,1,4,0,0
32102,163,4,17,16,1,4,0,0
0,0,0,0,0,0,0,0,0
0,0,0,0,0,0,0,0,0
32102,163,4,17,16,1,4,0,0
28551,47,4,0,0,0,0,0,0
0,0,0,0,0,0,0,0,0
0,0,0,0,0,0,0,0,0
0,0,0,0,0,0,0,0,0
9627,112,2,4,4,0,2,0,0
0,0,0,0,0,0,0,0,0
9627,112,2,4,4,0,2,0,0
9627,112,2,4,4,0,2,0,0
9627,112,2,4,4,0,2,0,0
0,0,0,0,0,0,0,0,0
0,0,0,0,0,0,0,0,0
9627,112,2,4,4,0,2,0,0
0,0,0,0,0,0,0,0,0
0,0,0,0,0,0,0,0,0
0,0,0,0,0,0,0,0,0
0,0,0,0,0,0,0,0,0
0,0,0,0,0,0,0,0,0
0,0,0,0,0,0,0,0,0
0,0,0,0,0,0,0,0,0
0,0,0,0,0,0,0,0,0
3788,44,0,2,0,2,1,0,0
0,0,0,0,0,0,0,0,0
0,0,0,0,0,0,0,0,0
0,0,0,0,0,0,0,0,0
0,0,0,0,0,0,0,0,0
0,0,0,0,0,0,0,0,0
71578,48,4,0,0,0,1,0,0
0,0,0,0,0,0,0,0,0
0,0,0,0,0,0,0,0,0
655887,28,1,0,0,0,0,0,0
655887,28,1,0,0,0,0,0,0
0,0,0,0,0,0,0,0,0
0,0,0,0,0,0,0,0,0
0,0,0,0,0,0,0,0,0
0,0,0,0,0,0,0,0,0
0,0,0,0,0,0,0,0,0
415540,70,4,3,3,0,2,1,0
415540,70,4,3,3,0,2,1,0
0,0,0,0,0,0,0,0,0
0,0,0,0,0,0,0,0,0
0,0,0,0,0,0,0,0,0
0,0,0,0,0,0,0,0,0
0,0,0,0,0,0,0,0,0
415540,70,4,3,3,0,2,1,0
415540,70,4,3,3,0,2,1,0
0,0,0,0,0,0,0,0,0
0,0,0,0,0,0,0,0,0
0,0,0,0,0,0,0,0,0
0,0,0,0,0,0,0,0,0
415540,70,4,3,3,0,2,1,0
415540,70,4,3,3,0,2,1,0
0,0,0,0,0,0,0,0,0
0,0,0,0,0,0,0,0,0
0,0,0,0,0,0,0,0,0
0,0,0,0,0,0,0,0,0
0,0,0,0,0,0,0,0,0
0,0,0,0,0,0,0,0,0
0,0,0,0,0,0,0,0,0
0,0,0,0,0,0,0,0,0
0,0,0,0,0,0,0,0,0
0,0,0,0,0,0,0,0,0
415540,70,4,3,3,0,2,1,0
0,0,0,0,0,0,0,0,0
0,0,0,0,0,0,0,0,0
0,0,0,0,0,0,0,0,0
0,0,0,0,0,0,0,0,0
28052,97,0,2,0,2,2,0,0
30048,51,2,0,0,0,2,0,0
0,0,0,0,0,0,0,0,0
0,0,0,0,0,0,0,0,0
0,0,0,0,0,0,0,0,0
0,0,0,0,0,0,0,0,0
0,0,0,0,0,0,0,0,0
121452,48,4,0,0,0,0,0,0
0,0,0,0,0,0,0,0,0
0,0,0,0,0,0,0,0,0
0,0,0,0,0,0,0,0,0
0,0,0,0,0,0,0,0,0
0,0,0,0,0,0,0,0,0
0,0,0,0,0,0,0,0,0
0,0,0,0,0,0,0,0,0
0,0,0,0,0,0,0,0,0
0,0,0,0,0,0,0,0,0
0,0,0,0,0,0,0,0,0
0,0,0,0,0,0,0,0,0
0,0,0,0,0,0,0,0,0
676854,555,0,4,0,4,2,1,1
0,0,0,0,0,0,0,0,0
0,0,0,0,0,0,0,0,0
0,0,0,0,0,0,0,0,0
48612,145,3,6,3,3,2,0,0
0,0,0,0,0,0,0,0,0
0,0,0,0,0,0,0,0,0
0,0,0,0,0,0,0,0,0
0,0,0,0,0,0,0,0,0
0,0,0,0,0,0,0,0,0
0,0,0,0,0,0,0,0,0
0,0,0,0,0,0,0,0,0
0,0,0,0,0,0,0,0,0
0,0,0,0,0,0,0,0,0
0,0,0,0,0,0,0,0,0
0,0,0,0,0,0,0,0,0
0,0,0,0,0,0,0,0,0
0,0,0,0,0,0,0,0,0
0,0,0,0,0,0,0,0,0
19676,66,0,1,0,1,2,1,0
11061,78,0,6,2,4,0,1,0
0,0,0,0,0,0,0,0,0
28010,102,0,0,0,0,0,0,0
9550,28,1,2,1,1,0,0,0
9550,28,1,2,2,0,0,0,0
108620,615,9,72,67,5,1,1,0
0,0,0,0,0,0,0,0,0
19777,71,0,3,2,1,1,0,0
0,0,0,0,0,0,0,0,0
0,0,0,0,0,0,0,0,0
0,0,0,0,0,0,0,0,0
673491,555,0,4,4,0,2,1,1
0,0,0,0,0,0,0,0,0
165411,476,4,2,1,1,7,0,0
175412,533,4,7,4,3,8,0,0
169777,490,4,4,3,1,8,1,0
0,0,0,0,0,0,0,0,0
165830,477,4,4,3,1,8,0,0
0,0,0,0,0,0,0,0,0
0,0,0,0,0,0,0,0,0
0,0,0,0,0,0,0,0,0
0,0,0,0,0,0,0,0,0
0,0,0,0,0,0,0,0,0
0,0,0,0,0,0,0,0,0
0,0,0,0,0,0,0,0,0
0,0,0,0,0,0,0,0,0
0,0,0,0,0,0,0,0,0
0,0,0,0,0,0,0,0,0
8182,146,0,15,15,0,5,1,0
0,0,0,0,0,0,0,0,0
0,0,0,0,0,0,0,0,0
0,0,0,0,0,0,0,0,0
0,0,0,0,0,0,0,0,0
0,0,0,0,0,0,0,0,0
0,0,0,0,0,0,0,0,0
0,0,0,0,0,0,0,0,0
0,0,0,0,0,0,0,0,0
4764148,268,4,6,6,0,1,1,0
9394,31,1,0,0,0,1,0,0
77738,101,1,4,2,2,0,0,0
0,0,0,0,0,0,0,0,0
39945,127,2,5,2,3,1,1,0
60814,279,12,13,12,1,1,0,0
60814,279,12,13,2,11,1,0,0
0,0,0,0,0,0,0,0,0
0,0,0,0,0,0,0,0,0
0,0,0,0,0,0,0,0,0
0,0,0,0,0,0,0,0,0
0,0,0,0,0,0,0,0,0
0,0,0,0,0,0,0,0,0
0,0,0,0,0,0,0,0,0
71594,48,4,0,0,0,1,0,0
0,0,0,0,0,0,0,0,0
0,0,0,0,0,0,0,0,0
0,0,0,0,0,0,0,0,0
0,0,0,0,0,0,0,0,0
0,0,0,0,0,0,0,0,0
0,0,0,0,0,0,0,0,0
2115,30,2,1,0,1,0,0,0
0,0,0,0,0,0,0,0,0
0,0,0,0,0,0,0,0,0
444363,59,2,5,4,1,3,1,0
0,0,0,0,0,0,0,0,0
0,0,0,0,0,0,0,0,0
0,0,0,0,0,0,0,0,0
0,0,0,0,0,0,0,0,0
0,0,0,0,0,0,0,0,0
0,0,0,0,0,0,0,0,0
0,0,0,0,0,0,0,0,0
0,0,0,0,0,0,0,0,0
0,0,0,0,0,0,0,0,0
61181,301,1,6,4,2,0,0,0
0,0,0,0,0,0,0,0,0
0,0,0,0,0,0,0,0,0
0,0,0,0,0,0,0,0,0
0,0,0,0,0,0,0,0,0
0,0,0,0,0,0,0,0,0
0,0,0,0,0,0,0,0,0
0,0,0,0,0,0,0,0,0
0,0,0,0,0,0,0,0,0
0,0,0,0,0,0,0,0,0
0,0,0,0,0,0,0,0,0
0,0,0,0,0,0,0,0,0
0,0,0,0,0,0,0,0,0
121237,710,4,103,99,4,2,1,0
0,0,0,0,0,0,0,0,0
0,0,0,0,0,0,0,0,0
0,0,0,0,0,0,0,0,0
0,0,0,0,0,0,0,0,0
0,0,0,0,0,0,0,0,0
0,0,0,0,0,0,0,0,0
0,0,0,0,0,0,0,0,0
0,0,0,0,0,0,0,0,0
0,0,0,0,0,0,0,0,0
0,0,0,0,0,0,0,0,0
0,0,0,0,0,0,0,0,0
77822,101,1,4,2,2,0,0,0
0,0,0,0,0,0,0,0,0
0,0,0,0,0,0,0,0,0
0,0,0,0,0,0,0,0,0
0,0,0,0,0,0,0,0,0
0,0,0,0,0,0,0,0,0
0,0,0,0,0,0,0,0,0
0,0,0,0,0,0,0,0,0
0,0,0,0,0,0,0,0,0
0,0,0,0,0,0,0,0,0
0,0,0,0,0,0,0,0,0
0,0,0,0,0,0,0,0,0
0,0,0,0,0,0,0,0,0
0,0,0,0,0,0,0,0,0
0,0,0,0,0,0,0,0,0
0,0,0,0,0,0,0,0,0
0,0,0,0,0,0,0,0,0
0,0,0,0,0,0,0,0,0
0,0,0,0,0,0,0,0,0
0,0,0,0,0,0,0,0,0
0,0,0,0,0,0,0,0,0
0,0,0,0,0,0,0,0,0
0,0,0,0,0,0,0,0,0
0,0,0,0,0,0,0,0,0
0,0,0,0,0,0,0,0,0
0,0,0,0,0,0,0,0,0
0,0,0,0,0,0,0,0,0
253945,1082,1,259,220,39,3,0,0
253945,1082,1,259,221,38,3,0,0
0,0,0,0,0,0,0,0,0
0,0,0,0,0,0,0,0,0
0,0,0,0,0,0,0,0,0
207364,1068,1,259,220,39,3,0,0
207364,1068,1,259,220,39,3,0,0
0,0,0,0,0,0,0,0,0
0,0,0,0,0,0,0,0,0
0,0,0,0,0,0,0,0,0
0,0,0,0,0,0,0,0,0
0,0,0,0,0,0,0,0,0
0,0,0,0,0,0,0,0,0
0,0,0,0,0,0,0,0,0
0,0,0,0,0,0,0,0,0
0,0,0,0,0,0,0,0,0
0,0,0,0,0,0,0,0,0
0,0,0,0,0,0,0,0,0
0,0,0,0,0,0,0,0,0
0,0,0,0,0,0,0,0,0
34403,50,2,0,0,0,2,0,0
0,0,0,0,0,0,0,0,0
0,0,0,0,0,0,0,0,0
0,0,0,0,0,0,0,0,0
16744,33,1,0,0,0,1,0,0
0,0,0,0,0,0,0,0,0
77222,42,4,1,1,0,2,0,0
34403,50,2,0,0,0,2,0,0
0,0,0,0,0,0,0,0,0
0,0,0,0,0,0,0,0,0
0,0,0,0,0,0,0,0,0
232881,64,4,3,3,0,2,1,0
77222,42,4,1,1,0,2,0,0
0,0,0,0,0,0,0,0,0
60453,82,4,6,6,0,5,0,0
16744,33,1,0,0,0,1,0,0
124953,204,2,50,49,1,0,1,0
60453,82,4,6,6,0,5,0,0
2742761,5,0,0,0,0,0,0,0
124953,204,2,50,49,1,0,1,0
60453,82,4,6,6,0,5,0,0
60453,82,4,6,6,0,5,0,0
0,0,0,0,0,0,0,0,0
0,0,0,0,0,0,0,0,0
2742761,5,0,0,0,0,0,0,0
0,0,0,0,0,0,0,0,0
337892,43,4,1,1,0,2,0,0
0,0,0,0,0,0,0,0,0
0,0,0,0,0,0,0,0,0
0,0,0,0,0,0,0,0,0
337892,43,4,1,1,0,2,0,0
0,0,0,0,0,0,0,0,0
0,0,0,0,0,0,0,0,0
0,0,0,0,0,0,0,0,0
0,0,0,0,0,0,0,0,0
60453,82,4,6,6,0,5,0,0
0,0,0,0,0,0,0,0,0
0,0,0,0,0,0,0,0,0
0,0,0,0,0,0,0,0,0
0,0,0,0,0,0,0,0,0
0,0,0,0,0,0,0,0,0
0,0,0,0,0,0,0,0,0
0,0,0,0,0,0,0,0,0
0,0,0,0,0,0,0,0,0
0,0,0,0,0,0,0,0,0
0,0,0,0,0,0,0,0,0
0,0,0,0,0,0,0,0,0
0,0,0,0,0,0,0,0,0
0,0,0,0,0,0,0,0,0
0,0,0,0,0,0,0,0,0
0,0,0,0,0,0,0,0,0
0,0,0,0,0,0,0,0,0
0,0,0,0,0,0,0,0,0
0,0,0,0,0,0,0,0,0
0,0,0,0,0,0,0,0,0
0,0,0,0,0,0,0,0,0
0,0,0,0,0,0,0,0,0
0,0,0,0,0,0,0,0,0
0,0,0,0,0,0,0,0,0
0,0,0,0,0,0,0,0,0
0,0,0,0,0,0,0,0,0
0,0,0,0,0,0,0,0,0
0,0,0,0,0,0,0,0,0
0,0,0,0,0,0,0,0,0
0,0,0,0,0,0,0,0,0
0,0,0,0,0,0,0,0,0
0,0,0,0,0,0,0,0,0
0,0,0,0,0,0,0,0,0
0,0,0,0,0,0,0,0,0
0,0,0,0,0,0,0,0,0
0,0,0,0,0,0,0,0,0
0,0,0,0,0,0,0,0,0
0,0,0,0,0,0,0,0,0
0,0,0,0,0,0,0,0,0
0,0,0,0,0,0,0,0,0
0,0,0,0,0,0,0,0,0
0,0,0,0,0,0,0,0,0
0,0,0,0,0,0,0,0,0
0,0,0,0,0,0,0,0,0
0,0,0,0,0,0,0,0,0
0,0,0,0,0,0,0,0,0
0,0,0,0,0,0,0,0,0
0,0,0,0,0,0,0,0,0
0,0,0,0,0,0,0,0,0
0,0,0,0,0,0,0,0,0
0,0,0,0,0,0,0,0,0
0,0,0,0,0,0,0,0,0
0,0,0,0,0,0,0,0,0
0,0,0,0,0,0,0,0,0
0,0,0,0,0,0,0,0,0
0,0,0,0,0,0,0,0,0
0,0,0,0,0,0,0,0,0
0,0,0,0,0,0,0,0,0
0,0,0,0,0,0,0,0,0
0,0,0,0,0,0,0,0,0
0,0,0,0,0,0,0,0,0
0,0,0,0,0,0,0,0,0
0,0,0,0,0,0,0,0,0
0,0,0,0,0,0,0,0,0
0,0,0,0,0,0,0,0,0
0,0,0,0,0,0,0,0,0
0,0,0,0,0,0,0,0,0
0,0,0,0,0,0,0,0,0
0,0,0,0,0,0,0,0,0
0,0,0,0,0,0,0,0,0
0,0,0,0,0,0,0,0,0
0,0,0,0,0,0,0,0,0
0,0,0,0,0,0,0,0,0
0,0,0,0,0,0,0,0,0
0,0,0,0,0,0,0,0,0
0,0,0,0,0,0,0,0,0
0,0,0,0,0,0,0,0,0
0,0,0,0,0,0,0,0,0
0,0,0,0,0,0,0,0,0
0,0,0,0,0,0,0,0,0
0,0,0,0,0,0,0,0,0
0,0,0,0,0,0,0,0,0
0,0,0,0,0,0,0,0,0
0,0,0,0,0,0,0,0,0
0,0,0,0,0,0,0,0,0
0,0,0,0,0,0,0,0,0
0,0,0,0,0,0,0,0,0
0,0,0,0,0,0,0,0,0
0,0,0,0,0,0,0,0,0
0,0,0,0,0,0,0,0,0
0,0,0,0,0,0,0,0,0
0,0,0,0,0,0,0,0,0
0,0,0,0,0,0,0,0,0
308537,260,6,3,3,0,0,1,0
77738,101,1,4,2,2,0,0,0
77774,101,1,4,2,2,0,0,0
0,0,0,0,0,0,0,0,0
0,0,0,0,0,0,0,0,0
0,0,0,0,0,0,0,0,0
3776,44,0,2,0,2,1,0,0
0,0,0,0,0,0,0,0,0
0,0,0,0,0,0,0,0,0
0,0,0,0,0,0,0,0,0
0,0,0,0,0,0,0,0,0
0,0,0,0,0,0,0,0,0
0,0,0,0,0,0,0,0,0
0,0,0,0,0,0,0,0,0
0,0,0,0,0,0,0,0,0
0,0,0,0,0,0,0,0,0
0,0,0,0,0,0,0,0,0
0,0,0,0,0,0,0,0,0
0,0,0,0,0,0,0,0,0
0,0,0,0,0,0,0,0,0
0,0,0,0,0,0,0,0,0
0,0,0,0,0,0,0,0,0
0,0,0,0,0,0,0,0,0
0,0,0,0,0,0,0,0,0
16295,89,0,15,1,14,0,1,0
0,0,0,0,0,0,0,0,0
0,0,0,0,0,0,0,0,0
0,0,0,0,0,0,0,0,0
0,0,0,0,0,0,0,0,0
0,0,0,0,0,0,0,0,0
0,0,0,0,0,0,0,0,0
0,0,0,0,0,0,0,0,0
0,0,0,0,0,0,0,0,0
0,0,0,0,0,0,0,0,0
0,0,0,0,0,0,0,0,0
0,0,0,0,0,0,0,0,0
0,0,0,0,0,0,0,0,0
0,0,0,0,0,0,0,0,0
0,0,0,0,0,0,0,0,0
0,0,0,0,0,0,0,0,0
0,0,0,0,0,0,0,0,0
0,0,0,0,0,0,0,0,0
0,0,0,0,0,0,0,0,0
106520,926,6,226,50,176,5,1,0
0,0,0,0,0,0,0,0,0
0,0,0,0,0,0,0,0,0
0,0,0,0,0,0,0,0,0
0,0,0,0,0,0,0,0,0
0,0,0,0,0,0,0,0,0
0,0,0,0,0,0,0,0,0
0,0,0,0,0,0,0,0,0
0,0,0,0,0,0,0,0,0
0,0,0,0,0,0,0,0,0
0,0,0,0,0,0,0,0,0
11059,78,0,6,2,4,0,1,0
0,0,0,0,0,0,0,0,0
0,0,0,0,0,0,0,0,0
0,0,0,0,0,0,0,0,0
0,0,0,0,0,0,0,0,0
3201725,55,2,1,1,0,0,1,0
0,0,0,0,0,0,0,0,0
0,0,0,0,0,0,0,0,0
0,0,0,0,0,0,0,0,0
0,0,0,0,0,0,0,0,0
163646,472,4,2,1,1,7,0,0
166222,477,4,4,3,1,8,0,0
0,0,0,0,0,0,0,0,0
0,0,0,0,0,0,0,0,0
0,0,0,0,0,0,0,0,0
17250,89,1,0,0,0,2,0,0
0,0,0,0,0,0,0,0,0
0,0,0,0,0,0,0,0,0
0,0,0,0,0,0,0,0,0
0,0,0,0,0,0,0,0,0
0,0,0,0,0,0,0,0,0
0,0,0,0,0,0,0,0,0
71596,48,4,0,0,0,1,0,0
0,0,0,0,0,0,0,0,0
0,0,0,0,0,0,0,0,0
0,0,0,0,0,0,0,0,0
0,0,0,0,0,0,0,0,0
0,0,0,0,0,0,0,0,0
0,0,0,0,0,0,0,0,0
0,0,0,0,0,0,0,0,0
0,0,0,0,0,0,0,0,0
0,0,0,0,0,0,0,0,0
0,0,0,0,0,0,0,0,0
0,0,0,0,0,0,0,0,0
0,0,0,0,0,0,0,0,0
672818,555,0,4,4,0,2,1,1
9537,28,1,2,2,0,0,0,0
9537,28,1,2,1,1,0,0,0
0,0,0,0,0,0,0,0,0
0,0,0,0,0,0,0,0,0
0,0,0,0,0,0,0,0,0
0,0,0,0,0,0,0,0,0
0,0,0,0,0,0,0,0,0
0,0,0,0,0,0,0,0,0
0,0,0,0,0,0,0,0,0
0,0,0,0,0,0,0,0,0
138091,405,8,26,1,25,32,1,0
94543,60,1,3,3,0,0,1,0
0,0,0,0,0,0,0,0,0
0,0,0,0,0,0,0,0,0
0,0,0,0,0,0,0,0,0
0,0,0,0,0,0,0,0,0
0,0,0,0,0,0,0,0,0
0,0,0,0,0,0,0,0,0
0,0,0,0,0,0,0,0,0
0,0,0,0,0,0,0,0,0
0,0,0,0,0,0,0,0,0
0,0,0,0,0,0,0,0,0
672744,555,0,4,4,0,2,1,1
0,0,0,0,0,0,0,0,0
0,0,0,0,0,0,0,0,0
0,0,0,0,0,0,0,0,0
0,0,0,0,0,0,0,0,0
8073,140,7,26,6,20,1,1,0
0,0,0,0,0,0,0,0,0
0,0,0,0,0,0,0,0,0
0,0,0,0,0,0,0,0,0
213002,475,3,3,0,3,2,0,0
0,0,0,0,0,0,0,0,0
0,0,0,0,0,0,0,0,0
123911,1595,3,210,173,37,10,1,0
0,0,0,0,0,0,0,0,0
0,0,0,0,0,0,0,0,0
0,0,0,0,0,0,0,0,0
0,0,0,0,0,0,0,0,0
0,0,0,0,0,0,0,0,0
0,0,0,0,0,0,0,0,0
0,0,0,0,0,0,0,0,0
0,0,0,0,0,0,0,0,0
0,0,0,0,0,0,0,0,0
0,0,0,0,0,0,0,0,0
0,0,0,0,0,0,0,0,0
0,0,0,0,0,0,0,0,0
0,0,0,0,0,0,0,0,0
138094,405,8,26,24,2,32,1,0
0,0,0,0,0,0,0,0,0
0,0,0,0,0,0,0,0,0
0,0,0,0,0,0,0,0,0
71581,48,4,0,0,0,1,0,0
0,0,0,0,0,0,0,0,0
0,0,0,0,0,0,0,0,0
0,0,0,0,0,0,0,0,0
0,0,0,0,0,0,0,0,0
0,0,0,0,0,0,0,0,0
0,0,0,0,0,0,0,0,0
0,0,0,0,0,0,0,0,0
0,0,0,0,0,0,0,0,0
168432,514,4,2,1,1,8,1,0
163628,485,4,4,3,1,8,0,0
166433,479,4,4,3,1,8,0,0
0,0,0,0,0,0,0,0,0
0,0,0,0,0,0,0,0,0
232881,64,4,3,3,0,2,1,0
0,0,0,0,0,0,0,0,0
0,0,0,0,0,0,0,0,0
0,0,0,0,0,0,0,0,0
0,0,0,0,0,0,0,0,0
0,0,0,0,0,0,0,0,0
0,0,0,0,0,0,0,0,0
0,0,0,0,0,0,0,0,0
0,0,0,0,0,0,0,0,0
0,0,0,0,0,0,0,0,0
0,0,0,0,0,0,0,0,0
0,0,0,0,0,0,0,0,0
0,0,0,0,0,0,0,0,0
0,0,0,0,0,0,0,0,0
0,0,0,0,0,0,0,0,0
0,0,0,0,0,0,0,0,0
0,0,0,0,0,0,0,0,0
0,0,0,0,0,0,0,0,0
196399,1519,9,54,49,5,1,1,0
0,0,0,0,0,0,0,0,0
0,0,0,0,0,0,0,0,0
0,0,0,0,0,0,0,0,0
0,0,0,0,0,0,0,0,0
0,0,0,0,0,0,0,0,0
0,0,0,0,0,0,0,0,0
0,0,0,0,0,0,0,0,0
0,0,0,0,0,0,0,0,0
0,0,0,0,0,0,0,0,0
0,0,0,0,0,0,0,0,0
0,0,0,0,0,0,0,0,0
0,0,0,0,0,0,0,0,0
0,0,0,0,0,0,0,0,0
0,0,0,0,0,0,0,0,0
8173,146,0,15,15,0,5,1,0
162681,218,4,26,19,7,2,1,0
0,0,0,0,0,0,0,0,0
0,0,0,0,0,0,0,0,0
0,0,0,0,0,0,0,0,0
0,0,0,0,0,0,0,0,0
0,0,0,0,0,0,0,0,0
0,0,0,0,0,0,0,0,0
0,0,0,0,0,0,0,0,0
0,0,0,0,0,0,0,0,0
0,0,0,0,0,0,0,0,0
0,0,0,0,0,0,0,0,0
0,0,0,0,0,0,0,0,0
0,0,0,0,0,0,0,0,0
0,0,0,0,0,0,0,0,0
0,0,0,0,0,0,0,0,0
0,0,0,0,0,0,0,0,0
0,0,0,0,0,0,0,0,0
0,0,0,0,0,0,0,0,0
0,0,0,0,0,0,0,0,0
0,0,0,0,0,0,0,0,0
0,0,0,0,0,0,0,0,0
0,0,0,0,0,0,0,0,0
19976,213,2,48,47,1,2,1,0
0,0,0,0,0,0,0,0,0
0,0,0,0,0,0,0,0,0
0,0,0,0,0,0,0,0,0
0,0,0,0,0,0,0,0,0
0,0,0,0,0,0,0,0,0
0,0,0,0,0,0,0,0,0
0,0,0,0,0,0,0,0,0
0,0,0,0,0,0,0,0,0
33205,178,1,35,35,0,2,0,0
0,0,0,0,0,0,0,0,0
0,0,0,0,0,0,0,0,0
0,0,0,0,0,0,0,0,0
0,0,0,0,0,0,0,0,0
0,0,0,0,0,0,0,0,0
0,0,0,0,0,0,0,0,0
0,0,0,0,0,0,0,0,0
0,0,0,0,0,0,0,0,0
0,0,0,0,0,0,0,0,0
0,0,0,0,0,0,0,0,0
0,0,0,0,0,0,0,0,0
0,0,0,0,0,0,0,0,0
0,0,0,0,0,0,0,0,0
0,0,0,0,0,0,0,0,0
0,0,0,0,0,0,0,0,0
0,0,0,0,0,0,0,0,0
0,0,0,0,0,0,0,0,0
0,0,0,0,0,0,0,0,0
0,0,0,0,0,0,0,0,0
3433,18,0,0,0,0,5,0,0
3450,18,0,0,0,0,5,0,0
0,0,0,0,0,0,0,0,0
0,0,0,0,0,0,0,0,0
0,0,0,0,0,0,0,0,0
0,0,0,0,0,0,0,0,0
0,0,0,0,0,0,0,0,0
0,0,0,0,0,0,0,0,0
0,0,0,0,0,0,0,0,0
0,0,0,0,0,0,0,0,0
0,0,0,0,0,0,0,0,0
34412,50,2,0,0,0,2,0,0
34412,50,2,0,0,0,2,0,0
33583,46,2,0,0,0,2,0,0
33583,46,2,0,0,0,2,0,0
0,0,0,0,0,0,0,0,0
0,0,0,0,0,0,0,0,0
34412,50,2,0,0,0,2,0,0
34412,50,2,0,0,0,2,0,0
0,0,0,0,0,0,0,0,0
33583,46,2,0,0,0,2,0,0
33583,46,2,0,0,0,2,0,0
0,0,0,0,0,0,0,0,0
0,0,0,0,0,0,0,0,0
33583,46,2,0,0,0,2,0,0
33583,46,2,0,0,0,2,0,0
0,0,0,0,0,0,0,0,0
0,0,0,0,0,0,0,0,0
0,0,0,0,0,0,0,0,0
33583,46,2,0,0,0,2,0,0
0,0,0,0,0,0,0,0,0
0,0,0,0,0,0,0,0,0
36413,50,2,0,0,0,2,0,0
36413,50,2,0,0,0,2,0,0
134437,59,4,3,3,0,2,1,0
134437,59,4,3,3,0,2,1,0
134437,59,4,3,3,0,2,1,0
134437,59,4,3,3,0,2,1,0
134437,59,4,3,3,0,2,1,0
0,0,0,0,0,0,0,0,0
104973,65,4,9,9,0,2,1,0
104973,65,4,9,9,0,2,1,0
0,0,0,0,0,0,0,0,0
0,0,0,0,0,0,0,0,0
0,0,0,0,0,0,0,0,0
0,0,0,0,0,0,0,0,0
104973,65,4,9,9,0,2,1,0
0,0,0,0,0,0,0,0,0
0,0,0,0,0,0,0,0,0
0,0,0,0,0,0,0,0,0
0,0,0,0,0,0,0,0,0
102468,28,2,0,0,0,0,0,0
0,0,0,0,0,0,0,0,0
0,0,0,0,0,0,0,0,0
0,0,0,0,0,0,0,0,0
102468,28,2,0,0,0,0,0,0
0,0,0,0,0,0,0,0,0
0,0,0,0,0,0,0,0,0
0,0,0,0,0,0,0,0,0
9198,61,2,5,5,0,2,0,0
9198,61,2,5,5,0,2,0,0
232808,61,4,3,3,0,2,1,0
232808,61,4,3,3,0,2,1,0
9198,61,2,5,5,0,2,0,0
232808,61,4,3,3,0,2,1,0
420891,62,4,3,3,0,2,1,0
420891,62,4,3,3,0,2,1,0
0,0,0,0,0,0,0,0,0
232808,61,4,3,3,0,2,1,0
0,0,0,0,0,0,0,0,0
0,0,0,0,0,0,0,0,0
0,0,0,0,0,0,0,0,0
420891,62,4,3,3,0,2,1,0
0,0,0,0,0,0,0,0,0
0,0,0,0,0,0,0,0,0
0,0,0,0,0,0,0,0,0
420891,62,4,3,3,0,2,1,0
0,0,0,0,0,0,0,0,0
415564,62,4,3,3,0,2,1,0
415564,62,4,3,3,0,2,1,0
0,0,0,0,0,0,0,0,0
0,0,0,0,0,0,0,0,0
0,0,0,0,0,0,0,0,0
0,0,0,0,0,0,0,0,0
0,0,0,0,0,0,0,0,0
0,0,0,0,0,0,0,0,0
0,0,0,0,0,0,0,0,0
0,0,0,0,0,0,0,0,0
0,0,0,0,0,0,0,0,0
0,0,0,0,0,0,0,0,0
0,0,0,0,0,0,0,0,0
0,0,0,0,0,0,0,0,0
0,0,0,0,0,0,0,0,0
0,0,0,0,0,0,0,0,0
0,0,0,0,0,0,0,0,0
0,0,0,0,0,0,0,0,0
0,0,0,0,0,0,0,0,0
0,0,0,0,0,0,0,0,0
0,0,0,0,0,0,0,0,0
0,0,0,0,0,0,0,0,0
0,0,0,0,0,0,0,0,0
0,0,0,0,0,0,0,0,0
0,0,0,0,0,0,0,0,0
0,0,0,0,0,0,0,0,0
0,0,0,0,0,0,0,0,0
0,0,0,0,0,0,0,0,0
0,0,0,0,0,0,0,0,0
0,0,0,0,0,0,0,0,0
0,0,0,0,0,0,0,0,0
0,0,0,0,0,0,0,0,0
0,0,0,0,0,0,0,0,0
0,0,0,0,0,0,0,0,0
0,0,0,0,0,0,0,0,0
0,0,0,0,0,0,0,0,0
0,0,0,0,0,0,0,0,0
0,0,0,0,0,0,0,0,0
90214,135,3,21,1,20,3,0,0
90214,135,3,21,1,20,3,0,0
0,0,0,0,0,0,0,0,0
0,0,0,0,0,0,0,0,0
0,0,0,0,0,0,0,0,0
0,0,0,0,0,0,0,0,0
0,0,0,0,0,0,0,0,0
0,0,0,0,0,0,0,0,0
0,0,0,0,0,0,0,0,0
0,0,0,0,0,0,0,0,0
8411,52,3,0,0,0,4,0,0
8411,52,3,0,0,0,4,0,0
0,0,0,0,0,0,0,0,0
10906,56,3,0,0,0,2,0,0
10906,56,3,0,0,0,2,0,0
0,0,0,0,0,0,0,0,0
0,0,0,0,0,0,0,0,0
0,0,0,0,0,0,0,0,0
0,0,0,0,0,0,0,0,0
0,0,0,0,0,0,0,0,0
90214,135,3,21,1,20,3,0,0
90214,135,3,21,1,20,3,0,0
8411,52,3,0,0,0,4,0,0
10906,56,3,0,0,0,2,0,0
90214,135,3,21,1,20,3,0,0
8411,52,3,0,0,0,4,0,0
8411,52,3,0,0,0,4,0,0
0,0,0,0,0,0,0,0,0
0,0,0,0,0,0,0,0,0
10906,56,3,0,0,0,2,0,0
0,0,0,0,0,0,0,0,0
0,0,0,0,0,0,0,0,0
0,0,0,0,0,0,0,0,0
0,0,0,0,0,0,0,0,0
0,0,0,0,0,0,0,0,0
0,0,0,0,0,0,0,0,0
0,0,0,0,0,0,0,0,0
0,0,0,0,0,0,0,0,0
0,0,0,0,0,0,0,0,0
0,0,0,0,0,0,0,0,0
0,0,0,0,0,0,0,0,0
0,0,0,0,0,0,0,0,0
11001,82,0,7,6,1,0,1,0
27754,145,5,5,1,4,1,0,0
0,0,0,0,0,0,0,0,0
0,0,0,0,0,0,0,0,0
0,0,0,0,0,0,0,0,0
0,0,0,0,0,0,0,0,0
2741,39,0,0,0,0,0,0,0
1178581,1269,1,44,29,15,7,1,0
0,0,0,0,0,0,0,0,0
0,0,0,0,0,0,0,0,0
7430,57,4,1,1,0,0,1,0
0,0,0,0,0,0,0,0,0
0,0,0,0,0,0,0,0,0
0,0,0,0,0,0,0,0,0
0,0,0,0,0,0,0,0,0
306738,831,4,119,5,114,11,1,0
0,0,0,0,0,0,0,0,0
0,0,0,0,0,0,0,0,0
0,0,0,0,0,0,0,0,0
0,0,0,0,0,0,0,0,0
0,0,0,0,0,0,0,0,0
0,0,0,0,0,0,0,0,0
0,0,0,0,0,0,0,0,0
0,0,0,0,0,0,0,0,0
0,0,0,0,0,0,0,0,0
0,0,0,0,0,0,0,0,0
0,0,0,0,0,0,0,0,0
0,0,0,0,0,0,0,0,0
0,0,0,0,0,0,0,0,0
0,0,0,0,0,0,0,0,0
0,0,0,0,0,0,0,0,0
0,0,0,0,0,0,0,0,0
0,0,0,0,0,0,0,0,0
0,0,0,0,0,0,0,0,0
0,0,0,0,0,0,0,0,0
0,0,0,0,0,0,0,0,0
0,0,0,0,0,0,0,0,0
0,0,0,0,0,0,0,0,0
0,0,0,0,0,0,0,0,0
0,0,0,0,0,0,0,0,0
0,0,0,0,0,0,0,0,0
0,0,0,0,0,0,0,0,0
0,0,0,0,0,0,0,0,0
120220,899,6,223,33,190,6,1,0
0,0,0,0,0,0,0,0,0
0,0,0,0,0,0,0,0,0
0,0,0,0,0,0,0,0,0
0,0,0,0,0,0,0,0,0
0,0,0,0,0,0,0,0,0
0,0,0,0,0,0,0,0,0
0,0,0,0,0,0,0,0,0
0,0,0,0,0,0,0,0,0
0,0,0,0,0,0,0,0,0
0,0,0,0,0,0,0,0,0
0,0,0,0,0,0,0,0,0
0,0,0,0,0,0,0,0,0
0,0,0,0,0,0,0,0,0
0,0,0,0,0,0,0,0,0
0,0,0,0,0,0,0,0,0
0,0,0,0,0,0,0,0,0
0,0,0,0,0,0,0,0,0
0,0,0,0,0,0,0,0,0
0,0,0,0,0,0,0,0,0
0,0,0,0,0,0,0,0,0
0,0,0,0,0,0,0,0,0
0,0,0,0,0,0,0,0,0
0,0,0,0,0,0,0,0,0
120220,899,6,223,149,74,6,1,0
120220,899,6,223,49,174,6,1,0
0,0,0,0,0,0,0,0,0
0,0,0,0,0,0,0,0,0
0,0,0,0,0,0,0,0,0
0,0,0,0,0,0,0,0,0
0,0,0,0,0,0,0,0,0
0,0,0,0,0,0,0,0,0
0,0,0,0,0,0,0,0,0
120220,899,6,223,34,189,6,1,0
0,0,0,0,0,0,0,0,0
0,0,0,0,0,0,0,0,0
0,0,0,0,0,0,0,0,0
0,0,0,0,0,0,0,0,0
0,0,0,0,0,0,0,0,0
5340,29,0,0,0,0,1,0,0
0,0,0,0,0,0,0,0,0
0,0,0,0,0,0,0,0,0
0,0,0,0,0,0,0,0,0
0,0,0,0,0,0,0,0,0
120218,899,6,223,29,194,6,1,0
0,0,0,0,0,0,0,0,0
0,0,0,0,0,0,0,0,0
0,0,0,0,0,0,0,0,0
0,0,0,0,0,0,0,0,0
0,0,0,0,0,0,0,0,0
0,0,0,0,0,0,0,0,0
120220,899,6,223,29,194,6,1,0
0,0,0,0,0,0,0,0,0
0,0,0,0,0,0,0,0,0
0,0,0,0,0,0,0,0,0
0,0,0,0,0,0,0,0,0
0,0,0,0,0,0,0,0,0
0,0,0,0,0,0,0,0,0
0,0,0,0,0,0,0,0,0
0,0,0,0,0,0,0,0,0
0,0,0,0,0,0,0,0,0
0,0,0,0,0,0,0,0,0
0,0,0,0,0,0,0,0,0
0,0,0,0,0,0,0,0,0
0,0,0,0,0,0,0,0,0
0,0,0,0,0,0,0,0,0
58911,900,4,163,2,161,3,1,0
59106,901,4,163,2,161,3,1,0
59106,901,4,163,2,161,3,1,0
0,0,0,0,0,0,0,0,0
59106,901,4,163,2,161,3,1,0
59106,901,4,163,2,161,3,1,0
58904,900,4,163,2,161,3,1,0
58904,900,4,163,2,161,3,1,0
58709,899,4,163,2,161,3,1,0
59106,901,4,163,2,161,3,1,0
58904,900,4,163,2,161,3,1,0
58904,900,4,163,2,161,3,1,0
58904,900,4,163,2,161,3,1,0
0,0,0,0,0,0,0,0,0
0,0,0,0,0,0,0,0,0
0,0,0,0,0,0,0,0,0
0,0,0,0,0,0,0,0,0
0,0,0,0,0,0,0,0,0
0,0,0,0,0,0,0,0,0
0,0,0,0,0,0,0,0,0
0,0,0,0,0,0,0,0,0
0,0,0,0,0,0,0,0,0
0,0,0,0,0,0,0,0,0
0,0,0,0,0,0,0,0,0
0,0,0,0,0,0,0,0,0
72670,48,4,0,0,0,1,0,0
0,0,0,0,0,0,0,0,0
0,0,0,0,0,0,0,0,0
0,0,0,0,0,0,0,0,0
0,0,0,0,0,0,0,0,0
0,0,0,0,0,0,0,0,0
0,0,0,0,0,0,0,0,0
0,0,0,0,0,0,0,0,0
0,0,0,0,0,0,0,0,0
0,0,0,0,0,0,0,0,0
0,0,0,0,0,0,0,0,0
0,0,0,0,0,0,0,0,0
0,0,0,0,0,0,0,0,0
0,0,0,0,0,0,0,0,0
0,0,0,0,0,0,0,0,0
0,0,0,0,0,0,0,0,0
0,0,0,0,0,0,0,0,0
0,0,0,0,0,0,0,0,0
0,0,0,0,0,0,0,0,0
0,0,0,0,0,0,0,0,0
0,0,0,0,0,0,0,0,0
72658,48,4,0,0,0,1,0,0
72658,48,4,0,0,0,1,0,0
0,0,0,0,0,0,0,0,0
10209,65,0,3,2,1,0,0,0
120217,899,6,223,49,174,6,1,0
8073,140,7,26,7,19,1,1,0
0,0,0,0,0,0,0,0,0
0,0,0,0,0,0,0,0,0
140364,407,8,28,24,4,32,1,0
0,0,0,0,0,0,0,0,0
11219,150,7,25,25,0,0,1,0
0,0,0,0,0,0,0,0,0
8073,140,7,26,10,16,1,1,0
0,0,0,0,0,0,0,0,0
0,0,0,0,0,0,0,0,0
0,0,0,0,0,0,0,0,0
0,0,0,0,0,0,0,0,0
0,0,0,0,0,0,0,0,0
0,0,0,0,0,0,0,0,0
8073,140,7,26,6,20,1,1,0
0,0,0,0,0,0,0,0,0
10395,85,1,0,0,0,0,0,0
0,0,0,0,0,0,0,0,0
72658,48,4,0,0,0,1,0,0
0,0,0,0,0,0,0,0,0
0,0,0,0,0,0,0,0,0
0,0,0,0,0,0,0,0,0
0,0,0,0,0,0,0,0,0
0,0,0,0,0,0,0,0,0
0,0,0,0,0,0,0,0,0
0,0,0,0,0,0,0,0,0
167160,540,4,4,3,1,8,1,0
0,0,0,0,0,0,0,0,0
0,0,0,0,0,0,0,0,0
165389,477,4,4,3,1,8,0,0
0,0,0,0,0,0,0,0,0
0,0,0,0,0,0,0,0,0
139936,406,8,28,24,4,32,1,0
164663,474,4,2,1,1,7,0,0
0,0,0,0,0,0,0,0,0
19672,32,0,1,1,0,0,1,0
0,0,0,0,0,0,0,0,0
0,0,0,0,0,0,0,0,0
0,0,0,0,0,0,0,0,0
0,0,0,0,0,0,0,0,0
0,0,0,0,0,0,0,0,0
0,0,0,0,0,0,0,0,0
0,0,0,0,0,0,0,0,0
0,0,0,0,0,0,0,0,0
0,0,0,0,0,0,0,0,0
0,0,0,0,0,0,0,0,0
8073,140,7,26,6,20,1,1,0
0,0,0,0,0,0,0,0,0
0,0,0,0,0,0,0,0,0
170613,655,4,4,3,1,8,0,0
144784,770,2,38,31,7,11,0,0
72658,48,4,0,0,0,1,0,0
0,0,0,0,0,0,0,0,0
0,0,0,0,0,0,0,0,0
170945,1107,4,2,1,1,7,0,0
0,0,0,0,0,0,0,0,0
0,0,0,0,0,0,0,0,0
0,0,0,0,0,0,0,0,0
0,0,0,0,0,0,0,0,0
0,0,0,0,0,0,0,0,0
0,0,0,0,0,0,0,0,0
8073,140,7,26,6,20,1,1,0
0,0,0,0,0,0,0,0,0
0,0,0,0,0,0,0,0,0
0,0,0,0,0,0,0,0,0
0,0,0,0,0,0,0,0,0
8073,140,7,26,6,20,1,1,0
8073,140,7,26,6,20,1,1,0
8073,140,7,26,8,18,1,1,0
0,0,0,0,0,0,0,0,0
0,0,0,0,0,0,0,0,0
72515,47,4,0,0,0,1,0,0
0,0,0,0,0,0,0,0,0
72670,48,4,0,0,0,1,0,0
22538,101,1,9,2,7,0,0,0
72658,48,4,0,0,0,1,0,0
0,0,0,0,0,0,0,0,0
73895,87,1,5,1,4,0,0,0
47036,203,2,1,1,0,1,0,0
0,0,0,0,0,0,0,0,0
0,0,0,0,0,0,0,0,0
0,0,0,0,0,0,0,0,0
0,0,0,0,0,0,0,0,0
0,0,0,0,0,0,0,0,0
0,0,0,0,0,0,0,0,0
102538,642,2,13,4,9,7,1,0
0,0,0,0,0,0,0,0,0
0,0,0,0,0,0,0,0,0
0,0,0,0,0,0,0,0,0
0,0,0,0,0,0,0,0,0
0,0,0,0,0,0,0,0,0
0,0,0,0,0,0,0,0,0
0,0,0,0,0,0,0,0,0
0,0,0,0,0,0,0,0,0
0,0,0,0,0,0,0,0,0
0,0,0,0,0,0,0,0,0
0,0,0,0,0,0,0,0,0
0,0,0,0,0,0,0,0,0
0,0,0,0,0,0,0,0,0
0,0,0,0,0,0,0,0,0
98537,635,8,43,12,31,0,1,0
0,0,0,0,0,0,0,0,0
0,0,0,0,0,0,0,0,0
0,0,0,0,0,0,0,0,0
0,0,0,0,0,0,0,0,0
0,0,0,0,0,0,0,0,0
0,0,0,0,0,0,0,0,0
0,0,0,0,0,0,0,0,0
0,0,0,0,0,0,0,0,0
23291,225,3,24,24,0,0,1,0
0,0,0,0,0,0,0,0,0
0,0,0,0,0,0,0,0,0
0,0,0,0,0,0,0,0,0
0,0,0,0,0,0,0,0,0
0,0,0,0,0,0,0,0,0
0,0,0,0,0,0,0,0,0
0,0,0,0,0,0,0,0,0
0,0,0,0,0,0,0,0,0
8073,140,7,26,6,20,1,1,0
0,0,0,0,0,0,0,0,0
0,0,0,0,0,0,0,0,0
0,0,0,0,0,0,0,0,0
0,0,0,0,0,0,0,0,0
0,0,0,0,0,0,0,0,0
0,0,0,0,0,0,0,0,0
0,0,0,0,0,0,0,0,0
0,0,0,0,0,0,0,0,0
0,0,0,0,0,0,0,0,0
0,0,0,0,0,0,0,0,0
21544,338,5,18,15,3,1,1,0
21544,338,5,18,15,3,1,1,0
0,0,0,0,0,0,0,0,0
0,0,0,0,0,0,0,0,0
0,0,0,0,0,0,0,0,0
0,0,0,0,0,0,0,0,0
0,0,0,0,0,0,0,0,0
0,0,0,0,0,0,0,0,0
0,0,0,0,0,0,0,0,0
0,0,0,0,0,0,0,0,0
0,0,0,0,0,0,0,0,0
0,0,0,0,0,0,0,0,0
0,0,0,0,0,0,0,0,0
0,0,0,0,0,0,0,0,0
0,0,0,0,0,0,0,0,0
0,0,0,0,0,0,0,0,0
72658,48,4,0,0,0,1,0,0
0,0,0,0,0,0,0,0,0
0,0,0,0,0,0,0,0,0
0,0,0,0,0,0,0,0,0
28621,47,4,0,0,0,0,0,0
0,0,0,0,0,0,0,0,0
0,0,0,0,0,0,0,0,0
0,0,0,0,0,0,0,0,0
0,0,0,0,0,0,0,0,0
0,0,0,0,0,0,0,0,0
0,0,0,0,0,0,0,0,0
0,0,0,0,0,0,0,0,0
0,0,0,0,0,0,0,0,0
0,0,0,0,0,0,0,0,0
0,0,0,0,0,0,0,0,0
10884,61,6,0,0,0,4,1,0
0,0,0,0,0,0,0,0,0
0,0,0,0,0,0,0,0,0
0,0,0,0,0,0,0,0,0
0,0,0,0,0,0,0,0,0
0,0,0,0,0,0,0,0,0
0,0,0,0,0,0,0,0,0
0,0,0,0,0,0,0,0,0
0,0,0,0,0,0,0,0,0
98837,42,4,1,1,0,2,0,0
0,0,0,0,0,0,0,0,0
0,0,0,0,0,0,0,0,0
0,0,0,0,0,0,0,0,0
0,0,0,0,0,0,0,0,0
0,0,0,0,0,0,0,0,0
0,0,0,0,0,0,0,0,0
0,0,0,0,0,0,0,0,0
0,0,0,0,0,0,0,0,0
0,0,0,0,0,0,0,0,0
0,0,0,0,0,0,0,0,0
0,0,0,0,0,0,0,0,0
0,0,0,0,0,0,0,0,0
0,0,0,0,0,0,0,0,0
0,0,0,0,0,0,0,0,0
0,0,0,0,0,0,0,0,0
0,0,0,0,0,0,0,0,0
0,0,0,0,0,0,0,0,0
0,0,0,0,0,0,0,0,0
0,0,0,0,0,0,0,0,0
0,0,0,0,0,0,0,0,0
0,0,0,0,0,0,0,0,0
0,0,0,0,0,0,0,0,0
79865,336,8,22,14,8,1,0,0
72658,48,4,0,0,0,1,0,0
0,0,0,0,0,0,0,0,0
0,0,0,0,0,0,0,0,0
0,0,0,0,0,0,0,0,0
0,0,0,0,0,0,0,0,0
36426,48,1,0,0,0,0,0,0
0,0,0,0,0,0,0,0,0
0,0,0,0,0,0,0,0,0
0,0,0,0,0,0,0,0,0
0,0,0,0,0,0,0,0,0
0,0,0,0,0,0,0,0,0
0,0,0,0,0,0,0,0,0
0,0,0,0,0,0,0,0,0
0,0,0,0,0,0,0,0,0
0,0,0,0,0,0,0,0,0
0,0,0,0,0,0,0,0,0
112483,84,1,4,1,3,0,0,0
265588,510,4,49,33,16,7,1,0
0,0,0,0,0,0,0,0,0
0,0,0,0,0,0,0,0,0
0,0,0,0,0,0,0,0,0
0,0,0,0,0,0,0,0,0
68962,353,1,8,2,6,0,0,0
181810,2014,3,201,174,27,9,0,0
233271,64,4,3,3,0,2,1,0
0,0,0,0,0,0,0,0,0
0,0,0,0,0,0,0,0,0
0,0,0,0,0,0,0,0,0
0,0,0,0,0,0,0,0,0
0,0,0,0,0,0,0,0,0
0,0,0,0,0,0,0,0,0
0,0,0,0,0,0,0,0,0
0,0,0,0,0,0,0,0,0
0,0,0,0,0,0,0,0,0
0,0,0,0,0,0,0,0,0
0,0,0,0,0,0,0,0,0
0,0,0,0,0,0,0,0,0
0,0,0,0,0,0,0,0,0
0,0,0,0,0,0,0,0,0
0,0,0,0,0,0,0,0,0
1154740,364,1,19,14,5,0,1,0
0,0,0,0,0,0,0,0,0
0,0,0,0,0,0,0,0,0
10874,33,1,0,0,0,1,0,0
0,0,0,0,0,0,0,0,0
0,0,0,0,0,0,0,0,0
0,0,0,0,0,0,0,0,0
0,0,0,0,0,0,0,0,0
0,0,0,0,0,0,0,0,0
672702,555,0,4,4,0,2,1,1
0,0,0,0,0,0,0,0,0
0,0,0,0,0,0,0,0,0
225371,71,3,2,1,1,2,1,0
0,0,0,0,0,0,0,0,0
672161,555,0,4,4,0,2,1,1
0,0,0,0,0,0,0,0,0
0,0,0,0,0,0,0,0,0
0,0,0,0,0,0,0,0,0
0,0,0,0,0,0,0,0,0
163958,469,4,2,1,1,7,0,0
167771,492,4,3,2,1,7,1,0
0,0,0,0,0,0,0,0,0
0,0,0,0,0,0,0,0,0
0,0,0,0,0,0,0,0,0
8072,140,7,26,6,20,1,1,0
0,0,0,0,0,0,0,0,0
0,0,0,0,0,0,0,0,0
670178,555,0,4,4,0,2,1,1
138566,404,8,28,24,4,32,1,0
0,0,0,0,0,0,0,0,0
0,0,0,0,0,0,0,0,0
0,0,0,0,0,0,0,0,0
0,0,0,0,0,0,0,0,0
0,0,0,0,0,0,0,0,0
0,0,0,0,0,0,0,0,0
0,0,0,0,0,0,0,0,0
0,0,0,0,0,0,0,0,0
0,0,0,0,0,0,0,0,0
0,0,0,0,0,0,0,0,0
0,0,0,0,0,0,0,0,0
0,0,0,0,0,0,0,0,0
8073,140,7,26,10,16,1,1,0
8073,140,7,26,6,20,1,1,0
72658,48,4,0,0,0,1,0,0
0,0,0,0,0,0,0,0,0
51302,76,0,1,0,1,0,0,0
4372,63,1,1,1,0,1,1,0
0,0,0,0,0,0,0,0,0
35541,170,6,3,1,2,1,0,0
0,0,0,0,0,0,0,0,0
0,0,0,0,0,0,0,0,0
72670,48,4,0,0,0,1,0,0
0,0,0,0,0,0,0,0,0
0,0,0,0,0,0,0,0,0
138281,397,8,26,24,2,33,1,0
0,0,0,0,0,0,0,0,0
0,0,0,0,0,0,0,0,0
677598,555,0,4,0,4,2,1,1
86514,66,0,9,4,5,5,0,0
0,0,0,0,0,0,0,0,0
0,0,0,0,0,0,0,0,0
0,0,0,0,0,0,0,0,0
0,0,0,0,0,0,0,0,0
0,0,0,0,0,0,0,0,0
0,0,0,0,0,0,0,0,0
0,0,0,0,0,0,0,0,0
0,0,0,0,0,0,0,0,0
0,0,0,0,0,0,0,0,0
0,0,0,0,0,0,0,0,0
0,0,0,0,0,0,0,0,0
0,0,0,0,0,0,0,0,0
0,0,0,0,0,0,0,0,0
0,0,0,0,0,0,0,0,0
0,0,0,0,0,0,0,0,0
32166,25,0,3,1,2,0,0,0
0,0,0,0,0,0,0,0,0
0,0,0,0,0,0,0,0,0
0,0,0,0,0,0,0,0,0
0,0,0,0,0,0,0,0,0
0,0,0,0,0,0,0,0,0
0,0,0,0,0,0,0,0,0
51302,76,0,1,0,1,0,0,0
0,0,0,0,0,0,0,0,0
0,0,0,0,0,0,0,0,0
0,0,0,0,0,0,0,0,0
0,0,0,0,0,0,0,0,0
672157,555,0,4,4,0,2,1,1
0,0,0,0,0,0,0,0,0
0,0,0,0,0,0,0,0,0
0,0,0,0,0,0,0,0,0
11122,76,4,1,1,0,0,1,0
0,0,0,0,0,0,0,0,0
0,0,0,0,0,0,0,0,0
293478,196,6,1,1,0,0,1,0
295146,193,6,1,1,0,0,1,0
0,0,0,0,0,0,0,0,0
0,0,0,0,0,0,0,0,0
0,0,0,0,0,0,0,0,0
0,0,0,0,0,0,0,0,0
0,0,0,0,0,0,0,0,0
0,0,0,0,0,0,0,0,0
0,0,0,0,0,0,0,0,0
0,0,0,0,0,0,0,0,0
0,0,0,0,0,0,0,0,0
0,0,0,0,0,0,0,0,0
0,0,0,0,0,0,0,0,0
62295,200,1,4,3,1,0,1,0
0,0,0,0,0,0,0,0,0
0,0,0,0,0,0,0,0,0
0,0,0,0,0,0,0,0,0
0,0,0,0,0,0,0,0,0
0,0,0,0,0,0,0,0,0
0,0,0,0,0,0,0,0,0
0,0,0,0,0,0,0,0,0
0,0,0,0,0,0,0,0,0
0,0,0,0,0,0,0,0,0
0,0,0,0,0,0,0,0,0
0,0,0,0,0,0,0,0,0
0,0,0,0,0,0,0,0,0
27127,311,4,2,0,2,7,1,0
0,0,0,0,0,0,0,0,0
0,0,0,0,0,0,0,0,0
25051,185,3,21,2,19,0,1,0
0,0,0,0,0,0,0,0,0
0,0,0,0,0,0,0,0,0
0,0,0,0,0,0,0,0,0
0,0,0,0,0,0,0,0,0
0,0,0,0,0,0,0,0,0
0,0,0,0,0,0,0,0,0
0,0,0,0,0,0,0,0,0
0,0,0,0,0,0,0,0,0
0,0,0,0,0,0,0,0,0
0,0,0,0,0,0,0,0,0
0,0,0,0,0,0,0,0,0
0,0,0,0,0,0,0,0,0
0,0,0,0,0,0,0,0,0
0,0,0,0,0,0,0,0,0
43689,296,0,13,0,13,0,1,0
43689,296,0,13,0,13,0,1,0
0,0,0,0,0,0,0,0,0
0,0,0,0,0,0,0,0,0
0,0,0,0,0,0,0,0,0
0,0,0,0,0,0,0,0,0
0,0,0,0,0,0,0,0,0
0,0,0,0,0,0,0,0,0
0,0,0,0,0,0,0,0,0
0,0,0,0,0,0,0,0,0
0,0,0,0,0,0,0,0,0
0,0,0,0,0,0,0,0,0
0,0,0,0,0,0,0,0,0
0,0,0,0,0,0,0,0,0
0,0,0,0,0,0,0,0,0
0,0,0,0,0,0,0,0,0
0,0,0,0,0,0,0,0,0
0,0,0,0,0,0,0,0,0
0,0,0,0,0,0,0,0,0
0,0,0,0,0,0,0,0,0
0,0,0,0,0,0,0,0,0
0,0,0,0,0,0,0,0,0
0,0,0,0,0,0,0,0,0
199258,653,4,18,1,17,7,0,0
0,0,0,0,0,0,0,0,0
0,0,0,0,0,0,0,0,0
0,0,0,0,0,0,0,0,0
0,0,0,0,0,0,0,0,0
0,0,0,0,0,0,0,0,0
0,0,0,0,0,0,0,0,0
10845,33,1,0,0,0,1,0,0
0,0,0,0,0,0,0,0,0
0,0,0,0,0,0,0,0,0
0,0,0,0,0,0,0,0,0
0,0,0,0,0,0,0,0,0
0,0,0,0,0,0,0,0,0
0,0,0,0,0,0,0,0,0
0,0,0,0,0,0,0,0,0
0,0,0,0,0,0,0,0,0
0,0,0,0,0,0,0,0,0
0,0,0,0,0,0,0,0,0
0,0,0,0,0,0,0,0,0
0,0,0,0,0,0,0,0,0
0,0,0,0,0,0,0,0,0
0,0,0,0,0,0,0,0,0
0,0,0,0,0,0,0,0,0
0,0,0,0,0,0,0,0,0
0,0,0,0,0,0,0,0,0
0,0,0,0,0,0,0,0,0
0,0,0,0,0,0,0,0,0
0,0,0,0,0,0,0,0,0
0,0,0,0,0,0,0,0,0
0,0,0,0,0,0,0,0,0
0,0,0,0,0,0,0,0,0
0,0,0,0,0,0,0,0,0
0,0,0,0,0,0,0,0,0
0,0,0,0,0,0,0,0,0
0,0,0,0,0,0,0,0,0
0,0,0,0,0,0,0,0,0
5886888,59,3,1,1,0,2,1,0
0,0,0,0,0,0,0,0,0
0,0,0,0,0,0,0,0,0
0,0,0,0,0,0,0,0,0
0,0,0,0,0,0,0,0,0
0,0,0,0,0,0,0,0,0
0,0,0,0,0,0,0,0,0
0,0,0,0,0,0,0,0,0
5886888,59,3,1,1,0,2,1,0
0,0,0,0,0,0,0,0,0
5886888,59,3,1,1,0,2,1,0
0,0,0,0,0,0,0,0,0
0,0,0,0,0,0,0,0,0
0,0,0,0,0,0,0,0,0
0,0,0,0,0,0,0,0,0
0,0,0,0,0,0,0,0,0
0,0,0,0,0,0,0,0,0
0,0,0,0,0,0,0,0,0
0,0,0,0,0,0,0,0,0
0,0,0,0,0,0,0,0,0
0,0,0,0,0,0,0,0,0
0,0,0,0,0,0,0,0,0
0,0,0,0,0,0,0,0,0
0,0,0,0,0,0,0,0,0
0,0,0,0,0,0,0,0,0
0,0,0,0,0,0,0,0,0
0,0,0,0,0,0,0,0,0
0,0,0,0,0,0,0,0,0
0,0,0,0,0,0,0,0,0
8073,140,7,26,6,20,1,1,0
0,0,0,0,0,0,0,0,0
8073,140,7,26,6,20,1,1,0
0,0,0,0,0,0,0,0,0
0,0,0,0,0,0,0,0,0
0,0,0,0,0,0,0,0,0
0,0,0,0,0,0,0,0,0
7105,92,3,4,3,1,0,0,0
0,0,0,0,0,0,0,0,0
7106,92,3,4,3,1,0,0,0
0,0,0,0,0,0,0,0,0
0,0,0,0,0,0,0,0,0
30048,51,2,0,0,0,2,0,0
0,0,0,0,0,0,0,0,0
36426,48,1,0,0,0,0,0,0
36426,48,1,0,0,0,0,0,0
0,0,0,0,0,0,0,0,0
0,0,0,0,0,0,0,0,0
77774,101,1,4,2,2,0,0,0
0,0,0,0,0,0,0,0,0
0,0,0,0,0,0,0,0,0
0,0,0,0,0,0,0,0,0
0,0,0,0,0,0,0,0,0
0,0,0,0,0,0,0,0,0
0,0,0,0,0,0,0,0,0
0,0,0,0,0,0,0,0,0
0,0,0,0,0,0,0,0,0
0,0,0,0,0,0,0,0,0
0,0,0,0,0,0,0,0,0
0,0,0,0,0,0,0,0,0
689563,74,4,2,1,1,3,1,0
0,0,0,0,0,0,0,0,0
0,0,0,0,0,0,0,0,0
136069,42,4,1,1,0,2,0,0
102681,76,4,6,6,0,5,1,0
13480,39,1,0,0,0,5,0,0
13110,108,1,0,0,0,0,0,0
0,0,0,0,0,0,0,0,0
383589,211,6,1,1,0,0,1,0
0,0,0,0,0,0,0,0,0
0,0,0,0,0,0,0,0,0
3385,41,0,6,0,6,0,0,0
0,0,0,0,0,0,0,0,0
0,0,0,0,0,0,0,0,0
0,0,0,0,0,0,0,0,0
0,0,0,0,0,0,0,0,0
0,0,0,0,0,0,0,0,0
0,0,0,0,0,0,0,0,0
0,0,0,0,0,0,0,0,0
0,0,0,0,0,0,0,0,0
0,0,0,0,0,0,0,0,0
0,0,0,0,0,0,0,0,0
0,0,0,0,0,0,0,0,0
0,0,0,0,0,0,0,0,0
138594,398,8,27,24,3,34,1,0
0,0,0,0,0,0,0,0,0
199318,653,4,18,1,17,7,0,0
0,0,0,0,0,0,0,0,0
0,0,0,0,0,0,0,0,0
0,0,0,0,0,0,0,0,0
0,0,0,0,0,0,0,0,0
0,0,0,0,0,0,0,0,0
0,0,0,0,0,0,0,0,0
0,0,0,0,0,0,0,0,0
72670,48,4,0,0,0,1,0,0
0,0,0,0,0,0,0,0,0
0,0,0,0,0,0,0,0,0
4986,55,1,2,2,0,1,1,0
0,0,0,0,0,0,0,0,0
0,0,0,0,0,0,0,0,0
0,0,0,0,0,0,0,0,0
72658,48,4,0,0,0,1,0,0
72669,48,4,0,0,0,1,0,0
0,0,0,0,0,0,0,0,0
8073,140,7,26,10,16,1,1,0
8073,140,7,26,6,20,1,1,0
8073,140,7,26,8,18,1,1,0
8072,140,7,26,10,16,1,1,0
8072,140,7,26,8,18,1,1,0
8073,140,7,26,8,18,1,1,0
8072,140,7,26,6,20,1,1,0
0,0,0,0,0,0,0,0,0
0,0,0,0,0,0,0,0,0
72670,48,4,0,0,0,1,0,0
0,0,0,0,0,0,0,0,0
0,0,0,0,0,0,0,0,0
0,0,0,0,0,0,0,0,0
0,0,0,0,0,0,0,0,0
0,0,0,0,0,0,0,0,0
0,0,0,0,0,0,0,0,0
8073,140,7,26,6,20,1,1,0
0,0,0,0,0,0,0,0,0
0,0,0,0,0,0,0,0,0
0,0,0,0,0,0,0,0,0
0,0,0,0,0,0,0,0,0
0,0,0,0,0,0,0,0,0
8073,140,7,26,9,17,1,1,0
0,0,0,0,0,0,0,0,0
72658,48,4,0,0,0,1,0,0
28307,160,6,4,2,2,1,0,0
0,0,0,0,0,0,0,0,0
0,0,0,0,0,0,0,0,0
0,0,0,0,0,0,0,0,0
0,0,0,0,0,0,0,0,0
8073,140,7,26,6,20,1,1,0
0,0,0,0,0,0,0,0,0
0,0,0,0,0,0,0,0,0
0,0,0,0,0,0,0,0,0
0,0,0,0,0,0,0,0,0
0,0,0,0,0,0,0,0,0
0,0,0,0,0,0,0,0,0
0,0,0,0,0,0,0,0,0
0,0,0,0,0,0,0,0,0
1834,40,1,0,0,0,0,0,0
0,0,0,0,0,0,0,0,0
140387,414,8,27,24,3,32,1,0
0,0,0,0,0,0,0,0,0
0,0,0,0,0,0,0,0,0
0,0,0,0,0,0,0,0,0
0,0,0,0,0,0,0,0,0
0,0,0,0,0,0,0,0,0
8073,140,7,26,6,20,1,1,0
0,0,0,0,0,0,0,0,0
138518,399,8,27,24,3,32,1,0
8073,140,7,26,6,20,1,1,0
0,0,0,0,0,0,0,0,0
0,0,0,0,0,0,0,0,0
0,0,0,0,0,0,0,0,0
0,0,0,0,0,0,0,0,0
88658,379,8,66,65,1,1,0,0
0,0,0,0,0,0,0,0,0
0,0,0,0,0,0,0,0,0
0,0,0,0,0,0,0,0,0
0,0,0,0,0,0,0,0,0
0,0,0,0,0,0,0,0,0
0,0,0,0,0,0,0,0,0
0,0,0,0,0,0,0,0,0
0,0,0,0,0,0,0,0,0
0,0,0,0,0,0,0,0,0
0,0,0,0,0,0,0,0,0
0,0,0,0,0,0,0,0,0
0,0,0,0,0,0,0,0,0
0,0,0,0,0,0,0,0,0
0,0,0,0,0,0,0,0,0
0,0,0,0,0,0,0,0,0
0,0,0,0,0,0,0,0,0
0,0,0,0,0,0,0,0,0
0,0,0,0,0,0,0,0,0
0,0,0,0,0,0,0,0,0
0,0,0,0,0,0,0,0,0
288765,191,6,1,1,0,0,1,0
0,0,0,0,0,0,0,0,0
0,0,0,0,0,0,0,0,0
298795,203,6,1,1,0,0,1,0
148947,580,16,69,65,4,1,1,0
0,0,0,0,0,0,0,0,0
13080,102,1,14,8,6,1,0,0
13080,102,1,14,8,6,1,0,0
0,0,0,0,0,0,0,0,0
0,0,0,0,0,0,0,0,0
148941,580,16,69,65,4,1,1,0
293628,194,6,1,1,0,0,1,0
0,0,0,0,0,0,0,0,0
138839,398,8,27,24,3,31,1,0
0,0,0,0,0,0,0,0,0
0,0,0,0,0,0,0,0,0
0,0,0,0,0,0,0,0,0
509277,173,6,1,1,0,0,1,0
0,0,0,0,0,0,0,0,0
297326,194,6,1,1,0,0,1,0
0,0,0,0,0,0,0,0,0
0,0,0,0,0,0,0,0,0
0,0,0,0,0,0,0,0,0
0,0,0,0,0,0,0,0,0
0,0,0,0,0,0,0,0,0
0,0,0,0,0,0,0,0,0
12435,142,0,56,52,4,0,0,0
0,0,0,0,0,0,0,0,0
0,0,0,0,0,0,0,0,0
0,0,0,0,0,0,0,0,0
6989,66,1,4,4,0,0,1,0
0,0,0,0,0,0,0,0,0
0,0,0,0,0,0,0,0,0
19612,32,0,1,1,0,0,1,0
0,0,0,0,0,0,0,0,0
0,0,0,0,0,0,0,0,0
0,0,0,0,0,0,0,0,0
0,0,0,0,0,0,0,0,0
27127,311,4,2,0,2,7,1,0
27127,311,4,2,0,2,7,1,0
0,0,0,0,0,0,0,0,0
7007,66,1,4,4,0,0,1,0
0,0,0,0,0,0,0,0,0
0,0,0,0,0,0,0,0,0
36096,167,2,5,4,1,18,0,0
271015,1052,10,129,124,5,18,0,0
0,0,0,0,0,0,0,0,0
0,0,0,0,0,0,0,0,0
0,0,0,0,0,0,0,0,0
0,0,0,0,0,0,0,0,0
0,0,0,0,0,0,0,0,0
0,0,0,0,0,0,0,0,0
0,0,0,0,0,0,0,0,0
0,0,0,0,0,0,0,0,0
0,0,0,0,0,0,0,0,0
0,0,0,0,0,0,0,0,0
0,0,0,0,0,0,0,0,0
0,0,0,0,0,0,0,0,0
0,0,0,0,0,0,0,0,0
0,0,0,0,0,0,0,0,0
0,0,0,0,0,0,0,0,0
0,0,0,0,0,0,0,0,0
0,0,0,0,0,0,0,0,0
0,0,0,0,0,0,0,0,0
0,0,0,0,0,0,0,0,0
0,0,0,0,0,0,0,0,0
0,0,0,0,0,0,0,0,0
0,0,0,0,0,0,0,0,0
0,0,0,0,0,0,0,0,0
0,0,0,0,0,0,0,0,0
0,0,0,0,0,0,0,0,0
0,0,0,0,0,0,0,0,0
0,0,0,0,0,0,0,0,0
0,0,0,0,0,0,0,0,0
0,0,0,0,0,0,0,0,0
0,0,0,0,0,0,0,0,0
0,0,0,0,0,0,0,0,0
0,0,0,0,0,0,0,0,0
0,0,0,0,0,0,0,0,0
0,0,0,0,0,0,0,0,0
0,0,0,0,0,0,0,0,0
0,0,0,0,0,0,0,0,0
0,0,0,0,0,0,0,0,0
0,0,0,0,0,0,0,0,0
0,0,0,0,0,0,0,0,0
351436,68,4,9,9,0,2,1,0
0,0,0,0,0,0,0,0,0
0,0,0,0,0,0,0,0,0
0,0,0,0,0,0,0,0,0
351436,68,4,9,9,0,2,1,0
351436,68,4,9,9,0,2,1,0
0,0,0,0,0,0,0,0,0
0,0,0,0,0,0,0,0,0
0,0,0,0,0,0,0,0,0
28858,171,6,3,1,2,1,0,0
72658,48,4,0,0,0,1,0,0
0,0,0,0,0,0,0,0,0
67304,58,3,1,1,0,4,1,0
0,0,0,0,0,0,0,0,0
0,0,0,0,0,0,0,0,0
0,0,0,0,0,0,0,0,0
0,0,0,0,0,0,0,0,0
0,0,0,0,0,0,0,0,0
0,0,0,0,0,0,0,0,0
0,0,0,0,0,0,0,0,0
0,0,0,0,0,0,0,0,0
0,0,0,0,0,0,0,0,0
0,0,0,0,0,0,0,0,0
0,0,0,0,0,0,0,0,0
0,0,0,0,0,0,0,0,0
0,0,0,0,0,0,0,0,0
0,0,0,0,0,0,0,0,0
0,0,0,0,0,0,0,0,0
0,0,0,0,0,0,0,0,0
0,0,0,0,0,0,0,0,0
0,0,0,0,0,0,0,0,0
0,0,0,0,0,0,0,0,0
0,0,0,0,0,0,0,0,0
0,0,0,0,0,0,0,0,0
0,0,0,0,0,0,0,0,0
0,0,0,0,0,0,0,0,0
0,0,0,0,0,0,0,0,0
0,0,0,0,0,0,0,0,0
0,0,0,0,0,0,0,0,0
0,0,0,0,0,0,0,0,0
0,0,0,0,0,0,0,0,0
0,0,0,0,0,0,0,0,0
0,0,0,0,0,0,0,0,0
1554,25,1,1,1,0,0,0,0
0,0,0,0,0,0,0,0,0
672115,551,0,4,0,4,1,1,1
671457,552,0,4,0,4,2,1,1
5880,231,3,5,5,0,0,0,0
5880,231,3,5,5,0,0,0,0
2541,37,0,2,0,2,0,0,0
0,0,0,0,0,0,0,0,0
0,0,0,0,0,0,0,0,0
0,0,0,0,0,0,0,0,0
38176,288,5,5,4,1,1,0,0
0,0,0,0,0,0,0,0,0
0,0,0,0,0,0,0,0,0
0,0,0,0,0,0,0,0,0
0,0,0,0,0,0,0,0,0
0,0,0,0,0,0,0,0,0
0,0,0,0,0,0,0,0,0
0,0,0,0,0,0,0,0,0
0,0,0,0,0,0,0,0,0
36981,319,10,42,41,1,2,0,0
36981,319,10,42,41,1,2,0,0
0,0,0,0,0,0,0,0,0
0,0,0,0,0,0,0,0,0
0,0,0,0,0,0,0,0,0
0,0,0,0,0,0,0,0,0
0,0,0,0,0,0,0,0,0
0,0,0,0,0,0,0,0,0
0,0,0,0,0,0,0,0,0
0,0,0,0,0,0,0,0,0
0,0,0,0,0,0,0,0,0
72658,48,4,0,0,0,1,0,0
48612,145,3,6,3,3,2,0,0
0,0,0,0,0,0,0,0,0
0,0,0,0,0,0,0,0,0
0,0,0,0,0,0,0,0,0
11091,76,4,1,1,0,0,1,0
0,0,0,0,0,0,0,0,0
0,0,0,0,0,0,0,0,0
0,0,0,0,0,0,0,0,0
0,0,0,0,0,0,0,0,0
0,0,0,0,0,0,0,0,0
0,0,0,0,0,0,0,0,0
0,0,0,0,0,0,0,0,0
0,0,0,0,0,0,0,0,0
0,0,0,0,0,0,0,0,0
0,0,0,0,0,0,0,0,0
0,0,0,0,0,0,0,0,0
0,0,0,0,0,0,0,0,0
0,0,0,0,0,0,0,0,0
0,0,0,0,0,0,0,0,0
0,0,0,0,0,0,0,0,0
0,0,0,0,0,0,0,0,0
0,0,0,0,0,0,0,0,0
12202,51,3,0,0,0,2,0,0
12202,51,3,0,0,0,2,0,0
0,0,0,0,0,0,0,0,0
420902,62,4,3,3,0,2,1,0
0,0,0,0,0,0,0,0,0
420902,62,4,3,3,0,2,1,0
0,0,0,0,0,0,0,0,0
0,0,0,0,0,0,0,0,0
0,0,0,0,0,0,0,0,0
0,0,0,0,0,0,0,0,0
0,0,0,0,0,0,0,0,0
0,0,0,0,0,0,0,0,0
0,0,0,0,0,0,0,0,0
54199,820,2,139,136,3,0,1,0
0,0,0,0,0,0,0,0,0
0,0,0,0,0,0,0,0,0
0,0,0,0,0,0,0,0,0
0,0,0,0,0,0,0,0,0
739872,220,0,50,50,0,3,1,0
72670,48,4,0,0,0,1,0,0
72658,48,4,0,0,0,1,0,0
72658,48,4,0,0,0,1,0,0
72658,48,4,0,0,0,1,0,0
77806,101,1,4,2,2,0,0,0
55887,295,2,2,1,1,1,0,0
0,0,0,0,0,0,0,0,0
9379,80,1,0,0,0,0,0,0
0,0,0,0,0,0,0,0,0
0,0,0,0,0,0,0,0,0
0,0,0,0,0,0,0,0,0
170449,43,3,0,0,0,0,0,0
0,0,0,0,0,0,0,0,0
0,0,0,0,0,0,0,0,0
9698,86,1,0,0,0,0,0,0
0,0,0,0,0,0,0,0,0
167183,548,4,4,3,1,8,1,0
0,0,0,0,0,0,0,0,0
169027,528,4,4,3,1,8,1,0
168040,504,4,4,3,1,9,0,0
169832,704,4,4,3,1,8,1,0
164868,470,4,2,1,1,7,0,0
0,0,0,0,0,0,0,0,0
166006,485,4,2,1,1,7,0,0
166083,477,4,4,3,1,8,0,0
0,0,0,0,0,0,0,0,0
0,0,0,0,0,0,0,0,0
14986,284,2,31,29,2,1,1,0
0,0,0,0,0,0,0,0,0
0,0,0,0,0,0,0,0,0
0,0,0,0,0,0,0,0,0
0,0,0,0,0,0,0,0,0
0,0,0,0,0,0,0,0,0
0,0,0,0,0,0,0,0,0
0,0,0,0,0,0,0,0,0
0,0,0,0,0,0,0,0,0
0,0,0,0,0,0,0,0,0
0,0,0,0,0,0,0,0,0
0,0,0,0,0,0,0,0,0
0,0,0,0,0,0,0,0,0
0,0,0,0,0,0,0,0,0
0,0,0,0,0,0,0,0,0
0,0,0,0,0,0,0,0,0
0,0,0,0,0,0,0,0,0
0,0,0,0,0,0,0,0,0
0,0,0,0,0,0,0,0,0
0,0,0,0,0,0,0,0,0
0,0,0,0,0,0,0,0,0
0,0,0,0,0,0,0,0,0
0,0,0,0,0,0,0,0,0
0,0,0,0,0,0,0,0,0
0,0,0,0,0,0,0,0,0
0,0,0,0,0,0,0,0,0
0,0,0,0,0,0,0,0,0
0,0,0,0,0,0,0,0,0
0,0,0,0,0,0,0,0,0
0,0,0,0,0,0,0,0,0
72660,48,4,0,0,0,1,0,0
0,0,0,0,0,0,0,0,0
0,0,0,0,0,0,0,0,0
0,0,0,0,0,0,0,0,0
0,0,0,0,0,0,0,0,0
0,0,0,0,0,0,0,0,0
0,0,0,0,0,0,0,0,0
0,0,0,0,0,0,0,0,0
14986,284,2,31,29,2,1,1,0
0,0,0,0,0,0,0,0,0
0,0,0,0,0,0,0,0,0
0,0,0,0,0,0,0,0,0
0,0,0,0,0,0,0,0,0
0,0,0,0,0,0,0,0,0
673410,555,0,4,4,0,2,1,1
0,0,0,0,0,0,0,0,0
0,0,0,0,0,0,0,0,0
0,0,0,0,0,0,0,0,0
0,0,0,0,0,0,0,0,0
0,0,0,0,0,0,0,0,0
0,0,0,0,0,0,0,0,0
0,0,0,0,0,0,0,0,0
0,0,0,0,0,0,0,0,0
0,0,0,0,0,0,0,0,0
0,0,0,0,0,0,0,0,0
0,0,0,0,0,0,0,0,0
0,0,0,0,0,0,0,0,0
0,0,0,0,0,0,0,0,0
0,0,0,0,0,0,0,0,0
0,0,0,0,0,0,0,0,0
0,0,0,0,0,0,0,0,0
0,0,0,0,0,0,0,0,0
0,0,0,0,0,0,0,0,0
0,0,0,0,0,0,0,0,0
0,0,0,0,0,0,0,0,0
0,0,0,0,0,0,0,0,0
0,0,0,0,0,0,0,0,0
0,0,0,0,0,0,0,0,0
8072,140,7,26,8,18,1,1,0
0,0,0,0,0,0,0,0,0
0,0,0,0,0,0,0,0,0
0,0,0,0,0,0,0,0,0
9756,57,0,1,1,0,0,0,0
9756,57,0,1,1,0,0,0,0
0,0,0,0,0,0,0,0,0
0,0,0,0,0,0,0,0,0
0,0,0,0,0,0,0,0,0
0,0,0,0,0,0,0,0,0
0,0,0,0,0,0,0,0,0
72669,48,4,0,0,0,1,0,0
0,0,0,0,0,0,0,0,0
0,0,0,0,0,0,0,0,0
0,0,0,0,0,0,0,0,0
0,0,0,0,0,0,0,0,0
0,0,0,0,0,0,0,0,0
0,0,0,0,0,0,0,0,0
0,0,0,0,0,0,0,0,0
0,0,0,0,0,0,0,0,0
0,0,0,0,0,0,0,0,0
0,0,0,0,0,0,0,0,0
0,0,0,0,0,0,0,0,0
0,0,0,0,0,0,0,0,0
0,0,0,0,0,0,0,0,0
0,0,0,0,0,0,0,0,0
0,0,0,0,0,0,0,0,0
0,0,0,0,0,0,0,0,0
0,0,0,0,0,0,0,0,0
0,0,0,0,0,0,0,0,0
0,0,0,0,0,0,0,0,0
135985,42,4,1,1,0,2,0,0
135985,42,4,1,1,0,2,0,0
0,0,0,0,0,0,0,0,0
0,0,0,0,0,0,0,0,0
0,0,0,0,0,0,0,0,0
0,0,0,0,0,0,0,0,0
0,0,0,0,0,0,0,0,0
0,0,0,0,0,0,0,0,0
111859,61,4,3,3,0,2,1,0
0,0,0,0,0,0,0,0,0
0,0,0,0,0,0,0,0,0
0,0,0,0,0,0,0,0,0
0,0,0,0,0,0,0,0,0
0,0,0,0,0,0,0,0,0
0,0,0,0,0,0,0,0,0
0,0,0,0,0,0,0,0,0
0,0,0,0,0,0,0,0,0
0,0,0,0,0,0,0,0,0
0,0,0,0,0,0,0,0,0
0,0,0,0,0,0,0,0,0
0,0,0,0,0,0,0,0,0
0,0,0,0,0,0,0,0,0
0,0,0,0,0,0,0,0,0
0,0,0,0,0,0,0,0,0
0,0,0,0,0,0,0,0,0
0,0,0,0,0,0,0,0,0
0,0,0,0,0,0,0,0,0
0,0,0,0,0,0,0,0,0
0,0,0,0,0,0,0,0,0
0,0,0,0,0,0,0,0,0
0,0,0,0,0,0,0,0,0
0,0,0,0,0,0,0,0,0
0,0,0,0,0,0,0,0,0
0,0,0,0,0,0,0,0,0
0,0,0,0,0,0,0,0,0
0,0,0,0,0,0,0,0,0
0,0,0,0,0,0,0,0,0
0,0,0,0,0,0,0,0,0
0,0,0,0,0,0,0,0,0
0,0,0,0,0,0,0,0,0
0,0,0,0,0,0,0,0,0
0,0,0,0,0,0,0,0,0
0,0,0,0,0,0,0,0,0
0,0,0,0,0,0,0,0,0
0,0,0,0,0,0,0,0,0
0,0,0,0,0,0,0,0,0
0,0,0,0,0,0,0,0,0
0,0,0,0,0,0,0,0,0
0,0,0,0,0,0,0,0,0
0,0,0,0,0,0,0,0,0
0,0,0,0,0,0,0,0,0
0,0,0,0,0,0,0,0,0
0,0,0,0,0,0,0,0,0
0,0,0,0,0,0,0,0,0
0,0,0,0,0,0,0,0,0
0,0,0,0,0,0,0,0,0
0,0,0,0,0,0,0,0,0
0,0,0,0,0,0,0,0,0
0,0,0,0,0,0,0,0,0
0,0,0,0,0,0,0,0,0
0,0,0,0,0,0,0,0,0
0,0,0,0,0,0,0,0,0
0,0,0,0,0,0,0,0,0
0,0,0,0,0,0,0,0,0
0,0,0,0,0,0,0,0,0
0,0,0,0,0,0,0,0,0
0,0,0,0,0,0,0,0,0
0,0,0,0,0,0,0,0,0
0,0,0,0,0,0,0,0,0
0,0,0,0,0,0,0,0,0
0,0,0,0,0,0,0,0,0
0,0,0,0,0,0,0,0,0
0,0,0,0,0,0,0,0,0
0,0,0,0,0,0,0,0,0
0,0,0,0,0,0,0,0,0
0,0,0,0,0,0,0,0,0
0,0,0,0,0,0,0,0,0
0,0,0,0,0,0,0,0,0
0,0,0,0,0,0,0,0,0
0,0,0,0,0,0,0,0,0
0,0,0,0,0,0,0,0,0
0,0,0,0,0,0,0,0,0
0,0,0,0,0,0,0,0,0
0,0,0,0,0,0,0,0,0
0,0,0,0,0,0,0,0,0
0,0,0,0,0,0,0,0,0
0,0,0,0,0,0,0,0,0
0,0,0,0,0,0,0,0,0
0,0,0,0,0,0,0,0,0
0,0,0,0,0,0,0,0,0
0,0,0,0,0,0,0,0,0
0,0,0,0,0,0,0,0,0
0,0,0,0,0,0,0,0,0
0,0,0,0,0,0,0,0,0
0,0,0,0,0,0,0,0,0
0,0,0,0,0,0,0,0,0
0,0,0,0,0,0,0,0,0
0,0,0,0,0,0,0,0,0
0,0,0,0,0,0,0,0,0
0,0,0,0,0,0,0,0,0
0,0,0,0,0,0,0,0,0
0,0,0,0,0,0,0,0,0
0,0,0,0,0,0,0,0,0
0,0,0,0,0,0,0,0,0
0,0,0,0,0,0,0,0,0
0,0,0,0,0,0,0,0,0
9741,61,0,0,0,0,0,0,0
0,0,0,0,0,0,0,0,0
0,0,0,0,0,0,0,0,0
0,0,0,0,0,0,0,0,0
0,0,0,0,0,0,0,0,0
36426,48,1,0,0,0,0,0,0
0,0,0,0,0,0,0,0,0
0,0,0,0,0,0,0,0,0
0,0,0,0,0,0,0,0,0
165064,473,4,2,1,1,7,0,0
0,0,0,0,0,0,0,0,0
0,0,0,0,0,0,0,0,0
0,0,0,0,0,0,0,0,0
0,0,0,0,0,0,0,0,0
0,0,0,0,0,0,0,0,0
372961,40,4,0,0,0,2,1,0
503728,48,2,2,2,0,2,0,0
0,0,0,0,0,0,0,0,0
0,0,0,0,0,0,0,0,0
0,0,0,0,0,0,0,0,0
0,0,0,0,0,0,0,0,0
0,0,0,0,0,0,0,0,0
0,0,0,0,0,0,0,0,0
0,0,0,0,0,0,0,0,0
0,0,0,0,0,0,0,0,0
0,0,0,0,0,0,0,0,0
0,0,0,0,0,0,0,0,0
0,0,0,0,0,0,0,0,0
239803,403,2,25,18,7,17,0,0
0,0,0,0,0,0,0,0,0
0,0,0,0,0,0,0,0,0
8072,140,7,26,6,20,1,1,0
0,0,0,0,0,0,0,0,0
0,0,0,0,0,0,0,0,0
72670,48,4,0,0,0,1,0,0
10686,162,7,26,17,9,0,1,0
164067,471,4,2,1,1,7,0,0
164963,479,4,4,3,1,8,0,0
0,0,0,0,0,0,0,0,0
166401,484,4,4,3,1,8,0,0
171056,504,4,5,4,1,8,1,0
164660,478,4,4,3,1,8,0,0
164543,472,4,2,1,1,7,0,0
164096,475,4,4,1,3,7,0,0
165879,483,4,4,3,1,8,0,0
164088,472,4,2,1,1,7,0,0
0,0,0,0,0,0,0,0,0
165841,474,4,2,1,1,7,0,0
169699,503,4,4,3,1,8,1,0
0,0,0,0,0,0,0,0,0
165743,479,4,3,2,1,7,0,0
167556,504,4,2,1,1,8,0,0
166652,483,4,4,3,1,8,0,0
164582,471,4,2,1,1,7,0,0
168405,581,4,4,3,1,8,1,0
165883,479,4,2,1,1,7,0,0
166617,482,4,6,3,3,8,0,0
165901,483,4,4,3,1,8,0,0
166495,479,4,4,3,1,8,0,0
163773,473,4,2,1,1,7,0,0
169139,731,4,4,3,1,8,0,0
165060,479,4,4,3,1,8,0,0
168802,500,4,5,4,1,8,1,0
0,0,0,0,0,0,0,0,0
164919,473,4,2,1,1,7,0,0
164045,474,4,2,1,1,7,0,0
165344,479,4,2,1,1,7,0,0
165795,477,4,4,3,1,8,0,0
165176,477,4,4,3,1,8,0,0
168810,500,4,5,4,1,8,1,0
0,0,0,0,0,0,0,0,0
0,0,0,0,0,0,0,0,0
0,0,0,0,0,0,0,0,0
166252,483,4,4,3,1,8,0,0
169105,498,4,4,1,3,7,0,0
0,0,0,0,0,0,0,0,0
0,0,0,0,0,0,0,0,0
0,0,0,0,0,0,0,0,0
0,0,0,0,0,0,0,0,0
0,0,0,0,0,0,0,0,0
0,0,0,0,0,0,0,0,0
0,0,0,0,0,0,0,0,0
165417,481,4,4,3,1,8,0,0
165675,481,4,2,1,1,7,0,0
0,0,0,0,0,0,0,0,0
0,0,0,0,0,0,0,0,0
0,0,0,0,0,0,0,0,0
0,0,0,0,0,0,0,0,0
166801,479,4,4,3,1,8,0,0
167040,484,4,4,3,1,8,0,0
166621,484,4,4,3,1,8,0,0
166088,479,4,4,3,1,8,0,0
166343,479,4,4,3,1,8,0,0
169878,514,4,4,3,1,9,0,0
166942,484,4,4,3,1,8,0,0
166450,482,4,4,3,1,8,0,0
168774,624,4,4,3,1,8,0,0
166658,484,4,4,3,1,8,0,0
166663,484,4,4,3,1,8,0,0
165348,477,4,2,1,1,7,0,0
165514,477,4,2,1,1,7,0,0
163796,470,4,2,1,1,7,0,0
166812,479,4,4,3,1,8,0,0
164065,470,4,2,1,1,7,0,0
0,0,0,0,0,0,0,0,0
169000,656,4,4,3,1,8,1,0
165697,477,4,4,3,1,8,0,0
172204,1060,4,4,3,1,8,1,0
0,0,0,0,0,0,0,0,0
0,0,0,0,0,0,0,0,0
0,0,0,0,0,0,0,0,0
167433,556,4,2,1,1,7,0,0
0,0,0,0,0,0,0,0,0
0,0,0,0,0,0,0,0,0
0,0,0,0,0,0,0,0,0
0,0,0,0,0,0,0,0,0
672441,555,0,4,4,0,2,1,1
0,0,0,0,0,0,0,0,0
167565,493,4,6,3,3,8,1,0
0,0,0,0,0,0,0,0,0
164193,475,4,2,1,1,7,0,0
0,0,0,0,0,0,0,0,0
0,0,0,0,0,0,0,0,0
0,0,0,0,0,0,0,0,0
0,0,0,0,0,0,0,0,0
169232,504,4,4,3,1,9,0,0
0,0,0,0,0,0,0,0,0
164133,466,4,2,1,1,7,0,0
0,0,0,0,0,0,0,0,0
0,0,0,0,0,0,0,0,0
72668,48,4,0,0,0,1,0,0
8073,140,7,26,12,14,1,1,0
0,0,0,0,0,0,0,0,0
0,0,0,0,0,0,0,0,0
0,0,0,0,0,0,0,0,0
8173,146,0,15,15,0,5,1,0
0,0,0,0,0,0,0,0,0
0,0,0,0,0,0,0,0,0
0,0,0,0,0,0,0,0,0
165567,477,4,4,3,1,8,0,0
168455,492,4,2,1,1,7,0,0
165136,471,4,2,1,1,7,0,0
170869,694,4,4,3,1,8,0,0
170845,839,4,4,3,1,8,1,0
163624,470,4,2,1,1,7,0,0
8891,75,1,0,0,0,0,0,0
0,0,0,0,0,0,0,0,0
166277,560,4,2,1,1,7,1,0
165351,482,4,2,1,1,7,0,0
0,0,0,0,0,0,0,0,0
169312,668,4,4,3,1,8,1,0
169247,501,4,3,2,1,7,1,0
0,0,0,0,0,0,0,0,0
0,0,0,0,0,0,0,0,0
0,0,0,0,0,0,0,0,0
409253,575,5,87,46,41,16,0,0
0,0,0,0,0,0,0,0,0
0,0,0,0,0,0,0,0,0
0,0,0,0,0,0,0,0,0
0,0,0,0,0,0,0,0,0
0,0,0,0,0,0,0,0,0
0,0,0,0,0,0,0,0,0
0,0,0,0,0,0,0,0,0
0,0,0,0,0,0,0,0,0
0,0,0,0,0,0,0,0,0
0,0,0,0,0,0,0,0,0
0,0,0,0,0,0,0,0,0
0,0,0,0,0,0,0,0,0
0,0,0,0,0,0,0,0,0
0,0,0,0,0,0,0,0,0
8073,140,7,26,6,20,1,1,0
0,0,0,0,0,0,0,0,0
0,0,0,0,0,0,0,0,0
0,0,0,0,0,0,0,0,0
0,0,0,0,0,0,0,0,0
27127,311,4,2,0,2,7,1,0
0,0,0,0,0,0,0,0,0
0,0,0,0,0,0,0,0,0
0,0,0,0,0,0,0,0,0
0,0,0,0,0,0,0,0,0
0,0,0,0,0,0,0,0,0
162498,218,4,26,18,8,2,1,0
0,0,0,0,0,0,0,0,0
0,0,0,0,0,0,0,0,0
0,0,0,0,0,0,0,0,0
0,0,0,0,0,0,0,0,0
0,0,0,0,0,0,0,0,0
269870,515,4,50,34,16,7,1,0
0,0,0,0,0,0,0,0,0
0,0,0,0,0,0,0,0,0
0,0,0,0,0,0,0,0,0
0,0,0,0,0,0,0,0,0
135983,392,8,27,24,3,30,1,0
0,0,0,0,0,0,0,0,0
0,0,0,0,0,0,0,0,0
196361,145,1,6,0,6,0,0,0
0,0,0,0,0,0,0,0,0
0,0,0,0,0,0,0,0,0
0,0,0,0,0,0,0,0,0
0,0,0,0,0,0,0,0,0
0,0,0,0,0,0,0,0,0
0,0,0,0,0,0,0,0,0
0,0,0,0,0,0,0,0,0
0,0,0,0,0,0,0,0,0
72670,48,4,0,0,0,1,0,0
0,0,0,0,0,0,0,0,0
8073,140,7,26,8,18,1,1,0
0,0,0,0,0,0,0,0,0
0,0,0,0,0,0,0,0,0
169217,1119,6,57,39,18,7,1,0
0,0,0,0,0,0,0,0,0
0,0,0,0,0,0,0,0,0
0,0,0,0,0,0,0,0,0
0,0,0,0,0,0,0,0,0
0,0,0,0,0,0,0,0,0
0,0,0,0,0,0,0,0,0
293811,204,6,1,1,0,0,1,0
0,0,0,0,0,0,0,0,0
0,0,0,0,0,0,0,0,0
283403,193,6,1,1,0,0,1,0
12961,142,0,56,51,5,0,0,0
284075,191,6,1,1,0,0,1,0
0,0,0,0,0,0,0,0,0
0,0,0,0,0,0,0,0,0
0,0,0,0,0,0,0,0,0
0,0,0,0,0,0,0,0,0
0,0,0,0,0,0,0,0,0
0,0,0,0,0,0,0,0,0
0,0,0,0,0,0,0,0,0
34482,217,0,51,3,48,1,1,0
5029,71,1,6,6,0,2,0,0
0,0,0,0,0,0,0,0,0
1179432,1275,1,44,29,15,7,1,0
0,0,0,0,0,0,0,0,0
0,0,0,0,0,0,0,0,0
27127,311,4,2,0,2,7,1,0
0,0,0,0,0,0,0,0,0
0,0,0,0,0,0,0,0,0
0,0,0,0,0,0,0,0,0
0,0,0,0,0,0,0,0,0
0,0,0,0,0,0,0,0,0
0,0,0,0,0,0,0,0,0
0,0,0,0,0,0,0,0,0
0,0,0,0,0,0,0,0,0
0,0,0,0,0,0,0,0,0
0,0,0,0,0,0,0,0,0
0,0,0,0,0,0,0,0,0
0,0,0,0,0,0,0,0,0
0,0,0,0,0,0,0,0,0
0,0,0,0,0,0,0,0,0
0,0,0,0,0,0,0,0,0
0,0,0,0,0,0,0,0,0
0,0,0,0,0,0,0,0,0
0,0,0,0,0,0,0,0,0
8560,41,0,2,2,0,1,0,0
8560,41,0,2,2,0,1,0,0
0,0,0,0,0,0,0,0,0
0,0,0,0,0,0,0,0,0
0,0,0,0,0,0,0,0,0
0,0,0,0,0,0,0,0,0
0,0,0,0,0,0,0,0,0
0,0,0,0,0,0,0,0,0
0,0,0,0,0,0,0,0,0
0,0,0,0,0,0,0,0,0
0,0,0,0,0,0,0,0,0
0,0,0,0,0,0,0,0,0
0,0,0,0,0,0,0,0,0
0,0,0,0,0,0,0,0,0
0,0,0,0,0,0,0,0,0
0,0,0,0,0,0,0,0,0
0,0,0,0,0,0,0,0,0
0,0,0,0,0,0,0,0,0
0,0,0,0,0,0,0,0,0
0,0,0,0,0,0,0,0,0
0,0,0,0,0,0,0,0,0
0,0,0,0,0,0,0,0,0
0,0,0,0,0,0,0,0,0
0,0,0,0,0,0,0,0,0
0,0,0,0,0,0,0,0,0
0,0,0,0,0,0,0,0,0
0,0,0,0,0,0,0,0,0
0,0,0,0,0,0,0,0,0
0,0,0,0,0,0,0,0,0
0,0,0,0,0,0,0,0,0
0,0,0,0,0,0,0,0,0
0,0,0,0,0,0,0,0,0
0,0,0,0,0,0,0,0,0
0,0,0,0,0,0,0,0,0
0,0,0,0,0,0,0,0,0
0,0,0,0,0,0,0,0,0
0,0,0,0,0,0,0,0,0
0,0,0,0,0,0,0,0,0
0,0,0,0,0,0,0,0,0
0,0,0,0,0,0,0,0,0
0,0,0,0,0,0,0,0,0
0,0,0,0,0,0,0,0,0
0,0,0,0,0,0,0,0,0
0,0,0,0,0,0,0,0,0
0,0,0,0,0,0,0,0,0
0,0,0,0,0,0,0,0,0
0,0,0,0,0,0,0,0,0
0,0,0,0,0,0,0,0,0
191475,136,3,21,1,20,3,0,0
191475,136,3,21,1,20,3,0,0
0,0,0,0,0,0,0,0,0
0,0,0,0,0,0,0,0,0
0,0,0,0,0,0,0,0,0
0,0,0,0,0,0,0,0,0
25079,365,1,100,100,0,0,1,0
0,0,0,0,0,0,0,0,0
33854,46,2,0,0,0,2,0,0
0,0,0,0,0,0,0,0,0
0,0,0,0,0,0,0,0,0
3008710,329,1,77,77,0,1,0,0
0,0,0,0,0,0,0,0,0
0,0,0,0,0,0,0,0,0
112479,84,1,4,1,3,0,0,0
0,0,0,0,0,0,0,0,0
186425,127,4,8,8,0,7,1,0
503727,48,2,2,2,0,2,0,0
0,0,0,0,0,0,0,0,0
0,0,0,0,0,0,0,0,0
0,0,0,0,0,0,0,0,0
0,0,0,0,0,0,0,0,0
135124,83,3,4,2,2,0,0,0
0,0,0,0,0,0,0,0,0
0,0,0,0,0,0,0,0,0
0,0,0,0,0,0,0,0,0
0,0,0,0,0,0,0,0,0
0,0,0,0,0,0,0,0,0
0,0,0,0,0,0,0,0,0
0,0,0,0,0,0,0,0,0
0,0,0,0,0,0,0,0,0
0,0,0,0,0,0,0,0,0
165640,383,3,7,4,3,1,0,0
0,0,0,0,0,0,0,0,0
0,0,0,0,0,0,0,0,0
0,0,0,0,0,0,0,0,0
0,0,0,0,0,0,0,0,0
0,0,0,0,0,0,0,0,0
0,0,0,0,0,0,0,0,0
0,0,0,0,0,0,0,0,0
0,0,0,0,0,0,0,0,0
280084,492,4,49,46,3,2,1,0
72670,48,4,0,0,0,1,0,0
72670,48,4,0,0,0,1,0,0
169780,480,4,4,3,1,8,0,0
169510,501,4,5,4,1,8,1,0
165929,478,4,4,3,1,8,0,0
0,0,0,0,0,0,0,0,0
0,0,0,0,0,0,0,0,0
165276,472,4,2,1,1,7,0,0
0,0,0,0,0,0,0,0,0
0,0,0,0,0,0,0,0,0
0,0,0,0,0,0,0,0,0
0,0,0,0,0,0,0,0,0
0,0,0,0,0,0,0,0,0
0,0,0,0,0,0,0,0,0
23373,138,0,17,17,0,4,0,0
0,0,0,0,0,0,0,0,0
0,0,0,0,0,0,0,0,0
8073,140,7,26,6,20,1,1,0
266769,515,4,50,34,16,7,1,0
3813,63,0,0,0,0,0,0,0
0,0,0,0,0,0,0,0,0
0,0,0,0,0,0,0,0,0
0,0,0,0,0,0,0,0,0
72670,48,4,0,0,0,1,0,0
0,0,0,0,0,0,0,0,0
72670,48,4,0,0,0,1,0,0
0,0,0,0,0,0,0,0,0
0,0,0,0,0,0,0,0,0
0,0,0,0,0,0,0,0,0
0,0,0,0,0,0,0,0,0
0,0,0,0,0,0,0,0,0
0,0,0,0,0,0,0,0,0
0,0,0,0,0,0,0,0,0
0,0,0,0,0,0,0,0,0
0,0,0,0,0,0,0,0,0
0,0,0,0,0,0,0,0,0
0,0,0,0,0,0,0,0,0
0,0,0,0,0,0,0,0,0
0,0,0,0,0,0,0,0,0
0,0,0,0,0,0,0,0,0
0,0,0,0,0,0,0,0,0
337630,58,1,6,3,3,0,0,0
0,0,0,0,0,0,0,0,0
8172,146,0,15,15,0,5,1,0
0,0,0,0,0,0,0,0,0
0,0,0,0,0,0,0,0,0
0,0,0,0,0,0,0,0,0
673883,555,0,4,4,0,2,1,1
0,0,0,0,0,0,0,0,0
0,0,0,0,0,0,0,0,0
0,0,0,0,0,0,0,0,0
0,0,0,0,0,0,0,0,0
0,0,0,0,0,0,0,0,0
0,0,0,0,0,0,0,0,0
0,0,0,0,0,0,0,0,0
0,0,0,0,0,0,0,0,0
0,0,0,0,0,0,0,0,0
0,0,0,0,0,0,0,0,0
0,0,0,0,0,0,0,0,0
0,0,0,0,0,0,0,0,0
143121,241,5,23,19,4,0,1,0
0,0,0,0,0,0,0,0,0
8073,140,7,26,6,20,1,1,0
1834,40,1,0,0,0,0,0,0
72670,48,4,0,0,0,1,0,0
8073,140,7,26,6,20,1,1,0
0,0,0,0,0,0,0,0,0
72658,48,4,0,0,0,1,0,0
0,0,0,0,0,0,0,0,0
72670,48,4,0,0,0,1,0,0
8073,140,7,26,6,20,1,1,0
0,0,0,0,0,0,0,0,0
0,0,0,0,0,0,0,0,0
0,0,0,0,0,0,0,0,0
75686,1273,7,82,45,37,14,1,0
72670,48,4,0,0,0,1,0,0
9186,28,1,2,1,1,0,0,0
0,0,0,0,0,0,0,0,0
0,0,0,0,0,0,0,0,0
0,0,0,0,0,0,0,0,0
0,0,0,0,0,0,0,0,0
0,0,0,0,0,0,0,0,0
0,0,0,0,0,0,0,0,0
0,0,0,0,0,0,0,0,0
0,0,0,0,0,0,0,0,0
167501,466,4,2,1,1,7,0,0
166378,479,4,4,3,1,8,0,0
166010,478,4,4,3,1,8,0,0
0,0,0,0,0,0,0,0,0
0,0,0,0,0,0,0,0,0
0,0,0,0,0,0,0,0,0
171020,547,4,4,3,1,9,1,0
165501,482,4,2,1,1,7,0,0
0,0,0,0,0,0,0,0,0
71985,227,2,15,6,9,0,1,0
0,0,0,0,0,0,0,0,0
0,0,0,0,0,0,0,0,0
0,0,0,0,0,0,0,0,0
0,0,0,0,0,0,0,0,0
0,0,0,0,0,0,0,0,0
0,0,0,0,0,0,0,0,0
0,0,0,0,0,0,0,0,0
0,0,0,0,0,0,0,0,0
0,0,0,0,0,0,0,0,0
0,0,0,0,0,0,0,0,0
0,0,0,0,0,0,0,0,0
0,0,0,0,0,0,0,0,0
132486,449,2,130,109,21,3,1,0
0,0,0,0,0,0,0,0,0
133705,314,8,27,24,3,17,1,0
0,0,0,0,0,0,0,0,0
0,0,0,0,0,0,0,0,0
0,0,0,0,0,0,0,0,0
0,0,0,0,0,0,0,0,0
298995,196,6,1,1,0,0,1,0
0,0,0,0,0,0,0,0,0
0,0,0,0,0,0,0,0,0
0,0,0,0,0,0,0,0,0
0,0,0,0,0,0,0,0,0
0,0,0,0,0,0,0,0,0
0,0,0,0,0,0,0,0,0
0,0,0,0,0,0,0,0,0
0,0,0,0,0,0,0,0,0
0,0,0,0,0,0,0,0,0
0,0,0,0,0,0,0,0,0
0,0,0,0,0,0,0,0,0
2663,27,4,6,1,5,0,0,0
0,0,0,0,0,0,0,0,0
0,0,0,0,0,0,0,0,0
0,0,0,0,0,0,0,0,0
0,0,0,0,0,0,0,0,0
0,0,0,0,0,0,0,0,0
0,0,0,0,0,0,0,0,0
0,0,0,0,0,0,0,0,0
0,0,0,0,0,0,0,0,0
0,0,0,0,0,0,0,0,0
0,0,0,0,0,0,0,0,0
10450,44,1,4,4,0,2,0,0
0,0,0,0,0,0,0,0,0
0,0,0,0,0,0,0,0,0
0,0,0,0,0,0,0,0,0
0,0,0,0,0,0,0,0,0
0,0,0,0,0,0,0,0,0
0,0,0,0,0,0,0,0,0
0,0,0,0,0,0,0,0,0
0,0,0,0,0,0,0,0,0
0,0,0,0,0,0,0,0,0
0,0,0,0,0,0,0,0,0
0,0,0,0,0,0,0,0,0
10450,44,1,4,4,0,2,0,0
484357,507,11,27,25,2,1,1,0
0,0,0,0,0,0,0,0,0
0,0,0,0,0,0,0,0,0
0,0,0,0,0,0,0,0,0
0,0,0,0,0,0,0,0,0
0,0,0,0,0,0,0,0,0
164955,470,4,2,1,1,7,0,0
0,0,0,0,0,0,0,0,0
0,0,0,0,0,0,0,0,0
0,0,0,0,0,0,0,0,0
0,0,0,0,0,0,0,0,0
0,0,0,0,0,0,0,0,0
0,0,0,0,0,0,0,0,0
0,0,0,0,0,0,0,0,0
0,0,0,0,0,0,0,0,0
0,0,0,0,0,0,0,0,0
0,0,0,0,0,0,0,0,0
0,0,0,0,0,0,0,0,0
0,0,0,0,0,0,0,0,0
0,0,0,0,0,0,0,0,0
13123,29,1,0,0,0,3,0,0
0,0,0,0,0,0,0,0,0
0,0,0,0,0,0,0,0,0
0,0,0,0,0,0,0,0,0
0,0,0,0,0,0,0,0,0
13123,29,1,0,0,0,3,0,0
0,0,0,0,0,0,0,0,0
13123,29,1,0,0,0,3,0,0
0,0,0,0,0,0,0,0,0
13139,29,1,0,0,0,3,0,0
0,0,0,0,0,0,0,0,0
0,0,0,0,0,0,0,0,0
0,0,0,0,0,0,0,0,0
0,0,0,0,0,0,0,0,0
0,0,0,0,0,0,0,0,0
0,0,0,0,0,0,0,0,0
214522,67,4,9,9,0,2,1,0
214522,67,4,9,9,0,2,1,0
0,0,0,0,0,0,0,0,0
36462,51,2,0,0,0,2,0,0
0,0,0,0,0,0,0,0,0
0,0,0,0,0,0,0,0,0
0,0,0,0,0,0,0,0,0
0,0,0,0,0,0,0,0,0
28268,161,6,4,2,2,1,0,0
72672,48,4,0,0,0,1,0,0
0,0,0,0,0,0,0,0,0
0,0,0,0,0,0,0,0,0
0,0,0,0,0,0,0,0,0
0,0,0,0,0,0,0,0,0
0,0,0,0,0,0,0,0,0
0,0,0,0,0,0,0,0,0
0,0,0,0,0,0,0,0,0
0,0,0,0,0,0,0,0,0
0,0,0,0,0,0,0,0,0
0,0,0,0,0,0,0,0,0
0,0,0,0,0,0,0,0,0
48013,76,2,1,1,0,3,1,0
98539,72,4,2,1,1,2,1,0
0,0,0,0,0,0,0,0,0
5107,30,3,0,0,0,2,0,0
0,0,0,0,0,0,0,0,0
0,0,0,0,0,0,0,0,0
0,0,0,0,0,0,0,0,0
0,0,0,0,0,0,0,0,0
0,0,0,0,0,0,0,0,0
0,0,0,0,0,0,0,0,0
0,0,0,0,0,0,0,0,0
0,0,0,0,0,0,0,0,0
0,0,0,0,0,0,0,0,0
0,0,0,0,0,0,0,0,0
43067,479,1,1,0,1,1,0,0
3385,41,0,6,0,6,0,0,0
0,0,0,0,0,0,0,0,0
0,0,0,0,0,0,0,0,0
0,0,0,0,0,0,0,0,0
0,0,0,0,0,0,0,0,0
0,0,0,0,0,0,0,0,0
0,0,0,0,0,0,0,0,0
0,0,0,0,0,0,0,0,0
0,0,0,0,0,0,0,0,0
0,0,0,0,0,0,0,0,0
0,0,0,0,0,0,0,0,0
0,0,0,0,0,0,0,0,0
0,0,0,0,0,0,0,0,0
0,0,0,0,0,0,0,0,0
0,0,0,0,0,0,0,0,0
0,0,0,0,0,0,0,0,0
0,0,0,0,0,0,0,0,0
0,0,0,0,0,0,0,0,0
0,0,0,0,0,0,0,0,0
0,0,0,0,0,0,0,0,0
0,0,0,0,0,0,0,0,0
0,0,0,0,0,0,0,0,0
0,0,0,0,0,0,0,0,0
0,0,0,0,0,0,0,0,0
0,0,0,0,0,0,0,0,0
0,0,0,0,0,0,0,0,0
9929,57,4,1,1,0,1,0,0
9929,57,4,1,1,0,1,0,0
0,0,0,0,0,0,0,0,0
0,0,0,0,0,0,0,0,0
0,0,0,0,0,0,0,0,0
0,0,0,0,0,0,0,0,0
0,0,0,0,0,0,0,0,0
0,0,0,0,0,0,0,0,0
0,0,0,0,0,0,0,0,0
254073,1083,1,259,220,39,3,0,0
254073,1083,1,259,220,39,3,0,0
0,0,0,0,0,0,0,0,0
0,0,0,0,0,0,0,0,0
0,0,0,0,0,0,0,0,0
0,0,0,0,0,0,0,0,0
0,0,0,0,0,0,0,0,0
0,0,0,0,0,0,0,0,0
0,0,0,0,0,0,0,0,0
0,0,0,0,0,0,0,0,0
0,0,0,0,0,0,0,0,0
0,0,0,0,0,0,0,0,0
0,0,0,0,0,0,0,0,0
0,0,0,0,0,0,0,0,0
0,0,0,0,0,0,0,0,0
0,0,0,0,0,0,0,0,0
0,0,0,0,0,0,0,0,0
0,0,0,0,0,0,0,0,0
8073,140,7,26,6,20,1,1,0
0,0,0,0,0,0,0,0,0
0,0,0,0,0,0,0,0,0
0,0,0,0,0,0,0,0,0
0,0,0,0,0,0,0,0,0
72669,48,4,0,0,0,1,0,0
0,0,0,0,0,0,0,0,0
72670,48,4,0,0,0,1,0,0
167629,482,4,4,3,1,8,0,0
170814,1108,4,4,1,3,7,0,0
166195,472,4,2,1,1,7,0,0
0,0,0,0,0,0,0,0,0
0,0,0,0,0,0,0,0,0
72670,48,4,0,0,0,1,0,0
0,0,0,0,0,0,0,0,0
0,0,0,0,0,0,0,0,0
0,0,0,0,0,0,0,0,0
0,0,0,0,0,0,0,0,0
0,0,0,0,0,0,0,0,0
0,0,0,0,0,0,0,0,0
0,0,0,0,0,0,0,0,0
0,0,0,0,0,0,0,0,0
0,0,0,0,0,0,0,0,0
0,0,0,0,0,0,0,0,0
0,0,0,0,0,0,0,0,0
0,0,0,0,0,0,0,0,0
0,0,0,0,0,0,0,0,0
0,0,0,0,0,0,0,0,0
0,0,0,0,0,0,0,0,0
0,0,0,0,0,0,0,0,0
0,0,0,0,0,0,0,0,0
670194,555,0,4,4,0,2,1,1
0,0,0,0,0,0,0,0,0
0,0,0,0,0,0,0,0,0
0,0,0,0,0,0,0,0,0
0,0,0,0,0,0,0,0,0
0,0,0,0,0,0,0,0,0
0,0,0,0,0,0,0,0,0
1154759,364,1,19,14,5,0,1,0
0,0,0,0,0,0,0,0,0
0,0,0,0,0,0,0,0,0
0,0,0,0,0,0,0,0,0
0,0,0,0,0,0,0,0,0
0,0,0,0,0,0,0,0,0
0,0,0,0,0,0,0,0,0
0,0,0,0,0,0,0,0,0
120220,899,6,223,32,191,6,1,0
0,0,0,0,0,0,0,0,0
0,0,0,0,0,0,0,0,0
0,0,0,0,0,0,0,0,0
0,0,0,0,0,0,0,0,0
0,0,0,0,0,0,0,0,0
0,0,0,0,0,0,0,0,0
0,0,0,0,0,0,0,0,0
0,0,0,0,0,0,0,0,0
505739,205,6,1,1,0,1,1,0
8073,140,7,26,12,14,1,1,0
8073,140,7,26,10,16,1,1,0
0,0,0,0,0,0,0,0,0
139896,413,8,27,24,3,32,1,0
0,0,0,0,0,0,0,0,0
0,0,0,0,0,0,0,0,0
0,0,0,0,0,0,0,0,0
0,0,0,0,0,0,0,0,0
0,0,0,0,0,0,0,0,0
0,0,0,0,0,0,0,0,0
8073,140,7,26,6,20,1,1,0
0,0,0,0,0,0,0,0,0
0,0,0,0,0,0,0,0,0
0,0,0,0,0,0,0,0,0
0,0,0,0,0,0,0,0,0
0,0,0,0,0,0,0,0,0
57055,50,2,0,0,0,0,1,0
0,0,0,0,0,0,0,0,0
48612,145,3,6,3,3,2,0,0
48612,145,3,6,3,3,2,0,0
0,0,0,0,0,0,0,0,0
0,0,0,0,0,0,0,0,0
0,0,0,0,0,0,0,0,0
4547,35,0,2,0,2,0,0,0
0,0,0,0,0,0,0,0,0
0,0,0,0,0,0,0,0,0
72020,47,4,0,0,0,1,0,0
0,0,0,0,0,0,0,0,0
0,0,0,0,0,0,0,0,0
0,0,0,0,0,0,0,0,0
0,0,0,0,0,0,0,0,0
303456,203,6,1,1,0,0,1,0
0,0,0,0,0,0,0,0,0
0,0,0,0,0,0,0,0,0
0,0,0,0,0,0,0,0,0
65974,309,8,28,24,4,16,1,0
139943,413,8,27,24,3,32,1,0
19623,32,0,1,1,0,0,1,0
0,0,0,0,0,0,0,0,0
0,0,0,0,0,0,0,0,0
0,0,0,0,0,0,0,0,0
0,0,0,0,0,0,0,0,0
0,0,0,0,0,0,0,0,0
0,0,0,0,0,0,0,0,0
0,0,0,0,0,0,0,0,0
0,0,0,0,0,0,0,0,0
0,0,0,0,0,0,0,0,0
0,0,0,0,0,0,0,0,0
0,0,0,0,0,0,0,0,0
0,0,0,0,0,0,0,0,0
0,0,0,0,0,0,0,0,0
0,0,0,0,0,0,0,0,0
0,0,0,0,0,0,0,0,0
0,0,0,0,0,0,0,0,0
0,0,0,0,0,0,0,0,0
72657,48,4,0,0,0,1,0,0
0,0,0,0,0,0,0,0,0
0,0,0,0,0,0,0,0,0
0,0,0,0,0,0,0,0,0
0,0,0,0,0,0,0,0,0
0,0,0,0,0,0,0,0,0
0,0,0,0,0,0,0,0,0
27127,311,4,2,0,2,7,1,0
0,0,0,0,0,0,0,0,0
0,0,0,0,0,0,0,0,0
0,0,0,0,0,0,0,0,0
0,0,0,0,0,0,0,0,0
0,0,0,0,0,0,0,0,0
108055,496,10,36,33,3,1,1,0
0,0,0,0,0,0,0,0,0
0,0,0,0,0,0,0,0,0
0,0,0,0,0,0,0,0,0
0,0,0,0,0,0,0,0,0
0,0,0,0,0,0,0,0,0
0,0,0,0,0,0,0,0,0
0,0,0,0,0,0,0,0,0
0,0,0,0,0,0,0,0,0
0,0,0,0,0,0,0,0,0
0,0,0,0,0,0,0,0,0
2807643,254,2,19,15,4,4,1,0
0,0,0,0,0,0,0,0,0
0,0,0,0,0,0,0,0,0
0,0,0,0,0,0,0,0,0
5262,37,0,0,0,0,0,0,0
5262,37,0,0,0,0,0,0,0
2807643,254,2,19,16,3,4,1,0
0,0,0,0,0,0,0,0,0
0,0,0,0,0,0,0,0,0
5262,37,0,0,0,0,0,0,0
0,0,0,0,0,0,0,0,0
0,0,0,0,0,0,0,0,0
5262,37,0,0,0,0,0,0,0
0,0,0,0,0,0,0,0,0
0,0,0,0,0,0,0,0,0
0,0,0,0,0,0,0,0,0
0,0,0,0,0,0,0,0,0
99850,55,4,0,0,0,3,1,0
0,0,0,0,0,0,0,0,0
0,0,0,0,0,0,0,0,0
0,0,0,0,0,0,0,0,0
0,0,0,0,0,0,0,0,0
0,0,0,0,0,0,0,0,0
98967,66,4,0,0,0,2,1,0
249877,75,0,17,15,2,0,0,0
98965,66,4,0,0,0,2,1,0
254921,159,0,41,39,2,0,0,0
98928,66,4,0,0,0,2,1,0
98928,66,4,0,0,0,2,1,0
0,0,0,0,0,0,0,0,0
0,0,0,0,0,0,0,0,0
0,0,0,0,0,0,0,0,0
254921,159,0,41,39,2,0,0,0
254921,159,0,41,39,2,0,0,0
0,0,0,0,0,0,0,0,0
98967,66,4,0,0,0,2,1,0
249877,75,0,17,15,2,0,0,0
249877,75,0,17,15,2,0,0,0
98965,66,4,0,0,0,2,1,0
98928,66,4,0,0,0,2,1,0
0,0,0,0,0,0,0,0,0
0,0,0,0,0,0,0,0,0
0,0,0,0,0,0,0,0,0
0,0,0,0,0,0,0,0,0
0,0,0,0,0,0,0,0,0
11681,60,5,0,0,0,4,1,0
11681,60,5,0,0,0,4,1,0
11681,60,5,0,0,0,4,1,0
11681,60,5,0,0,0,4,1,0
11681,60,5,0,0,0,4,1,0
11681,60,5,0,0,0,4,1,0
11681,60,5,0,0,0,4,1,0
17713,51,0,1,1,0,0,0,0
17713,51,0,1,1,0,0,0,0
0,0,0,0,0,0,0,0,0
0,0,0,0,0,0,0,0,0
0,0,0,0,0,0,0,0,0
0,0,0,0,0,0,0,0,0
0,0,0,0,0,0,0,0,0
17713,51,0,1,1,0,0,0,0
17713,51,0,1,1,0,0,0,0
45437,642,4,163,26,137,3,1,0
0,0,0,0,0,0,0,0,0
0,0,0,0,0,0,0,0,0
0,0,0,0,0,0,0,0,0
0,0,0,0,0,0,0,0,0
136252,1228,8,203,199,4,11,1,0
0,0,0,0,0,0,0,0,0
0,0,0,0,0,0,0,0,0
0,0,0,0,0,0,0,0,0
9292,61,2,3,3,0,2,0,0
0,0,0,0,0,0,0,0,0
0,0,0,0,0,0,0,0,0
0,0,0,0,0,0,0,0,0
13614,100,0,1,0,1,0,0,0
324320,226,6,2,2,0,0,1,0
0,0,0,0,0,0,0,0,0
28977,45,0,4,1,3,0,0,0
0,0,0,0,0,0,0,0,0
0,0,0,0,0,0,0,0,0
0,0,0,0,0,0,0,0,0
0,0,0,0,0,0,0,0,0
0,0,0,0,0,0,0,0,0
0,0,0,0,0,0,0,0,0
0,0,0,0,0,0,0,0,0
0,0,0,0,0,0,0,0,0
0,0,0,0,0,0,0,0,0
0,0,0,0,0,0,0,0,0
0,0,0,0,0,0,0,0,0
0,0,0,0,0,0,0,0,0
0,0,0,0,0,0,0,0,0
0,0,0,0,0,0,0,0,0
169532,616,4,2,1,1,7,0,0
171948,618,4,2,1,1,7,0,0
172096,647,4,2,1,1,7,0,0
0,0,0,0,0,0,0,0,0
10849,84,1,2,2,0,0,0,0
0,0,0,0,0,0,0,0,0
0,0,0,0,0,0,0,0,0
0,0,0,0,0,0,0,0,0
20772,158,0,1,0,1,0,1,0
20772,158,0,1,0,1,0,1,0
0,0,0,0,0,0,0,0,0
0,0,0,0,0,0,0,0,0
0,0,0,0,0,0,0,0,0
0,0,0,0,0,0,0,0,0
0,0,0,0,0,0,0,0,0
0,0,0,0,0,0,0,0,0
0,0,0,0,0,0,0,0,0
0,0,0,0,0,0,0,0,0
0,0,0,0,0,0,0,0,0
0,0,0,0,0,0,0,0,0
0,0,0,0,0,0,0,0,0
0,0,0,0,0,0,0,0,0
172146,521,4,6,3,3,9,0,0
166205,482,4,2,1,1,7,0,0
3766,44,0,2,0,2,1,0,0
174982,1462,4,2,1,1,7,0,0
168458,488,4,2,1,1,7,1,0
0,0,0,0,0,0,0,0,0
0,0,0,0,0,0,0,0,0
141649,414,8,29,24,5,31,1,0
15020,142,0,56,51,5,0,0,0
1162945,323,5,5,2,3,7,1,0
0,0,0,0,0,0,0,0,0
0,0,0,0,0,0,0,0,0
0,0,0,0,0,0,0,0,0
0,0,0,0,0,0,0,0,0
0,0,0,0,0,0,0,0,0
10361,83,1,0,0,0,0,0,0
0,0,0,0,0,0,0,0,0
0,0,0,0,0,0,0,0,0
358836,198,6,3,1,2,0,1,0
0,0,0,0,0,0,0,0,0
48031,224,2,2,1,1,1,0,0
0,0,0,0,0,0,0,0,0
140917,418,8,28,24,4,32,1,0
0,0,0,0,0,0,0,0,0
0,0,0,0,0,0,0,0,0
184481,880,9,70,67,3,0,0,0
72657,48,4,0,0,0,1,0,0
0,0,0,0,0,0,0,0,0
0,0,0,0,0,0,0,0,0
0,0,0,0,0,0,0,0,0
72658,48,4,0,0,0,1,0,0
0,0,0,0,0,0,0,0,0
0,0,0,0,0,0,0,0,0
0,0,0,0,0,0,0,0,0
192380,222,2,57,56,1,2,1,0
266224,514,4,50,34,16,7,1,0
0,0,0,0,0,0,0,0,0
0,0,0,0,0,0,0,0,0
0,0,0,0,0,0,0,0,0
265829,514,4,50,34,16,7,1,0
0,0,0,0,0,0,0,0,0
0,0,0,0,0,0,0,0,0
0,0,0,0,0,0,0,0,0
0,0,0,0,0,0,0,0,0
0,0,0,0,0,0,0,0,0
0,0,0,0,0,0,0,0,0
0,0,0,0,0,0,0,0,0
0,0,0,0,0,0,0,0,0
398156,248,8,6,6,0,0,1,0
11280,112,2,4,4,0,2,0,0
0,0,0,0,0,0,0,0,0
0,0,0,0,0,0,0,0,0
144139,68,2,1,0,1,0,1,0
144139,68,2,1,0,1,0,1,0
0,0,0,0,0,0,0,0,0
0,0,0,0,0,0,0,0,0
0,0,0,0,0,0,0,0,0
192284,222,2,57,56,1,2,1,0
0,0,0,0,0,0,0,0,0
0,0,0,0,0,0,0,0,0
0,0,0,0,0,0,0,0,0
0,0,0,0,0,0,0,0,0
672848,555,0,4,4,0,2,1,1
424,6,0,0,0,0,0,0,0
0,0,0,0,0,0,0,0,0
0,0,0,0,0,0,0,0,0
0,0,0,0,0,0,0,0,0
0,0,0,0,0,0,0,0,0
0,0,0,0,0,0,0,0,0
10387,85,1,0,0,0,0,0,0
35711,171,6,4,2,2,1,0,0
0,0,0,0,0,0,0,0,0
0,0,0,0,0,0,0,0,0
163952,473,4,2,1,1,7,0,0
0,0,0,0,0,0,0,0,0
0,0,0,0,0,0,0,0,0
0,0,0,0,0,0,0,0,0
0,0,0,0,0,0,0,0,0
289670,68,0,5,5,0,0,1,0
310204,283,6,1,1,0,0,1,0
72549,47,4,0,0,0,1,0,0
0,0,0,0,0,0,0,0,0
0,0,0,0,0,0,0,0,0
0,0,0,0,0,0,0,0,0
0,0,0,0,0,0,0,0,0
170880,684,4,4,3,1,8,0,0
177626,481,6,41,2,39,6,1,0
0,0,0,0,0,0,0,0,0
10387,85,1,0,0,0,0,0,0
140373,411,8,26,24,2,32,1,0
308030,207,6,1,1,0,0,1,0
0,0,0,0,0,0,0,0,0
0,0,0,0,0,0,0,0,0
0,0,0,0,0,0,0,0,0
0,0,0,0,0,0,0,0,0
80613,134,6,8,7,1,8,1,0
0,0,0,0,0,0,0,0,0
135762,327,8,27,24,3,17,1,0
0,0,0,0,0,0,0,0,0
0,0,0,0,0,0,0,0,0
0,0,0,0,0,0,0,0,0
0,0,0,0,0,0,0,0,0
293957,205,6,7,4,3,0,1,0
1687488,63,3,1,1,0,4,1,0
0,0,0,0,0,0,0,0,0
0,0,0,0,0,0,0,0,0
297370,191,6,1,1,0,0,1,0
0,0,0,0,0,0,0,0,0
0,0,0,0,0,0,0,0,0
38759,49,2,3,3,0,0,0,0
0,0,0,0,0,0,0,0,0
0,0,0,0,0,0,0,0,0
0,0,0,0,0,0,0,0,0
677619,555,0,4,0,4,2,1,1
0,0,0,0,0,0,0,0,0
0,0,0,0,0,0,0,0,0
2458,50,1,5,5,0,0,1,0
0,0,0,0,0,0,0,0,0
139947,410,8,26,24,2,32,1,0
0,0,0,0,0,0,0,0,0
0,0,0,0,0,0,0,0,0
89664,382,8,66,65,1,3,0,0
0,0,0,0,0,0,0,0,0
0,0,0,0,0,0,0,0,0
0,0,0,0,0,0,0,0,0
0,0,0,0,0,0,0,0,0
0,0,0,0,0,0,0,0,0
0,0,0,0,0,0,0,0,0
0,0,0,0,0,0,0,0,0
57784,764,5,15,13,2,0,1,0
0,0,0,0,0,0,0,0,0
0,0,0,0,0,0,0,0,0
0,0,0,0,0,0,0,0,0
0,0,0,0,0,0,0,0,0
0,0,0,0,0,0,0,0,0
0,0,0,0,0,0,0,0,0
0,0,0,0,0,0,0,0,0
0,0,0,0,0,0,0,0,0
0,0,0,0,0,0,0,0,0
0,0,0,0,0,0,0,0,0
48562,142,3,6,3,3,2,0,0
48562,142,3,6,3,3,2,0,0
0,0,0,0,0,0,0,0,0
0,0,0,0,0,0,0,0,0
0,0,0,0,0,0,0,0,0
39275,43,4,0,0,0,2,0,0
0,0,0,0,0,0,0,0,0
0,0,0,0,0,0,0,0,0
0,0,0,0,0,0,0,0,0
8072,140,7,26,6,20,1,1,0
8073,140,7,26,6,20,1,1,0
8072,140,7,26,6,20,1,1,0
8073,140,7,26,6,20,1,1,0
0,0,0,0,0,0,0,0,0
0,0,0,0,0,0,0,0,0
65183,303,1,6,4,2,0,0,0
47385,121,3,13,1,12,0,1,0
47385,121,3,13,2,11,0,1,0
0,0,0,0,0,0,0,0,0
0,0,0,0,0,0,0,0,0
20771,158,0,1,0,1,0,1,0
20771,158,0,1,0,1,0,1,0
0,0,0,0,0,0,0,0,0
26119,116,3,6,3,3,0,0,0
26388,117,3,6,3,3,0,0,0
0,0,0,0,0,0,0,0,0
0,0,0,0,0,0,0,0,0
0,0,0,0,0,0,0,0,0
0,0,0,0,0,0,0,0,0
0,0,0,0,0,0,0,0,0
0,0,0,0,0,0,0,0,0
0,0,0,0,0,0,0,0,0
16309,89,0,15,1,14,0,1,0
0,0,0,0,0,0,0,0,0
0,0,0,0,0,0,0,0,0
0,0,0,0,0,0,0,0,0
0,0,0,0,0,0,0,0,0
0,0,0,0,0,0,0,0,0
0,0,0,0,0,0,0,0,0
0,0,0,0,0,0,0,0,0
0,0,0,0,0,0,0,0,0
0,0,0,0,0,0,0,0,0
0,0,0,0,0,0,0,0,0
0,0,0,0,0,0,0,0,0
0,0,0,0,0,0,0,0,0
0,0,0,0,0,0,0,0,0
0,0,0,0,0,0,0,0,0
0,0,0,0,0,0,0,0,0
0,0,0,0,0,0,0,0,0
0,0,0,0,0,0,0,0,0
0,0,0,0,0,0,0,0,0
0,0,0,0,0,0,0,0,0
0,0,0,0,0,0,0,0,0
0,0,0,0,0,0,0,0,0
0,0,0,0,0,0,0,0,0
0,0,0,0,0,0,0,0,0
0,0,0,0,0,0,0,0,0
0,0,0,0,0,0,0,0,0
0,0,0,0,0,0,0,0,0
0,0,0,0,0,0,0,0,0
0,0,0,0,0,0,0,0,0
0,0,0,0,0,0,0,0,0
0,0,0,0,0,0,0,0,0
0,0,0,0,0,0,0,0,0
0,0,0,0,0,0,0,0,0
0,0,0,0,0,0,0,0,0
0,0,0,0,0,0,0,0,0
0,0,0,0,0,0,0,0,0
0,0,0,0,0,0,0,0,0
0,0,0,0,0,0,0,0,0
0,0,0,0,0,0,0,0,0
0,0,0,0,0,0,0,0,0
0,0,0,0,0,0,0,0,0
0,0,0,0,0,0,0,0,0
0,0,0,0,0,0,0,0,0
0,0,0,0,0,0,0,0,0
0,0,0,0,0,0,0,0,0
0,0,0,0,0,0,0,0,0
0,0,0,0,0,0,0,0,0
0,0,0,0,0,0,0,0,0
0,0,0,0,0,0,0,0,0
0,0,0,0,0,0,0,0,0
0,0,0,0,0,0,0,0,0
0,0,0,0,0,0,0,0,0
0,0,0,0,0,0,0,0,0
0,0,0,0,0,0,0,0,0
0,0,0,0,0,0,0,0,0
0,0,0,0,0,0,0,0,0
0,0,0,0,0,0,0,0,0
0,0,0,0,0,0,0,0,0
0,0,0,0,0,0,0,0,0
0,0,0,0,0,0,0,0,0
0,0,0,0,0,0,0,0,0
0,0,0,0,0,0,0,0,0
0,0,0,0,0,0,0,0,0
0,0,0,0,0,0,0,0,0
0,0,0,0,0,0,0,0,0
0,0,0,0,0,0,0,0,0
0,0,0,0,0,0,0,0,0
0,0,0,0,0,0,0,0,0
0,0,0,0,0,0,0,0,0
0,0,0,0,0,0,0,0,0
0,0,0,0,0,0,0,0,0
0,0,0,0,0,0,0,0,0
3788,26,0,0,0,0,0,0,0
0,0,0,0,0,0,0,0,0
0,0,0,0,0,0,0,0,0
0,0,0,0,0,0,0,0,0
0,0,0,0,0,0,0,0,0
0,0,0,0,0,0,0,0,0
0,0,0,0,0,0,0,0,0
0,0,0,0,0,0,0,0,0
0,0,0,0,0,0,0,0,0
0,0,0,0,0,0,0,0,0
0,0,0,0,0,0,0,0,0
0,0,0,0,0,0,0,0,0
72670,48,4,0,0,0,1,0,0
0,0,0,0,0,0,0,0,0
673504,555,0,4,4,0,2,1,1
0,0,0,0,0,0,0,0,0
0,0,0,0,0,0,0,0,0
0,0,0,0,0,0,0,0,0
0,0,0,0,0,0,0,0,0
0,0,0,0,0,0,0,0,0
0,0,0,0,0,0,0,0,0
0,0,0,0,0,0,0,0,0
0,0,0,0,0,0,0,0,0
0,0,0,0,0,0,0,0,0
6306,74,2,4,4,0,0,1,0
182025,569,4,4,1,3,7,0,0
0,0,0,0,0,0,0,0,0
0,0,0,0,0,0,0,0,0
0,0,0,0,0,0,0,0,0
0,0,0,0,0,0,0,0,0
0,0,0,0,0,0,0,0,0
0,0,0,0,0,0,0,0,0
0,0,0,0,0,0,0,0,0
0,0,0,0,0,0,0,0,0
0,0,0,0,0,0,0,0,0
0,0,0,0,0,0,0,0,0
0,0,0,0,0,0,0,0,0
0,0,0,0,0,0,0,0,0
0,0,0,0,0,0,0,0,0
0,0,0,0,0,0,0,0,0
0,0,0,0,0,0,0,0,0
0,0,0,0,0,0,0,0,0
0,0,0,0,0,0,0,0,0
0,0,0,0,0,0,0,0,0
0,0,0,0,0,0,0,0,0
0,0,0,0,0,0,0,0,0
0,0,0,0,0,0,0,0,0
0,0,0,0,0,0,0,0,0
0,0,0,0,0,0,0,0,0
0,0,0,0,0,0,0,0,0
0,0,0,0,0,0,0,0,0
0,0,0,0,0,0,0,0,0
0,0,0,0,0,0,0,0,0
0,0,0,0,0,0,0,0,0
8073,140,7,26,6,20,1,1,0
387850,241,5,2,0,2,2,0,0
1350,19,0,2,1,1,0,0,0
8073,140,7,26,6,20,1,1,0
0,0,0,0,0,0,0,0,0
0,0,0,0,0,0,0,0,0
0,0,0,0,0,0,0,0,0
121784,965,1,116,11,105,84,0,0
72658,48,4,0,0,0,1,0,0
72658,48,4,0,0,0,1,0,0
140361,416,8,29,24,5,32,1,0
0,0,0,0,0,0,0,0,0
7690,112,3,32,32,0,0,1,0
0,0,0,0,0,0,0,0,0
0,0,0,0,0,0,0,0,0
0,0,0,0,0,0,0,0,0
140510,417,8,28,24,4,33,1,0
318740,267,6,1,1,0,0,1,0
289311,257,6,1,1,0,0,1,0
0,0,0,0,0,0,0,0,0
0,0,0,0,0,0,0,0,0
0,0,0,0,0,0,0,0,0
136719,332,8,28,24,4,17,1,0
0,0,0,0,0,0,0,0,0
0,0,0,0,0,0,0,0,0
0,0,0,0,0,0,0,0,0
179920,330,3,22,7,15,14,1,0
0,0,0,0,0,0,0,0,0
0,0,0,0,0,0,0,0,0
0,0,0,0,0,0,0,0,0
0,0,0,0,0,0,0,0,0
12682,46,2,0,0,0,2,0,0
0,0,0,0,0,0,0,0,0
0,0,0,0,0,0,0,0,0
0,0,0,0,0,0,0,0,0
0,0,0,0,0,0,0,0,0
0,0,0,0,0,0,0,0,0
0,0,0,0,0,0,0,0,0
306612,196,6,1,1,0,0,1,0
0,0,0,0,0,0,0,0,0
15000,127,3,20,11,9,0,1,0
0,0,0,0,0,0,0,0,0
0,0,0,0,0,0,0,0,0
0,0,0,0,0,0,0,0,0
0,0,0,0,0,0,0,0,0
0,0,0,0,0,0,0,0,0
0,0,0,0,0,0,0,0,0
0,0,0,0,0,0,0,0,0
0,0,0,0,0,0,0,0,0
671234,555,0,4,4,0,2,1,1
0,0,0,0,0,0,0,0,0
0,0,0,0,0,0,0,0,0
0,0,0,0,0,0,0,0,0
672072,555,0,4,4,0,2,1,1
0,0,0,0,0,0,0,0,0
0,0,0,0,0,0,0,0,0
0,0,0,0,0,0,0,0,0
0,0,0,0,0,0,0,0,0
0,0,0,0,0,0,0,0,0
0,0,0,0,0,0,0,0,0
0,0,0,0,0,0,0,0,0
36248,170,2,5,4,1,18,0,0
0,0,0,0,0,0,0,0,0
0,0,0,0,0,0,0,0,0
0,0,0,0,0,0,0,0,0
0,0,0,0,0,0,0,0,0
0,0,0,0,0,0,0,0,0
0,0,0,0,0,0,0,0,0
0,0,0,0,0,0,0,0,0
0,0,0,0,0,0,0,0,0
59705,206,3,8,4,4,3,0,0
0,0,0,0,0,0,0,0,0
0,0,0,0,0,0,0,0,0
0,0,0,0,0,0,0,0,0
0,0,0,0,0,0,0,0,0
0,0,0,0,0,0,0,0,0
59067,391,5,22,19,3,2,1,0
0,0,0,0,0,0,0,0,0
0,0,0,0,0,0,0,0,0
0,0,0,0,0,0,0,0,0
254073,1083,1,259,220,39,3,0,0
254073,1083,1,259,220,39,3,0,0
0,0,0,0,0,0,0,0,0
0,0,0,0,0,0,0,0,0
0,0,0,0,0,0,0,0,0
0,0,0,0,0,0,0,0,0
0,0,0,0,0,0,0,0,0
0,0,0,0,0,0,0,0,0
22144,147,0,1,0,1,0,1,0
22144,147,0,1,0,1,0,1,0
99253,959,3,149,76,73,1,0,0
0,0,0,0,0,0,0,0,0
0,0,0,0,0,0,0,0,0
0,0,0,0,0,0,0,0,0
0,0,0,0,0,0,0,0,0
0,0,0,0,0,0,0,0,0
0,0,0,0,0,0,0,0,0
0,0,0,0,0,0,0,0,0
0,0,0,0,0,0,0,0,0
0,0,0,0,0,0,0,0,0
0,0,0,0,0,0,0,0,0
0,0,0,0,0,0,0,0,0
0,0,0,0,0,0,0,0,0
0,0,0,0,0,0,0,0,0
0,0,0,0,0,0,0,0,0
0,0,0,0,0,0,0,0,0
0,0,0,0,0,0,0,0,0
13647,99,0,1,0,1,0,0,0
0,0,0,0,0,0,0,0,0
0,0,0,0,0,0,0,0,0
0,0,0,0,0,0,0,0,0
0,0,0,0,0,0,0,0,0
0,0,0,0,0,0,0,0,0
0,0,0,0,0,0,0,0,0
0,0,0,0,0,0,0,0,0
0,0,0,0,0,0,0,0,0
165770,482,4,2,1,1,7,1,0
0,0,0,0,0,0,0,0,0
0,0,0,0,0,0,0,0,0
0,0,0,0,0,0,0,0,0
0,0,0,0,0,0,0,0,0
0,0,0,0,0,0,0,0,0
0,0,0,0,0,0,0,0,0
0,0,0,0,0,0,0,0,0
0,0,0,0,0,0,0,0,0
0,0,0,0,0,0,0,0,0
0,0,0,0,0,0,0,0,0
0,0,0,0,0,0,0,0,0
0,0,0,0,0,0,0,0,0
0,0,0,0,0,0,0,0,0
0,0,0,0,0,0,0,0,0
0,0,0,0,0,0,0,0,0
0,0,0,0,0,0,0,0,0
0,0,0,0,0,0,0,0,0
4675,115,2,0,0,0,1,0,0
0,0,0,0,0,0,0,0,0
672580,555,0,4,4,0,2,1,1
0,0,0,0,0,0,0,0,0
0,0,0,0,0,0,0,0,0
36248,170,2,5,4,1,18,0,0
0,0,0,0,0,0,0,0,0
36248,170,2,5,4,1,18,0,0
0,0,0,0,0,0,0,0,0
0,0,0,0,0,0,0,0,0
166943,482,4,4,3,1,8,0,0
163686,470,4,2,1,1,7,0,0
170527,726,4,4,3,1,8,0,0
163997,470,4,2,1,1,7,0,0
164916,477,4,4,3,1,8,0,0
167825,498,4,7,4,3,8,0,0
166441,482,4,4,3,1,8,0,0
165566,470,4,2,1,1,7,0,0
166402,482,4,4,3,1,8,0,0
168287,486,4,2,1,1,7,0,0
166969,482,4,4,3,1,8,0,0
164100,473,4,4,3,1,8,0,0
163669,470,4,2,1,1,7,0,0
165913,477,4,4,3,1,8,0,0
0,0,0,0,0,0,0,0,0
163870,471,4,2,1,1,7,0,0
163657,470,4,2,1,1,7,0,0
165076,473,4,4,3,1,8,0,0
164688,470,4,2,1,1,7,0,0
166902,482,4,4,3,1,8,0,0
165406,476,4,6,3,3,8,0,0
164085,473,4,4,3,1,8,0,0
0,0,0,0,0,0,0,0,0
169461,498,4,4,3,1,8,1,0
165263,478,4,4,3,1,8,0,0
162777,466,4,2,1,1,7,0,0
168048,493,5,4,3,1,8,0,0
164910,475,4,2,1,1,7,0,0
165177,478,4,4,3,1,8,0,0
163837,471,4,2,1,1,7,0,0
166362,479,4,4,3,1,8,0,0
164929,472,4,2,1,1,7,0,0
165121,473,4,2,1,1,7,0,0
166073,479,4,4,3,1,8,0,0
166320,488,4,5,4,1,6,0,0
165043,472,4,2,1,1,7,0,0
167510,498,4,2,1,1,8,0,0
0,0,0,0,0,0,0,0,0
0,0,0,0,0,0,0,0,0
166167,484,4,4,3,1,8,0,0
0,0,0,0,0,0,0,0,0
0,0,0,0,0,0,0,0,0
0,0,0,0,0,0,0,0,0
0,0,0,0,0,0,0,0,0
0,0,0,0,0,0,0,0,0
203975,145,3,2,1,1,18,0,0
203987,145,3,2,1,1,18,0,0
0,0,0,0,0,0,0,0,0
0,0,0,0,0,0,0,0,0
17694,210,1,51,50,1,0,1,0
17694,210,1,51,50,1,0,1,0
0,0,0,0,0,0,0,0,0
0,0,0,0,0,0,0,0,0
0,0,0,0,0,0,0,0,0
0,0,0,0,0,0,0,0,0
0,0,0,0,0,0,0,0,0
27121,102,1,7,7,0,2,0,0
0,0,0,0,0,0,0,0,0
0,0,0,0,0,0,0,0,0
0,0,0,0,0,0,0,0,0
376729,187,6,1,1,0,0,1,0
0,0,0,0,0,0,0,0,0
0,0,0,0,0,0,0,0,0
278911,177,6,1,1,0,0,1,0
0,0,0,0,0,0,0,0,0
0,0,0,0,0,0,0,0,0
0,0,0,0,0,0,0,0,0
0,0,0,0,0,0,0,0,0
0,0,0,0,0,0,0,0,0
0,0,0,0,0,0,0,0,0
0,0,0,0,0,0,0,0,0
0,0,0,0,0,0,0,0,0
0,0,0,0,0,0,0,0,0
72670,48,4,0,0,0,1,0,0
670579,555,0,4,4,0,2,1,1
0,0,0,0,0,0,0,0,0
0,0,0,0,0,0,0,0,0
0,0,0,0,0,0,0,0,0
36248,170,2,5,4,1,18,0,0
0,0,0,0,0,0,0,0,0
0,0,0,0,0,0,0,0,0
0,0,0,0,0,0,0,0,0
166933,483,4,4,3,1,8,0,0
0,0,0,0,0,0,0,0,0
0,0,0,0,0,0,0,0,0
0,0,0,0,0,0,0,0,0
0,0,0,0,0,0,0,0,0
0,0,0,0,0,0,0,0,0
385,23,0,4,4,0,0,0,0
0,0,0,0,0,0,0,0,0
0,0,0,0,0,0,0,0,0
0,0,0,0,0,0,0,0,0
0,0,0,0,0,0,0,0,0
0,0,0,0,0,0,0,0,0
0,0,0,0,0,0,0,0,0
0,0,0,0,0,0,0,0,0
0,0,0,0,0,0,0,0,0
0,0,0,0,0,0,0,0,0
0,0,0,0,0,0,0,0,0
0,0,0,0,0,0,0,0,0
0,0,0,0,0,0,0,0,0
0,0,0,0,0,0,0,0,0
0,0,0,0,0,0,0,0,0
0,0,0,0,0,0,0,0,0
0,0,0,0,0,0,0,0,0
0,0,0,0,0,0,0,0,0
0,0,0,0,0,0,0,0,0
0,0,0,0,0,0,0,0,0
0,0,0,0,0,0,0,0,0
0,0,0,0,0,0,0,0,0
0,0,0,0,0,0,0,0,0
0,0,0,0,0,0,0,0,0
0,0,0,0,0,0,0,0,0
0,0,0,0,0,0,0,0,0
0,0,0,0,0,0,0,0,0
0,0,0,0,0,0,0,0,0
0,0,0,0,0,0,0,0,0
0,0,0,0,0,0,0,0,0
0,0,0,0,0,0,0,0,0
0,0,0,0,0,0,0,0,0
135899,327,8,27,24,3,17,1,0
8073,140,7,26,6,20,1,1,0
0,0,0,0,0,0,0,0,0
0,0,0,0,0,0,0,0,0
39945,127,2,5,2,3,1,1,0
0,0,0,0,0,0,0,0,0
0,0,0,0,0,0,0,0,0
0,0,0,0,0,0,0,0,0
0,0,0,0,0,0,0,0,0
0,0,0,0,0,0,0,0,0
26915,143,2,16,4,12,0,1,1
26915,143,2,16,4,12,0,1,1
1059955,101,4,5,5,0,3,1,0
0,0,0,0,0,0,0,0,0
415481,62,4,3,3,0,2,1,0
415481,62,4,3,3,0,2,1,0
415481,62,4,3,3,0,2,1,0
415481,62,4,3,3,0,2,1,0
231255,136,3,21,1,20,3,0,0
231255,136,3,21,1,20,3,0,0
415481,62,4,3,3,0,2,1,0
415481,62,4,3,3,0,2,1,0
0,0,0,0,0,0,0,0,0
5663583,213,0,52,51,1,0,1,0
5663583,213,0,52,51,1,0,1,0
415481,62,4,3,3,0,2,1,0
231255,136,3,21,1,20,3,0,0
0,0,0,0,0,0,0,0,0
231255,136,3,21,1,20,3,0,0
5663583,213,0,52,51,1,0,1,0
5663583,213,0,52,51,1,0,1,0
5663583,213,0,52,51,1,0,1,0
0,0,0,0,0,0,0,0,0
0,0,0,0,0,0,0,0,0
0,0,0,0,0,0,0,0,0
0,0,0,0,0,0,0,0,0
0,0,0,0,0,0,0,0,0
0,0,0,0,0,0,0,0,0
0,0,0,0,0,0,0,0,0
0,0,0,0,0,0,0,0,0
0,0,0,0,0,0,0,0,0
0,0,0,0,0,0,0,0,0
0,0,0,0,0,0,0,0,0
0,0,0,0,0,0,0,0,0
0,0,0,0,0,0,0,0,0
20144,53,3,0,0,0,0,0,0
0,0,0,0,0,0,0,0,0
0,0,0,0,0,0,0,0,0
0,0,0,0,0,0,0,0,0
20144,53,3,0,0,0,0,0,0
0,0,0,0,0,0,0,0,0
3766,44,0,2,0,2,1,0,0
232879,64,4,3,3,0,2,1,0
0,0,0,0,0,0,0,0,0
0,0,0,0,0,0,0,0,0
0,0,0,0,0,0,0,0,0
0,0,0,0,0,0,0,0,0
0,0,0,0,0,0,0,0,0
0,0,0,0,0,0,0,0,0
0,0,0,0,0,0,0,0,0
0,0,0,0,0,0,0,0,0
0,0,0,0,0,0,0,0,0
0,0,0,0,0,0,0,0,0
0,0,0,0,0,0,0,0,0
1060484,101,4,5,5,0,3,1,0
0,0,0,0,0,0,0,0,0
0,0,0,0,0,0,0,0,0
0,0,0,0,0,0,0,0,0
0,0,0,0,0,0,0,0,0
0,0,0,0,0,0,0,0,0
0,0,0,0,0,0,0,0,0
0,0,0,0,0,0,0,0,0
0,0,0,0,0,0,0,0,0
0,0,0,0,0,0,0,0,0
0,0,0,0,0,0,0,0,0
0,0,0,0,0,0,0,0,0
673979,555,0,4,4,0,2,1,1
0,0,0,0,0,0,0,0,0
0,0,0,0,0,0,0,0,0
0,0,0,0,0,0,0,0,0
8072,140,7,26,6,20,1,1,0
0,0,0,0,0,0,0,0,0
8072,140,7,26,6,20,1,1,0
0,0,0,0,0,0,0,0,0
0,0,0,0,0,0,0,0,0
0,0,0,0,0,0,0,0,0
0,0,0,0,0,0,0,0,0
8073,140,7,26,6,20,1,1,0
0,0,0,0,0,0,0,0,0
72658,48,4,0,0,0,1,0,0
8073,140,7,26,6,20,1,1,0
0,0,0,0,0,0,0,0,0
0,0,0,0,0,0,0,0,0
0,0,0,0,0,0,0,0,0
0,0,0,0,0,0,0,0,0
0,0,0,0,0,0,0,0,0
0,0,0,0,0,0,0,0,0
0,0,0,0,0,0,0,0,0
72658,48,4,0,0,0,1,0,0
672575,555,0,4,4,0,2,1,1
0,0,0,0,0,0,0,0,0
0,0,0,0,0,0,0,0,0
0,0,0,0,0,0,0,0,0
259750,1332,4,26,1,25,0,1,0
110485,1037,4,161,161,0,3,0,0
163965,466,4,2,1,1,7,0,0
15325,51,2,0,0,0,2,0,0
0,0,0,0,0,0,0,0,0
72669,48,4,0,0,0,1,0,0
0,0,0,0,0,0,0,0,0
675957,555,0,4,2,2,2,1,1
0,0,0,0,0,0,0,0,0
0,0,0,0,0,0,0,0,0
0,0,0,0,0,0,0,0,0
12985,96,0,3,3,0,0,0,0
0,0,0,0,0,0,0,0,0
0,0,0,0,0,0,0,0,0
72658,48,4,0,0,0,1,0,0
0,0,0,0,0,0,0,0,0
0,0,0,0,0,0,0,0,0
0,0,0,0,0,0,0,0,0
0,0,0,0,0,0,0,0,0
670383,555,0,4,4,0,2,1,1
13008,98,0,3,3,0,0,0,0
0,0,0,0,0,0,0,0,0
0,0,0,0,0,0,0,0,0
0,0,0,0,0,0,0,0,0
0,0,0,0,0,0,0,0,0
0,0,0,0,0,0,0,0,0
0,0,0,0,0,0,0,0,0
0,0,0,0,0,0,0,0,0
0,0,0,0,0,0,0,0,0
0,0,0,0,0,0,0,0,0
0,0,0,0,0,0,0,0,0
3501,23,1,1,1,0,0,0,0
0,0,0,0,0,0,0,0,0
0,0,0,0,0,0,0,0,0
0,0,0,0,0,0,0,0,0
0,0,0,0,0,0,0,0,0
0,0,0,0,0,0,0,0,0
0,0,0,0,0,0,0,0,0
0,0,0,0,0,0,0,0,0
0,0,0,0,0,0,0,0,0
0,0,0,0,0,0,0,0,0
0,0,0,0,0,0,0,0,0
0,0,0,0,0,0,0,0,0
0,0,0,0,0,0,0,0,0
0,0,0,0,0,0,0,0,0
0,0,0,0,0,0,0,0,0
0,0,0,0,0,0,0,0,0
0,0,0,0,0,0,0,0,0
0,0,0,0,0,0,0,0,0
0,0,0,0,0,0,0,0,0
0,0,0,0,0,0,0,0,0
0,0,0,0,0,0,0,0,0
0,0,0,0,0,0,0,0,0
111860,61,4,3,3,0,2,1,0
111860,61,4,3,3,0,2,1,0
0,0,0,0,0,0,0,0,0
111860,61,4,3,3,0,2,1,0
0,0,0,0,0,0,0,0,0
0,0,0,0,0,0,0,0,0
0,0,0,0,0,0,0,0,0
0,0,0,0,0,0,0,0,0
111860,61,4,3,3,0,2,1,0
0,0,0,0,0,0,0,0,0
0,0,0,0,0,0,0,0,0
0,0,0,0,0,0,0,0,0
0,0,0,0,0,0,0,0,0
0,0,0,0,0,0,0,0,0
0,0,0,0,0,0,0,0,0
0,0,0,0,0,0,0,0,0
0,0,0,0,0,0,0,0,0
0,0,0,0,0,0,0,0,0
0,0,0,0,0,0,0,0,0
0,0,0,0,0,0,0,0,0
0,0,0,0,0,0,0,0,0
0,0,0,0,0,0,0,0,0
293829,194,6,1,1,0,0,1,0
138574,400,8,27,24,3,32,1,0
0,0,0,0,0,0,0,0,0
138889,404,8,28,24,4,31,1,0
132473,306,6,26,24,2,6,1,0
0,0,0,0,0,0,0,0,0
0,0,0,0,0,0,0,0,0
0,0,0,0,0,0,0,0,0
320066,252,6,7,7,0,0,1,0
0,0,0,0,0,0,0,0,0
0,0,0,0,0,0,0,0,0
0,0,0,0,0,0,0,0,0
0,0,0,0,0,0,0,0,0
397359,4038,8,1052,1052,0,4,0,0
0,0,0,0,0,0,0,0,0
685689,4,0,0,0,0,0,0,0
685689,4,0,0,0,0,0,0,0
685689,4,0,0,0,0,0,0,0
441096,98,3,2,2,0,0,0,0
0,0,0,0,0,0,0,0,0
0,0,0,0,0,0,0,0,0
0,0,0,0,0,0,0,0,0
0,0,0,0,0,0,0,0,0
0,0,0,0,0,0,0,0,0
0,0,0,0,0,0,0,0,0
0,0,0,0,0,0,0,0,0
674320,555,0,4,4,0,2,1,1
0,0,0,0,0,0,0,0,0
0,0,0,0,0,0,0,0,0
0,0,0,0,0,0,0,0,0
0,0,0,0,0,0,0,0,0
0,0,0,0,0,0,0,0,0
0,0,0,0,0,0,0,0,0
0,0,0,0,0,0,0,0,0
0,0,0,0,0,0,0,0,0
0,0,0,0,0,0,0,0,0
0,0,0,0,0,0,0,0,0
0,0,0,0,0,0,0,0,0
34478,50,2,0,0,0,2,0,0
34474,50,2,0,0,0,2,0,0
0,0,0,0,0,0,0,0,0
0,0,0,0,0,0,0,0,0
0,0,0,0,0,0,0,0,0
0,0,0,0,0,0,0,0,0
0,0,0,0,0,0,0,0,0
0,0,0,0,0,0,0,0,0
0,0,0,0,0,0,0,0,0
0,0,0,0,0,0,0,0,0
0,0,0,0,0,0,0,0,0
0,0,0,0,0,0,0,0,0
0,0,0,0,0,0,0,0,0
0,0,0,0,0,0,0,0,0
0,0,0,0,0,0,0,0,0
72660,48,4,0,0,0,1,0,0
0,0,0,0,0,0,0,0,0
0,0,0,0,0,0,0,0,0
0,0,0,0,0,0,0,0,0
0,0,0,0,0,0,0,0,0
0,0,0,0,0,0,0,0,0
0,0,0,0,0,0,0,0,0
0,0,0,0,0,0,0,0,0
0,0,0,0,0,0,0,0,0
0,0,0,0,0,0,0,0,0
72658,48,4,0,0,0,1,0,0
0,0,0,0,0,0,0,0,0
0,0,0,0,0,0,0,0,0
0,0,0,0,0,0,0,0,0
0,0,0,0,0,0,0,0,0
0,0,0,0,0,0,0,0,0
166793,478,4,4,3,1,8,0,0
0,0,0,0,0,0,0,0,0
0,0,0,0,0,0,0,0,0
165937,478,4,4,3,1,8,0,0
163945,470,4,2,1,1,7,0,0
0,0,0,0,0,0,0,0,0
164938,471,4,2,1,1,7,0,0
0,0,0,0,0,0,0,0,0
165271,471,4,2,1,1,7,0,0
164513,470,4,2,1,1,7,0,0
165678,478,4,4,3,1,8,0,0
165365,472,4,2,1,1,7,0,0
165690,478,4,4,3,1,8,0,0
0,0,0,0,0,0,0,0,0
164311,471,4,2,1,1,7,0,0
164902,476,4,2,1,1,7,0,0
0,0,0,0,0,0,0,0,0
0,0,0,0,0,0,0,0,0
164786,473,4,2,1,1,7,0,0
0,0,0,0,0,0,0,0,0
0,0,0,0,0,0,0,0,0
165393,477,4,4,3,1,8,0,0
0,0,0,0,0,0,0,0,0
0,0,0,0,0,0,0,0,0
166047,484,4,2,1,1,7,1,0
0,0,0,0,0,0,0,0,0
169379,480,4,4,3,1,8,0,0
0,0,0,0,0,0,0,0,0
0,0,0,0,0,0,0,0,0
165818,478,4,4,3,1,8,0,0
164203,471,4,2,1,1,7,0,0
0,0,0,0,0,0,0,0,0
165855,476,4,4,1,3,7,0,0
0,0,0,0,0,0,0,0,0
166981,483,4,6,3,3,8,0,0
0,0,0,0,0,0,0,0,0
169970,505,4,5,4,1,8,1,0
0,0,0,0,0,0,0,0,0
167210,478,4,4,3,1,8,0,0
165567,478,4,4,3,1,8,0,0
166818,478,4,4,3,1,8,0,0
0,0,0,0,0,0,0,0,0
167156,478,4,4,3,1,8,0,0
167052,478,4,4,3,1,8,0,0
0,0,0,0,0,0,0,0,0
0,0,0,0,0,0,0,0,0
0,0,0,0,0,0,0,0,0
169916,620,4,3,2,1,7,1,0
0,0,0,0,0,0,0,0,0
0,0,0,0,0,0,0,0,0
0,0,0,0,0,0,0,0,0
0,0,0,0,0,0,0,0,0
0,0,0,0,0,0,0,0,0
0,0,0,0,0,0,0,0,0
163099,466,4,2,1,1,7,0,0
165007,475,4,2,1,1,7,0,0
166711,482,4,6,3,3,8,0,0
0,0,0,0,0,0,0,0,0
165674,522,4,2,1,1,7,0,0
0,0,0,0,0,0,0,0,0
0,0,0,0,0,0,0,0,0
169913,547,4,5,2,3,7,1,0
175023,512,4,3,2,1,7,1,0
165778,473,4,4,3,1,8,0,0
0,0,0,0,0,0,0,0,0
0,0,0,0,0,0,0,0,0
0,0,0,0,0,0,0,0,0
170798,504,4,2,0,2,7,0,0
0,0,0,0,0,0,0,0,0
170893,504,4,2,0,2,7,0,0
172858,519,4,2,0,2,7,0,0
169832,505,4,2,0,2,7,0,0
170561,504,4,2,0,2,7,0,0
170476,504,4,2,0,2,7,0,0
170797,504,4,2,0,2,7,0,0
0,0,0,0,0,0,0,0,0
0,0,0,0,0,0,0,0,0
170795,504,4,2,0,2,7,0,0
0,0,0,0,0,0,0,0,0
0,0,0,0,0,0,0,0,0
0,0,0,0,0,0,0,0,0
0,0,0,0,0,0,0,0,0
170798,504,4,2,0,2,7,0,0
168354,466,4,2,1,1,7,0,0
0,0,0,0,0,0,0,0,0
169842,505,4,2,0,2,7,0,0
0,0,0,0,0,0,0,0,0
170950,504,4,2,0,2,7,0,0
0,0,0,0,0,0,0,0,0
164297,471,4,2,1,1,7,0,0
0,0,0,0,0,0,0,0,0
0,0,0,0,0,0,0,0,0
0,0,0,0,0,0,0,0,0
0,0,0,0,0,0,0,0,0
0,0,0,0,0,0,0,0,0
0,0,0,0,0,0,0,0,0
0,0,0,0,0,0,0,0,0
0,0,0,0,0,0,0,0,0
0,0,0,0,0,0,0,0,0
0,0,0,0,0,0,0,0,0
0,0,0,0,0,0,0,0,0
0,0,0,0,0,0,0,0,0
0,0,0,0,0,0,0,0,0
0,0,0,0,0,0,0,0,0
0,0,0,0,0,0,0,0,0
0,0,0,0,0,0,0,0,0
0,0,0,0,0,0,0,0,0
0,0,0,0,0,0,0,0,0
0,0,0,0,0,0,0,0,0
0,0,0,0,0,0,0,0,0
0,0,0,0,0,0,0,0,0
0,0,0,0,0,0,0,0,0
0,0,0,0,0,0,0,0,0
0,0,0,0,0,0,0,0,0
0,0,0,0,0,0,0,0,0
0,0,0,0,0,0,0,0,0
0,0,0,0,0,0,0,0,0
0,0,0,0,0,0,0,0,0
0,0,0,0,0,0,0,0,0
0,0,0,0,0,0,0,0,0
0,0,0,0,0,0,0,0,0
0,0,0,0,0,0,0,0,0
0,0,0,0,0,0,0,0,0
0,0,0,0,0,0,0,0,0
0,0,0,0,0,0,0,0,0
0,0,0,0,0,0,0,0,0
0,0,0,0,0,0,0,0,0
0,0,0,0,0,0,0,0,0
0,0,0,0,0,0,0,0,0
0,0,0,0,0,0,0,0,0
0,0,0,0,0,0,0,0,0
0,0,0,0,0,0,0,0,0
0,0,0,0,0,0,0,0,0
0,0,0,0,0,0,0,0,0
0,0,0,0,0,0,0,0,0
0,0,0,0,0,0,0,0,0
0,0,0,0,0,0,0,0,0
0,0,0,0,0,0,0,0,0
0,0,0,0,0,0,0,0,0
0,0,0,0,0,0,0,0,0
0,0,0,0,0,0,0,0,0
0,0,0,0,0,0,0,0,0
0,0,0,0,0,0,0,0,0
0,0,0,0,0,0,0,0,0
0,0,0,0,0,0,0,0,0
0,0,0,0,0,0,0,0,0
0,0,0,0,0,0,0,0,0
0,0,0,0,0,0,0,0,0
0,0,0,0,0,0,0,0,0
0,0,0,0,0,0,0,0,0
0,0,0,0,0,0,0,0,0
0,0,0,0,0,0,0,0,0
0,0,0,0,0,0,0,0,0
0,0,0,0,0,0,0,0,0
0,0,0,0,0,0,0,0,0
0,0,0,0,0,0,0,0,0
0,0,0,0,0,0,0,0,0
0,0,0,0,0,0,0,0,0
0,0,0,0,0,0,0,0,0
0,0,0,0,0,0,0,0,0
0,0,0,0,0,0,0,0,0
0,0,0,0,0,0,0,0,0
0,0,0,0,0,0,0,0,0
0,0,0,0,0,0,0,0,0
0,0,0,0,0,0,0,0,0
0,0,0,0,0,0,0,0,0
0,0,0,0,0,0,0,0,0
170213,758,4,4,3,1,8,1,0
0,0,0,0,0,0,0,0,0
169561,670,4,4,3,1,8,1,0
170079,748,4,4,3,1,8,1,0
0,0,0,0,0,0,0,0,0
0,0,0,0,0,0,0,0,0
166690,471,4,2,1,1,7,0,0
0,0,0,0,0,0,0,0,0
0,0,0,0,0,0,0,0,0
0,0,0,0,0,0,0,0,0
0,0,0,0,0,0,0,0,0
0,0,0,0,0,0,0,0,0
0,0,0,0,0,0,0,0,0
0,0,0,0,0,0,0,0,0
0,0,0,0,0,0,0,0,0
0,0,0,0,0,0,0,0,0
0,0,0,0,0,0,0,0,0
0,0,0,0,0,0,0,0,0
0,0,0,0,0,0,0,0,0
0,0,0,0,0,0,0,0,0
0,0,0,0,0,0,0,0,0
0,0,0,0,0,0,0,0,0
0,0,0,0,0,0,0,0,0
0,0,0,0,0,0,0,0,0
0,0,0,0,0,0,0,0,0
0,0,0,0,0,0,0,0,0
0,0,0,0,0,0,0,0,0
168869,650,4,2,1,1,7,0,0
0,0,0,0,0,0,0,0,0
0,0,0,0,0,0,0,0,0
0,0,0,0,0,0,0,0,0
0,0,0,0,0,0,0,0,0
0,0,0,0,0,0,0,0,0
0,0,0,0,0,0,0,0,0
0,0,0,0,0,0,0,0,0
0,0,0,0,0,0,0,0,0
0,0,0,0,0,0,0,0,0
0,0,0,0,0,0,0,0,0
0,0,0,0,0,0,0,0,0
0,0,0,0,0,0,0,0,0
0,0,0,0,0,0,0,0,0
0,0,0,0,0,0,0,0,0
0,0,0,0,0,0,0,0,0
0,0,0,0,0,0,0,0,0
0,0,0,0,0,0,0,0,0
0,0,0,0,0,0,0,0,0
0,0,0,0,0,0,0,0,0
0,0,0,0,0,0,0,0,0
0,0,0,0,0,0,0,0,0
0,0,0,0,0,0,0,0,0
0,0,0,0,0,0,0,0,0
0,0,0,0,0,0,0,0,0
0,0,0,0,0,0,0,0,0
0,0,0,0,0,0,0,0,0
0,0,0,0,0,0,0,0,0
0,0,0,0,0,0,0,0,0
0,0,0,0,0,0,0,0,0
0,0,0,0,0,0,0,0,0
0,0,0,0,0,0,0,0,0
0,0,0,0,0,0,0,0,0
0,0,0,0,0,0,0,0,0
0,0,0,0,0,0,0,0,0
0,0,0,0,0,0,0,0,0
0,0,0,0,0,0,0,0,0
0,0,0,0,0,0,0,0,0
0,0,0,0,0,0,0,0,0
0,0,0,0,0,0,0,0,0
0,0,0,0,0,0,0,0,0
0,0,0,0,0,0,0,0,0
0,0,0,0,0,0,0,0,0
0,0,0,0,0,0,0,0,0
0,0,0,0,0,0,0,0,0
0,0,0,0,0,0,0,0,0
0,0,0,0,0,0,0,0,0
0,0,0,0,0,0,0,0,0
0,0,0,0,0,0,0,0,0
0,0,0,0,0,0,0,0,0
0,0,0,0,0,0,0,0,0
0,0,0,0,0,0,0,0,0
0,0,0,0,0,0,0,0,0
0,0,0,0,0,0,0,0,0
0,0,0,0,0,0,0,0,0
0,0,0,0,0,0,0,0,0
0,0,0,0,0,0,0,0,0
0,0,0,0,0,0,0,0,0
0,0,0,0,0,0,0,0,0
0,0,0,0,0,0,0,0,0
0,0,0,0,0,0,0,0,0
0,0,0,0,0,0,0,0,0
0,0,0,0,0,0,0,0,0
0,0,0,0,0,0,0,0,0
0,0,0,0,0,0,0,0,0
0,0,0,0,0,0,0,0,0
0,0,0,0,0,0,0,0,0
0,0,0,0,0,0,0,0,0
0,0,0,0,0,0,0,0,0
0,0,0,0,0,0,0,0,0
0,0,0,0,0,0,0,0,0
0,0,0,0,0,0,0,0,0
0,0,0,0,0,0,0,0,0
0,0,0,0,0,0,0,0,0
0,0,0,0,0,0,0,0,0
0,0,0,0,0,0,0,0,0
0,0,0,0,0,0,0,0,0
0,0,0,0,0,0,0,0,0
0,0,0,0,0,0,0,0,0
0,0,0,0,0,0,0,0,0
169484,767,4,2,1,1,7,0,0
0,0,0,0,0,0,0,0,0
0,0,0,0,0,0,0,0,0
0,0,0,0,0,0,0,0,0
0,0,0,0,0,0,0,0,0
169025,685,4,2,1,1,7,0,0
169474,741,4,2,1,1,7,0,0
0,0,0,0,0,0,0,0,0
170435,698,4,4,3,1,8,0,0
170013,819,4,2,1,1,7,0,0
169825,794,4,2,1,1,7,0,0
169596,760,4,2,1,1,7,0,0
0,0,0,0,0,0,0,0,0
168449,598,4,2,1,1,7,0,0
168762,666,4,2,1,1,7,0,0
0,0,0,0,0,0,0,0,0
0,0,0,0,0,0,0,0,0
169012,676,4,2,1,1,7,0,0
169219,707,4,2,1,1,7,0,0
0,0,0,0,0,0,0,0,0
0,0,0,0,0,0,0,0,0
169915,821,4,2,1,1,7,0,0
169555,722,4,2,1,1,7,0,0
169124,687,4,2,1,1,7,0,0
170182,843,4,2,1,1,7,0,0
169905,798,4,2,1,1,7,0,0
170011,804,4,2,1,1,7,0,0
173552,850,4,5,2,3,7,0,0
169988,801,4,2,1,1,7,0,0
164241,469,4,4,1,3,7,0,0
169920,789,4,2,1,1,7,0,0
0,0,0,0,0,0,0,0,0
165631,476,4,4,1,3,7,0,0
0,0,0,0,0,0,0,0,0
171099,954,4,2,1,1,7,0,0
171682,837,4,4,3,1,8,0,0
170234,764,4,2,1,1,7,0,0
165785,480,4,4,3,1,8,0,0
0,0,0,0,0,0,0,0,0
169924,835,4,2,1,1,7,0,0
0,0,0,0,0,0,0,0,0
170292,707,4,2,1,1,7,0,0
172364,808,5,2,1,1,7,0,0
165394,479,4,4,3,1,8,0,0
169296,746,4,2,1,1,7,0,0
172280,519,4,2,1,1,7,0,0
0,0,0,0,0,0,0,0,0
0,0,0,0,0,0,0,0,0
169333,691,4,2,1,1,7,0,0
170003,818,4,2,1,1,7,0,0
0,0,0,0,0,0,0,0,0
0,0,0,0,0,0,0,0,0
0,0,0,0,0,0,0,0,0
0,0,0,0,0,0,0,0,0
0,0,0,0,0,0,0,0,0
0,0,0,0,0,0,0,0,0
0,0,0,0,0,0,0,0,0
0,0,0,0,0,0,0,0,0
0,0,0,0,0,0,0,0,0
0,0,0,0,0,0,0,0,0
0,0,0,0,0,0,0,0,0
170036,504,4,7,4,3,8,1,0
0,0,0,0,0,0,0,0,0
0,0,0,0,0,0,0,0,0
0,0,0,0,0,0,0,0,0
0,0,0,0,0,0,0,0,0
0,0,0,0,0,0,0,0,0
0,0,0,0,0,0,0,0,0
0,0,0,0,0,0,0,0,0
0,0,0,0,0,0,0,0,0
0,0,0,0,0,0,0,0,0
0,0,0,0,0,0,0,0,0
0,0,0,0,0,0,0,0,0
0,0,0,0,0,0,0,0,0
0,0,0,0,0,0,0,0,0
0,0,0,0,0,0,0,0,0
0,0,0,0,0,0,0,0,0
0,0,0,0,0,0,0,0,0
0,0,0,0,0,0,0,0,0
0,0,0,0,0,0,0,0,0
0,0,0,0,0,0,0,0,0
0,0,0,0,0,0,0,0,0
0,0,0,0,0,0,0,0,0
0,0,0,0,0,0,0,0,0
0,0,0,0,0,0,0,0,0
0,0,0,0,0,0,0,0,0
0,0,0,0,0,0,0,0,0
163417,482,4,4,3,1,8,0,0
0,0,0,0,0,0,0,0,0
0,0,0,0,0,0,0,0,0
0,0,0,0,0,0,0,0,0
0,0,0,0,0,0,0,0,0
0,0,0,0,0,0,0,0,0
0,0,0,0,0,0,0,0,0
0,0,0,0,0,0,0,0,0
0,0,0,0,0,0,0,0,0
0,0,0,0,0,0,0,0,0
0,0,0,0,0,0,0,0,0
165349,470,4,2,1,1,7,0,0
0,0,0,0,0,0,0,0,0
0,0,0,0,0,0,0,0,0
0,0,0,0,0,0,0,0,0
0,0,0,0,0,0,0,0,0
0,0,0,0,0,0,0,0,0
0,0,0,0,0,0,0,0,0
0,0,0,0,0,0,0,0,0
0,0,0,0,0,0,0,0,0
0,0,0,0,0,0,0,0,0
0,0,0,0,0,0,0,0,0
0,0,0,0,0,0,0,0,0
0,0,0,0,0,0,0,0,0
0,0,0,0,0,0,0,0,0
0,0,0,0,0,0,0,0,0
0,0,0,0,0,0,0,0,0
166296,466,4,2,1,1,7,0,0
0,0,0,0,0,0,0,0,0
0,0,0,0,0,0,0,0,0
0,0,0,0,0,0,0,0,0
0,0,0,0,0,0,0,0,0
0,0,0,0,0,0,0,0,0
0,0,0,0,0,0,0,0,0
0,0,0,0,0,0,0,0,0
0,0,0,0,0,0,0,0,0
0,0,0,0,0,0,0,0,0
164410,466,4,2,1,1,7,0,0
0,0,0,0,0,0,0,0,0
0,0,0,0,0,0,0,0,0
0,0,0,0,0,0,0,0,0
0,0,0,0,0,0,0,0,0
0,0,0,0,0,0,0,0,0
0,0,0,0,0,0,0,0,0
0,0,0,0,0,0,0,0,0
0,0,0,0,0,0,0,0,0
0,0,0,0,0,0,0,0,0
0,0,0,0,0,0,0,0,0
0,0,0,0,0,0,0,0,0
0,0,0,0,0,0,0,0,0
0,0,0,0,0,0,0,0,0
165392,478,4,4,3,1,8,0,0
0,0,0,0,0,0,0,0,0
0,0,0,0,0,0,0,0,0
164048,471,4,2,1,1,7,0,0
0,0,0,0,0,0,0,0,0
163819,472,4,2,1,1,7,0,0
167209,501,4,2,1,1,8,0,0
165974,480,4,4,3,1,8,0,0
0,0,0,0,0,0,0,0,0
0,0,0,0,0,0,0,0,0
0,0,0,0,0,0,0,0,0
165208,470,4,2,1,1,7,0,0
0,0,0,0,0,0,0,0,0
163078,466,4,2,1,1,7,0,0
163837,472,4,2,1,1,7,0,0
0,0,0,0,0,0,0,0,0
164697,467,4,2,1,1,7,0,0
166827,485,4,4,1,3,7,1,0
0,0,0,0,0,0,0,0,0
163702,471,4,2,1,1,7,0,0
164361,472,4,2,1,1,7,0,0
166129,477,4,4,3,1,8,0,0
165828,477,4,4,3,1,8,0,0
0,0,0,0,0,0,0,0,0
164493,471,4,2,1,1,7,0,0
0,0,0,0,0,0,0,0,0
163973,466,4,2,1,1,7,0,0
0,0,0,0,0,0,0,0,0
163961,472,4,2,1,1,7,0,0
168394,500,4,5,4,1,8,1,0
0,0,0,0,0,0,0,0,0
0,0,0,0,0,0,0,0,0
169240,499,4,5,4,1,8,1,0
167630,496,4,6,3,3,8,1,0
0,0,0,0,0,0,0,0,0
169186,474,4,2,1,1,7,0,0
165889,548,4,2,1,1,7,0,0
0,0,0,0,0,0,0,0,0
164748,470,4,2,1,1,7,0,0
166649,467,4,2,1,1,7,0,0
165335,473,4,4,3,1,8,0,0
163901,466,4,2,1,1,7,0,0
0,0,0,0,0,0,0,0,0
165151,470,4,2,1,1,7,0,0
164516,473,4,4,3,1,8,0,0
0,0,0,0,0,0,0,0,0
0,0,0,0,0,0,0,0,0
167214,488,4,4,3,1,8,1,0
0,0,0,0,0,0,0,0,0
168243,492,4,3,2,1,7,1,0
167481,477,4,4,3,1,8,0,0
0,0,0,0,0,0,0,0,0
165217,477,4,4,3,1,8,0,0
0,0,0,0,0,0,0,0,0
164980,477,4,4,3,1,8,0,0
170275,705,4,4,3,1,8,0,0
165828,477,4,4,3,1,8,0,0
164969,475,4,4,3,1,8,0,0
170193,739,4,4,3,1,8,0,0
164865,470,4,2,1,1,7,0,0
72658,48,4,0,0,0,1,0,0
0,0,0,0,0,0,0,0,0
0,0,0,0,0,0,0,0,0
168737,476,4,6,3,3,8,0,0
167195,478,4,4,3,1,8,0,0
0,0,0,0,0,0,0,0,0
169195,480,4,4,3,1,8,0,0
0,0,0,0,0,0,0,0,0
164835,475,4,4,3,1,8,0,0
0,0,0,0,0,0,0,0,0
164825,475,4,4,3,1,8,0,0
163664,470,4,2,1,1,7,0,0
0,0,0,0,0,0,0,0,0
0,0,0,0,0,0,0,0,0
168890,479,4,4,3,1,8,0,0
165280,477,4,4,3,1,8,0,0
0,0,0,0,0,0,0,0,0
0,0,0,0,0,0,0,0,0
0,0,0,0,0,0,0,0,0
0,0,0,0,0,0,0,0,0
0,0,0,0,0,0,0,0,0
0,0,0,0,0,0,0,0,0
0,0,0,0,0,0,0,0,0
0,0,0,0,0,0,0,0,0
0,0,0,0,0,0,0,0,0
0,0,0,0,0,0,0,0,0
0,0,0,0,0,0,0,0,0
0,0,0,0,0,0,0,0,0
0,0,0,0,0,0,0,0,0
0,0,0,0,0,0,0,0,0
0,0,0,0,0,0,0,0,0
167955,493,4,3,2,1,7,1,0
165174,478,4,4,3,1,8,0,0
164936,480,4,2,1,1,7,0,0
166694,482,4,6,3,3,8,0,0
164941,473,4,2,1,1,7,0,0
164335,472,4,2,1,1,7,0,0
171445,870,4,2,1,1,7,0,0
164873,473,4,2,1,1,7,0,0
164885,478,4,4,3,1,8,0,0
166776,479,4,4,3,1,8,0,0
165616,476,4,2,1,1,7,0,0
170675,504,4,7,4,3,8,1,0
171085,688,4,4,3,1,8,0,0
169250,500,4,5,4,1,8,1,0
163384,473,4,2,1,1,7,0,0
170193,505,4,7,4,3,8,1,0
164840,480,4,4,3,1,8,0,0
172030,515,4,4,1,3,7,0,0
0,0,0,0,0,0,0,0,0
163776,471,4,2,1,1,7,0,0
0,0,0,0,0,0,0,0,0
163396,473,4,2,1,1,7,0,0
0,0,0,0,0,0,0,0,0
0,0,0,0,0,0,0,0,0
0,0,0,0,0,0,0,0,0
165845,478,4,4,3,1,8,0,0
169928,504,4,7,4,3,8,1,0
0,0,0,0,0,0,0,0,0
166441,487,4,4,3,1,8,0,0
163657,470,4,2,1,1,7,0,0
0,0,0,0,0,0,0,0,0
165626,479,4,4,3,1,8,0,0
170844,629,4,4,3,1,8,0,0
163419,473,4,2,1,1,7,0,0
165332,479,4,4,3,1,8,0,0
0,0,0,0,0,0,0,0,0
164367,472,4,2,1,1,7,0,0
0,0,0,0,0,0,0,0,0
0,0,0,0,0,0,0,0,0
167694,496,4,6,3,3,8,1,0
165104,472,4,2,1,1,7,0,0
168283,621,4,2,1,1,7,0,0
163625,473,4,2,1,1,7,0,0
0,0,0,0,0,0,0,0,0
164804,476,4,2,1,1,7,0,0
165482,478,4,4,3,1,8,0,0
172493,1277,4,2,1,1,7,1,0
164598,470,4,2,1,1,7,0,0
0,0,0,0,0,0,0,0,0
165756,485,4,4,3,1,8,0,0
0,0,0,0,0,0,0,0,0
165114,478,4,4,3,1,8,0,0
0,0,0,0,0,0,0,0,0
0,0,0,0,0,0,0,0,0
163426,473,4,2,1,1,7,0,0
164915,474,4,2,1,1,7,0,0
168417,498,4,6,3,3,8,1,0
164932,475,4,2,1,1,7,0,0
169719,504,4,7,4,3,8,1,0
165208,474,4,4,1,3,7,0,0
166493,728,4,2,1,1,7,1,0
169848,504,4,7,4,3,8,1,0
169930,506,4,7,4,3,8,1,0
165044,473,4,2,1,1,7,0,0
165618,472,4,2,1,1,7,0,0
0,0,0,0,0,0,0,0,0
0,0,0,0,0,0,0,0,0
0,0,0,0,0,0,0,0,0
0,0,0,0,0,0,0,0,0
0,0,0,0,0,0,0,0,0
164501,475,4,4,1,3,7,0,0
165462,478,4,4,3,1,8,0,0
0,0,0,0,0,0,0,0,0
163030,466,4,2,1,1,7,0,0
171697,781,4,4,3,1,8,0,0
0,0,0,0,0,0,0,0,0
163802,472,4,2,1,1,7,0,0
0,0,0,0,0,0,0,0,0
0,0,0,0,0,0,0,0,0
0,0,0,0,0,0,0,0,0
0,0,0,0,0,0,0,0,0
171183,509,4,2,0,2,7,0,0
0,0,0,0,0,0,0,0,0
0,0,0,0,0,0,0,0,0
0,0,0,0,0,0,0,0,0
0,0,0,0,0,0,0,0,0
166655,478,4,4,3,1,8,0,0
0,0,0,0,0,0,0,0,0
0,0,0,0,0,0,0,0,0
0,0,0,0,0,0,0,0,0
0,0,0,0,0,0,0,0,0
0,0,0,0,0,0,0,0,0
166032,483,4,4,3,1,8,0,0
0,0,0,0,0,0,0,0,0
0,0,0,0,0,0,0,0,0
0,0,0,0,0,0,0,0,0
0,0,0,0,0,0,0,0,0
0,0,0,0,0,0,0,0,0
0,0,0,0,0,0,0,0,0
0,0,0,0,0,0,0,0,0
0,0,0,0,0,0,0,0,0
0,0,0,0,0,0,0,0,0
0,0,0,0,0,0,0,0,0
0,0,0,0,0,0,0,0,0
0,0,0,0,0,0,0,0,0
0,0,0,0,0,0,0,0,0
0,0,0,0,0,0,0,0,0
0,0,0,0,0,0,0,0,0
0,0,0,0,0,0,0,0,0
0,0,0,0,0,0,0,0,0
0,0,0,0,0,0,0,0,0
0,0,0,0,0,0,0,0,0
0,0,0,0,0,0,0,0,0
0,0,0,0,0,0,0,0,0
0,0,0,0,0,0,0,0,0
0,0,0,0,0,0,0,0,0
0,0,0,0,0,0,0,0,0
0,0,0,0,0,0,0,0,0
0,0,0,0,0,0,0,0,0
0,0,0,0,0,0,0,0,0
0,0,0,0,0,0,0,0,0
0,0,0,0,0,0,0,0,0
0,0,0,0,0,0,0,0,0
0,0,0,0,0,0,0,0,0
0,0,0,0,0,0,0,0,0
0,0,0,0,0,0,0,0,0
0,0,0,0,0,0,0,0,0
0,0,0,0,0,0,0,0,0
0,0,0,0,0,0,0,0,0
0,0,0,0,0,0,0,0,0
3459,33,2,2,0,2,0,0,0
0,0,0,0,0,0,0,0,0
0,0,0,0,0,0,0,0,0
0,0,0,0,0,0,0,0,0
0,0,0,0,0,0,0,0,0
0,0,0,0,0,0,0,0,0
0,0,0,0,0,0,0,0,0
0,0,0,0,0,0,0,0,0
169426,737,4,2,1,1,7,0,0
0,0,0,0,0,0,0,0,0
0,0,0,0,0,0,0,0,0
0,0,0,0,0,0,0,0,0
0,0,0,0,0,0,0,0,0
0,0,0,0,0,0,0,0,0
0,0,0,0,0,0,0,0,0
0,0,0,0,0,0,0,0,0
0,0,0,0,0,0,0,0,0
0,0,0,0,0,0,0,0,0
0,0,0,0,0,0,0,0,0
0,0,0,0,0,0,0,0,0
0,0,0,0,0,0,0,0,0
0,0,0,0,0,0,0,0,0
0,0,0,0,0,0,0,0,0
0,0,0,0,0,0,0,0,0
0,0,0,0,0,0,0,0,0
0,0,0,0,0,0,0,0,0
0,0,0,0,0,0,0,0,0
0,0,0,0,0,0,0,0,0
0,0,0,0,0,0,0,0,0
0,0,0,0,0,0,0,0,0
0,0,0,0,0,0,0,0,0
0,0,0,0,0,0,0,0,0
0,0,0,0,0,0,0,0,0
0,0,0,0,0,0,0,0,0
0,0,0,0,0,0,0,0,0
0,0,0,0,0,0,0,0,0
0,0,0,0,0,0,0,0,0
0,0,0,0,0,0,0,0,0
0,0,0,0,0,0,0,0,0
0,0,0,0,0,0,0,0,0
0,0,0,0,0,0,0,0,0
0,0,0,0,0,0,0,0,0
0,0,0,0,0,0,0,0,0
72547,47,4,0,0,0,1,0,0
0,0,0,0,0,0,0,0,0
0,0,0,0,0,0,0,0,0
0,0,0,0,0,0,0,0,0
0,0,0,0,0,0,0,0,0
0,0,0,0,0,0,0,0,0
0,0,0,0,0,0,0,0,0
0,0,0,0,0,0,0,0,0
0,0,0,0,0,0,0,0,0
0,0,0,0,0,0,0,0,0
0,0,0,0,0,0,0,0,0
0,0,0,0,0,0,0,0,0
0,0,0,0,0,0,0,0,0
0,0,0,0,0,0,0,0,0
0,0,0,0,0,0,0,0,0
0,0,0,0,0,0,0,0,0
0,0,0,0,0,0,0,0,0
0,0,0,0,0,0,0,0,0
0,0,0,0,0,0,0,0,0
0,0,0,0,0,0,0,0,0
0,0,0,0,0,0,0,0,0
0,0,0,0,0,0,0,0,0
0,0,0,0,0,0,0,0,0
0,0,0,0,0,0,0,0,0
0,0,0,0,0,0,0,0,0
0,0,0,0,0,0,0,0,0
0,0,0,0,0,0,0,0,0
165050,473,4,2,1,1,7,0,0
0,0,0,0,0,0,0,0,0
0,0,0,0,0,0,0,0,0
0,0,0,0,0,0,0,0,0
0,0,0,0,0,0,0,0,0
0,0,0,0,0,0,0,0,0
0,0,0,0,0,0,0,0,0
165143,478,4,4,3,1,8,0,0
0,0,0,0,0,0,0,0,0
169842,505,4,2,0,2,7,0,0
0,0,0,0,0,0,0,0,0
166056,478,4,4,3,1,8,0,0
0,0,0,0,0,0,0,0,0
0,0,0,0,0,0,0,0,0
0,0,0,0,0,0,0,0,0
0,0,0,0,0,0,0,0,0
165991,476,4,2,1,1,7,0,0
0,0,0,0,0,0,0,0,0
0,0,0,0,0,0,0,0,0
0,0,0,0,0,0,0,0,0
168568,499,4,5,4,1,8,1,0
0,0,0,0,0,0,0,0,0
0,0,0,0,0,0,0,0,0
0,0,0,0,0,0,0,0,0
0,0,0,0,0,0,0,0,0
0,0,0,0,0,0,0,0,0
164430,471,4,2,1,1,7,0,0
0,0,0,0,0,0,0,0,0
0,0,0,0,0,0,0,0,0
0,0,0,0,0,0,0,0,0
0,0,0,0,0,0,0,0,0
0,0,0,0,0,0,0,0,0
0,0,0,0,0,0,0,0,0
166738,485,4,4,3,1,8,0,0
0,0,0,0,0,0,0,0,0
170112,751,4,4,3,1,8,1,0
165143,479,4,2,1,1,7,0,0
0,0,0,0,0,0,0,0,0
0,0,0,0,0,0,0,0,0
0,0,0,0,0,0,0,0,0
0,0,0,0,0,0,0,0,0
0,0,0,0,0,0,0,0,0
0,0,0,0,0,0,0,0,0
0,0,0,0,0,0,0,0,0
0,0,0,0,0,0,0,0,0
0,0,0,0,0,0,0,0,0
0,0,0,0,0,0,0,0,0
0,0,0,0,0,0,0,0,0
166424,486,4,2,1,1,7,1,0
0,0,0,0,0,0,0,0,0
0,0,0,0,0,0,0,0,0
0,0,0,0,0,0,0,0,0
0,0,0,0,0,0,0,0,0
0,0,0,0,0,0,0,0,0
0,0,0,0,0,0,0,0,0
0,0,0,0,0,0,0,0,0
0,0,0,0,0,0,0,0,0
0,0,0,0,0,0,0,0,0
0,0,0,0,0,0,0,0,0
0,0,0,0,0,0,0,0,0
0,0,0,0,0,0,0,0,0
0,0,0,0,0,0,0,0,0
72658,48,4,0,0,0,1,0,0
0,0,0,0,0,0,0,0,0
0,0,0,0,0,0,0,0,0
165798,478,4,4,3,1,8,0,0
169292,712,4,2,1,1,7,0,0
171197,936,4,2,1,1,7,0,0
164422,470,4,2,1,1,7,0,0
170039,502,4,4,1,3,8,0,0
169349,718,4,2,1,1,7,0,0
0,0,0,0,0,0,0,0,0
0,0,0,0,0,0,0,0,0
169140,643,4,2,1,1,7,0,0
0,0,0,0,0,0,0,0,0
0,0,0,0,0,0,0,0,0
0,0,0,0,0,0,0,0,0
0,0,0,0,0,0,0,0,0
0,0,0,0,0,0,0,0,0
0,0,0,0,0,0,0,0,0
0,0,0,0,0,0,0,0,0
0,0,0,0,0,0,0,0,0
0,0,0,0,0,0,0,0,0
0,0,0,0,0,0,0,0,0
0,0,0,0,0,0,0,0,0
0,0,0,0,0,0,0,0,0
0,0,0,0,0,0,0,0,0
0,0,0,0,0,0,0,0,0
0,0,0,0,0,0,0,0,0
0,0,0,0,0,0,0,0,0
166056,484,4,4,1,3,7,0,0
0,0,0,0,0,0,0,0,0
169978,705,4,4,3,1,8,0,0
167103,478,4,4,3,1,8,0,0
0,0,0,0,0,0,0,0,0
0,0,0,0,0,0,0,0,0
0,0,0,0,0,0,0,0,0
0,0,0,0,0,0,0,0,0
0,0,0,0,0,0,0,0,0
166859,482,4,2,1,1,7,1,0
166553,486,4,4,3,1,8,1,0
169402,507,4,2,1,1,8,0,0
0,0,0,0,0,0,0,0,0
0,0,0,0,0,0,0,0,0
0,0,0,0,0,0,0,0,0
0,0,0,0,0,0,0,0,0
0,0,0,0,0,0,0,0,0
165210,475,4,4,3,1,8,0,0
0,0,0,0,0,0,0,0,0
0,0,0,0,0,0,0,0,0
0,0,0,0,0,0,0,0,0
0,0,0,0,0,0,0,0,0
0,0,0,0,0,0,0,0,0
165232,475,4,2,1,1,7,0,0
0,0,0,0,0,0,0,0,0
164273,475,4,4,1,3,7,0,0
0,0,0,0,0,0,0,0,0
0,0,0,0,0,0,0,0,0
164721,470,4,2,1,1,7,0,0
166500,484,4,3,2,1,8,0,0
165039,476,4,2,1,1,7,0,0
166834,499,4,2,1,1,8,0,0
0,0,0,0,0,0,0,0,0
165784,485,4,4,3,1,8,0,0
164988,472,4,2,1,1,7,0,0
165054,478,4,4,3,1,8,0,0
165225,479,4,4,3,1,8,0,0
0,0,0,0,0,0,0,0,0
0,0,0,0,0,0,0,0,0
165628,474,4,2,1,1,7,0,0
165507,479,4,4,3,1,8,0,0
164554,470,4,2,1,1,7,0,0
163540,473,4,2,1,1,7,0,0
0,0,0,0,0,0,0,0,0
164441,475,4,4,1,3,7,0,0
163959,473,4,2,1,1,7,0,0
166867,478,4,2,1,1,7,0,0
165466,482,4,6,3,3,8,0,0
166384,481,4,2,1,1,7,1,0
672724,555,0,4,4,0,2,1,1
0,0,0,0,0,0,0,0,0
165156,472,4,2,1,1,7,0,0
164015,473,4,4,3,1,8,0,0
165523,485,4,4,3,1,8,0,0
0,0,0,0,0,0,0,0,0
165097,479,4,2,1,1,7,0,0
164485,470,4,2,1,1,7,0,0
0,0,0,0,0,0,0,0,0
0,0,0,0,0,0,0,0,0
165919,485,4,5,4,1,8,0,0
167810,548,4,4,3,1,8,0,0
171142,678,4,4,3,1,8,0,0
0,0,0,0,0,0,0,0,0
0,0,0,0,0,0,0,0,0
0,0,0,0,0,0,0,0,0
0,0,0,0,0,0,0,0,0
0,0,0,0,0,0,0,0,0
0,0,0,0,0,0,0,0,0
0,0,0,0,0,0,0,0,0
0,0,0,0,0,0,0,0,0
0,0,0,0,0,0,0,0,0
0,0,0,0,0,0,0,0,0
0,0,0,0,0,0,0,0,0
0,0,0,0,0,0,0,0,0
0,0,0,0,0,0,0,0,0
0,0,0,0,0,0,0,0,0
0,0,0,0,0,0,0,0,0
0,0,0,0,0,0,0,0,0
0,0,0,0,0,0,0,0,0
0,0,0,0,0,0,0,0,0
0,0,0,0,0,0,0,0,0
0,0,0,0,0,0,0,0,0
0,0,0,0,0,0,0,0,0
0,0,0,0,0,0,0,0,0
0,0,0,0,0,0,0,0,0
0,0,0,0,0,0,0,0,0
0,0,0,0,0,0,0,0,0
0,0,0,0,0,0,0,0,0
0,0,0,0,0,0,0,0,0
0,0,0,0,0,0,0,0,0
0,0,0,0,0,0,0,0,0
0,0,0,0,0,0,0,0,0
0,0,0,0,0,0,0,0,0
0,0,0,0,0,0,0,0,0
0,0,0,0,0,0,0,0,0
0,0,0,0,0,0,0,0,0
0,0,0,0,0,0,0,0,0
0,0,0,0,0,0,0,0,0
0,0,0,0,0,0,0,0,0
0,0,0,0,0,0,0,0,0
0,0,0,0,0,0,0,0,0
0,0,0,0,0,0,0,0,0
0,0,0,0,0,0,0,0,0
0,0,0,0,0,0,0,0,0
165765,480,4,6,3,3,8,0,0
0,0,0,0,0,0,0,0,0
0,0,0,0,0,0,0,0,0
0,0,0,0,0,0,0,0,0
0,0,0,0,0,0,0,0,0
0,0,0,0,0,0,0,0,0
0,0,0,0,0,0,0,0,0
0,0,0,0,0,0,0,0,0
0,0,0,0,0,0,0,0,0
0,0,0,0,0,0,0,0,0
0,0,0,0,0,0,0,0,0
0,0,0,0,0,0,0,0,0
0,0,0,0,0,0,0,0,0
0,0,0,0,0,0,0,0,0
0,0,0,0,0,0,0,0,0
0,0,0,0,0,0,0,0,0
165658,477,4,4,3,1,8,0,0
0,0,0,0,0,0,0,0,0
0,0,0,0,0,0,0,0,0
0,0,0,0,0,0,0,0,0
0,0,0,0,0,0,0,0,0
0,0,0,0,0,0,0,0,0
0,0,0,0,0,0,0,0,0
0,0,0,0,0,0,0,0,0
0,0,0,0,0,0,0,0,0
0,0,0,0,0,0,0,0,0
0,0,0,0,0,0,0,0,0
0,0,0,0,0,0,0,0,0
0,0,0,0,0,0,0,0,0
0,0,0,0,0,0,0,0,0
0,0,0,0,0,0,0,0,0
0,0,0,0,0,0,0,0,0
0,0,0,0,0,0,0,0,0
0,0,0,0,0,0,0,0,0
0,0,0,0,0,0,0,0,0
0,0,0,0,0,0,0,0,0
0,0,0,0,0,0,0,0,0
0,0,0,0,0,0,0,0,0
0,0,0,0,0,0,0,0,0
0,0,0,0,0,0,0,0,0
0,0,0,0,0,0,0,0,0
165621,477,4,4,3,1,8,0,0
165700,477,4,4,3,1,8,0,0
0,0,0,0,0,0,0,0,0
0,0,0,0,0,0,0,0,0
0,0,0,0,0,0,0,0,0
0,0,0,0,0,0,0,0,0
0,0,0,0,0,0,0,0,0
0,0,0,0,0,0,0,0,0
0,0,0,0,0,0,0,0,0
0,0,0,0,0,0,0,0,0
0,0,0,0,0,0,0,0,0
0,0,0,0,0,0,0,0,0
0,0,0,0,0,0,0,0,0
0,0,0,0,0,0,0,0,0
0,0,0,0,0,0,0,0,0
165147,482,4,2,1,1,7,0,0
0,0,0,0,0,0,0,0,0
0,0,0,0,0,0,0,0,0
0,0,0,0,0,0,0,0,0
0,0,0,0,0,0,0,0,0
0,0,0,0,0,0,0,0,0
0,0,0,0,0,0,0,0,0
0,0,0,0,0,0,0,0,0
0,0,0,0,0,0,0,0,0
0,0,0,0,0,0,0,0,0
0,0,0,0,0,0,0,0,0
0,0,0,0,0,0,0,0,0
0,0,0,0,0,0,0,0,0
0,0,0,0,0,0,0,0,0
0,0,0,0,0,0,0,0,0
0,0,0,0,0,0,0,0,0
0,0,0,0,0,0,0,0,0
0,0,0,0,0,0,0,0,0
0,0,0,0,0,0,0,0,0
0,0,0,0,0,0,0,0,0
0,0,0,0,0,0,0,0,0
0,0,0,0,0,0,0,0,0
170587,504,4,2,0,2,7,0,0
0,0,0,0,0,0,0,0,0
165567,484,4,2,1,1,7,0,0
0,0,0,0,0,0,0,0,0
0,0,0,0,0,0,0,0,0
0,0,0,0,0,0,0,0,0
0,0,0,0,0,0,0,0,0
0,0,0,0,0,0,0,0,0
0,0,0,0,0,0,0,0,0
0,0,0,0,0,0,0,0,0
165121,482,4,2,1,1,7,0,0
0,0,0,0,0,0,0,0,0
0,0,0,0,0,0,0,0,0
0,0,0,0,0,0,0,0,0
169832,501,4,5,4,1,8,1,0
0,0,0,0,0,0,0,0,0
0,0,0,0,0,0,0,0,0
171105,695,4,4,3,1,8,0,0
0,0,0,0,0,0,0,0,0
0,0,0,0,0,0,0,0,0
0,0,0,0,0,0,0,0,0
165357,482,4,2,1,1,7,0,0
0,0,0,0,0,0,0,0,0
164413,471,4,2,1,1,7,0,0
0,0,0,0,0,0,0,0,0
165454,482,4,2,1,1,7,0,0
0,0,0,0,0,0,0,0,0
0,0,0,0,0,0,0,0,0
0,0,0,0,0,0,0,0,0
0,0,0,0,0,0,0,0,0
165211,482,4,2,1,1,7,0,0
166262,477,4,4,3,1,8,0,0
165285,482,4,2,1,1,7,0,0
0,0,0,0,0,0,0,0,0
0,0,0,0,0,0,0,0,0
165257,482,4,2,1,1,7,0,0
165405,482,4,2,1,1,7,0,0
165156,482,4,2,1,1,7,0,0
165259,482,4,2,1,1,7,0,0
169473,505,5,2,1,1,10,0,0
165376,482,4,2,1,1,7,0,0
165261,482,4,2,1,1,7,0,0
0,0,0,0,0,0,0,0,0
165339,482,4,2,1,1,7,0,0
0,0,0,0,0,0,0,0,0
165640,482,4,2,1,1,7,0,0
165114,482,4,2,1,1,7,0,0
165700,477,4,4,3,1,8,0,0
165812,482,4,2,1,1,7,0,0
165869,482,4,2,1,1,7,0,0
165152,482,4,2,1,1,7,0,0
166084,477,4,4,3,1,8,0,0
165658,477,4,4,3,1,8,0,0
166078,477,4,4,3,1,8,0,0
165684,477,4,2,1,1,7,0,0
165663,477,4,4,3,1,8,0,0
165700,477,4,4,3,1,8,0,0
165700,477,4,4,3,1,8,0,0
0,0,0,0,0,0,0,0,0
0,0,0,0,0,0,0,0,0
0,0,0,0,0,0,0,0,0
0,0,0,0,0,0,0,0,0
215370,1013,8,80,72,8,14,1,0
0,0,0,0,0,0,0,0,0
0,0,0,0,0,0,0,0,0
0,0,0,0,0,0,0,0,0
0,0,0,0,0,0,0,0,0
0,0,0,0,0,0,0,0,0
0,0,0,0,0,0,0,0,0
0,0,0,0,0,0,0,0,0
0,0,0,0,0,0,0,0,0
0,0,0,0,0,0,0,0,0
0,0,0,0,0,0,0,0,0
0,0,0,0,0,0,0,0,0
0,0,0,0,0,0,0,0,0
0,0,0,0,0,0,0,0,0
0,0,0,0,0,0,0,0,0
0,0,0,0,0,0,0,0,0
0,0,0,0,0,0,0,0,0
45140,122,4,6,3,3,0,1,0
0,0,0,0,0,0,0,0,0
0,0,0,0,0,0,0,0,0
0,0,0,0,0,0,0,0,0
0,0,0,0,0,0,0,0,0
0,0,0,0,0,0,0,0,0
0,0,0,0,0,0,0,0,0
0,0,0,0,0,0,0,0,0
0,0,0,0,0,0,0,0,0
0,0,0,0,0,0,0,0,0
0,0,0,0,0,0,0,0,0
0,0,0,0,0,0,0,0,0
0,0,0,0,0,0,0,0,0
0,0,0,0,0,0,0,0,0
148162,541,9,45,35,10,1,1,0
388095,2026,7,125,124,1,93,1,0
0,0,0,0,0,0,0,0,0
0,0,0,0,0,0,0,0,0
0,0,0,0,0,0,0,0,0
0,0,0,0,0,0,0,0,0
0,0,0,0,0,0,0,0,0
102298,152,4,4,4,0,2,1,0
0,0,0,0,0,0,0,0,0
0,0,0,0,0,0,0,0,0
0,0,0,0,0,0,0,0,0
35059,123,3,15,0,15,0,0,0
23168,194,4,15,9,6,0,1,0
0,0,0,0,0,0,0,0,0
0,0,0,0,0,0,0,0,0
72640,48,4,0,0,0,1,0,0
0,0,0,0,0,0,0,0,0
0,0,0,0,0,0,0,0,0
0,0,0,0,0,0,0,0,0
0,0,0,0,0,0,0,0,0
0,0,0,0,0,0,0,0,0
0,0,0,0,0,0,0,0,0
0,0,0,0,0,0,0,0,0
0,0,0,0,0,0,0,0,0
0,0,0,0,0,0,0,0,0
0,0,0,0,0,0,0,0,0
0,0,0,0,0,0,0,0,0
0,0,0,0,0,0,0,0,0
0,0,0,0,0,0,0,0,0
0,0,0,0,0,0,0,0,0
0,0,0,0,0,0,0,0,0
16126,89,3,7,3,4,0,1,0
0,0,0,0,0,0,0,0,0
0,0,0,0,0,0,0,0,0
0,0,0,0,0,0,0,0,0
0,0,0,0,0,0,0,0,0
20771,158,0,1,0,1,0,1,0
20771,158,0,1,0,1,0,1,0
22376,147,1,1,0,1,0,1,0
22376,147,1,1,0,1,0,1,0
0,0,0,0,0,0,0,0,0
0,0,0,0,0,0,0,0,0
409327,521,6,14,14,0,0,1,0
409519,521,6,14,14,0,0,1,0
0,0,0,0,0,0,0,0,0
0,0,0,0,0,0,0,0,0
0,0,0,0,0,0,0,0,0
0,0,0,0,0,0,0,0,0
0,0,0,0,0,0,0,0,0
0,0,0,0,0,0,0,0,0
0,0,0,0,0,0,0,0,0
0,0,0,0,0,0,0,0,0
0,0,0,0,0,0,0,0,0
0,0,0,0,0,0,0,0,0
0,0,0,0,0,0,0,0,0
0,0,0,0,0,0,0,0,0
12334,84,2,7,6,1,2,1,0
12334,84,2,7,6,1,2,1,0
12334,84,2,7,6,1,2,1,0
12334,84,2,7,6,1,2,1,0
12334,84,2,7,6,1,2,1,0
12334,84,2,7,6,1,2,1,0
12334,84,2,7,6,1,2,1,0
12981,84,1,3,3,0,0,0,0
12981,84,1,3,3,0,0,0,0
12981,84,1,3,3,0,0,0,0
12981,84,1,3,3,0,0,0,0
0,0,0,0,0,0,0,0,0
0,0,0,0,0,0,0,0,0
0,0,0,0,0,0,0,0,0
1028661,1073,2,55,17,38,23,1,0
0,0,0,0,0,0,0,0,0
232812,61,4,3,3,0,2,1,0
0,0,0,0,0,0,0,0,0
0,0,0,0,0,0,0,0,0
0,0,0,0,0,0,0,0,0
232812,61,4,3,3,0,2,1,0
0,0,0,0,0,0,0,0,0
0,0,0,0,0,0,0,0,0
0,0,0,0,0,0,0,0,0
232812,61,4,3,3,0,2,1,0
0,0,0,0,0,0,0,0,0
0,0,0,0,0,0,0,0,0
0,0,0,0,0,0,0,0,0
139333,68,2,1,0,1,0,1,0
139333,68,2,1,0,1,0,1,0
139333,68,2,1,0,1,0,1,0
139333,68,2,1,0,1,0,1,0
139333,68,2,1,0,1,0,1,0
136546,42,4,1,1,0,2,0,0
136546,42,4,1,1,0,2,0,0
136546,42,4,1,1,0,2,0,0
136546,42,4,1,1,0,2,0,0
0,0,0,0,0,0,0,0,0
0,0,0,0,0,0,0,0,0
0,0,0,0,0,0,0,0,0
0,0,0,0,0,0,0,0,0
0,0,0,0,0,0,0,0,0
0,0,0,0,0,0,0,0,0
0,0,0,0,0,0,0,0,0
0,0,0,0,0,0,0,0,0
0,0,0,0,0,0,0,0,0
0,0,0,0,0,0,0,0,0
4033,25,1,0,0,0,2,0,0
0,0,0,0,0,0,0,0,0
0,0,0,0,0,0,0,0,0
0,0,0,0,0,0,0,0,0
0,0,0,0,0,0,0,0,0
26690,36,2,0,0,0,0,0,0
0,0,0,0,0,0,0,0,0
72652,48,4,0,0,0,1,0,0
0,0,0,0,0,0,0,0,0
0,0,0,0,0,0,0,0,0
0,0,0,0,0,0,0,0,0
0,0,0,0,0,0,0,0,0
0,0,0,0,0,0,0,0,0
0,0,0,0,0,0,0,0,0
0,0,0,0,0,0,0,0,0
0,0,0,0,0,0,0,0,0
0,0,0,0,0,0,0,0,0
821912,2053,4,126,113,13,51,1,0
0,0,0,0,0,0,0,0,0
0,0,0,0,0,0,0,0,0
0,0,0,0,0,0,0,0,0
0,0,0,0,0,0,0,0,0
0,0,0,0,0,0,0,0,0
0,0,0,0,0,0,0,0,0
0,0,0,0,0,0,0,0,0
0,0,0,0,0,0,0,0,0
0,0,0,0,0,0,0,0,0
8073,140,7,26,7,19,1,1,0
8073,140,7,26,7,19,1,1,0
8073,140,7,26,6,20,1,1,0
0,0,0,0,0,0,0,0,0
0,0,0,0,0,0,0,0,0
0,0,0,0,0,0,0,0,0
0,0,0,0,0,0,0,0,0
0,0,0,0,0,0,0,0,0
0,0,0,0,0,0,0,0,0
672796,555,0,4,4,0,2,1,1
0,0,0,0,0,0,0,0,0
0,0,0,0,0,0,0,0,0
0,0,0,0,0,0,0,0,0
28081,151,5,5,1,4,1,0,0
162249,218,4,26,18,8,2,1,0
0,0,0,0,0,0,0,0,0
0,0,0,0,0,0,0,0,0
0,0,0,0,0,0,0,0,0
0,0,0,0,0,0,0,0,0
72654,48,4,0,0,0,1,0,0
0,0,0,0,0,0,0,0,0
0,0,0,0,0,0,0,0,0
52838,207,3,8,5,3,4,1,0
0,0,0,0,0,0,0,0,0
0,0,0,0,0,0,0,0,0
0,0,0,0,0,0,0,0,0
0,0,0,0,0,0,0,0,0
0,0,0,0,0,0,0,0,0
0,0,0,0,0,0,0,0,0
12964,98,0,3,3,0,0,0,0
67150,317,8,29,24,5,19,1,0
142353,419,8,28,24,4,35,1,0
8073,140,7,26,6,20,1,1,0
0,0,0,0,0,0,0,0,0
0,0,0,0,0,0,0,0,0
0,0,0,0,0,0,0,0,0
9918,28,1,2,1,1,0,0,0
678992,555,0,4,0,4,2,1,1
197236,121,1,4,1,3,0,1,0
0,0,0,0,0,0,0,0,0
72652,48,4,0,0,0,1,0,0
0,0,0,0,0,0,0,0,0
0,0,0,0,0,0,0,0,0
0,0,0,0,0,0,0,0,0
0,0,0,0,0,0,0,0,0
72640,48,4,0,0,0,1,0,0
0,0,0,0,0,0,0,0,0
0,0,0,0,0,0,0,0,0
0,0,0,0,0,0,0,0,0
0,0,0,0,0,0,0,0,0
0,0,0,0,0,0,0,0,0
0,0,0,0,0,0,0,0,0
9926,28,1,2,2,0,0,0,0
0,0,0,0,0,0,0,0,0
0,0,0,0,0,0,0,0,0
0,0,0,0,0,0,0,0,0
0,0,0,0,0,0,0,0,0
8073,140,7,26,10,16,1,1,0
12942,96,0,3,3,0,0,0,0
181377,1131,2,312,300,12,2,0,0
79872,1099,1,156,156,0,11,1,0
0,0,0,0,0,0,0,0,0
0,0,0,0,0,0,0,0,0
47269,203,2,1,1,0,1,0,0
0,0,0,0,0,0,0,0,0
0,0,0,0,0,0,0,0,0
0,0,0,0,0,0,0,0,0
0,0,0,0,0,0,0,0,0
0,0,0,0,0,0,0,0,0
0,0,0,0,0,0,0,0,0
0,0,0,0,0,0,0,0,0
0,0,0,0,0,0,0,0,0
0,0,0,0,0,0,0,0,0
0,0,0,0,0,0,0,0,0
41850,107,5,0,0,0,3,1,0
0,0,0,0,0,0,0,0,0
0,0,0,0,0,0,0,0,0
0,0,0,0,0,0,0,0,0
0,0,0,0,0,0,0,0,0
0,0,0,0,0,0,0,0,0
0,0,0,0,0,0,0,0,0
72640,48,4,0,0,0,1,0,0
0,0,0,0,0,0,0,0,0
0,0,0,0,0,0,0,0,0
0,0,0,0,0,0,0,0,0
34015,148,5,19,12,7,1,0,0
0,0,0,0,0,0,0,0,0
0,0,0,0,0,0,0,0,0
8602,71,1,0,0,0,0,0,0
0,0,0,0,0,0,0,0,0
672446,555,0,4,4,0,2,1,1
0,0,0,0,0,0,0,0,0
0,0,0,0,0,0,0,0,0
27660,182,0,1,0,1,0,0,0
27660,182,0,1,0,1,0,0,0
0,0,0,0,0,0,0,0,0
0,0,0,0,0,0,0,0,0
0,0,0,0,0,0,0,0,0
0,0,0,0,0,0,0,0,0
0,0,0,0,0,0,0,0,0
72640,48,4,0,0,0,1,0,0
139310,402,8,26,24,2,35,1,0
17702,210,1,51,50,1,0,1,0
17702,210,1,51,50,1,0,1,0
17702,210,1,51,50,1,0,1,0
0,0,0,0,0,0,0,0,0
0,0,0,0,0,0,0,0,0
0,0,0,0,0,0,0,0,0
0,0,0,0,0,0,0,0,0
0,0,0,0,0,0,0,0,0
0,0,0,0,0,0,0,0,0
0,0,0,0,0,0,0,0,0
12392,72,4,0,0,0,0,1,0
0,0,0,0,0,0,0,0,0
0,0,0,0,0,0,0,0,0
27842,38,0,1,0,1,0,0,0
77754,101,1,4,2,2,0,0,0
297110,30,0,3,0,3,0,1,0
26690,36,2,0,0,0,0,0,0
0,0,0,0,0,0,0,0,0
0,0,0,0,0,0,0,0,0
0,0,0,0,0,0,0,0,0
0,0,0,0,0,0,0,0,0
0,0,0,0,0,0,0,0,0
0,0,0,0,0,0,0,0,0
0,0,0,0,0,0,0,0,0
0,0,0,0,0,0,0,0,0
15186,108,0,3,3,0,0,0,0
0,0,0,0,0,0,0,0,0
0,0,0,0,0,0,0,0,0
0,0,0,0,0,0,0,0,0
12960,96,0,3,3,0,0,0,0
0,0,0,0,0,0,0,0,0
131605,1031,5,149,149,0,2,0,0
164167,471,4,2,1,1,7,0,0
0,0,0,0,0,0,0,0,0
0,0,0,0,0,0,0,0,0
0,0,0,0,0,0,0,0,0
35226,409,6,37,7,30,3,1,0
0,0,0,0,0,0,0,0,0
7719,58,4,7,1,6,0,0,0
15595,113,0,1,0,1,0,0,0
0,0,0,0,0,0,0,0,0
72652,48,4,0,0,0,1,0,0
42402,82,5,0,0,0,0,0,0
9118,62,0,1,0,1,0,0,0
0,0,0,0,0,0,0,0,0
0,0,0,0,0,0,0,0,0
0,0,0,0,0,0,0,0,0
8073,140,7,26,6,20,1,1,0
8073,140,7,26,6,20,1,1,0
0,0,0,0,0,0,0,0,0
0,0,0,0,0,0,0,0,0
0,0,0,0,0,0,0,0,0
0,0,0,0,0,0,0,0,0
0,0,0,0,0,0,0,0,0
0,0,0,0,0,0,0,0,0
0,0,0,0,0,0,0,0,0
675162,555,0,4,0,4,2,1,1
0,0,0,0,0,0,0,0,0
0,0,0,0,0,0,0,0,0
8073,140,7,26,6,20,1,1,0
34138,415,5,26,26,0,3,1,0
12971,98,0,3,3,0,0,0,0
125995,1964,2,637,536,101,6,1,0
0,0,0,0,0,0,0,0,0
0,0,0,0,0,0,0,0,0
0,0,0,0,0,0,0,0,0
12665,86,0,1,1,0,0,0,0
14551,104,0,1,1,0,0,0,0
12665,86,0,1,1,0,0,0,0
0,0,0,0,0,0,0,0,0
0,0,0,0,0,0,0,0,0
0,0,0,0,0,0,0,0,0
0,0,0,0,0,0,0,0,0
285091,267,6,1,1,0,0,1,0
324501,284,6,2,1,1,0,1,0
0,0,0,0,0,0,0,0,0
0,0,0,0,0,0,0,0,0
0,0,0,0,0,0,0,0,0
0,0,0,0,0,0,0,0,0
503055,196,6,3,1,2,0,1,0
503055,196,6,3,1,2,0,1,0
0,0,0,0,0,0,0,0,0
0,0,0,0,0,0,0,0,0
0,0,0,0,0,0,0,0,0
0,0,0,0,0,0,0,0,0
0,0,0,0,0,0,0,0,0
0,0,0,0,0,0,0,0,0
36248,170,2,5,4,1,18,0,0
0,0,0,0,0,0,0,0,0
0,0,0,0,0,0,0,0,0
36248,170,2,5,4,1,18,0,0
0,0,0,0,0,0,0,0,0
0,0,0,0,0,0,0,0,0
137904,337,8,28,24,4,20,1,0
36248,170,2,5,4,1,18,0,0
36248,170,2,5,4,1,18,0,0
36248,170,2,5,4,1,18,0,0
36248,170,2,5,4,1,18,0,0
0,0,0,0,0,0,0,0,0
72736,48,4,0,0,0,1,0,0
0,0,0,0,0,0,0,0,0
72725,48,4,0,0,0,1,0,0
0,0,0,0,0,0,0,0,0
8073,140,7,26,6,20,1,1,0
8073,140,7,26,6,20,1,1,0
0,0,0,0,0,0,0,0,0
672229,555,0,4,4,0,2,1,1
0,0,0,0,0,0,0,0,0
66064,303,8,26,24,2,19,1,0
84586,444,1,36,17,19,0,1,0
0,0,0,0,0,0,0,0,0
12525,86,0,1,1,0,0,0,0
0,0,0,0,0,0,0,0,0
12929,97,0,3,3,0,0,0,0
8072,140,7,26,6,20,1,1,0
0,0,0,0,0,0,0,0,0
0,0,0,0,0,0,0,0,0
0,0,0,0,0,0,0,0,0
672013,555,0,4,4,0,2,1,1
25107,67,2,1,1,0,2,0,0
25107,67,2,1,1,0,2,0,0
25107,67,2,1,1,0,2,0,0
25107,67,2,1,1,0,2,0,0
0,0,0,0,0,0,0,0,0
25107,67,2,1,1,0,2,0,0
0,0,0,0,0,0,0,0,0
0,0,0,0,0,0,0,0,0
0,0,0,0,0,0,0,0,0
81527,1057,1,76,20,56,2,1,0
0,0,0,0,0,0,0,0,0
0,0,0,0,0,0,0,0,0
0,0,0,0,0,0,0,0,0
10268,83,1,0,0,0,0,0,0
0,0,0,0,0,0,0,0,0
0,0,0,0,0,0,0,0,0
0,0,0,0,0,0,0,0,0
0,0,0,0,0,0,0,0,0
0,0,0,0,0,0,0,0,0
0,0,0,0,0,0,0,0,0
0,0,0,0,0,0,0,0,0
303890,62,4,0,0,0,3,1,0
303886,62,4,0,0,0,3,1,0
34482,50,2,0,0,0,2,0,0
303879,62,4,0,0,0,3,1,0
303879,62,4,0,0,0,3,1,0
0,0,0,0,0,0,0,0,0
303879,62,4,0,0,0,3,1,0
0,0,0,0,0,0,0,0,0
0,0,0,0,0,0,0,0,0
0,0,0,0,0,0,0,0,0
81082,45,1,0,0,0,0,0,0
81082,45,1,0,0,0,0,0,0
0,0,0,0,0,0,0,0,0
0,0,0,0,0,0,0,0,0
0,0,0,0,0,0,0,0,0
0,0,0,0,0,0,0,0,0
0,0,0,0,0,0,0,0,0
5162,36,1,0,0,0,0,0,0
0,0,0,0,0,0,0,0,0
5162,36,1,0,0,0,0,0,0
0,0,0,0,0,0,0,0,0
0,0,0,0,0,0,0,0,0
0,0,0,0,0,0,0,0,0
270459,61,4,2,2,0,2,1,0
0,0,0,0,0,0,0,0,0
75125,200,3,22,4,18,0,0,0
0,0,0,0,0,0,0,0,0
36426,48,1,0,0,0,0,0,0
0,0,0,0,0,0,0,0,0
0,0,0,0,0,0,0,0,0
0,0,0,0,0,0,0,0,0
716908,599,1,29,0,29,3,1,0
0,0,0,0,0,0,0,0,0
5243,47,4,0,0,0,2,1,0
0,0,0,0,0,0,0,0,0
0,0,0,0,0,0,0,0,0
0,0,0,0,0,0,0,0,0
190713,73,4,2,1,1,2,1,0
0,0,0,0,0,0,0,0,0
15035,112,0,1,0,1,0,0,0
0,0,0,0,0,0,0,0,0
0,0,0,0,0,0,0,0,0
297073,194,6,1,1,0,0,1,0
0,0,0,0,0,0,0,0,0
0,0,0,0,0,0,0,0,0
0,0,0,0,0,0,0,0,0
0,0,0,0,0,0,0,0,0
0,0,0,0,0,0,0,0,0
0,0,0,0,0,0,0,0,0
13672,103,0,3,3,0,0,0,0
0,0,0,0,0,0,0,0,0
0,0,0,0,0,0,0,0,0
8073,140,7,26,6,20,1,1,0
0,0,0,0,0,0,0,0,0
9464,148,1,21,2,19,0,1,0
9464,148,1,21,2,19,0,1,0
0,0,0,0,0,0,0,0,0
0,0,0,0,0,0,0,0,0
0,0,0,0,0,0,0,0,0
0,0,0,0,0,0,0,0,0
0,0,0,0,0,0,0,0,0
0,0,0,0,0,0,0,0,0
0,0,0,0,0,0,0,0,0
0,0,0,0,0,0,0,0,0
8073,140,7,26,8,18,1,1,0
8073,140,7,26,6,20,1,1,0
8073,140,7,26,6,20,1,1,0
0,0,0,0,0,0,0,0,0
0,0,0,0,0,0,0,0,0
0,0,0,0,0,0,0,0,0
0,0,0,0,0,0,0,0,0
0,0,0,0,0,0,0,0,0
9189,75,1,0,0,0,0,0,0
165510,478,4,4,3,1,8,0,0
0,0,0,0,0,0,0,0,0
232,6,0,0,0,0,0,0,0
232,6,0,0,0,0,0,0,0
0,0,0,0,0,0,0,0,0
0,0,0,0,0,0,0,0,0
73498,48,4,0,0,0,1,0,0
0,0,0,0,0,0,0,0,0
0,0,0,0,0,0,0,0,0
1834,40,1,0,0,0,0,0,0
0,0,0,0,0,0,0,0,0
0,0,0,0,0,0,0,0,0
0,0,0,0,0,0,0,0,0
120221,899,6,223,29,194,6,1,0
0,0,0,0,0,0,0,0,0
9065,79,1,0,0,0,0,0,0
0,0,0,0,0,0,0,0,0
12575,86,0,1,1,0,0,0,0
0,0,0,0,0,0,0,0,0
0,0,0,0,0,0,0,0,0
0,0,0,0,0,0,0,0,0
0,0,0,0,0,0,0,0,0
0,0,0,0,0,0,0,0,0
0,0,0,0,0,0,0,0,0
37772,137,1,6,4,2,0,0,0
0,0,0,0,0,0,0,0,0
0,0,0,0,0,0,0,0,0
0,0,0,0,0,0,0,0,0
0,0,0,0,0,0,0,0,0
0,0,0,0,0,0,0,0,0
0,0,0,0,0,0,0,0,0
12535,86,0,1,1,0,0,0,0
9069,79,1,0,0,0,0,0,0
9069,79,1,0,0,0,0,0,0
0,0,0,0,0,0,0,0,0
0,0,0,0,0,0,0,0,0
0,0,0,0,0,0,0,0,0
0,0,0,0,0,0,0,0,0
0,0,0,0,0,0,0,0,0
0,0,0,0,0,0,0,0,0
0,0,0,0,0,0,0,0,0
0,0,0,0,0,0,0,0,0
0,0,0,0,0,0,0,0,0
0,0,0,0,0,0,0,0,0
0,0,0,0,0,0,0,0,0
0,0,0,0,0,0,0,0,0
0,0,0,0,0,0,0,0,0
0,0,0,0,0,0,0,0,0
0,0,0,0,0,0,0,0,0
0,0,0,0,0,0,0,0,0
0,0,0,0,0,0,0,0,0
0,0,0,0,0,0,0,0,0
287901,196,6,1,1,0,0,1,0
0,0,0,0,0,0,0,0,0
0,0,0,0,0,0,0,0,0
0,0,0,0,0,0,0,0,0
0,0,0,0,0,0,0,0,0
0,0,0,0,0,0,0,0,0
0,0,0,0,0,0,0,0,0
0,0,0,0,0,0,0,0,0
0,0,0,0,0,0,0,0,0
0,0,0,0,0,0,0,0,0
0,0,0,0,0,0,0,0,0
0,0,0,0,0,0,0,0,0
0,0,0,0,0,0,0,0,0
14751,106,0,1,0,1,0,0,0
10270,83,1,0,0,0,0,0,0
0,0,0,0,0,0,0,0,0
0,0,0,0,0,0,0,0,0
0,0,0,0,0,0,0,0,0
36248,170,2,5,4,1,18,0,0
0,0,0,0,0,0,0,0,0
0,0,0,0,0,0,0,0,0
350612,380,4,44,3,41,13,1,0
0,0,0,0,0,0,0,0,0
0,0,0,0,0,0,0,0,0
0,0,0,0,0,0,0,0,0
0,0,0,0,0,0,0,0,0
0,0,0,0,0,0,0,0,0
13701,104,0,3,3,0,0,0,0
0,0,0,0,0,0,0,0,0
0,0,0,0,0,0,0,0,0
0,0,0,0,0,0,0,0,0
0,0,0,0,0,0,0,0,0
0,0,0,0,0,0,0,0,0
0,0,0,0,0,0,0,0,0
0,0,0,0,0,0,0,0,0
0,0,0,0,0,0,0,0,0
0,0,0,0,0,0,0,0,0
0,0,0,0,0,0,0,0,0
0,0,0,0,0,0,0,0,0
0,0,0,0,0,0,0,0,0
0,0,0,0,0,0,0,0,0
0,0,0,0,0,0,0,0,0
0,0,0,0,0,0,0,0,0
0,0,0,0,0,0,0,0,0
0,0,0,0,0,0,0,0,0
31683,69,6,1,0,1,0,1,0
31683,69,6,1,0,1,0,1,0
31683,69,6,1,0,1,0,1,0
31683,69,6,1,0,1,0,1,0
0,0,0,0,0,0,0,0,0
0,0,0,0,0,0,0,0,0
0,0,0,0,0,0,0,0,0
0,0,0,0,0,0,0,0,0
0,0,0,0,0,0,0,0,0
0,0,0,0,0,0,0,0,0
0,0,0,0,0,0,0,0,0
0,0,0,0,0,0,0,0,0
0,0,0,0,0,0,0,0,0
9019,47,3,1,1,0,2,0,0
0,0,0,0,0,0,0,0,0
0,0,0,0,0,0,0,0,0
0,0,0,0,0,0,0,0,0
0,0,0,0,0,0,0,0,0
0,0,0,0,0,0,0,0,0
33862,196,5,16,13,3,1,0,0
9062,79,1,0,0,0,0,0,0
0,0,0,0,0,0,0,0,0
0,0,0,0,0,0,0,0,0
27645,155,5,5,2,3,1,0,0
0,0,0,0,0,0,0,0,0
0,0,0,0,0,0,0,0,0
0,0,0,0,0,0,0,0,0
0,0,0,0,0,0,0,0,0
0,0,0,0,0,0,0,0,0
0,0,0,0,0,0,0,0,0
0,0,0,0,0,0,0,0,0
0,0,0,0,0,0,0,0,0
0,0,0,0,0,0,0,0,0
0,0,0,0,0,0,0,0,0
0,0,0,0,0,0,0,0,0
0,0,0,0,0,0,0,0,0
0,0,0,0,0,0,0,0,0
36248,170,2,5,4,1,18,0,0
36248,170,2,5,4,1,18,0,0
36248,170,2,5,4,1,18,0,0
36248,170,2,5,4,1,18,0,0
0,0,0,0,0,0,0,0,0
0,0,0,0,0,0,0,0,0
0,0,0,0,0,0,0,0,0
0,0,0,0,0,0,0,0,0
0,0,0,0,0,0,0,0,0
0,0,0,0,0,0,0,0,0
0,0,0,0,0,0,0,0,0
73496,48,4,0,0,0,1,0,0
73498,48,4,0,0,0,1,0,0
0,0,0,0,0,0,0,0,0
5177,48,3,0,0,0,0,0,0
303389,60,4,2,2,0,2,1,0
127659,125,3,0,0,0,3,0,0
9019,47,3,1,1,0,2,0,0
9019,47,3,1,1,0,2,0,0
9019,47,3,1,1,0,2,0,0
52695,232,3,4,0,4,3,1,0
0,0,0,0,0,0,0,0,0
0,0,0,0,0,0,0,0,0
0,0,0,0,0,0,0,0,0
5573,49,0,0,0,0,0,0,0
0,0,0,0,0,0,0,0,0
0,0,0,0,0,0,0,0,0
168509,497,4,7,4,3,8,0,0
0,0,0,0,0,0,0,0,0
0,0,0,0,0,0,0,0,0
0,0,0,0,0,0,0,0,0
0,0,0,0,0,0,0,0,0
0,0,0,0,0,0,0,0,0
36248,170,2,5,4,1,18,0,0
0,0,0,0,0,0,0,0,0
0,0,0,0,0,0,0,0,0
0,0,0,0,0,0,0,0,0
0,0,0,0,0,0,0,0,0
36248,170,2,5,4,1,18,0,0
44614,351,10,45,45,0,0,1,0
41850,107,5,0,0,0,3,1,0
43498,181,4,1,1,0,4,1,0
0,0,0,0,0,0,0,0,0
8073,140,7,26,6,20,1,1,0
42402,82,5,0,0,0,0,0,0
16244,57,0,2,2,0,0,1,0
0,0,0,0,0,0,0,0,0
0,0,0,0,0,0,0,0,0
0,0,0,0,0,0,0,0,0
0,0,0,0,0,0,0,0,0
0,0,0,0,0,0,0,0,0
0,0,0,0,0,0,0,0,0
0,0,0,0,0,0,0,0,0
0,0,0,0,0,0,0,0,0
22402,147,1,1,0,1,0,1,0
22402,147,1,1,0,1,0,1,0
0,0,0,0,0,0,0,0,0
0,0,0,0,0,0,0,0,0
0,0,0,0,0,0,0,0,0
0,0,0,0,0,0,0,0,0
0,0,0,0,0,0,0,0,0
0,0,0,0,0,0,0,0,0
0,0,0,0,0,0,0,0,0
0,0,0,0,0,0,0,0,0
0,0,0,0,0,0,0,0,0
0,0,0,0,0,0,0,0,0
0,0,0,0,0,0,0,0,0
0,0,0,0,0,0,0,0,0
0,0,0,0,0,0,0,0,0
0,0,0,0,0,0,0,0,0
0,0,0,0,0,0,0,0,0
0,0,0,0,0,0,0,0,0
0,0,0,0,0,0,0,0,0
0,0,0,0,0,0,0,0,0
0,0,0,0,0,0,0,0,0
0,0,0,0,0,0,0,0,0
0,0,0,0,0,0,0,0,0
0,0,0,0,0,0,0,0,0
0,0,0,0,0,0,0,0,0
0,0,0,0,0,0,0,0,0
0,0,0,0,0,0,0,0,0
0,0,0,0,0,0,0,0,0
0,0,0,0,0,0,0,0,0
0,0,0,0,0,0,0,0,0
0,0,0,0,0,0,0,0,0
0,0,0,0,0,0,0,0,0
48748,706,4,163,30,133,3,1,0
0,0,0,0,0,0,0,0,0
0,0,0,0,0,0,0,0,0
0,0,0,0,0,0,0,0,0
0,0,0,0,0,0,0,0,0
16317,124,4,3,3,0,5,1,0
0,0,0,0,0,0,0,0,0
47618,75,2,1,1,0,3,1,0
1059955,101,4,5,5,0,3,1,0
0,0,0,0,0,0,0,0,0
0,0,0,0,0,0,0,0,0
0,0,0,0,0,0,0,0,0
0,0,0,0,0,0,0,0,0
0,0,0,0,0,0,0,0,0
0,0,0,0,0,0,0,0,0
0,0,0,0,0,0,0,0,0
0,0,0,0,0,0,0,0,0
73510,48,4,0,0,0,1,0,0
0,0,0,0,0,0,0,0,0
0,0,0,0,0,0,0,0,0
135686,325,8,29,24,5,20,1,0
151994,107,3,3,3,0,2,1,0
13063,97,0,3,3,0,0,0,0
15263,109,0,3,3,0,0,0,0
0,0,0,0,0,0,0,0,0
0,0,0,0,0,0,0,0,0
0,0,0,0,0,0,0,0,0
0,0,0,0,0,0,0,0,0
0,0,0,0,0,0,0,0,0
16780,126,0,1,0,1,0,0,0
0,0,0,0,0,0,0,0,0
0,0,0,0,0,0,0,0,0
0,0,0,0,0,0,0,0,0
0,0,0,0,0,0,0,0,0
0,0,0,0,0,0,0,0,0
0,0,0,0,0,0,0,0,0
12973,98,0,3,3,0,0,0,0
0,0,0,0,0,0,0,0,0
8073,140,7,26,6,20,1,1,0
0,0,0,0,0,0,0,0,0
0,0,0,0,0,0,0,0,0
16570,124,0,3,3,0,0,0,0
0,0,0,0,0,0,0,0,0
36248,170,2,5,4,1,18,0,0
0,0,0,0,0,0,0,0,0
0,0,0,0,0,0,0,0,0
0,0,0,0,0,0,0,0,0
0,0,0,0,0,0,0,0,0
0,0,0,0,0,0,0,0,0
10849,84,1,2,2,0,0,0,0
0,0,0,0,0,0,0,0,0
141200,415,8,29,24,5,34,1,0
0,0,0,0,0,0,0,0,0
12988,98,0,3,3,0,0,0,0
0,0,0,0,0,0,0,0,0
0,0,0,0,0,0,0,0,0
0,0,0,0,0,0,0,0,0
73500,48,4,0,0,0,1,0,0
8073,140,7,26,6,20,1,1,0
0,0,0,0,0,0,0,0,0
10272,83,1,0,0,0,0,0,0
10272,83,1,0,0,0,0,0,0
0,0,0,0,0,0,0,0,0
0,0,0,0,0,0,0,0,0
0,0,0,0,0,0,0,0,0
670238,555,0,4,4,0,2,1,1
73498,48,4,0,0,0,1,0,0
73355,47,4,0,0,0,1,0,0
0,0,0,0,0,0,0,0,0
0,0,0,0,0,0,0,0,0
22400,147,1,1,0,1,0,1,0
22400,147,1,1,0,1,0,1,0
0,0,0,0,0,0,0,0,0
0,0,0,0,0,0,0,0,0
0,0,0,0,0,0,0,0,0
0,0,0,0,0,0,0,0,0
0,0,0,0,0,0,0,0,0
73498,48,4,0,0,0,1,0,0
0,0,0,0,0,0,0,0,0
0,0,0,0,0,0,0,0,0
0,0,0,0,0,0,0,0,0
0,0,0,0,0,0,0,0,0
20771,158,0,1,0,1,0,1,0
20771,158,0,1,0,1,0,1,0
0,0,0,0,0,0,0,0,0
22400,147,1,1,0,1,0,1,0
22400,147,1,1,0,1,0,1,0
0,0,0,0,0,0,0,0,0
0,0,0,0,0,0,0,0,0
0,0,0,0,0,0,0,0,0
265240,511,4,49,35,14,7,1,0
0,0,0,0,0,0,0,0,0
0,0,0,0,0,0,0,0,0
0,0,0,0,0,0,0,0,0
0,0,0,0,0,0,0,0,0
0,0,0,0,0,0,0,0,0
0,0,0,0,0,0,0,0,0
0,0,0,0,0,0,0,0,0
0,0,0,0,0,0,0,0,0
0,0,0,0,0,0,0,0,0
0,0,0,0,0,0,0,0,0
12216,51,3,0,0,0,2,0,0
12216,51,3,0,0,0,2,0,0
12216,51,3,0,0,0,2,0,0
0,0,0,0,0,0,0,0,0
0,0,0,0,0,0,0,0,0
0,0,0,0,0,0,0,0,0
12216,51,3,0,0,0,2,0,0
12216,51,3,0,0,0,2,0,0
233342,64,4,3,3,0,2,1,0
233342,64,4,3,3,0,2,1,0
0,0,0,0,0,0,0,0,0
233342,64,4,3,3,0,2,1,0
327178,77,4,3,3,0,2,1,0
327178,77,4,3,3,0,2,1,0
0,0,0,0,0,0,0,0,0
5046,24,3,0,0,0,0,0,0
5046,24,3,0,0,0,0,0,0
5046,24,3,0,0,0,0,0,0
0,0,0,0,0,0,0,0,0
0,0,0,0,0,0,0,0,0
0,0,0,0,0,0,0,0,0
0,0,0,0,0,0,0,0,0
0,0,0,0,0,0,0,0,0
0,0,0,0,0,0,0,0,0
0,0,0,0,0,0,0,0,0
0,0,0,0,0,0,0,0,0
0,0,0,0,0,0,0,0,0
0,0,0,0,0,0,0,0,0
5967018,68,5,1,1,0,2,1,0
5967018,68,5,1,1,0,2,1,0
0,0,0,0,0,0,0,0,0
38146,50,1,0,0,0,2,1,0
38146,50,1,0,0,0,2,1,0
0,0,0,0,0,0,0,0,0
0,0,0,0,0,0,0,0,0
0,0,0,0,0,0,0,0,0
0,0,0,0,0,0,0,0,0
0,0,0,0,0,0,0,0,0
0,0,0,0,0,0,0,0,0
0,0,0,0,0,0,0,0,0
5967018,68,5,1,1,0,2,1,0
0,0,0,0,0,0,0,0,0
5967018,68,5,1,1,0,2,1,0
0,0,0,0,0,0,0,0,0
0,0,0,0,0,0,0,0,0
234242,60,5,3,3,0,2,1,0
0,0,0,0,0,0,0,0,0
0,0,0,0,0,0,0,0,0
0,0,0,0,0,0,0,0,0
0,0,0,0,0,0,0,0,0
0,0,0,0,0,0,0,0,0
0,0,0,0,0,0,0,0,0
0,0,0,0,0,0,0,0,0
0,0,0,0,0,0,0,0,0
0,0,0,0,0,0,0,0,0
0,0,0,0,0,0,0,0,0
0,0,0,0,0,0,0,0,0
0,0,0,0,0,0,0,0,0
0,0,0,0,0,0,0,0,0
0,0,0,0,0,0,0,0,0
10398,73,0,0,0,0,0,0,0
165604,476,4,2,1,1,7,0,0
31452,36,1,0,0,0,1,0,0
34627,51,2,0,0,0,2,0,0
34627,51,2,0,0,0,2,0,0
125859,33,2,0,0,0,1,0,0
73497,48,4,0,0,0,1,0,0
122967,91,5,0,0,0,0,0,0
0,0,0,0,0,0,0,0,0
0,0,0,0,0,0,0,0,0
0,0,0,0,0,0,0,0,0
0,0,0,0,0,0,0,0,0
0,0,0,0,0,0,0,0,0
0,0,0,0,0,0,0,0,0
0,0,0,0,0,0,0,0,0
47933,76,2,1,1,0,3,1,0
135900,218,4,26,18,8,2,1,0
0,0,0,0,0,0,0,0,0
28762,168,5,3,1,2,1,0,0
0,0,0,0,0,0,0,0,0
127821,47,2,1,0,1,0,0,0
0,0,0,0,0,0,0,0,0
0,0,0,0,0,0,0,0,0
0,0,0,0,0,0,0,0,0
0,0,0,0,0,0,0,0,0
0,0,0,0,0,0,0,0,0
0,0,0,0,0,0,0,0,0
0,0,0,0,0,0,0,0,0
0,0,0,0,0,0,0,0,0
186941,378,3,25,7,18,13,1,0
3502,62,1,3,1,2,0,0,0
0,0,0,0,0,0,0,0,0
0,0,0,0,0,0,0,0,0
0,0,0,0,0,0,0,0,0
0,0,0,0,0,0,0,0,0
0,0,0,0,0,0,0,0,0
0,0,0,0,0,0,0,0,0
0,0,0,0,0,0,0,0,0
0,0,0,0,0,0,0,0,0
0,0,0,0,0,0,0,0,0
33513,277,1,15,11,4,13,0,0
165001,473,4,2,1,1,7,0,0
0,0,0,0,0,0,0,0,0
3854,36,2,2,1,1,0,0,0
0,0,0,0,0,0,0,0,0
0,0,0,0,0,0,0,0,0
0,0,0,0,0,0,0,0,0
0,0,0,0,0,0,0,0,0
0,0,0,0,0,0,0,0,0
127923,141,4,13,13,0,0,0,0
168634,534,4,4,3,1,8,1,0
350724,380,4,44,3,41,13,1,0
350712,380,4,44,3,41,13,1,0
133433,313,6,30,24,6,9,1,0
672858,555,0,4,4,0,2,1,1
0,0,0,0,0,0,0,0,0
0,0,0,0,0,0,0,0,0
0,0,0,0,0,0,0,0,0
283430,78,4,2,0,2,0,1,0
281482,77,4,2,0,2,0,1,0
594,13,0,2,2,0,0,0,0
594,13,0,2,2,0,0,0,0
1967,15,1,0,0,0,0,0,0
0,0,0,0,0,0,0,0,0
8073,140,7,26,6,20,1,1,0
10513,85,1,0,0,0,0,0,0
672628,555,0,4,4,0,2,1,1
73498,48,4,0,0,0,1,0,0
13263,103,0,3,2,1,0,0,0
0,0,0,0,0,0,0,0,0
0,0,0,0,0,0,0,0,0
0,0,0,0,0,0,0,0,0
8929,78,1,0,0,0,0,0,0
73498,48,4,0,0,0,1,0,0
0,0,0,0,0,0,0,0,0
0,0,0,0,0,0,0,0,0
0,0,0,0,0,0,0,0,0
0,0,0,0,0,0,0,0,0
0,0,0,0,0,0,0,0,0
13199,94,0,1,1,0,0,0,0
677892,555,0,4,0,4,2,1,1
73498,48,4,0,0,0,1,0,0
0,0,0,0,0,0,0,0,0
0,0,0,0,0,0,0,0,0
73498,48,4,0,0,0,1,0,0
0,0,0,0,0,0,0,0,0
0,0,0,0,0,0,0,0,0
0,0,0,0,0,0,0,0,0
680466,555,0,4,0,4,2,1,1
0,0,0,0,0,0,0,0,0
0,0,0,0,0,0,0,0,0
0,0,0,0,0,0,0,0,0
0,0,0,0,0,0,0,0,0
0,0,0,0,0,0,0,0,0
0,0,0,0,0,0,0,0,0
0,0,0,0,0,0,0,0,0
0,0,0,0,0,0,0,0,0
0,0,0,0,0,0,0,0,0
137906,341,8,29,24,5,20,1,0
36248,170,2,5,4,1,18,0,0
36248,170,2,5,4,1,18,0,0
0,0,0,0,0,0,0,0,0
0,0,0,0,0,0,0,0,0
0,0,0,0,0,0,0,0,0
0,0,0,0,0,0,0,0,0
0,0,0,0,0,0,0,0,0
0,0,0,0,0,0,0,0,0
0,0,0,0,0,0,0,0,0
0,0,0,0,0,0,0,0,0
0,0,0,0,0,0,0,0,0
34015,148,5,19,12,7,1,0,0
0,0,0,0,0,0,0,0,0
11846,52,3,0,0,0,2,0,0
0,0,0,0,0,0,0,0,0
0,0,0,0,0,0,0,0,0
0,0,0,0,0,0,0,0,0
0,0,0,0,0,0,0,0,0
8073,140,7,26,10,16,1,1,0
0,0,0,0,0,0,0,0,0
0,0,0,0,0,0,0,0,0
0,0,0,0,0,0,0,0,0
0,0,0,0,0,0,0,0,0
0,0,0,0,0,0,0,0,0
0,0,0,0,0,0,0,0,0
0,0,0,0,0,0,0,0,0
0,0,0,0,0,0,0,0,0
0,0,0,0,0,0,0,0,0
0,0,0,0,0,0,0,0,0
0,0,0,0,0,0,0,0,0
0,0,0,0,0,0,0,0,0
0,0,0,0,0,0,0,0,0
42402,82,5,0,0,0,0,0,0
0,0,0,0,0,0,0,0,0
293988,194,6,1,1,0,0,1,0
284780,186,6,1,1,0,0,1,0
0,0,0,0,0,0,0,0,0
0,0,0,0,0,0,0,0,0
0,0,0,0,0,0,0,0,0
280874,182,6,1,1,0,0,1,0
0,0,0,0,0,0,0,0,0
0,0,0,0,0,0,0,0,0
0,0,0,0,0,0,0,0,0
13016,97,0,3,3,0,0,0,0
0,0,0,0,0,0,0,0,0
0,0,0,0,0,0,0,0,0
0,0,0,0,0,0,0,0,0
0,0,0,0,0,0,0,0,0
12970,98,0,3,3,0,0,0,0
0,0,0,0,0,0,0,0,0
0,0,0,0,0,0,0,0,0
0,0,0,0,0,0,0,0,0
0,0,0,0,0,0,0,0,0
0,0,0,0,0,0,0,0,0
285152,47,0,4,4,0,0,0,0
0,0,0,0,0,0,0,0,0
0,0,0,0,0,0,0,0,0
285152,47,0,4,4,0,0,0,0
0,0,0,0,0,0,0,0,0
0,0,0,0,0,0,0,0,0
285152,47,0,4,4,0,0,0,0
285152,47,0,4,4,0,0,0,0
5054,24,3,0,0,0,0,0,0
0,0,0,0,0,0,0,0,0
5054,24,3,0,0,0,0,0,0
5054,24,3,0,0,0,0,0,0
5054,24,3,0,0,0,0,0,0
0,0,0,0,0,0,0,0,0
5054,24,3,0,0,0,0,0,0
0,0,0,0,0,0,0,0,0
0,0,0,0,0,0,0,0,0
0,0,0,0,0,0,0,0,0
0,0,0,0,0,0,0,0,0
0,0,0,0,0,0,0,0,0
0,0,0,0,0,0,0,0,0
58911,900,4,163,2,161,3,1,0
0,0,0,0,0,0,0,0,0
36412,50,2,0,0,0,2,0,0
0,0,0,0,0,0,0,0,0
0,0,0,0,0,0,0,0,0
0,0,0,0,0,0,0,0,0
0,0,0,0,0,0,0,0,0
0,0,0,0,0,0,0,0,0
0,0,0,0,0,0,0,0,0
0,0,0,0,0,0,0,0,0
0,0,0,0,0,0,0,0,0
0,0,0,0,0,0,0,0,0
0,0,0,0,0,0,0,0,0
0,0,0,0,0,0,0,0,0
0,0,0,0,0,0,0,0,0
0,0,0,0,0,0,0,0,0
0,0,0,0,0,0,0,0,0
0,0,0,0,0,0,0,0,0
0,0,0,0,0,0,0,0,0
0,0,0,0,0,0,0,0,0
0,0,0,0,0,0,0,0,0
0,0,0,0,0,0,0,0,0
0,0,0,0,0,0,0,0,0
0,0,0,0,0,0,0,0,0
0,0,0,0,0,0,0,0,0
0,0,0,0,0,0,0,0,0
0,0,0,0,0,0,0,0,0
203979,145,3,2,1,1,18,0,0
203991,145,3,2,1,1,18,0,0
0,0,0,0,0,0,0,0,0
2843865,60,3,1,1,0,4,1,0
0,0,0,0,0,0,0,0,0
0,0,0,0,0,0,0,0,0
0,0,0,0,0,0,0,0,0
0,0,0,0,0,0,0,0,0
0,0,0,0,0,0,0,0,0
0,0,0,0,0,0,0,0,0
9602,83,1,0,0,0,0,0,0
0,0,0,0,0,0,0,0,0
13011,95,0,3,3,0,0,0,0
0,0,0,0,0,0,0,0,0
12948,97,0,3,3,0,0,0,0
10517,85,1,0,0,0,0,0,0
10517,85,1,0,0,0,0,0,0
73498,48,4,0,0,0,1,0,0
12969,97,0,3,3,0,0,0,0
9552,28,1,2,2,0,0,0,0
0,0,0,0,0,0,0,0,0
0,0,0,0,0,0,0,0,0
9547,28,1,2,2,0,0,0,0
0,0,0,0,0,0,0,0,0
0,0,0,0,0,0,0,0,0
0,0,0,0,0,0,0,0,0
8073,140,7,26,6,20,1,1,0
8073,140,7,26,6,20,1,1,0
8073,140,7,26,6,20,1,1,0
8073,140,7,26,6,20,1,1,0
0,0,0,0,0,0,0,0,0
0,0,0,0,0,0,0,0,0
0,0,0,0,0,0,0,0,0
0,0,0,0,0,0,0,0,0
73566,412,7,8,8,0,0,1,0
0,0,0,0,0,0,0,0,0
674019,555,0,4,4,0,2,1,1
8073,140,7,26,6,20,1,1,0
0,0,0,0,0,0,0,0,0
73510,48,4,0,0,0,1,0,0
14248,160,5,1,0,1,0,1,0
14248,160,5,1,0,1,0,1,0
9553,28,1,2,1,1,0,0,0
0,0,0,0,0,0,0,0,0
0,0,0,0,0,0,0,0,0
671626,555,0,4,4,0,2,1,1
673971,555,0,4,4,0,2,1,1
0,0,0,0,0,0,0,0,0
0,0,0,0,0,0,0,0,0
0,0,0,0,0,0,0,0,0
671617,555,0,4,4,0,2,1,1
672396,555,0,4,4,0,2,1,1
8073,140,7,26,6,20,1,1,0
12889,96,0,3,3,0,0,0,0
0,0,0,0,0,0,0,0,0
0,0,0,0,0,0,0,0,0
29904,108,3,3,2,1,1,0,0
0,0,0,0,0,0,0,0,0
0,0,0,0,0,0,0,0,0
0,0,0,0,0,0,0,0,0
0,0,0,0,0,0,0,0,0
0,0,0,0,0,0,0,0,0
0,0,0,0,0,0,0,0,0
0,0,0,0,0,0,0,0,0
0,0,0,0,0,0,0,0,0
0,0,0,0,0,0,0,0,0
0,0,0,0,0,0,0,0,0
0,0,0,0,0,0,0,0,0
0,0,0,0,0,0,0,0,0
0,0,0,0,0,0,0,0,0
0,0,0,0,0,0,0,0,0
0,0,0,0,0,0,0,0,0
301063,244,6,1,1,0,0,1,0
301063,244,6,1,1,0,0,1,0
301063,244,6,1,1,0,0,1,0
0,0,0,0,0,0,0,0,0
0,0,0,0,0,0,0,0,0
0,0,0,0,0,0,0,0,0
0,0,0,0,0,0,0,0,0
0,0,0,0,0,0,0,0,0
0,0,0,0,0,0,0,0,0
0,0,0,0,0,0,0,0,0
0,0,0,0,0,0,0,0,0
0,0,0,0,0,0,0,0,0
0,0,0,0,0,0,0,0,0
0,0,0,0,0,0,0,0,0
39315,168,3,8,4,4,11,1,0
40440,172,3,8,4,4,11,1,0
56348,325,13,23,23,0,0,0,0
0,0,0,0,0,0,0,0,0
0,0,0,0,0,0,0,0,0
0,0,0,0,0,0,0,0,0
8073,140,7,26,6,20,1,1,0
0,0,0,0,0,0,0,0,0
13048,97,0,3,3,0,0,0,0
0,0,0,0,0,0,0,0,0
70273,62,3,0,0,0,3,0,0
0,0,0,0,0,0,0,0,0
0,0,0,0,0,0,0,0,0
0,0,0,0,0,0,0,0,0
0,0,0,0,0,0,0,0,0
0,0,0,0,0,0,0,0,0
0,0,0,0,0,0,0,0,0
0,0,0,0,0,0,0,0,0
0,0,0,0,0,0,0,0,0
0,0,0,0,0,0,0,0,0
0,0,0,0,0,0,0,0,0
0,0,0,0,0,0,0,0,0
0,0,0,0,0,0,0,0,0
31683,69,6,1,0,1,0,1,0
0,0,0,0,0,0,0,0,0
31683,69,6,1,0,1,0,1,0
0,0,0,0,0,0,0,0,0
0,0,0,0,0,0,0,0,0
31683,69,6,1,0,1,0,1,0
0,0,0,0,0,0,0,0,0
0,0,0,0,0,0,0,0,0
0,0,0,0,0,0,0,0,0
0,0,0,0,0,0,0,0,0
0,0,0,0,0,0,0,0,0
0,0,0,0,0,0,0,0,0
0,0,0,0,0,0,0,0,0
0,0,0,0,0,0,0,0,0
31683,69,6,1,0,1,0,1,0
13137,29,1,0,0,0,3,0,0
0,0,0,0,0,0,0,0,0
31683,69,6,1,0,1,0,1,0
0,0,0,0,0,0,0,0,0
0,0,0,0,0,0,0,0,0
0,0,0,0,0,0,0,0,0
0,0,0,0,0,0,0,0,0
0,0,0,0,0,0,0,0,0
0,0,0,0,0,0,0,0,0
13137,29,1,0,0,0,3,0,0
415562,72,4,3,3,0,2,1,0
0,0,0,0,0,0,0,0,0
0,0,0,0,0,0,0,0,0
0,0,0,0,0,0,0,0,0
0,0,0,0,0,0,0,0,0
0,0,0,0,0,0,0,0,0
0,0,0,0,0,0,0,0,0
415562,72,4,3,3,0,2,1,0
415562,72,4,3,3,0,2,1,0
415562,72,4,3,3,0,2,1,0
0,0,0,0,0,0,0,0,0
0,0,0,0,0,0,0,0,0
0,0,0,0,0,0,0,0,0
0,0,0,0,0,0,0,0,0
0,0,0,0,0,0,0,0,0
0,0,0,0,0,0,0,0,0
0,0,0,0,0,0,0,0,0
0,0,0,0,0,0,0,0,0
0,0,0,0,0,0,0,0,0
0,0,0,0,0,0,0,0,0
167495,475,4,2,1,1,7,0,0
0,0,0,0,0,0,0,0,0
26686,36,2,0,0,0,0,0,0
0,0,0,0,0,0,0,0,0
0,0,0,0,0,0,0,0,0
0,0,0,0,0,0,0,0,0
258289,183,6,1,1,0,0,1,0
0,0,0,0,0,0,0,0,0
3385,41,0,6,0,6,0,0,0
6256,82,0,0,0,0,3,1,0
0,0,0,0,0,0,0,0,0
0,0,0,0,0,0,0,0,0
0,0,0,0,0,0,0,0,0
59106,901,4,163,2,161,3,1,0
0,0,0,0,0,0,0,0,0
0,0,0,0,0,0,0,0,0
138918,404,8,27,24,3,35,1,0
0,0,0,0,0,0,0,0,0
0,0,0,0,0,0,0,0,0
16412,115,0,1,1,0,0,0,0
0,0,0,0,0,0,0,0,0
0,0,0,0,0,0,0,0,0
12719,86,0,1,1,0,0,0,0
0,0,0,0,0,0,0,0,0
73510,48,4,0,0,0,1,0,0
674230,555,0,4,4,0,2,1,1
674509,555,0,4,4,0,2,1,1
0,0,0,0,0,0,0,0,0
166253,486,4,4,3,1,8,0,0
0,0,0,0,0,0,0,0,0
0,0,0,0,0,0,0,0,0
12920,96,0,3,3,0,0,0,0
674282,555,0,4,4,0,2,1,1
675981,555,0,4,2,2,2,1,1
674808,555,0,4,4,0,2,1,1
0,0,0,0,0,0,0,0,0
12882,97,0,3,3,0,0,0,0
0,0,0,0,0,0,0,0,0
0,0,0,0,0,0,0,0,0
0,0,0,0,0,0,0,0,0
0,0,0,0,0,0,0,0,0
0,0,0,0,0,0,0,0,0
0,0,0,0,0,0,0,0,0
0,0,0,0,0,0,0,0,0
674171,555,0,4,4,0,2,1,1
0,0,0,0,0,0,0,0,0
0,0,0,0,0,0,0,0,0
8073,140,7,26,8,18,1,1,0
0,0,0,0,0,0,0,0,0
0,0,0,0,0,0,0,0,0
0,0,0,0,0,0,0,0,0
11796,66,2,4,4,0,1,0,0
73497,48,4,0,0,0,1,0,0
675522,555,0,4,4,0,2,1,1
73498,48,4,0,0,0,1,0,0
0,0,0,0,0,0,0,0,0
0,0,0,0,0,0,0,0,0
671662,555,0,4,4,0,2,1,1
0,0,0,0,0,0,0,0,0
0,0,0,0,0,0,0,0,0
0,0,0,0,0,0,0,0,0
0,0,0,0,0,0,0,0,0
9551,28,1,2,2,0,0,0,0
263699,180,6,1,1,0,0,1,0
349795,183,6,3,1,2,0,1,0
309004,206,6,1,1,0,0,1,0
73498,48,4,0,0,0,1,0,0
88801,867,3,69,13,56,2,0,0
0,0,0,0,0,0,0,0,0
0,0,0,0,0,0,0,0,0
0,0,0,0,0,0,0,0,0
0,0,0,0,0,0,0,0,0
0,0,0,0,0,0,0,0,0
0,0,0,0,0,0,0,0,0
0,0,0,0,0,0,0,0,0
147704,581,11,51,48,3,1,1,0
0,0,0,0,0,0,0,0,0
0,0,0,0,0,0,0,0,0
0,0,0,0,0,0,0,0,0
0,0,0,0,0,0,0,0,0
0,0,0,0,0,0,0,0,0
33849,46,2,0,0,0,2,0,0
0,0,0,0,0,0,0,0,0
0,0,0,0,0,0,0,0,0
0,0,0,0,0,0,0,0,0
672268,555,0,4,4,0,2,1,1
0,0,0,0,0,0,0,0,0
0,0,0,0,0,0,0,0,0
0,0,0,0,0,0,0,0,0
0,0,0,0,0,0,0,0,0
0,0,0,0,0,0,0,0,0
0,0,0,0,0,0,0,0,0
0,0,0,0,0,0,0,0,0
0,0,0,0,0,0,0,0,0
0,0,0,0,0,0,0,0,0
0,0,0,0,0,0,0,0,0
0,0,0,0,0,0,0,0,0
0,0,0,0,0,0,0,0,0
1547202,213,0,52,51,1,0,1,0
1547202,213,0,52,51,1,0,1,0
0,0,0,0,0,0,0,0,0
1547202,213,0,52,51,1,0,1,0
1547202,213,0,52,51,1,0,1,0
0,0,0,0,0,0,0,0,0
0,0,0,0,0,0,0,0,0
0,0,0,0,0,0,0,0,0
1546986,208,0,52,51,1,0,1,0
0,0,0,0,0,0,0,0,0
0,0,0,0,0,0,0,0,0
0,0,0,0,0,0,0,0,0
0,0,0,0,0,0,0,0,0
0,0,0,0,0,0,0,0,0
0,0,0,0,0,0,0,0,0
0,0,0,0,0,0,0,0,0
0,0,0,0,0,0,0,0,0
420886,62,4,3,3,0,2,1,0
0,0,0,0,0,0,0,0,0
0,0,0,0,0,0,0,0,0
0,0,0,0,0,0,0,0,0
0,0,0,0,0,0,0,0,0
154384,43,2,3,2,1,0,0,0
0,0,0,0,0,0,0,0,0
0,0,0,0,0,0,0,0,0
0,0,0,0,0,0,0,0,0
0,0,0,0,0,0,0,0,0
0,0,0,0,0,0,0,0,0
0,0,0,0,0,0,0,0,0
420886,62,4,3,3,0,2,1,0
420886,62,4,3,3,0,2,1,0
111857,61,4,3,3,0,2,1,0
111857,61,4,3,3,0,2,1,0
111857,61,4,3,3,0,2,1,0
154384,43,2,3,2,1,0,0,0
154384,43,2,3,2,1,0,0,0
111857,61,4,3,3,0,2,1,0
154384,43,2,3,2,1,0,0,0
0,0,0,0,0,0,0,0,0
6978,50,2,1,1,0,0,1,0
6978,50,2,1,1,0,0,1,0
154384,43,2,3,2,1,0,0,0
6978,50,2,1,1,0,0,1,0
6978,50,2,1,1,0,0,1,0
0,0,0,0,0,0,0,0,0
6978,50,2,1,1,0,0,1,0
0,0,0,0,0,0,0,0,0
13499,75,1,2,2,0,2,0,0
13499,75,1,2,2,0,2,0,0
32632,67,3,5,4,1,3,0,0
13499,75,1,2,2,0,2,0,0
0,0,0,0,0,0,0,0,0
13499,75,1,2,2,0,2,0,0
0,0,0,0,0,0,0,0,0
32632,67,3,5,4,1,3,0,0
0,0,0,0,0,0,0,0,0
81082,45,1,0,0,0,0,0,0
81082,45,1,0,0,0,0,0,0
111860,61,4,3,3,0,2,1,0
111860,61,4,3,3,0,2,1,0
81082,45,1,0,0,0,0,0,0
81082,45,1,0,0,0,0,0,0
111860,61,4,3,3,0,2,1,0
111860,61,4,3,3,0,2,1,0
0,0,0,0,0,0,0,0,0
81082,45,1,0,0,0,0,0,0
0,0,0,0,0,0,0,0,0
0,0,0,0,0,0,0,0,0
0,0,0,0,0,0,0,0,0
0,0,0,0,0,0,0,0,0
0,0,0,0,0,0,0,0,0
0,0,0,0,0,0,0,0,0
0,0,0,0,0,0,0,0,0
0,0,0,0,0,0,0,0,0
0,0,0,0,0,0,0,0,0
0,0,0,0,0,0,0,0,0
0,0,0,0,0,0,0,0,0
192908,609,4,14,1,13,7,0,0
0,0,0,0,0,0,0,0,0
0,0,0,0,0,0,0,0,0
0,0,0,0,0,0,0,0,0
0,0,0,0,0,0,0,0,0
0,0,0,0,0,0,0,0,0
0,0,0,0,0,0,0,0,0
0,0,0,0,0,0,0,0,0
164316,478,4,4,1,3,7,0,0
165525,477,4,4,3,1,8,0,0
169373,504,4,5,4,1,8,1,0
166106,477,4,4,3,1,8,0,0
167410,491,4,5,2,3,7,0,0
13668,78,0,7,7,0,0,1,0
0,0,0,0,0,0,0,0,0
0,0,0,0,0,0,0,0,0
0,0,0,0,0,0,0,0,0
0,0,0,0,0,0,0,0,0
0,0,0,0,0,0,0,0,0
267529,512,4,49,36,13,7,1,0
22434,147,1,1,0,1,0,1,0
22434,147,1,1,0,1,0,1,0
3639,46,0,0,0,0,0,0,0
3639,46,0,0,0,0,0,0,0
0,0,0,0,0,0,0,0,0
20771,158,0,1,0,1,0,1,0
20771,158,0,1,0,1,0,1,0
0,0,0,0,0,0,0,0,0
0,0,0,0,0,0,0,0,0
0,0,0,0,0,0,0,0,0
0,0,0,0,0,0,0,0,0
675856,555,0,4,4,0,2,1,1
8073,140,7,26,6,20,1,1,0
8073,140,7,26,10,16,1,1,0
8073,140,7,26,6,20,1,1,0
0,0,0,0,0,0,0,0,0
0,0,0,0,0,0,0,0,0
0,0,0,0,0,0,0,0,0
0,0,0,0,0,0,0,0,0
0,0,0,0,0,0,0,0,0
673417,555,0,4,4,0,2,1,1
73498,48,4,0,0,0,1,0,0
0,0,0,0,0,0,0,0,0
73498,48,4,0,0,0,1,0,0
73498,48,4,0,0,0,1,0,0
0,0,0,0,0,0,0,0,0
29104,169,6,5,1,4,1,0,0
0,0,0,0,0,0,0,0,0
8073,140,7,26,6,20,1,1,0
8073,140,7,26,10,16,1,1,0
8073,140,7,26,6,20,1,1,0
0,0,0,0,0,0,0,0,0
0,0,0,0,0,0,0,0,0
10123,80,1,0,0,0,0,0,0
0,0,0,0,0,0,0,0,0
0,0,0,0,0,0,0,0,0
0,0,0,0,0,0,0,0,0
0,0,0,0,0,0,0,0,0
0,0,0,0,0,0,0,0,0
0,0,0,0,0,0,0,0,0
76157,208,1,9,3,6,7,1,0
8073,140,7,26,6,20,1,1,0
0,0,0,0,0,0,0,0,0
73498,48,4,0,0,0,1,0,0
0,0,0,0,0,0,0,0,0
0,0,0,0,0,0,0,0,0
0,0,0,0,0,0,0,0,0
672400,555,0,4,4,0,2,1,1
0,0,0,0,0,0,0,0,0
0,0,0,0,0,0,0,0,0
0,0,0,0,0,0,0,0,0
0,0,0,0,0,0,0,0,0
0,0,0,0,0,0,0,0,0
12740,86,0,1,1,0,0,0,0
9285,83,1,0,0,0,0,0,0
0,0,0,0,0,0,0,0,0
0,0,0,0,0,0,0,0,0
0,0,0,0,0,0,0,0,0
9574,84,1,0,0,0,0,0,0
308969,205,6,1,1,0,0,1,0
0,0,0,0,0,0,0,0,0
0,0,0,0,0,0,0,0,0
12901,97,0,3,3,0,0,0,0
0,0,0,0,0,0,0,0,0
0,0,0,0,0,0,0,0,0
0,0,0,0,0,0,0,0,0
0,0,0,0,0,0,0,0,0
0,0,0,0,0,0,0,0,0
0,0,0,0,0,0,0,0,0
0,0,0,0,0,0,0,0,0
10267,83,1,0,0,0,0,0,0
0,0,0,0,0,0,0,0,0
0,0,0,0,0,0,0,0,0
0,0,0,0,0,0,0,0,0
0,0,0,0,0,0,0,0,0
14635,69,4,6,5,1,5,1,0
0,0,0,0,0,0,0,0,0
0,0,0,0,0,0,0,0,0
135786,330,8,30,24,6,20,1,0
135875,327,8,27,24,3,20,1,0
674549,555,0,4,4,0,2,1,1
672233,555,0,4,4,0,2,1,1
47230,202,2,2,1,1,1,0,0
9082,77,1,0,0,0,0,0,0
8968,77,1,0,0,0,0,0,0
0,0,0,0,0,0,0,0,0
0,0,0,0,0,0,0,0,0
0,0,0,0,0,0,0,0,0
0,0,0,0,0,0,0,0,0
0,0,0,0,0,0,0,0,0
0,0,0,0,0,0,0,0,0
0,0,0,0,0,0,0,0,0
0,0,0,0,0,0,0,0,0
0,0,0,0,0,0,0,0,0
0,0,0,0,0,0,0,0,0
0,0,0,0,0,0,0,0,0
0,0,0,0,0,0,0,0,0
0,0,0,0,0,0,0,0,0
0,0,0,0,0,0,0,0,0
0,0,0,0,0,0,0,0,0
0,0,0,0,0,0,0,0,0
0,0,0,0,0,0,0,0,0
0,0,0,0,0,0,0,0,0
0,0,0,0,0,0,0,0,0
0,0,0,0,0,0,0,0,0
0,0,0,0,0,0,0,0,0
0,0,0,0,0,0,0,0,0
0,0,0,0,0,0,0,0,0
0,0,0,0,0,0,0,0,0
0,0,0,0,0,0,0,0,0
0,0,0,0,0,0,0,0,0
11000,82,0,7,6,1,0,1,0
0,0,0,0,0,0,0,0,0
0,0,0,0,0,0,0,0,0
0,0,0,0,0,0,0,0,0
0,0,0,0,0,0,0,0,0
28297,160,6,4,2,2,1,0,0
73498,48,4,0,0,0,1,0,0
0,0,0,0,0,0,0,0,0
0,0,0,0,0,0,0,0,0
0,0,0,0,0,0,0,0,0
0,0,0,0,0,0,0,0,0
0,0,0,0,0,0,0,0,0
0,0,0,0,0,0,0,0,0
0,0,0,0,0,0,0,0,0
0,0,0,0,0,0,0,0,0
0,0,0,0,0,0,0,0,0
420882,62,4,3,3,0,2,1,0
420882,62,4,3,3,0,2,1,0
420882,62,4,3,3,0,2,1,0
0,0,0,0,0,0,0,0,0
0,0,0,0,0,0,0,0,0
58911,900,4,163,2,161,3,1,0
0,0,0,0,0,0,0,0,0
0,0,0,0,0,0,0,0,0
36426,48,1,0,0,0,0,0,0
166790,530,4,2,1,1,7,0,0
1060484,101,4,5,5,0,3,1,0
0,0,0,0,0,0,0,0,0
0,0,0,0,0,0,0,0,0
0,0,0,0,0,0,0,0,0
0,0,0,0,0,0,0,0,0
0,0,0,0,0,0,0,0,0
0,0,0,0,0,0,0,0,0
0,0,0,0,0,0,0,0,0
0,0,0,0,0,0,0,0,0
0,0,0,0,0,0,0,0,0
0,0,0,0,0,0,0,0,0
0,0,0,0,0,0,0,0,0
0,0,0,0,0,0,0,0,0
0,0,0,0,0,0,0,0,0
0,0,0,0,0,0,0,0,0
0,0,0,0,0,0,0,0,0
0,0,0,0,0,0,0,0,0
0,0,0,0,0,0,0,0,0
0,0,0,0,0,0,0,0,0
0,0,0,0,0,0,0,0,0
0,0,0,0,0,0,0,0,0
0,0,0,0,0,0,0,0,0
0,0,0,0,0,0,0,0,0
0,0,0,0,0,0,0,0,0
0,0,0,0,0,0,0,0,0
0,0,0,0,0,0,0,0,0
0,0,0,0,0,0,0,0,0
295251,2357,1,250,4,246,4,1,0
57291,229,7,14,12,2,3,0,0
0,0,0,0,0,0,0,0,0
43935,191,3,7,5,2,4,1,0
0,0,0,0,0,0,0,0,0
0,0,0,0,0,0,0,0,0
0,0,0,0,0,0,0,0,0
0,0,0,0,0,0,0,0,0
665739,62,4,3,3,0,2,1,0
665739,62,4,3,3,0,2,1,0
665739,62,4,3,3,0,2,1,0
665739,62,4,3,3,0,2,1,0
0,0,0,0,0,0,0,0,0
0,0,0,0,0,0,0,0,0
111834,61,4,3,3,0,2,1,0
0,0,0,0,0,0,0,0,0
665739,62,4,3,3,0,2,1,0
111834,61,4,3,3,0,2,1,0
111834,61,4,3,3,0,2,1,0
0,0,0,0,0,0,0,0,0
0,0,0,0,0,0,0,0,0
0,0,0,0,0,0,0,0,0
0,0,0,0,0,0,0,0,0
0,0,0,0,0,0,0,0,0
0,0,0,0,0,0,0,0,0
0,0,0,0,0,0,0,0,0
0,0,0,0,0,0,0,0,0
0,0,0,0,0,0,0,0,0
0,0,0,0,0,0,0,0,0
0,0,0,0,0,0,0,0,0
0,0,0,0,0,0,0,0,0
0,0,0,0,0,0,0,0,0
0,0,0,0,0,0,0,0,0
0,0,0,0,0,0,0,0,0
58904,900,4,163,2,161,3,1,0
58904,900,4,163,2,161,3,1,0
0,0,0,0,0,0,0,0,0
27970,139,6,5,3,2,1,0,0
0,0,0,0,0,0,0,0,0
0,0,0,0,0,0,0,0,0
0,0,0,0,0,0,0,0,0
0,0,0,0,0,0,0,0,0
0,0,0,0,0,0,0,0,0
0,0,0,0,0,0,0,0,0
0,0,0,0,0,0,0,0,0
0,0,0,0,0,0,0,0,0
9435,43,3,0,0,0,2,0,0
0,0,0,0,0,0,0,0,0
166472,487,4,4,3,1,8,0,0
0,0,0,0,0,0,0,0,0
0,0,0,0,0,0,0,0,0
279151,180,6,1,1,0,0,1,0
35304,179,6,14,12,2,1,0,0
0,0,0,0,0,0,0,0,0
674749,555,0,4,4,0,2,1,1
0,0,0,0,0,0,0,0,0
0,0,0,0,0,0,0,0,0
166451,489,4,4,3,1,8,1,0
169591,961,4,2,1,1,7,0,0
0,0,0,0,0,0,0,0,0
0,0,0,0,0,0,0,0,0
0,0,0,0,0,0,0,0,0
672731,555,0,4,4,0,2,1,1
0,0,0,0,0,0,0,0,0
0,0,0,0,0,0,0,0,0
10361,83,1,0,0,0,0,0,0
0,0,0,0,0,0,0,0,0
73387,47,4,0,0,0,1,0,0
10361,83,1,0,0,0,0,0,0
0,0,0,0,0,0,0,0,0
73387,47,4,0,0,0,1,0,0
0,0,0,0,0,0,0,0,0
0,0,0,0,0,0,0,0,0
0,0,0,0,0,0,0,0,0
0,0,0,0,0,0,0,0,0
0,0,0,0,0,0,0,0,0
0,0,0,0,0,0,0,0,0
0,0,0,0,0,0,0,0,0
0,0,0,0,0,0,0,0,0
0,0,0,0,0,0,0,0,0
0,0,0,0,0,0,0,0,0
0,0,0,0,0,0,0,0,0
137070,333,8,27,24,3,20,1,0
0,0,0,0,0,0,0,0,0
0,0,0,0,0,0,0,0,0
0,0,0,0,0,0,0,0,0
0,0,0,0,0,0,0,0,0
0,0,0,0,0,0,0,0,0
0,0,0,0,0,0,0,0,0
0,0,0,0,0,0,0,0,0
0,0,0,0,0,0,0,0,0
0,0,0,0,0,0,0,0,0
0,0,0,0,0,0,0,0,0
673267,555,0,4,4,0,2,1,1
0,0,0,0,0,0,0,0,0
0,0,0,0,0,0,0,0,0
0,0,0,0,0,0,0,0,0
0,0,0,0,0,0,0,0,0
0,0,0,0,0,0,0,0,0
0,0,0,0,0,0,0,0,0
0,0,0,0,0,0,0,0,0
0,0,0,0,0,0,0,0,0
0,0,0,0,0,0,0,0,0
0,0,0,0,0,0,0,0,0
0,0,0,0,0,0,0,0,0
0,0,0,0,0,0,0,0,0
0,0,0,0,0,0,0,0,0
0,0,0,0,0,0,0,0,0
0,0,0,0,0,0,0,0,0
0,0,0,0,0,0,0,0,0
0,0,0,0,0,0,0,0,0
0,0,0,0,0,0,0,0,0
0,0,0,0,0,0,0,0,0
0,0,0,0,0,0,0,0,0
167975,52,3,0,0,0,2,0,0
0,0,0,0,0,0,0,0,0
167975,52,3,0,0,0,2,0,0
167975,52,3,0,0,0,2,0,0
0,0,0,0,0,0,0,0,0
0,0,0,0,0,0,0,0,0
59106,901,4,163,2,161,3,1,0
59106,901,4,163,2,161,3,1,0
0,0,0,0,0,0,0,0,0
0,0,0,0,0,0,0,0,0
0,0,0,0,0,0,0,0,0
193754,92,1,3,1,2,5,0,0
6710,59,3,2,2,0,2,1,0
8512,71,1,0,0,0,0,0,0
108283,981,5,26,25,1,1,1,0
0,0,0,0,0,0,0,0,0
0,0,0,0,0,0,0,0,0
0,0,0,0,0,0,0,0,0
0,0,0,0,0,0,0,0,0
0,0,0,0,0,0,0,0,0
0,0,0,0,0,0,0,0,0
0,0,0,0,0,0,0,0,0
0,0,0,0,0,0,0,0,0
0,0,0,0,0,0,0,0,0
0,0,0,0,0,0,0,0,0
0,0,0,0,0,0,0,0,0
0,0,0,0,0,0,0,0,0
73429,47,4,0,0,0,1,0,0
104594,28,2,0,0,0,0,0,0
0,0,0,0,0,0,0,0,0
73427,47,4,0,0,0,1,0,0
17608,124,0,1,0,1,0,0,0
0,0,0,0,0,0,0,0,0
0,0,0,0,0,0,0,0,0
73538,48,4,0,0,0,1,0,0
0,0,0,0,0,0,0,0,0
0,0,0,0,0,0,0,0,0
0,0,0,0,0,0,0,0,0
12914,97,0,3,3,0,0,0,0
673076,555,0,4,4,0,2,1,1
0,0,0,0,0,0,0,0,0
49643,117,2,1,1,0,0,1,0
54677,192,3,8,5,3,4,1,0
0,0,0,0,0,0,0,0,0
73538,48,4,0,0,0,1,0,0
186070,374,3,25,7,18,14,1,0
0,0,0,0,0,0,0,0,0
0,0,0,0,0,0,0,0,0
0,0,0,0,0,0,0,0,0
0,0,0,0,0,0,0,0,0
73550,48,4,0,0,0,1,0,0
0,0,0,0,0,0,0,0,0
0,0,0,0,0,0,0,0,0
50459,231,2,2,2,0,1,0,0
136695,391,6,26,24,2,25,1,0
0,0,0,0,0,0,0,0,0
8073,140,7,26,6,20,1,1,0
8072,140,7,26,6,20,1,1,0
8073,140,7,26,6,20,1,1,0
0,0,0,0,0,0,0,0,0
0,0,0,0,0,0,0,0,0
0,0,0,0,0,0,0,0,0
0,0,0,0,0,0,0,0,0
0,0,0,0,0,0,0,0,0
0,0,0,0,0,0,0,0,0
0,0,0,0,0,0,0,0,0
73551,48,4,0,0,0,1,0,0
0,0,0,0,0,0,0,0,0
0,0,0,0,0,0,0,0,0
0,0,0,0,0,0,0,0,0
0,0,0,0,0,0,0,0,0
0,0,0,0,0,0,0,0,0
670115,555,0,4,4,0,2,1,1
8072,140,7,26,6,20,1,1,0
0,0,0,0,0,0,0,0,0
0,0,0,0,0,0,0,0,0
0,0,0,0,0,0,0,0,0
0,0,0,0,0,0,0,0,0
0,0,0,0,0,0,0,0,0
8073,140,7,26,6,20,1,1,0
73550,48,4,0,0,0,1,0,0
0,0,0,0,0,0,0,0,0
25122,67,2,1,1,0,2,0,0
25122,67,2,1,1,0,2,0,0
0,0,0,0,0,0,0,0,0
25122,67,2,1,1,0,2,0,0
25122,67,2,1,1,0,2,0,0
25122,67,2,1,1,0,2,0,0
25122,67,2,1,1,0,2,0,0
25122,67,2,1,1,0,2,0,0
0,0,0,0,0,0,0,0,0
0,0,0,0,0,0,0,0,0
0,0,0,0,0,0,0,0,0
0,0,0,0,0,0,0,0,0
5881700,59,3,1,1,0,2,1,0
0,0,0,0,0,0,0,0,0
12229,51,3,0,0,0,2,0,0
286491,83,4,4,4,0,2,1,0
0,0,0,0,0,0,0,0,0
0,0,0,0,0,0,0,0,0
5881700,59,3,1,1,0,2,1,0
0,0,0,0,0,0,0,0,0
0,0,0,0,0,0,0,0,0
5881700,59,3,1,1,0,2,1,0
5881700,59,3,1,1,0,2,1,0
0,0,0,0,0,0,0,0,0
12229,51,3,0,0,0,2,0,0
286491,83,4,4,4,0,2,1,0
12229,51,3,0,0,0,2,0,0
286491,83,4,4,4,0,2,1,0
0,0,0,0,0,0,0,0,0
5881700,59,3,1,1,0,2,1,0
0,0,0,0,0,0,0,0,0
0,0,0,0,0,0,0,0,0
0,0,0,0,0,0,0,0,0
0,0,0,0,0,0,0,0,0
0,0,0,0,0,0,0,0,0
4165785,208,0,52,51,1,0,1,0
4166001,213,0,52,51,1,0,1,0
50721,48,4,0,0,0,0,0,0
125172,204,2,50,49,1,0,1,0
0,0,0,0,0,0,0,0,0
0,0,0,0,0,0,0,0,0
0,0,0,0,0,0,0,0,0
4166001,213,0,52,51,1,0,1,0
4166001,213,0,52,51,1,0,1,0
415529,72,4,3,3,0,2,1,0
415529,72,4,3,3,0,2,1,0
125172,204,2,50,49,1,0,1,0
4166001,213,0,52,51,1,0,1,0
4166001,213,0,52,51,1,0,1,0
0,0,0,0,0,0,0,0,0
415529,72,4,3,3,0,2,1,0
415529,72,4,3,3,0,2,1,0
0,0,0,0,0,0,0,0,0
0,0,0,0,0,0,0,0,0
0,0,0,0,0,0,0,0,0
0,0,0,0,0,0,0,0,0
0,0,0,0,0,0,0,0,0
415529,72,4,3,3,0,2,1,0
0,0,0,0,0,0,0,0,0
125172,204,2,50,49,1,0,1,0
0,0,0,0,0,0,0,0,0
0,0,0,0,0,0,0,0,0
0,0,0,0,0,0,0,0,0
0,0,0,0,0,0,0,0,0
0,0,0,0,0,0,0,0,0
0,0,0,0,0,0,0,0,0
0,0,0,0,0,0,0,0,0
0,0,0,0,0,0,0,0,0
0,0,0,0,0,0,0,0,0
0,0,0,0,0,0,0,0,0
0,0,0,0,0,0,0,0,0
0,0,0,0,0,0,0,0,0
0,0,0,0,0,0,0,0,0
0,0,0,0,0,0,0,0,0
0,0,0,0,0,0,0,0,0
0,0,0,0,0,0,0,0,0
53472,184,3,5,1,4,3,1,0
0,0,0,0,0,0,0,0,0
0,0,0,0,0,0,0,0,0
0,0,0,0,0,0,0,0,0
0,0,0,0,0,0,0,0,0
0,0,0,0,0,0,0,0,0
0,0,0,0,0,0,0,0,0
0,0,0,0,0,0,0,0,0
0,0,0,0,0,0,0,0,0
37835,96,7,0,0,0,1,0,0
0,0,0,0,0,0,0,0,0
0,0,0,0,0,0,0,0,0
0,0,0,0,0,0,0,0,0
0,0,0,0,0,0,0,0,0
0,0,0,0,0,0,0,0,0
672464,555,0,4,4,0,2,1,1
674102,555,0,4,4,0,2,1,1
5513,50,1,1,0,1,0,0,0
5513,50,1,1,0,1,0,0,0
0,0,0,0,0,0,0,0,0
0,0,0,0,0,0,0,0,0
0,0,0,0,0,0,0,0,0
0,0,0,0,0,0,0,0,0
0,0,0,0,0,0,0,0,0
0,0,0,0,0,0,0,0,0
69390,185,4,13,1,12,0,1,0
69390,185,4,13,1,12,0,1,0
0,0,0,0,0,0,0,0,0
0,0,0,0,0,0,0,0,0
0,0,0,0,0,0,0,0,0
203983,145,3,2,1,1,18,0,0
203995,145,3,2,1,1,18,0,0
0,0,0,0,0,0,0,0,0
0,0,0,0,0,0,0,0,0
0,0,0,0,0,0,0,0,0
0,0,0,0,0,0,0,0,0
0,0,0,0,0,0,0,0,0
0,0,0,0,0,0,0,0,0
0,0,0,0,0,0,0,0,0
8073,140,7,26,6,20,1,1,0
0,0,0,0,0,0,0,0,0
0,0,0,0,0,0,0,0,0
0,0,0,0,0,0,0,0,0
0,0,0,0,0,0,0,0,0
0,0,0,0,0,0,0,0,0
0,0,0,0,0,0,0,0,0
169737,504,4,7,4,3,8,1,0
0,0,0,0,0,0,0,0,0
673202,555,0,4,4,0,2,1,1
0,0,0,0,0,0,0,0,0
0,0,0,0,0,0,0,0,0
0,0,0,0,0,0,0,0,0
670673,555,0,4,4,0,2,1,1
672856,555,0,4,4,0,2,1,1
0,0,0,0,0,0,0,0,0
8073,140,7,26,6,20,1,1,0
0,0,0,0,0,0,0,0,0
0,0,0,0,0,0,0,0,0
73550,48,4,0,0,0,1,0,0
72147,685,1,126,122,4,12,1,0
0,0,0,0,0,0,0,0,0
0,0,0,0,0,0,0,0,0
0,0,0,0,0,0,0,0,0
244972,546,11,50,41,9,5,0,0
0,0,0,0,0,0,0,0,0
0,0,0,0,0,0,0,0,0
7021,30,0,3,0,3,0,1,0
0,0,0,0,0,0,0,0,0
0,0,0,0,0,0,0,0,0
8073,140,7,26,6,20,1,1,0
672341,555,0,4,4,0,2,1,1
73538,48,4,0,0,0,1,0,0
0,0,0,0,0,0,0,0,0
0,0,0,0,0,0,0,0,0
0,0,0,0,0,0,0,0,0
272583,1139,6,191,188,3,8,1,0
0,0,0,0,0,0,0,0,0
73538,48,4,0,0,0,1,0,0
0,0,0,0,0,0,0,0,0
0,0,0,0,0,0,0,0,0
0,0,0,0,0,0,0,0,0
85243,23,4,1,1,0,0,0,0
85243,23,4,1,1,0,0,0,0
0,0,0,0,0,0,0,0,0
0,0,0,0,0,0,0,0,0
0,0,0,0,0,0,0,0,0
36998,164,3,8,4,4,11,1,0
673283,2996,19,192,50,142,18,1,0
0,0,0,0,0,0,0,0,0
0,0,0,0,0,0,0,0,0
0,0,0,0,0,0,0,0,0
0,0,0,0,0,0,0,0,0
0,0,0,0,0,0,0,0,0
23548,39,2,0,0,0,0,1,0
1998630,67,5,1,1,0,2,1,0
0,0,0,0,0,0,0,0,0
0,0,0,0,0,0,0,0,0
0,0,0,0,0,0,0,0,0
0,0,0,0,0,0,0,0,0
0,0,0,0,0,0,0,0,0
0,0,0,0,0,0,0,0,0
0,0,0,0,0,0,0,0,0
0,0,0,0,0,0,0,0,0
0,0,0,0,0,0,0,0,0
0,0,0,0,0,0,0,0,0
0,0,0,0,0,0,0,0,0
1998630,67,5,1,1,0,2,1,0
0,0,0,0,0,0,0,0,0
1998630,67,5,1,1,0,2,1,0
0,0,0,0,0,0,0,0,0
0,0,0,0,0,0,0,0,0
0,0,0,0,0,0,0,0,0
257938,1147,1,207,43,164,7,1,0
257950,1147,1,207,43,164,7,1,0
257942,1147,1,207,43,164,7,1,0
0,0,0,0,0,0,0,0,0
0,0,0,0,0,0,0,0,0
0,0,0,0,0,0,0,0,0
0,0,0,0,0,0,0,0,0
0,0,0,0,0,0,0,0,0
0,0,0,0,0,0,0,0,0
0,0,0,0,0,0,0,0,0
0,0,0,0,0,0,0,0,0
0,0,0,0,0,0,0,0,0
0,0,0,0,0,0,0,0,0
0,0,0,0,0,0,0,0,0
0,0,0,0,0,0,0,0,0
0,0,0,0,0,0,0,0,0
0,0,0,0,0,0,0,0,0
0,0,0,0,0,0,0,0,0
0,0,0,0,0,0,0,0,0
0,0,0,0,0,0,0,0,0
0,0,0,0,0,0,0,0,0
0,0,0,0,0,0,0,0,0
0,0,0,0,0,0,0,0,0
0,0,0,0,0,0,0,0,0
0,0,0,0,0,0,0,0,0
0,0,0,0,0,0,0,0,0
0,0,0,0,0,0,0,0,0
0,0,0,0,0,0,0,0,0
0,0,0,0,0,0,0,0,0
0,0,0,0,0,0,0,0,0
0,0,0,0,0,0,0,0,0
0,0,0,0,0,0,0,0,0
0,0,0,0,0,0,0,0,0
0,0,0,0,0,0,0,0,0
0,0,0,0,0,0,0,0,0
0,0,0,0,0,0,0,0,0
0,0,0,0,0,0,0,0,0
0,0,0,0,0,0,0,0,0
0,0,0,0,0,0,0,0,0
0,0,0,0,0,0,0,0,0
0,0,0,0,0,0,0,0,0
12645,85,1,5,0,5,0,0,0
9086,79,1,0,0,0,0,0,0
108371,981,5,26,25,1,1,1,0
0,0,0,0,0,0,0,0,0
0,0,0,0,0,0,0,0,0
0,0,0,0,0,0,0,0,0
0,0,0,0,0,0,0,0,0
0,0,0,0,0,0,0,0,0
0,0,0,0,0,0,0,0,0
10327,81,1,0,0,0,0,0,0
0,0,0,0,0,0,0,0,0
0,0,0,0,0,0,0,0,0
0,0,0,0,0,0,0,0,0
0,0,0,0,0,0,0,0,0
73550,48,4,0,0,0,1,0,0
0,0,0,0,0,0,0,0,0
673263,555,0,4,4,0,2,1,1
73538,48,4,0,0,0,1,0,0
8073,140,7,26,6,20,1,1,0
0,0,0,0,0,0,0,0,0
672538,555,0,4,4,0,2,1,1
673449,555,0,4,4,0,2,1,1
0,0,0,0,0,0,0,0,0
0,0,0,0,0,0,0,0,0
8073,140,7,26,8,18,1,1,0
0,0,0,0,0,0,0,0,0
8073,140,7,26,6,20,1,1,0
0,0,0,0,0,0,0,0,0
73538,48,4,0,0,0,1,0,0
0,0,0,0,0,0,0,0,0
0,0,0,0,0,0,0,0,0
73538,48,4,0,0,0,1,0,0
0,0,0,0,0,0,0,0,0
670592,555,0,4,4,0,2,1,1
0,0,0,0,0,0,0,0,0
0,0,0,0,0,0,0,0,0
73538,48,4,0,0,0,1,0,0
0,0,0,0,0,0,0,0,0
8073,140,7,26,6,20,1,1,0
0,0,0,0,0,0,0,0,0
8073,140,7,26,6,20,1,1,0
0,0,0,0,0,0,0,0,0
0,0,0,0,0,0,0,0,0
0,0,0,0,0,0,0,0,0
0,0,0,0,0,0,0,0,0
0,0,0,0,0,0,0,0,0
0,0,0,0,0,0,0,0,0
73538,48,4,0,0,0,1,0,0
0,0,0,0,0,0,0,0,0
0,0,0,0,0,0,0,0,0
73538,48,4,0,0,0,1,0,0
12515,86,0,1,1,0,0,0,0
0,0,0,0,0,0,0,0,0
0,0,0,0,0,0,0,0,0
0,0,0,0,0,0,0,0,0
0,0,0,0,0,0,0,0,0
73550,48,4,0,0,0,1,0,0
0,0,0,0,0,0,0,0,0
0,0,0,0,0,0,0,0,0
7003,31,2,0,0,0,1,0,0
0,0,0,0,0,0,0,0,0
0,0,0,0,0,0,0,0,0
0,0,0,0,0,0,0,0,0
0,0,0,0,0,0,0,0,0
0,0,0,0,0,0,0,0,0
290910,2308,1,247,4,243,4,1,0
0,0,0,0,0,0,0,0,0
0,0,0,0,0,0,0,0,0
0,0,0,0,0,0,0,0,0
90951,1141,4,87,84,3,0,1,0
0,0,0,0,0,0,0,0,0
165674,473,4,2,1,1,7,0,0
0,0,0,0,0,0,0,0,0
0,0,0,0,0,0,0,0,0
166035,477,4,4,3,1,8,0,0
165641,477,4,4,3,1,8,0,0
165641,477,4,4,3,1,8,0,0
0,0,0,0,0,0,0,0,0
36356,50,2,0,0,0,2,0,0
36356,50,2,0,0,0,2,0,0
235936,208,0,52,51,1,0,1,0
236152,213,0,52,51,1,0,1,0
14441,41,2,0,0,0,2,0,0
14441,41,2,0,0,0,2,0,0
236152,213,0,52,51,1,0,1,0
236152,213,0,52,51,1,0,1,0
36356,50,2,0,0,0,2,0,0
236152,213,0,52,51,1,0,1,0
236152,213,0,52,51,1,0,1,0
36356,50,2,0,0,0,2,0,0
0,0,0,0,0,0,0,0,0
236152,213,0,52,51,1,0,1,0
0,0,0,0,0,0,0,0,0
0,0,0,0,0,0,0,0,0
0,0,0,0,0,0,0,0,0
0,0,0,0,0,0,0,0,0
233112,64,4,3,3,0,2,1,0
0,0,0,0,0,0,0,0,0
0,0,0,0,0,0,0,0,0
2026604,61,4,1,1,0,2,1,0
233112,64,4,3,3,0,2,1,0
0,0,0,0,0,0,0,0,0
2026604,61,4,1,1,0,2,1,0
233112,64,4,3,3,0,2,1,0
0,0,0,0,0,0,0,0,0
0,0,0,0,0,0,0,0,0
2026604,61,4,1,1,0,2,1,0
0,0,0,0,0,0,0,0,0
0,0,0,0,0,0,0,0,0
0,0,0,0,0,0,0,0,0
0,0,0,0,0,0,0,0,0
0,0,0,0,0,0,0,0,0
0,0,0,0,0,0,0,0,0
0,0,0,0,0,0,0,0,0
5047,24,3,0,0,0,0,0,0
0,0,0,0,0,0,0,0,0
0,0,0,0,0,0,0,0,0
0,0,0,0,0,0,0,0,0
0,0,0,0,0,0,0,0,0
5880466,59,3,1,1,0,2,1,0
0,0,0,0,0,0,0,0,0
5880466,59,3,1,1,0,2,1,0
5880466,59,3,1,1,0,2,1,0
5880466,59,3,1,1,0,2,1,0
5880466,59,3,1,1,0,2,1,0
0,0,0,0,0,0,0,0,0
5047,24,3,0,0,0,0,0,0
5047,24,3,0,0,0,0,0,0
5047,24,3,0,0,0,0,0,0
5047,24,3,0,0,0,0,0,0
0,0,0,0,0,0,0,0,0
0,0,0,0,0,0,0,0,0
0,0,0,0,0,0,0,0,0
0,0,0,0,0,0,0,0,0
0,0,0,0,0,0,0,0,0
0,0,0,0,0,0,0,0,0
0,0,0,0,0,0,0,0,0
0,0,0,0,0,0,0,0,0
0,0,0,0,0,0,0,0,0
0,0,0,0,0,0,0,0,0
4103,55,0,5,3,2,0,0,0
0,0,0,0,0,0,0,0,0
0,0,0,0,0,0,0,0,0
0,0,0,0,0,0,0,0,0
0,0,0,0,0,0,0,0,0
0,0,0,0,0,0,0,0,0
0,0,0,0,0,0,0,0,0
0,0,0,0,0,0,0,0,0
0,0,0,0,0,0,0,0,0
0,0,0,0,0,0,0,0,0
0,0,0,0,0,0,0,0,0
8525,129,2,11,11,0,0,1,0
0,0,0,0,0,0,0,0,0
0,0,0,0,0,0,0,0,0
0,0,0,0,0,0,0,0,0
0,0,0,0,0,0,0,0,0
0,0,0,0,0,0,0,0,0
0,0,0,0,0,0,0,0,0
0,0,0,0,0,0,0,0,0
0,0,0,0,0,0,0,0,0
8525,129,2,11,11,0,0,1,0
8525,129,2,11,11,0,0,1,0
8525,129,2,11,11,0,0,1,0
0,0,0,0,0,0,0,0,0
0,0,0,0,0,0,0,0,0
0,0,0,0,0,0,0,0,0
0,0,0,0,0,0,0,0,0
0,0,0,0,0,0,0,0,0
0,0,0,0,0,0,0,0,0
0,0,0,0,0,0,0,0,0
0,0,0,0,0,0,0,0,0
8073,140,7,26,6,20,1,1,0
8073,140,7,26,6,20,1,1,0
0,0,0,0,0,0,0,0,0
72793,48,4,0,0,0,1,0,0
8073,140,7,26,6,20,1,1,0
230841,1449,10,152,144,8,11,1,0
672843,555,0,4,4,0,2,1,1
72805,48,4,0,0,0,1,0,0
0,0,0,0,0,0,0,0,0
0,0,0,0,0,0,0,0,0
72805,48,4,0,0,0,1,0,0
72793,48,4,0,0,0,1,0,0
8073,140,7,26,6,20,1,1,0
157,4,0,0,0,0,0,0,0
0,0,0,0,0,0,0,0,0
0,0,0,0,0,0,0,0,0
0,0,0,0,0,0,0,0,0
436751,52,2,1,1,0,0,1,0
389284,287,8,5,5,0,0,1,0
302684,252,6,7,7,0,0,1,0
288143,196,6,1,1,0,0,1,0
0,0,0,0,0,0,0,0,0
0,0,0,0,0,0,0,0,0
0,0,0,0,0,0,0,0,0
0,0,0,0,0,0,0,0,0
0,0,0,0,0,0,0,0,0
0,0,0,0,0,0,0,0,0
0,0,0,0,0,0,0,0,0
0,0,0,0,0,0,0,0,0
0,0,0,0,0,0,0,0,0
0,0,0,0,0,0,0,0,0
8073,140,7,26,6,20,1,1,0
187338,879,0,80,55,25,11,1,0
0,0,0,0,0,0,0,0,0
0,0,0,0,0,0,0,0,0
0,0,0,0,0,0,0,0,0
0,0,0,0,0,0,0,0,0
0,0,0,0,0,0,0,0,0
0,0,0,0,0,0,0,0,0
0,0,0,0,0,0,0,0,0
0,0,0,0,0,0,0,0,0
0,0,0,0,0,0,0,0,0
0,0,0,0,0,0,0,0,0
0,0,0,0,0,0,0,0,0
0,0,0,0,0,0,0,0,0
0,0,0,0,0,0,0,0,0
0,0,0,0,0,0,0,0,0
30885,58,3,0,0,0,3,1,0
102298,152,4,4,4,0,2,1,0
0,0,0,0,0,0,0,0,0
0,0,0,0,0,0,0,0,0
29248,77,3,0,0,0,3,0,0
0,0,0,0,0,0,0,0,0
0,0,0,0,0,0,0,0,0
0,0,0,0,0,0,0,0,0
225811,119,0,15,6,9,0,1,0
225811,119,0,15,6,9,0,1,0
225811,119,0,15,6,9,0,1,0
225811,119,0,15,6,9,0,1,0
225811,119,0,15,6,9,0,1,0
225811,119,0,15,6,9,0,1,0
225811,119,0,15,6,9,0,1,0
8248,146,0,15,15,0,5,1,0
8315,146,0,15,15,0,5,1,0
0,0,0,0,0,0,0,0,0
8248,146,0,15,15,0,5,1,0
8315,146,0,15,15,0,5,1,0
8248,146,0,15,15,0,5,1,0
8315,146,0,15,15,0,5,1,0
0,0,0,0,0,0,0,0,0
0,0,0,0,0,0,0,0,0
0,0,0,0,0,0,0,0,0
0,0,0,0,0,0,0,0,0
0,0,0,0,0,0,0,0,0
14457,41,2,0,0,0,2,0,0
14457,41,2,0,0,0,2,0,0
14457,41,2,0,0,0,2,0,0
0,0,0,0,0,0,0,0,0
0,0,0,0,0,0,0,0,0
0,0,0,0,0,0,0,0,0
0,0,0,0,0,0,0,0,0
0,0,0,0,0,0,0,0,0
36360,50,2,0,0,0,2,0,0
36364,50,2,0,0,0,2,0,0
36356,50,2,0,0,0,2,0,0
33839,46,2,0,0,0,2,0,0
36364,50,2,0,0,0,2,0,0
36352,50,2,0,0,0,2,0,0
36364,50,2,0,0,0,2,0,0
34407,50,2,0,0,0,2,0,0
0,0,0,0,0,0,0,0,0
0,0,0,0,0,0,0,0,0
246828,59,3,1,1,0,2,1,0
36360,50,2,0,0,0,2,0,0
36364,50,2,0,0,0,2,0,0
36356,50,2,0,0,0,2,0,0
33610,46,2,0,0,0,2,0,0
36364,50,2,0,0,0,2,0,0
36364,50,2,0,0,0,2,0,0
36408,50,2,0,0,0,2,0,0
36352,50,2,0,0,0,2,0,0
36376,50,2,0,0,0,2,0,0
0,0,0,0,0,0,0,0,0
36352,50,2,0,0,0,2,0,0
34407,50,2,0,0,0,2,0,0
34415,50,2,0,0,0,2,0,0
36356,50,2,0,0,0,2,0,0
36356,50,2,0,0,0,2,0,0
33610,46,2,0,0,0,2,0,0
0,0,0,0,0,0,0,0,0
36364,50,2,0,0,0,2,0,0
36352,50,2,0,0,0,2,0,0
36364,50,2,0,0,0,2,0,0
36352,50,2,0,0,0,2,0,0
36376,50,2,0,0,0,2,0,0
36376,50,2,0,0,0,2,0,0
0,0,0,0,0,0,0,0,0
34415,50,2,0,0,0,2,0,0
36352,50,2,0,0,0,2,0,0
36352,50,2,0,0,0,2,0,0
34407,50,2,0,0,0,2,0,0
34407,50,2,0,0,0,2,0,0
246828,59,3,1,1,0,2,1,0
246828,59,3,1,1,0,2,1,0
36364,50,2,0,0,0,2,0,0
36364,50,2,0,0,0,2,0,0
36364,50,2,0,0,0,2,0,0
36364,50,2,0,0,0,2,0,0
246828,59,3,1,1,0,2,1,0
36360,50,2,0,0,0,2,0,0
36364,50,2,0,0,0,2,0,0
36356,50,2,0,0,0,2,0,0
33610,46,2,0,0,0,2,0,0
36364,50,2,0,0,0,2,0,0
36364,50,2,0,0,0,2,0,0
36408,50,2,0,0,0,2,0,0
36352,50,2,0,0,0,2,0,0
0,0,0,0,0,0,0,0,0
36376,50,2,0,0,0,2,0,0
0,0,0,0,0,0,0,0,0
36364,50,2,0,0,0,2,0,0
36352,50,2,0,0,0,2,0,0
0,0,0,0,0,0,0,0,0
34407,50,2,0,0,0,2,0,0
34415,50,2,0,0,0,2,0,0
104968,65,4,9,9,0,2,1,0
104970,65,4,9,9,0,2,1,0
104979,65,4,9,9,0,2,1,0
104968,65,4,9,9,0,2,1,0
104970,65,4,9,9,0,2,1,0
0,0,0,0,0,0,0,0,0
0,0,0,0,0,0,0,0,0
104979,65,4,9,9,0,2,1,0
104968,65,4,9,9,0,2,1,0
0,0,0,0,0,0,0,0,0
0,0,0,0,0,0,0,0,0
0,0,0,0,0,0,0,0,0
0,0,0,0,0,0,0,0,0
0,0,0,0,0,0,0,0,0
0,0,0,0,0,0,0,0,0
20158,53,3,0,0,0,0,0,0
20158,53,3,0,0,0,0,0,0
0,0,0,0,0,0,0,0,0
0,0,0,0,0,0,0,0,0
0,0,0,0,0,0,0,0,0
0,0,0,0,0,0,0,0,0
0,0,0,0,0,0,0,0,0
20144,53,3,0,0,0,0,0,0
0,0,0,0,0,0,0,0,0
0,0,0,0,0,0,0,0,0
0,0,0,0,0,0,0,0,0
0,0,0,0,0,0,0,0,0
0,0,0,0,0,0,0,0,0
0,0,0,0,0,0,0,0,0
0,0,0,0,0,0,0,0,0
20158,53,3,0,0,0,0,0,0
20158,53,3,0,0,0,0,0,0
20140,53,3,0,0,0,0,0,0
0,0,0,0,0,0,0,0,0
0,0,0,0,0,0,0,0,0
0,0,0,0,0,0,0,0,0
0,0,0,0,0,0,0,0,0
20144,53,3,0,0,0,0,0,0
0,0,0,0,0,0,0,0,0
0,0,0,0,0,0,0,0,0
0,0,0,0,0,0,0,0,0
0,0,0,0,0,0,0,0,0
0,0,0,0,0,0,0,0,0
0,0,0,0,0,0,0,0,0
0,0,0,0,0,0,0,0,0
0,0,0,0,0,0,0,0,0
0,0,0,0,0,0,0,0,0
20158,53,3,0,0,0,0,0,0
20158,53,3,0,0,0,0,0,0
0,0,0,0,0,0,0,0,0
0,0,0,0,0,0,0,0,0
20140,53,3,0,0,0,0,0,0
20140,53,3,0,0,0,0,0,0
0,0,0,0,0,0,0,0,0
0,0,0,0,0,0,0,0,0
0,0,0,0,0,0,0,0,0
20158,53,3,0,0,0,0,0,0
20140,53,3,0,0,0,0,0,0
0,0,0,0,0,0,0,0,0
0,0,0,0,0,0,0,0,0
0,0,0,0,0,0,0,0,0
20144,53,3,0,0,0,0,0,0
0,0,0,0,0,0,0,0,0
287241,72,4,4,4,0,4,1,0
287241,72,4,4,4,0,4,1,0
287241,72,4,4,4,0,4,1,0
287241,72,4,4,4,0,4,1,0
10395,54,6,0,0,0,2,1,0
10395,54,6,0,0,0,2,1,0
10395,54,6,0,0,0,2,1,0
10395,54,6,0,0,0,2,1,0
10395,54,6,0,0,0,2,1,0
13024,84,1,3,3,0,0,0,0
13024,84,1,3,3,0,0,0,0
13024,84,1,3,3,0,0,0,0
13024,84,1,3,3,0,0,0,0
13024,84,1,3,3,0,0,0,0
0,0,0,0,0,0,0,0,0
233063,62,4,3,3,0,2,1,0
234115,59,4,3,3,0,2,1,0
111842,61,4,3,3,0,2,1,0
111842,61,4,3,3,0,2,1,0
111858,61,4,3,3,0,2,1,0
0,0,0,0,0,0,0,0,0
0,0,0,0,0,0,0,0,0
232826,61,4,3,3,0,2,1,0
233305,64,4,3,3,0,2,1,0
233324,64,4,3,3,0,2,1,0
0,0,0,0,0,0,0,0,0
234115,59,4,3,3,0,2,1,0
111858,61,4,3,3,0,2,1,0
233129,64,4,3,3,0,2,1,0
233305,64,4,3,3,0,2,1,0
0,0,0,0,0,0,0,0,0
233324,64,4,3,3,0,2,1,0
233324,64,4,3,3,0,2,1,0
0,0,0,0,0,0,0,0,0
0,0,0,0,0,0,0,0,0
234115,59,4,3,3,0,2,1,0
234115,59,4,3,3,0,2,1,0
233129,64,4,3,3,0,2,1,0
0,0,0,0,0,0,0,0,0
111858,61,4,3,3,0,2,1,0
111858,61,4,3,3,0,2,1,0
232826,61,4,3,3,0,2,1,0
232826,61,4,3,3,0,2,1,0
232826,61,4,3,3,0,2,1,0
233305,64,4,3,3,0,2,1,0
233324,64,4,3,3,0,2,1,0
0,0,0,0,0,0,0,0,0
234115,59,4,3,3,0,2,1,0
0,0,0,0,0,0,0,0,0
111858,61,4,3,3,0,2,1,0
233129,64,4,3,3,0,2,1,0
139186,51,2,0,0,0,2,0,0
0,0,0,0,0,0,0,0,0
232886,64,4,3,3,0,2,1,0
33839,46,2,0,0,0,2,0,0
0,0,0,0,0,0,0,0,0
0,0,0,0,0,0,0,0,0
0,0,0,0,0,0,0,0,0
33839,46,2,0,0,0,2,0,0
33839,46,2,0,0,0,2,0,0
1446616,70,4,9,9,0,2,1,0
1446616,70,4,9,9,0,2,1,0
36408,50,2,0,0,0,2,0,0
36408,50,2,0,0,0,2,0,0
3717,22,0,2,2,0,1,0,0
3717,22,0,2,2,0,1,0,0
36364,50,2,0,0,0,2,0,0
36364,50,2,0,0,0,2,0,0
0,0,0,0,0,0,0,0,0
0,0,0,0,0,0,0,0,0
10486,39,1,0,0,0,1,0,0
10486,39,1,0,0,0,1,0,0
0,0,0,0,0,0,0,0,0
0,0,0,0,0,0,0,0,0
36360,50,2,0,0,0,2,0,0
36360,50,2,0,0,0,2,0,0
139186,51,2,0,0,0,2,0,0
139186,51,2,0,0,0,2,0,0
0,0,0,0,0,0,0,0,0
0,0,0,0,0,0,0,0,0
0,0,0,0,0,0,0,0,0
0,0,0,0,0,0,0,0,0
0,0,0,0,0,0,0,0,0
0,0,0,0,0,0,0,0,0
0,0,0,0,0,0,0,0,0
0,0,0,0,0,0,0,0,0
1315864,66,5,0,0,0,4,1,0
1315864,66,5,0,0,0,4,1,0
0,0,0,0,0,0,0,0,0
0,0,0,0,0,0,0,0,0
139186,51,2,0,0,0,2,0,0
232886,64,4,3,3,0,2,1,0
33839,46,2,0,0,0,2,0,0
0,0,0,0,0,0,0,0,0
0,0,0,0,0,0,0,0,0
0,0,0,0,0,0,0,0,0
0,0,0,0,0,0,0,0,0
0,0,0,0,0,0,0,0,0
0,0,0,0,0,0,0,0,0
0,0,0,0,0,0,0,0,0
160217,43,3,0,0,0,0,0,0
0,0,0,0,0,0,0,0,0
1315864,66,5,0,0,0,4,1,0
0,0,0,0,0,0,0,0,0
1446616,70,4,9,9,0,2,1,0
241310,54,3,0,0,0,0,1,0
0,0,0,0,0,0,0,0,0
233129,64,4,3,3,0,2,1,0
20158,53,3,0,0,0,0,0,0
20154,53,3,0,0,0,0,0,0
0,0,0,0,0,0,0,0,0
135934,41,4,1,1,0,2,0,0
0,0,0,0,0,0,0,0,0
1315864,66,5,0,0,0,4,1,0
7985,50,4,0,0,0,0,0,0
233112,64,4,3,3,0,2,1,0
55707,73,4,0,0,0,0,1,0
97661,39,4,0,0,0,2,1,0
0,0,0,0,0,0,0,0,0
233115,64,4,3,3,0,2,1,0
1446616,70,4,9,9,0,2,1,0
95898,54,4,1,1,0,2,1,0
233109,64,4,3,3,0,2,1,0
241310,54,3,0,0,0,0,1,0
0,0,0,0,0,0,0,0,0
0,0,0,0,0,0,0,0,0
0,0,0,0,0,0,0,0,0
0,0,0,0,0,0,0,0,0
233129,64,4,3,3,0,2,1,0
0,0,0,0,0,0,0,0,0
20154,53,3,0,0,0,0,0,0
7985,50,4,0,0,0,0,0,0
233112,64,4,3,3,0,2,1,0
233129,64,4,3,3,0,2,1,0
20158,53,3,0,0,0,0,0,0
20154,53,3,0,0,0,0,0,0
0,0,0,0,0,0,0,0,0
1315864,66,5,0,0,0,4,1,0
7985,50,4,0,0,0,0,0,0
233112,64,4,3,3,0,2,1,0
55707,73,4,0,0,0,0,1,0
97661,39,4,0,0,0,2,1,0
0,0,0,0,0,0,0,0,0
1446616,70,4,9,9,0,2,1,0
0,0,0,0,0,0,0,0,0
233109,64,4,3,3,0,2,1,0
241310,54,3,0,0,0,0,1,0
0,0,0,0,0,0,0,0,0
10486,39,1,0,0,0,1,0,0
10486,39,1,0,0,0,1,0,0
0,0,0,0,0,0,0,0,0
10486,39,1,0,0,0,1,0,0
232886,64,4,3,3,0,2,1,0
232886,64,4,3,3,0,2,1,0
232886,64,4,3,3,0,2,1,0
0,0,0,0,0,0,0,0,0
0,0,0,0,0,0,0,0,0
0,0,0,0,0,0,0,0,0
0,0,0,0,0,0,0,0,0
0,0,0,0,0,0,0,0,0
0,0,0,0,0,0,0,0,0
0,0,0,0,0,0,0,0,0
3717,22,0,2,2,0,1,0,0
3717,22,0,2,2,0,1,0,0
0,0,0,0,0,0,0,0,0
0,0,0,0,0,0,0,0,0
415409,62,4,3,3,0,2,1,0
415409,62,4,3,3,0,2,1,0
182425,60,4,2,0,2,2,1,0
182425,60,4,2,0,2,2,1,0
415542,73,4,3,3,0,2,1,0
415542,73,4,3,3,0,2,1,0
139186,51,2,0,0,0,2,0,0
182409,60,4,2,0,2,2,1,0
182409,60,4,2,0,2,2,1,0
415517,62,4,3,3,0,2,1,0
415517,62,4,3,3,0,2,1,0
0,0,0,0,0,0,0,0,0
0,0,0,0,0,0,0,0,0
415532,70,4,3,3,0,2,1,0
415532,70,4,3,3,0,2,1,0
0,0,0,0,0,0,0,0,0
415409,62,4,3,3,0,2,1,0
415409,62,4,3,3,0,2,1,0
182425,60,4,2,0,2,2,1,0
182425,60,4,2,0,2,2,1,0
415542,73,4,3,3,0,2,1,0
415542,73,4,3,3,0,2,1,0
415463,62,4,3,3,0,2,1,0
415463,62,4,3,3,0,2,1,0
182409,60,4,2,0,2,2,1,0
182409,60,4,2,0,2,2,1,0
415483,62,4,3,3,0,2,1,0
415483,62,4,3,3,0,2,1,0
665731,62,4,3,3,0,2,1,0
665731,62,4,3,3,0,2,1,0
415463,62,4,3,3,0,2,1,0
415463,62,4,3,3,0,2,1,0
415517,62,4,3,3,0,2,1,0
415517,62,4,3,3,0,2,1,0
415543,74,4,3,3,0,2,1,0
415543,74,4,3,3,0,2,1,0
94205,79,3,0,0,0,3,0,0
415532,70,4,3,3,0,2,1,0
415532,70,4,3,3,0,2,1,0
415457,62,4,3,3,0,2,1,0
415457,62,4,3,3,0,2,1,0
3262982,210,0,52,51,1,0,1,0
3262982,210,0,52,51,1,0,1,0
420881,62,4,3,3,0,2,1,0
420893,62,4,3,3,0,2,1,0
0,0,0,0,0,0,0,0,0
0,0,0,0,0,0,0,0,0
415483,62,4,3,3,0,2,1,0
415483,62,4,3,3,0,2,1,0
182409,60,4,2,0,2,2,1,0
0,0,0,0,0,0,0,0,0
415463,62,4,3,3,0,2,1,0
415463,62,4,3,3,0,2,1,0
415543,74,4,3,3,0,2,1,0
415532,70,4,3,3,0,2,1,0
415543,74,4,3,3,0,2,1,0
415532,70,4,3,3,0,2,1,0
415517,62,4,3,3,0,2,1,0
415457,62,4,3,3,0,2,1,0
415517,62,4,3,3,0,2,1,0
415457,62,4,3,3,0,2,1,0
0,0,0,0,0,0,0,0,0
0,0,0,0,0,0,0,0,0
0,0,0,0,0,0,0,0,0
0,0,0,0,0,0,0,0,0
0,0,0,0,0,0,0,0,0
0,0,0,0,0,0,0,0,0
63280,55,3,0,0,0,0,0,0
63280,55,3,0,0,0,0,0,0
182425,60,4,2,0,2,2,1,0
0,0,0,0,0,0,0,0,0
415409,62,4,3,3,0,2,1,0
415409,62,4,3,3,0,2,1,0
415542,73,4,3,3,0,2,1,0
415542,73,4,3,3,0,2,1,0
415463,62,4,3,3,0,2,1,0
415463,62,4,3,3,0,2,1,0
0,0,0,0,0,0,0,0,0
0,0,0,0,0,0,0,0,0
665731,62,4,3,3,0,2,1,0
665731,62,4,3,3,0,2,1,0
415409,62,4,3,3,0,2,1,0
182425,60,4,2,0,2,2,1,0
415542,73,4,3,3,0,2,1,0
415463,62,4,3,3,0,2,1,0
182409,60,4,2,0,2,2,1,0
415483,62,4,3,3,0,2,1,0
665731,62,4,3,3,0,2,1,0
415463,62,4,3,3,0,2,1,0
415517,62,4,3,3,0,2,1,0
415543,74,4,3,3,0,2,1,0
0,0,0,0,0,0,0,0,0
0,0,0,0,0,0,0,0,0
0,0,0,0,0,0,0,0,0
415532,70,4,3,3,0,2,1,0
415457,62,4,3,3,0,2,1,0
3262982,210,0,52,51,1,0,1,0
63280,55,3,0,0,0,0,0,0
420881,62,4,3,3,0,2,1,0
420893,62,4,3,3,0,2,1,0
0,0,0,0,0,0,0,0,0
0,0,0,0,0,0,0,0,0
6592,120,0,1,1,0,0,1,0
0,0,0,0,0,0,0,0,0
0,0,0,0,0,0,0,0,0
0,0,0,0,0,0,0,0,0
0,0,0,0,0,0,0,0,0
0,0,0,0,0,0,0,0,0
9704,33,4,0,0,0,2,0,0
0,0,0,0,0,0,0,0,0
0,0,0,0,0,0,0,0,0
0,0,0,0,0,0,0,0,0
0,0,0,0,0,0,0,0,0
484162,103,0,7,0,7,1,0,0
0,0,0,0,0,0,0,0,0
332695,83,4,4,4,0,2,1,0
41857,51,3,0,0,0,2,0,0
0,0,0,0,0,0,0,0,0
0,0,0,0,0,0,0,0,0
22416,50,0,0,0,0,0,0,0
2707,27,1,2,2,0,1,0,0
0,0,0,0,0,0,0,0,0
0,0,0,0,0,0,0,0,0
0,0,0,0,0,0,0,0,0
77754,101,1,4,2,2,0,0,0
0,0,0,0,0,0,0,0,0
278420,38,2,0,0,0,0,1,0
167005,482,4,2,1,1,7,1,0
0,0,0,0,0,0,0,0,0
12699,82,0,3,3,0,0,0,0
13471,85,0,3,3,0,0,0,0
11506,57,0,7,5,2,0,0,0
0,0,0,0,0,0,0,0,0
0,0,0,0,0,0,0,0,0
0,0,0,0,0,0,0,0,0
14141,117,0,11,6,5,5,1,0
0,0,0,0,0,0,0,0,0
0,0,0,0,0,0,0,0,0
0,0,0,0,0,0,0,0,0
232841,61,4,3,3,0,2,1,0
0,0,0,0,0,0,0,0,0
673066,555,0,4,4,0,2,1,1
132260,66,4,9,9,0,2,1,0
166526,478,4,4,3,1,8,0,0
0,0,0,0,0,0,0,0,0
0,0,0,0,0,0,0,0,0
0,0,0,0,0,0,0,0,0
0,0,0,0,0,0,0,0,0
0,0,0,0,0,0,0,0,0
0,0,0,0,0,0,0,0,0
0,0,0,0,0,0,0,0,0
0,0,0,0,0,0,0,0,0
0,0,0,0,0,0,0,0,0
0,0,0,0,0,0,0,0,0
0,0,0,0,0,0,0,0,0
0,0,0,0,0,0,0,0,0
0,0,0,0,0,0,0,0,0
0,0,0,0,0,0,0,0,0
0,0,0,0,0,0,0,0,0
0,0,0,0,0,0,0,0,0
203980,145,3,2,1,1,18,0,0
203992,145,3,2,1,1,18,0,0
0,0,0,0,0,0,0,0,0
8073,140,7,26,6,20,1,1,0
0,0,0,0,0,0,0,0,0
72793,48,4,0,0,0,1,0,0
0,0,0,0,0,0,0,0,0
165968,483,4,6,3,3,8,0,0
0,0,0,0,0,0,0,0,0
0,0,0,0,0,0,0,0,0
0,0,0,0,0,0,0,0,0
0,0,0,0,0,0,0,0,0
0,0,0,0,0,0,0,0,0
0,0,0,0,0,0,0,0,0
0,0,0,0,0,0,0,0,0
0,0,0,0,0,0,0,0,0
0,0,0,0,0,0,0,0,0
0,0,0,0,0,0,0,0,0
72793,48,4,0,0,0,1,0,0
72793,48,4,0,0,0,1,0,0
0,0,0,0,0,0,0,0,0
0,0,0,0,0,0,0,0,0
0,0,0,0,0,0,0,0,0
0,0,0,0,0,0,0,0,0
0,0,0,0,0,0,0,0,0
13540,142,0,56,51,5,0,0,0
7934,55,6,1,1,0,0,0,0
0,0,0,0,0,0,0,0,0
4131,13,1,0,0,0,0,0,0
0,0,0,0,0,0,0,0,0
0,0,0,0,0,0,0,0,0
0,0,0,0,0,0,0,0,0
0,0,0,0,0,0,0,0,0
28244,134,9,1,1,0,0,0,0
386746,274,8,5,5,0,0,1,0
0,0,0,0,0,0,0,0,0
0,0,0,0,0,0,0,0,0
0,0,0,0,0,0,0,0,0
0,0,0,0,0,0,0,0,0
0,0,0,0,0,0,0,0,0
50588,231,2,2,2,0,1,0,0
50623,231,2,2,2,0,1,0,0
0,0,0,0,0,0,0,0,0
0,0,0,0,0,0,0,0,0
0,0,0,0,0,0,0,0,0
0,0,0,0,0,0,0,0,0
598611,437,7,0,0,0,0,1,0
72805,48,4,0,0,0,1,0,0
0,0,0,0,0,0,0,0,0
8073,140,7,26,6,20,1,1,0
0,0,0,0,0,0,0,0,0
138253,313,3,11,11,0,2,0,0
0,0,0,0,0,0,0,0,0
0,0,0,0,0,0,0,0,0
0,0,0,0,0,0,0,0,0
0,0,0,0,0,0,0,0,0
0,0,0,0,0,0,0,0,0
0,0,0,0,0,0,0,0,0
0,0,0,0,0,0,0,0,0
0,0,0,0,0,0,0,0,0
0,0,0,0,0,0,0,0,0
135892,321,8,27,24,3,20,1,0
0,0,0,0,0,0,0,0,0
0,0,0,0,0,0,0,0,0
0,0,0,0,0,0,0,0,0
673116,555,0,4,4,0,2,1,1
673203,555,0,4,4,0,2,1,1
670376,555,0,4,4,0,2,1,1
672830,555,0,4,4,0,2,1,1
0,0,0,0,0,0,0,0,0
0,0,0,0,0,0,0,0,0
0,0,0,0,0,0,0,0,0
0,0,0,0,0,0,0,0,0
0,0,0,0,0,0,0,0,0
0,0,0,0,0,0,0,0,0
0,0,0,0,0,0,0,0,0
0,0,0,0,0,0,0,0,0
0,0,0,0,0,0,0,0,0
0,0,0,0,0,0,0,0,0
0,0,0,0,0,0,0,0,0
72805,48,4,0,0,0,1,0,0
8073,140,7,26,6,20,1,1,0
0,0,0,0,0,0,0,0,0
0,0,0,0,0,0,0,0,0
723484,1344,1,182,2,180,0,1,0
28378,152,6,4,2,2,1,0,0
0,0,0,0,0,0,0,0,0
23119,33,0,1,1,0,0,1,0
0,0,0,0,0,0,0,0,0
0,0,0,0,0,0,0,0,0
0,0,0,0,0,0,0,0,0
0,0,0,0,0,0,0,0,0
672387,555,0,4,4,0,2,1,1
4552,25,0,4,0,4,0,0,0
0,0,0,0,0,0,0,0,0
0,0,0,0,0,0,0,0,0
0,0,0,0,0,0,0,0,0
0,0,0,0,0,0,0,0,0
235226,60,4,1,1,0,2,1,0
0,0,0,0,0,0,0,0,0
0,0,0,0,0,0,0,0,0
235226,60,4,1,1,0,2,1,0
0,0,0,0,0,0,0,0,0
0,0,0,0,0,0,0,0,0
235226,60,4,1,1,0,2,1,0
111860,61,4,3,3,0,2,1,0
337630,58,1,6,3,3,0,0,0
0,0,0,0,0,0,0,0,0
0,0,0,0,0,0,0,0,0
0,0,0,0,0,0,0,0,0
0,0,0,0,0,0,0,0,0
0,0,0,0,0,0,0,0,0
5326,44,4,0,0,0,3,0,0
5326,44,4,0,0,0,3,0,0
5326,44,4,0,0,0,3,0,0
5326,44,4,0,0,0,3,0,0
5326,44,4,0,0,0,3,0,0
2026704,61,4,1,1,0,2,1,0
2026704,61,4,1,1,0,2,1,0
2026704,61,4,1,1,0,2,1,0
0,0,0,0,0,0,0,0,0
35581,172,6,3,1,2,1,0,0
72793,48,4,0,0,0,1,0,0
72793,48,4,0,0,0,1,0,0
0,0,0,0,0,0,0,0,0
77758,101,1,4,2,2,0,0,0
75144,171,0,13,12,1,3,1,0
88024,347,8,24,5,19,4,0,0
0,0,0,0,0,0,0,0,0
0,0,0,0,0,0,0,0,0
0,0,0,0,0,0,0,0,0
0,0,0,0,0,0,0,0,0
0,0,0,0,0,0,0,0,0
0,0,0,0,0,0,0,0,0
0,0,0,0,0,0,0,0,0
0,0,0,0,0,0,0,0,0
7021,30,0,3,0,3,0,1,0
0,0,0,0,0,0,0,0,0
0,0,0,0,0,0,0,0,0
0,0,0,0,0,0,0,0,0
0,0,0,0,0,0,0,0,0
0,0,0,0,0,0,0,0,0
0,0,0,0,0,0,0,0,0
0,0,0,0,0,0,0,0,0
0,0,0,0,0,0,0,0,0
0,0,0,0,0,0,0,0,0
0,0,0,0,0,0,0,0,0
0,0,0,0,0,0,0,0,0
72793,48,4,0,0,0,1,0,0
72793,48,4,0,0,0,1,0,0
0,0,0,0,0,0,0,0,0
0,0,0,0,0,0,0,0,0
0,0,0,0,0,0,0,0,0
0,0,0,0,0,0,0,0,0
0,0,0,0,0,0,0,0,0
0,0,0,0,0,0,0,0,0
181701,82,2,9,3,6,0,1,0
8073,140,7,26,6,20,1,1,0
8073,140,7,26,6,20,1,1,0
8073,140,7,26,6,20,1,1,0
8073,140,7,26,6,20,1,1,0
7314773,213,0,52,51,1,0,1,0
7314773,213,0,52,51,1,0,1,0
10871,33,1,0,0,0,1,0,0
10871,33,1,0,0,0,1,0,0
7314773,213,0,52,51,1,0,1,0
7314773,213,0,52,51,1,0,1,0
7314773,213,0,52,51,1,0,1,0
7314773,213,0,52,51,1,0,1,0
7314773,213,0,52,51,1,0,1,0
0,0,0,0,0,0,0,0,0
734060,101,4,4,4,0,4,1,0
734060,101,4,4,4,0,4,1,0
0,0,0,0,0,0,0,0,0
0,0,0,0,0,0,0,0,0
0,0,0,0,0,0,0,0,0
0,0,0,0,0,0,0,0,0
0,0,0,0,0,0,0,0,0
0,0,0,0,0,0,0,0,0
16116,72,4,0,0,0,0,1,0
16116,72,4,0,0,0,0,1,0
16098,72,4,0,0,0,0,1,0
16098,72,4,0,0,0,0,1,0
16040,72,4,0,0,0,0,1,0
0,0,0,0,0,0,0,0,0
16040,72,4,0,0,0,0,1,0
16040,72,4,0,0,0,0,1,0
0,0,0,0,0,0,0,0,0
0,0,0,0,0,0,0,0,0
0,0,0,0,0,0,0,0,0
0,0,0,0,0,0,0,0,0
0,0,0,0,0,0,0,0,0
0,0,0,0,0,0,0,0,0
0,0,0,0,0,0,0,0,0
0,0,0,0,0,0,0,0,0
0,0,0,0,0,0,0,0,0
4404,25,0,1,0,1,0,0,0
4404,25,0,1,0,1,0,0,0
18420,174,1,24,24,0,2,1,0
18419,174,1,24,24,0,2,1,0
5299,87,0,7,3,4,1,1,0
177271,518,4,7,2,5,7,1,0
0,0,0,0,0,0,0,0,0
0,0,0,0,0,0,0,0,0
0,0,0,0,0,0,0,0,0
0,0,0,0,0,0,0,0,0
0,0,0,0,0,0,0,0,0
0,0,0,0,0,0,0,0,0
0,0,0,0,0,0,0,0,0
72793,48,4,0,0,0,1,0,0
46411,184,3,5,2,3,3,1,0
72820,48,4,0,0,0,1,0,0
169004,500,4,5,4,1,8,1,0
72820,48,4,0,0,0,1,0,0
0,0,0,0,0,0,0,0,0
72820,48,4,0,0,0,1,0,0
0,0,0,0,0,0,0,0,0
0,0,0,0,0,0,0,0,0
11768,60,5,0,0,0,4,1,0
1059553,101,4,5,5,0,3,1,0
0,0,0,0,0,0,0,0,0
72820,48,4,0,0,0,1,0,0
0,0,0,0,0,0,0,0,0
0,0,0,0,0,0,0,0,0
167755,487,4,2,1,1,7,0,0
165663,477,4,4,3,1,8,0,0
0,0,0,0,0,0,0,0,0
0,0,0,0,0,0,0,0,0
0,0,0,0,0,0,0,0,0
0,0,0,0,0,0,0,0,0
0,0,0,0,0,0,0,0,0
1420530,35,4,0,0,0,0,1,0
0,0,0,0,0,0,0,0,0
0,0,0,0,0,0,0,0,0
0,0,0,0,0,0,0,0,0
0,0,0,0,0,0,0,0,0
0,0,0,0,0,0,0,0,0
0,0,0,0,0,0,0,0,0
148190,104,5,3,3,0,3,0,0
0,0,0,0,0,0,0,0,0
0,0,0,0,0,0,0,0,0
0,0,0,0,0,0,0,0,0
0,0,0,0,0,0,0,0,0
0,0,0,0,0,0,0,0,0
0,0,0,0,0,0,0,0,0
72820,48,4,0,0,0,1,0,0
9255,81,1,0,0,0,0,0,0
0,0,0,0,0,0,0,0,0
0,0,0,0,0,0,0,0,0
8073,140,7,26,6,20,1,1,0
4458,25,0,3,2,1,0,0,0
4552,25,0,4,0,4,0,0,0
11302,120,4,12,12,0,0,0,0
0,0,0,0,0,0,0,0,0
11303,120,4,12,12,0,0,0,0
0,0,0,0,0,0,0,0,0
72820,48,4,0,0,0,1,0,0
0,0,0,0,0,0,0,0,0
165316,479,4,4,3,1,8,0,0
0,0,0,0,0,0,0,0,0
0,0,0,0,0,0,0,0,0
0,0,0,0,0,0,0,0,0
0,0,0,0,0,0,0,0,0
670022,555,0,4,4,0,2,1,1
672028,555,0,4,4,0,2,1,1
0,0,0,0,0,0,0,0,0
72820,48,4,0,0,0,1,0,0
141261,418,8,27,24,3,36,1,0
0,0,0,0,0,0,0,0,0
136476,329,8,27,24,3,20,1,0
0,0,0,0,0,0,0,0,0
0,0,0,0,0,0,0,0,0
0,0,0,0,0,0,0,0,0
0,0,0,0,0,0,0,0,0
0,0,0,0,0,0,0,0,0
0,0,0,0,0,0,0,0,0
0,0,0,0,0,0,0,0,0
0,0,0,0,0,0,0,0,0
0,0,0,0,0,0,0,0,0
136879,329,8,26,24,2,20,1,0
0,0,0,0,0,0,0,0,0
0,0,0,0,0,0,0,0,0
253040,29,0,1,1,0,0,0,0
0,0,0,0,0,0,0,0,0
0,0,0,0,0,0,0,0,0
0,0,0,0,0,0,0,0,0
0,0,0,0,0,0,0,0,0
0,0,0,0,0,0,0,0,0
0,0,0,0,0,0,0,0,0
19844,53,3,0,0,0,0,0,0
19844,53,3,0,0,0,0,0,0
19844,53,3,0,0,0,0,0,0
19844,53,3,0,0,0,0,0,0
19844,53,3,0,0,0,0,0,0
19844,53,3,0,0,0,0,0,0
19844,53,3,0,0,0,0,0,0
415473,62,4,3,3,0,2,1,0
415473,62,4,3,3,0,2,1,0
415473,62,4,3,3,0,2,1,0
415473,62,4,3,3,0,2,1,0
415473,62,4,3,3,0,2,1,0
415473,62,4,3,3,0,2,1,0
415473,62,4,3,3,0,2,1,0
6002699,71,5,1,1,0,2,1,0
0,0,0,0,0,0,0,0,0
0,0,0,0,0,0,0,0,0
0,0,0,0,0,0,0,0,0
0,0,0,0,0,0,0,0,0
0,0,0,0,0,0,0,0,0
0,0,0,0,0,0,0,0,0
0,0,0,0,0,0,0,0,0
0,0,0,0,0,0,0,0,0
0,0,0,0,0,0,0,0,0
0,0,0,0,0,0,0,0,0
0,0,0,0,0,0,0,0,0
0,0,0,0,0,0,0,0,0
0,0,0,0,0,0,0,0,0
0,0,0,0,0,0,0,0,0
0,0,0,0,0,0,0,0,0
420882,62,4,3,3,0,2,1,0
135979,42,4,1,1,0,2,0,0
135979,42,4,1,1,0,2,0,0
135979,42,4,1,1,0,2,0,0
135979,42,4,1,1,0,2,0,0
135979,42,4,1,1,0,2,0,0
0,0,0,0,0,0,0,0,0
0,0,0,0,0,0,0,0,0
48709,144,4,1,0,1,5,0,0
48716,144,4,1,0,1,5,0,0
48720,144,4,1,0,1,5,0,0
48723,144,4,1,0,1,5,0,0
48709,144,4,1,0,1,5,0,0
11368,33,1,0,0,0,1,0,0
0,0,0,0,0,0,0,0,0
0,0,0,0,0,0,0,0,0
0,0,0,0,0,0,0,0,0
0,0,0,0,0,0,0,0,0
0,0,0,0,0,0,0,0,0
225815,119,0,15,6,9,0,1,0
225815,119,0,15,6,9,0,1,0
225815,119,0,15,6,9,0,1,0
225815,119,0,15,6,9,0,1,0
225815,119,0,15,6,9,0,1,0
225815,119,0,15,6,9,0,1,0
0,0,0,0,0,0,0,0,0
0,0,0,0,0,0,0,0,0
0,0,0,0,0,0,0,0,0
0,0,0,0,0,0,0,0,0
0,0,0,0,0,0,0,0,0
0,0,0,0,0,0,0,0,0
25114,67,2,1,1,0,2,0,0
0,0,0,0,0,0,0,0,0
0,0,0,0,0,0,0,0,0
0,0,0,0,0,0,0,0,0
0,0,0,0,0,0,0,0,0
0,0,0,0,0,0,0,0,0
0,0,0,0,0,0,0,0,0
0,0,0,0,0,0,0,0,0
0,0,0,0,0,0,0,0,0
0,0,0,0,0,0,0,0,0
0,0,0,0,0,0,0,0,0
0,0,0,0,0,0,0,0,0
0,0,0,0,0,0,0,0,0
36190,50,2,0,0,0,2,0,0
19790,66,0,1,0,1,2,1,0
0,0,0,0,0,0,0,0,0
5031,53,2,0,0,0,0,0,0
28292,160,6,4,2,2,1,0,0
40227,299,5,1,0,1,1,0,0
102665,76,4,6,6,0,5,1,0
0,0,0,0,0,0,0,0,0
0,0,0,0,0,0,0,0,0
9255,81,1,0,0,0,0,0,0
0,0,0,0,0,0,0,0,0
0,0,0,0,0,0,0,0,0
0,0,0,0,0,0,0,0,0
93951,295,1,0,0,0,1,0,0
0,0,0,0,0,0,0,0,0
99175,959,3,149,76,73,1,0,0
0,0,0,0,0,0,0,0,0
0,0,0,0,0,0,0,0,0
0,0,0,0,0,0,0,0,0
0,0,0,0,0,0,0,0,0
0,0,0,0,0,0,0,0,0
239559,402,2,25,18,7,17,0,0
72820,48,4,0,0,0,1,0,0
0,0,0,0,0,0,0,0,0
0,0,0,0,0,0,0,0,0
0,0,0,0,0,0,0,0,0
0,0,0,0,0,0,0,0,0
0,0,0,0,0,0,0,0,0
0,0,0,0,0,0,0,0,0
0,0,0,0,0,0,0,0,0
0,0,0,0,0,0,0,0,0
0,0,0,0,0,0,0,0,0
137276,336,8,27,24,3,20,1,0
0,0,0,0,0,0,0,0,0
0,0,0,0,0,0,0,0,0
0,0,0,0,0,0,0,0,0
0,0,0,0,0,0,0,0,0
0,0,0,0,0,0,0,0,0
0,0,0,0,0,0,0,0,0
0,0,0,0,0,0,0,0,0
0,0,0,0,0,0,0,0,0
0,0,0,0,0,0,0,0,0
8073,140,7,26,11,15,1,1,0
0,0,0,0,0,0,0,0,0
8073,140,7,26,6,20,1,1,0
0,0,0,0,0,0,0,0,0
0,0,0,0,0,0,0,0,0
136576,330,8,27,24,3,20,1,0
72820,48,4,0,0,0,1,0,0
47607,209,2,3,1,2,1,0,0
40405,75,1,0,0,0,0,1,0
0,0,0,0,0,0,0,0,0
0,0,0,0,0,0,0,0,0
0,0,0,0,0,0,0,0,0
0,0,0,0,0,0,0,0,0
0,0,0,0,0,0,0,0,0
678434,555,0,4,2,2,2,1,1
0,0,0,0,0,0,0,0,0
0,0,0,0,0,0,0,0,0
0,0,0,0,0,0,0,0,0
0,0,0,0,0,0,0,0,0
8072,140,7,26,6,20,1,1,0
8073,140,7,26,6,20,1,1,0
0,0,0,0,0,0,0,0,0
0,0,0,0,0,0,0,0,0
0,0,0,0,0,0,0,0,0
8073,140,7,26,6,20,1,1,0
0,0,0,0,0,0,0,0,0
0,0,0,0,0,0,0,0,0
0,0,0,0,0,0,0,0,0
0,0,0,0,0,0,0,0,0
15909,339,4,31,28,3,0,1,0
0,0,0,0,0,0,0,0,0
9187,28,1,2,2,0,0,0,0
0,0,0,0,0,0,0,0,0
9183,28,1,2,2,0,0,0,0
135615,320,8,27,24,3,20,1,0
0,0,0,0,0,0,0,0,0
0,0,0,0,0,0,0,0,0
671990,555,0,4,4,0,2,1,1
9183,28,1,2,2,0,0,0,0
0,0,0,0,0,0,0,0,0
671791,555,0,4,4,0,2,1,1
672536,555,0,4,4,0,2,1,1
307663,196,6,1,1,0,0,1,0
0,0,0,0,0,0,0,0,0
307506,196,6,1,1,0,0,1,0
0,0,0,0,0,0,0,0,0
0,0,0,0,0,0,0,0,0
0,0,0,0,0,0,0,0,0
0,0,0,0,0,0,0,0,0
0,0,0,0,0,0,0,0,0
331373,284,6,1,1,0,0,1,0
307594,196,6,1,1,0,0,1,0
0,0,0,0,0,0,0,0,0
0,0,0,0,0,0,0,0,0
0,0,0,0,0,0,0,0,0
0,0,0,0,0,0,0,0,0
0,0,0,0,0,0,0,0,0
0,0,0,0,0,0,0,0,0
0,0,0,0,0,0,0,0,0
280583,233,6,1,1,0,0,1,0
0,0,0,0,0,0,0,0,0
357255,182,6,1,1,0,0,1,0
135088,318,8,27,24,3,20,1,0
141521,412,8,28,24,4,35,1,0
0,0,0,0,0,0,0,0,0
0,0,0,0,0,0,0,0,0
0,0,0,0,0,0,0,0,0
0,0,0,0,0,0,0,0,0
0,0,0,0,0,0,0,0,0
0,0,0,0,0,0,0,0,0
0,0,0,0,0,0,0,0,0
0,0,0,0,0,0,0,0,0
0,0,0,0,0,0,0,0,0
0,0,0,0,0,0,0,0,0
671305,552,0,4,0,4,2,1,1
0,0,0,0,0,0,0,0,0
0,0,0,0,0,0,0,0,0
0,0,0,0,0,0,0,0,0
0,0,0,0,0,0,0,0,0
31754,52,2,0,0,0,0,0,0
31754,52,2,0,0,0,0,0,0
0,0,0,0,0,0,0,0,0
0,0,0,0,0,0,0,0,0
42836,48,2,0,0,0,2,0,0
42836,48,2,0,0,0,2,0,0
31754,52,2,0,0,0,0,0,0
42836,48,2,0,0,0,2,0,0
25121,67,2,1,1,0,2,0,0
105000,65,4,9,9,0,2,1,0
105000,65,4,9,9,0,2,1,0
0,0,0,0,0,0,0,0,0
105000,65,4,9,9,0,2,1,0
0,0,0,0,0,0,0,0,0
25121,67,2,1,1,0,2,0,0
198495,49,3,0,0,0,0,0,0
0,0,0,0,0,0,0,0,0
0,0,0,0,0,0,0,0,0
0,0,0,0,0,0,0,0,0
0,0,0,0,0,0,0,0,0
0,0,0,0,0,0,0,0,0
0,0,0,0,0,0,0,0,0
0,0,0,0,0,0,0,0,0
0,0,0,0,0,0,0,0,0
0,0,0,0,0,0,0,0,0
0,0,0,0,0,0,0,0,0
0,0,0,0,0,0,0,0,0
0,0,0,0,0,0,0,0,0
0,0,0,0,0,0,0,0,0
0,0,0,0,0,0,0,0,0
0,0,0,0,0,0,0,0,0
0,0,0,0,0,0,0,0,0
0,0,0,0,0,0,0,0,0
0,0,0,0,0,0,0,0,0
0,0,0,0,0,0,0,0,0
0,0,0,0,0,0,0,0,0
0,0,0,0,0,0,0,0,0
0,0,0,0,0,0,0,0,0
0,0,0,0,0,0,0,0,0
0,0,0,0,0,0,0,0,0
0,0,0,0,0,0,0,0,0
0,0,0,0,0,0,0,0,0
0,0,0,0,0,0,0,0,0
0,0,0,0,0,0,0,0,0
0,0,0,0,0,0,0,0,0
0,0,0,0,0,0,0,0,0
0,0,0,0,0,0,0,0,0
0,0,0,0,0,0,0,0,0
0,0,0,0,0,0,0,0,0
0,0,0,0,0,0,0,0,0
0,0,0,0,0,0,0,0,0
0,0,0,0,0,0,0,0,0
0,0,0,0,0,0,0,0,0
0,0,0,0,0,0,0,0,0
0,0,0,0,0,0,0,0,0
0,0,0,0,0,0,0,0,0
0,0,0,0,0,0,0,0,0
0,0,0,0,0,0,0,0,0
0,0,0,0,0,0,0,0,0
0,0,0,0,0,0,0,0,0
0,0,0,0,0,0,0,0,0
420882,62,4,3,3,0,2,1,0
420882,62,4,3,3,0,2,1,0
12383,72,4,0,0,0,0,1,0
12383,72,4,0,0,0,0,1,0
420882,62,4,3,3,0,2,1,0
0,0,0,0,0,0,0,0,0
0,0,0,0,0,0,0,0,0
12383,72,4,0,0,0,0,1,0
12383,72,4,0,0,0,0,1,0
12383,72,4,0,0,0,0,1,0
12383,72,4,0,0,0,0,1,0
12383,72,4,0,0,0,0,1,0
0,0,0,0,0,0,0,0,0
0,0,0,0,0,0,0,0,0
0,0,0,0,0,0,0,0,0
0,0,0,0,0,0,0,0,0
0,0,0,0,0,0,0,0,0
0,0,0,0,0,0,0,0,0
0,0,0,0,0,0,0,0,0
0,0,0,0,0,0,0,0,0
0,0,0,0,0,0,0,0,0
0,0,0,0,0,0,0,0,0
0,0,0,0,0,0,0,0,0
991073,60,3,0,0,0,2,1,0
177084,530,5,2,1,1,10,0,0
0,0,0,0,0,0,0,0,0
0,0,0,0,0,0,0,0,0
34983,193,5,13,9,4,1,0,0
0,0,0,0,0,0,0,0,0
0,0,0,0,0,0,0,0,0
0,0,0,0,0,0,0,0,0
508521,48,2,2,2,0,2,0,0
0,0,0,0,0,0,0,0,0
0,0,0,0,0,0,0,0,0
292663,181,6,1,1,0,0,1,0
384828,195,6,1,1,0,0,1,0
0,0,0,0,0,0,0,0,0
0,0,0,0,0,0,0,0,0
0,0,0,0,0,0,0,0,0
119446,200,2,4,1,3,0,0,0
0,0,0,0,0,0,0,0,0
0,0,0,0,0,0,0,0,0
0,0,0,0,0,0,0,0,0
0,0,0,0,0,0,0,0,0
0,0,0,0,0,0,0,0,0
0,0,0,0,0,0,0,0,0
0,0,0,0,0,0,0,0,0
0,0,0,0,0,0,0,0,0
0,0,0,0,0,0,0,0,0
0,0,0,0,0,0,0,0,0
0,0,0,0,0,0,0,0,0
0,0,0,0,0,0,0,0,0
0,0,0,0,0,0,0,0,0
0,0,0,0,0,0,0,0,0
0,0,0,0,0,0,0,0,0
0,0,0,0,0,0,0,0,0
48822,319,6,1,1,0,1,0,0
48822,319,6,1,1,0,1,0,0
0,0,0,0,0,0,0,0,0
0,0,0,0,0,0,0,0,0
0,0,0,0,0,0,0,0,0
0,0,0,0,0,0,0,0,0
0,0,0,0,0,0,0,0,0
0,0,0,0,0,0,0,0,0
0,0,0,0,0,0,0,0,0
0,0,0,0,0,0,0,0,0
0,0,0,0,0,0,0,0,0
0,0,0,0,0,0,0,0,0
0,0,0,0,0,0,0,0,0
0,0,0,0,0,0,0,0,0
0,0,0,0,0,0,0,0,0
0,0,0,0,0,0,0,0,0
0,0,0,0,0,0,0,0,0
0,0,0,0,0,0,0,0,0
0,0,0,0,0,0,0,0,0
0,0,0,0,0,0,0,0,0
0,0,0,0,0,0,0,0,0
0,0,0,0,0,0,0,0,0
0,0,0,0,0,0,0,0,0
0,0,0,0,0,0,0,0,0
0,0,0,0,0,0,0,0,0
0,0,0,0,0,0,0,0,0
0,0,0,0,0,0,0,0,0
0,0,0,0,0,0,0,0,0
0,0,0,0,0,0,0,0,0
0,0,0,0,0,0,0,0,0
72820,48,4,0,0,0,1,0,0
0,0,0,0,0,0,0,0,0
0,0,0,0,0,0,0,0,0
72820,48,4,0,0,0,1,0,0
72813,48,4,0,0,0,1,0,0
0,0,0,0,0,0,0,0,0
72822,48,4,0,0,0,1,0,0
72820,48,4,0,0,0,1,0,0
72820,48,4,0,0,0,1,0,0
0,0,0,0,0,0,0,0,0
9196,28,1,2,2,0,0,0,0
0,0,0,0,0,0,0,0,0
0,0,0,0,0,0,0,0,0
0,0,0,0,0,0,0,0,0
0,0,0,0,0,0,0,0,0
35800,61,3,3,3,0,2,0,0
0,0,0,0,0,0,0,0,0
72820,48,4,0,0,0,1,0,0
130116,298,5,26,24,2,8,1,0
0,0,0,0,0,0,0,0,0
76978,167,2,21,19,2,1,1,0
0,0,0,0,0,0,0,0,0
0,0,0,0,0,0,0,0,0
8073,140,7,26,6,20,1,1,0
72820,48,4,0,0,0,1,0,0
670927,555,0,4,4,0,2,1,1
0,0,0,0,0,0,0,0,0
72820,48,4,0,0,0,1,0,0
0,0,0,0,0,0,0,0,0
0,0,0,0,0,0,0,0,0
139657,401,8,26,24,2,35,1,0
48089,194,3,5,1,4,3,1,0
0,0,0,0,0,0,0,0,0
9186,28,1,2,2,0,0,0,0
0,0,0,0,0,0,0,0,0
0,0,0,0,0,0,0,0,0
0,0,0,0,0,0,0,0,0
0,0,0,0,0,0,0,0,0
0,0,0,0,0,0,0,0,0
0,0,0,0,0,0,0,0,0
136136,327,8,29,24,5,20,1,0
10686,162,7,26,17,9,0,1,0
9180,28,1,2,2,0,0,0,0
8073,140,7,26,6,20,1,1,0
0,0,0,0,0,0,0,0,0
0,0,0,0,0,0,0,0,0
72820,48,4,0,0,0,1,0,0
0,0,0,0,0,0,0,0,0
0,0,0,0,0,0,0,0,0
67459,312,11,27,21,6,2,1,0
0,0,0,0,0,0,0,0,0
0,0,0,0,0,0,0,0,0
28421,418,5,58,49,9,0,1,0
0,0,0,0,0,0,0,0,0
0,0,0,0,0,0,0,0,0
0,0,0,0,0,0,0,0,0
247263,170,6,1,1,0,0,1,0
46309,407,9,24,23,1,1,1,0
0,0,0,0,0,0,0,0,0
0,0,0,0,0,0,0,0,0
0,0,0,0,0,0,0,0,0
0,0,0,0,0,0,0,0,0
0,0,0,0,0,0,0,0,0
0,0,0,0,0,0,0,0,0
0,0,0,0,0,0,0,0,0
0,0,0,0,0,0,0,0,0
0,0,0,0,0,0,0,0,0
0,0,0,0,0,0,0,0,0
0,0,0,0,0,0,0,0,0
0,0,0,0,0,0,0,0,0
0,0,0,0,0,0,0,0,0
0,0,0,0,0,0,0,0,0
0,0,0,0,0,0,0,0,0
160090,43,2,3,2,1,0,0,0
0,0,0,0,0,0,0,0,0
5993591,71,5,1,1,0,2,1,0
234212,60,5,3,3,0,2,1,0
234212,60,5,3,3,0,2,1,0
234212,60,5,3,3,0,2,1,0
0,0,0,0,0,0,0,0,0
0,0,0,0,0,0,0,0,0
0,0,0,0,0,0,0,0,0
0,0,0,0,0,0,0,0,0
0,0,0,0,0,0,0,0,0
0,0,0,0,0,0,0,0,0
0,0,0,0,0,0,0,0,0
0,0,0,0,0,0,0,0,0
0,0,0,0,0,0,0,0,0
0,0,0,0,0,0,0,0,0
0,0,0,0,0,0,0,0,0
0,0,0,0,0,0,0,0,0
0,0,0,0,0,0,0,0,0
6760,30,2,0,0,0,1,0,0
0,0,0,0,0,0,0,0,0
0,0,0,0,0,0,0,0,0
6760,30,2,0,0,0,1,0,0
0,0,0,0,0,0,0,0,0
0,0,0,0,0,0,0,0,0
0,0,0,0,0,0,0,0,0
0,0,0,0,0,0,0,0,0
0,0,0,0,0,0,0,0,0
0,0,0,0,0,0,0,0,0
0,0,0,0,0,0,0,0,0
0,0,0,0,0,0,0,0,0
0,0,0,0,0,0,0,0,0
0,0,0,0,0,0,0,0,0
0,0,0,0,0,0,0,0,0
0,0,0,0,0,0,0,0,0
0,0,0,0,0,0,0,0,0
0,0,0,0,0,0,0,0,0
0,0,0,0,0,0,0,0,0
0,0,0,0,0,0,0,0,0
0,0,0,0,0,0,0,0,0
0,0,0,0,0,0,0,0,0
0,0,0,0,0,0,0,0,0
0,0,0,0,0,0,0,0,0
0,0,0,0,0,0,0,0,0
1198783,62,4,3,3,0,2,1,0
220031,1796,4,298,32,266,14,1,0
220256,1797,4,298,32,266,14,1,0
0,0,0,0,0,0,0,0,0
220142,1796,4,298,32,266,14,1,0
220152,1796,4,298,32,266,14,1,0
220553,1796,4,298,32,266,14,1,0
220655,1796,4,298,32,266,14,1,0
0,0,0,0,0,0,0,0,0
0,0,0,0,0,0,0,0,0
220735,1797,4,298,32,266,14,1,0
0,0,0,0,0,0,0,0,0
0,0,0,0,0,0,0,0,0
0,0,0,0,0,0,0,0,0
0,0,0,0,0,0,0,0,0
0,0,0,0,0,0,0,0,0
1165037,13516,3,2355,2351,4,10,1,0
2897,38,2,0,0,0,0,0,0
175088,712,5,4,1,3,10,0,0
165423,475,4,4,1,3,7,0,0
72820,48,4,0,0,0,1,0,0
0,0,0,0,0,0,0,0,0
0,0,0,0,0,0,0,0,0
0,0,0,0,0,0,0,0,0
47889,76,2,1,1,0,3,1,0
263092,100,4,5,5,0,3,1,0
20286,251,3,65,63,2,1,1,0
508524,48,2,2,2,0,2,0,0
0,0,0,0,0,0,0,0,0
9045,78,1,0,0,0,0,0,0
0,0,0,0,0,0,0,0,0
0,0,0,0,0,0,0,0,0
0,0,0,0,0,0,0,0,0
0,0,0,0,0,0,0,0,0
0,0,0,0,0,0,0,0,0
0,0,0,0,0,0,0,0,0
72820,48,4,0,0,0,1,0,0
0,0,0,0,0,0,0,0,0
0,0,0,0,0,0,0,0,0
0,0,0,0,0,0,0,0,0
0,0,0,0,0,0,0,0,0
0,0,0,0,0,0,0,0,0
0,0,0,0,0,0,0,0,0
10353,83,1,0,0,0,0,0,0
72820,48,4,0,0,0,1,0,0
72820,48,4,0,0,0,1,0,0
72820,48,4,0,0,0,1,0,0
0,0,0,0,0,0,0,0,0
0,0,0,0,0,0,0,0,0
0,0,0,0,0,0,0,0,0
0,0,0,0,0,0,0,0,0
0,0,0,0,0,0,0,0,0
2146,33,0,4,4,0,0,1,0
669619,555,0,4,4,0,2,1,1
72820,48,4,0,0,0,1,0,0
72808,48,4,0,0,0,1,0,0
0,0,0,0,0,0,0,0,0
8073,140,7,26,6,20,1,1,0
8072,140,7,26,6,20,1,1,0
10465,83,1,0,0,0,0,0,0
0,0,0,0,0,0,0,0,0
0,0,0,0,0,0,0,0,0
0,0,0,0,0,0,0,0,0
0,0,0,0,0,0,0,0,0
72820,48,4,0,0,0,1,0,0
16519,209,4,17,14,3,0,0,0
0,0,0,0,0,0,0,0,0
0,0,0,0,0,0,0,0,0
293431,194,6,1,1,0,0,1,0
296005,200,6,3,1,2,0,1,0
133556,313,8,26,24,2,20,1,0
0,0,0,0,0,0,0,0,0
0,0,0,0,0,0,0,0,0
136809,329,8,26,24,2,20,1,0
10619,122,4,23,19,4,2,0,0
0,0,0,0,0,0,0,0,0
0,0,0,0,0,0,0,0,0
0,0,0,0,0,0,0,0,0
39361,254,9,41,39,2,8,1,0
0,0,0,0,0,0,0,0,0
0,0,0,0,0,0,0,0,0
0,0,0,0,0,0,0,0,0
620411,902,2,49,1,48,1,1,0
0,0,0,0,0,0,0,0,0
12985,97,0,3,3,0,0,0,0
8106,46,1,1,0,1,0,1,0
0,0,0,0,0,0,0,0,0
72709,47,4,0,0,0,1,0,0
0,0,0,0,0,0,0,0,0
0,0,0,0,0,0,0,0,0
0,0,0,0,0,0,0,0,0
0,0,0,0,0,0,0,0,0
0,0,0,0,0,0,0,0,0
0,0,0,0,0,0,0,0,0
0,0,0,0,0,0,0,0,0
0,0,0,0,0,0,0,0,0
0,0,0,0,0,0,0,0,0
17548,142,0,56,51,5,0,0,0
0,0,0,0,0,0,0,0,0
668302,552,0,4,0,4,2,1,1
170159,172,0,6,2,4,1,1,1
669937,552,0,4,0,4,2,1,1
0,0,0,0,0,0,0,0,0
169391,172,0,6,2,4,1,1,1
669537,552,0,4,0,4,2,1,1
0,0,0,0,0,0,0,0,0
671628,552,0,4,0,4,2,1,1
0,0,0,0,0,0,0,0,0
0,0,0,0,0,0,0,0,0
0,0,0,0,0,0,0,0,0
0,0,0,0,0,0,0,0,0
0,0,0,0,0,0,0,0,0
0,0,0,0,0,0,0,0,0
671710,552,0,4,0,4,2,1,1
139349,717,17,86,71,15,3,0,0
10908,77,2,6,5,1,0,0,0
2781,24,1,3,0,3,0,0,0
72820,48,4,0,0,0,1,0,0
0,0,0,0,0,0,0,0,0
0,0,0,0,0,0,0,0,0
0,0,0,0,0,0,0,0,0
0,0,0,0,0,0,0,0,0
0,0,0,0,0,0,0,0,0
0,0,0,0,0,0,0,0,0
0,0,0,0,0,0,0,0,0
0,0,0,0,0,0,0,0,0
45529,275,11,10,10,0,1,1,0
0,0,0,0,0,0,0,0,0
0,0,0,0,0,0,0,0,0
0,0,0,0,0,0,0,0,0
0,0,0,0,0,0,0,0,0
0,0,0,0,0,0,0,0,0
0,0,0,0,0,0,0,0,0
0,0,0,0,0,0,0,0,0
0,0,0,0,0,0,0,0,0
0,0,0,0,0,0,0,0,0
0,0,0,0,0,0,0,0,0
0,0,0,0,0,0,0,0,0
0,0,0,0,0,0,0,0,0
0,0,0,0,0,0,0,0,0
0,0,0,0,0,0,0,0,0
0,0,0,0,0,0,0,0,0
0,0,0,0,0,0,0,0,0
673110,555,0,4,4,0,2,1,1
0,0,0,0,0,0,0,0,0
0,0,0,0,0,0,0,0,0
0,0,0,0,0,0,0,0,0
0,0,0,0,0,0,0,0,0
0,0,0,0,0,0,0,0,0
0,0,0,0,0,0,0,0,0
0,0,0,0,0,0,0,0,0
0,0,0,0,0,0,0,0,0
0,0,0,0,0,0,0,0,0
0,0,0,0,0,0,0,0,0
0,0,0,0,0,0,0,0,0
0,0,0,0,0,0,0,0,0
0,0,0,0,0,0,0,0,0
0,0,0,0,0,0,0,0,0
437455,53,2,1,1,0,0,1,0
36606,56,2,0,0,0,2,0,0
36606,56,2,0,0,0,2,0,0
0,0,0,0,0,0,0,0,0
685701,4,0,0,0,0,0,0,0
0,0,0,0,0,0,0,0,0
56057,61,5,1,1,0,1,0,0
0,0,0,0,0,0,0,0,0
0,0,0,0,0,0,0,0,0
0,0,0,0,0,0,0,0,0
0,0,0,0,0,0,0,0,0
0,0,0,0,0,0,0,0,0
0,0,0,0,0,0,0,0,0
0,0,0,0,0,0,0,0,0
0,0,0,0,0,0,0,0,0
56057,61,5,1,1,0,1,0,0
36606,56,2,0,0,0,2,0,0
0,0,0,0,0,0,0,0,0
0,0,0,0,0,0,0,0,0
0,0,0,0,0,0,0,0,0
11784,99,2,0,0,0,2,0,0
11784,99,2,0,0,0,2,0,0
685701,4,0,0,0,0,0,0,0
685701,4,0,0,0,0,0,0,0
0,0,0,0,0,0,0,0,0
0,0,0,0,0,0,0,0,0
0,0,0,0,0,0,0,0,0
0,0,0,0,0,0,0,0,0
0,0,0,0,0,0,0,0,0
0,0,0,0,0,0,0,0,0
0,0,0,0,0,0,0,0,0
0,0,0,0,0,0,0,0,0
36606,56,2,0,0,0,2,0,0
0,0,0,0,0,0,0,0,0
685701,4,0,0,0,0,0,0,0
0,0,0,0,0,0,0,0,0
0,0,0,0,0,0,0,0,0
0,0,0,0,0,0,0,0,0
0,0,0,0,0,0,0,0,0
0,0,0,0,0,0,0,0,0
0,0,0,0,0,0,0,0,0
0,0,0,0,0,0,0,0,0
0,0,0,0,0,0,0,0,0
0,0,0,0,0,0,0,0,0
36606,56,2,0,0,0,2,0,0
36606,56,2,0,0,0,2,0,0
0,0,0,0,0,0,0,0,0
0,0,0,0,0,0,0,0,0
0,0,0,0,0,0,0,0,0
0,0,0,0,0,0,0,0,0
56057,61,5,1,1,0,1,0,0
56057,61,5,1,1,0,1,0,0
0,0,0,0,0,0,0,0,0
0,0,0,0,0,0,0,0,0
36606,56,2,0,0,0,2,0,0
0,0,0,0,0,0,0,0,0
0,0,0,0,0,0,0,0,0
0,0,0,0,0,0,0,0,0
0,0,0,0,0,0,0,0,0
0,0,0,0,0,0,0,0,0
0,0,0,0,0,0,0,0,0
0,0,0,0,0,0,0,0,0
0,0,0,0,0,0,0,0,0
0,0,0,0,0,0,0,0,0
72818,48,4,0,0,0,1,0,0
0,0,0,0,0,0,0,0,0
0,0,0,0,0,0,0,0,0
0,0,0,0,0,0,0,0,0
436891,52,2,1,1,0,0,1,0
436891,52,2,1,1,0,0,1,0
11784,99,2,0,0,0,2,0,0
11784,99,2,0,0,0,2,0,0
11784,99,2,0,0,0,2,0,0
0,0,0,0,0,0,0,0,0
0,0,0,0,0,0,0,0,0
0,0,0,0,0,0,0,0,0
181644,557,5,4,3,1,11,0,0
0,0,0,0,0,0,0,0,0
0,0,0,0,0,0,0,0,0
0,0,0,0,0,0,0,0,0
460223,76,2,1,1,0,3,1,0
0,0,0,0,0,0,0,0,0
0,0,0,0,0,0,0,0,0
281988,197,7,1,1,0,0,1,0
72820,48,4,0,0,0,1,0,0
0,0,0,0,0,0,0,0,0
72820,48,4,0,0,0,1,0,0
0,0,0,0,0,0,0,0,0
0,0,0,0,0,0,0,0,0
3385,41,0,6,0,6,0,0,0
0,0,0,0,0,0,0,0,0
0,0,0,0,0,0,0,0,0
0,0,0,0,0,0,0,0,0
0,0,0,0,0,0,0,0,0
2781,24,1,3,0,3,0,0,0
72820,48,4,0,0,0,1,0,0
72820,48,4,0,0,0,1,0,0
72820,48,4,0,0,0,1,0,0
73389,367,14,55,44,11,7,1,0
0,0,0,0,0,0,0,0,0
0,0,0,0,0,0,0,0,0
0,0,0,0,0,0,0,0,0
0,0,0,0,0,0,0,0,0
0,0,0,0,0,0,0,0,0
0,0,0,0,0,0,0,0,0
0,0,0,0,0,0,0,0,0
0,0,0,0,0,0,0,0,0
0,0,0,0,0,0,0,0,0
0,0,0,0,0,0,0,0,0
0,0,0,0,0,0,0,0,0
0,0,0,0,0,0,0,0,0
0,0,0,0,0,0,0,0,0
0,0,0,0,0,0,0,0,0
0,0,0,0,0,0,0,0,0
23291,225,3,24,24,0,0,1,0
0,0,0,0,0,0,0,0,0
0,0,0,0,0,0,0,0,0
0,0,0,0,0,0,0,0,0
0,0,0,0,0,0,0,0,0
0,0,0,0,0,0,0,0,0
0,0,0,0,0,0,0,0,0
0,0,0,0,0,0,0,0,0
379708,237,5,2,0,2,2,0,0
284299,204,6,1,1,0,0,1,0
0,0,0,0,0,0,0,0,0
0,0,0,0,0,0,0,0,0
0,0,0,0,0,0,0,0,0
0,0,0,0,0,0,0,0,0
672264,555,0,4,4,0,2,1,1
0,0,0,0,0,0,0,0,0
0,0,0,0,0,0,0,0,0
0,0,0,0,0,0,0,0,0
0,0,0,0,0,0,0,0,0
0,0,0,0,0,0,0,0,0
0,0,0,0,0,0,0,0,0
0,0,0,0,0,0,0,0,0
55972,282,2,3,2,1,1,1,0
672918,555,0,4,4,0,2,1,1
6295,40,4,0,0,0,2,1,0
0,0,0,0,0,0,0,0,0
0,0,0,0,0,0,0,0,0
0,0,0,0,0,0,0,0,0
0,0,0,0,0,0,0,0,0
0,0,0,0,0,0,0,0,0
0,0,0,0,0,0,0,0,0
0,0,0,0,0,0,0,0,0
0,0,0,0,0,0,0,0,0
0,0,0,0,0,0,0,0,0
0,0,0,0,0,0,0,0,0
0,0,0,0,0,0,0,0,0
0,0,0,0,0,0,0,0,0
0,0,0,0,0,0,0,0,0
139622,407,6,29,24,5,24,1,0
0,0,0,0,0,0,0,0,0
0,0,0,0,0,0,0,0,0
0,0,0,0,0,0,0,0,0
0,0,0,0,0,0,0,0,0
0,0,0,0,0,0,0,0,0
0,0,0,0,0,0,0,0,0
6330,64,2,6,4,2,0,1,0
132978,303,6,27,24,3,9,1,0
0,0,0,0,0,0,0,0,0
8412,53,3,1,1,0,4,0,0
8412,53,3,1,1,0,4,0,0
8412,53,3,1,1,0,4,0,0
8412,53,3,1,1,0,4,0,0
8412,53,3,1,1,0,4,0,0
0,0,0,0,0,0,0,0,0
73540,371,8,22,1,21,1,1,0
0,0,0,0,0,0,0,0,0
0,0,0,0,0,0,0,0,0
0,0,0,0,0,0,0,0,0
46971,139,2,1,0,1,0,1,0
0,0,0,0,0,0,0,0,0
87359,66,0,9,4,5,5,0,0
87673,66,0,9,4,5,5,0,0
0,0,0,0,0,0,0,0,0
0,0,0,0,0,0,0,0,0
0,0,0,0,0,0,0,0,0
0,0,0,0,0,0,0,0,0
0,0,0,0,0,0,0,0,0
0,0,0,0,0,0,0,0,0
0,0,0,0,0,0,0,0,0
8073,140,7,26,6,20,1,1,0
0,0,0,0,0,0,0,0,0
2772,19,1,0,0,0,0,0,0
0,0,0,0,0,0,0,0,0
0,0,0,0,0,0,0,0,0
0,0,0,0,0,0,0,0,0
670359,555,0,4,4,0,2,1,1
53053,206,1,6,4,2,0,0,0
0,0,0,0,0,0,0,0,0
0,0,0,0,0,0,0,0,0
0,0,0,0,0,0,0,0,0
72819,48,4,0,0,0,1,0,0
0,0,0,0,0,0,0,0,0
72820,48,4,0,0,0,1,0,0
8072,140,7,26,6,20,1,1,0
72820,48,4,0,0,0,1,0,0
72820,48,4,0,0,0,1,0,0
2146,33,0,4,4,0,0,1,0
72820,48,4,0,0,0,1,0,0
0,0,0,0,0,0,0,0,0
672671,555,0,4,4,0,2,1,1
72820,48,4,0,0,0,1,0,0
72820,48,4,0,0,0,1,0,0
72820,48,4,0,0,0,1,0,0
72820,48,4,0,0,0,1,0,0
34055,52,3,0,0,0,2,0,0
34055,52,3,0,0,0,2,0,0
34055,52,3,0,0,0,2,0,0
0,0,0,0,0,0,0,0,0
0,0,0,0,0,0,0,0,0
0,0,0,0,0,0,0,0,0
0,0,0,0,0,0,0,0,0
0,0,0,0,0,0,0,0,0
0,0,0,0,0,0,0,0,0
0,0,0,0,0,0,0,0,0
0,0,0,0,0,0,0,0,0
0,0,0,0,0,0,0,0,0
0,0,0,0,0,0,0,0,0
8073,140,7,26,6,20,1,1,0
0,0,0,0,0,0,0,0,0
0,0,0,0,0,0,0,0,0
30463,99,2,1,1,0,0,0,0
20275,49,2,1,1,0,0,0,0
0,0,0,0,0,0,0,0,0
110186,55,1,0,0,0,0,0,0
8969,105,2,13,8,5,0,1,0
8993,105,2,13,8,5,0,1,0
8073,140,7,26,6,20,1,1,0
0,0,0,0,0,0,0,0,0
0,0,0,0,0,0,0,0,0
0,0,0,0,0,0,0,0,0
47665,199,3,7,4,3,3,1,0
72820,48,4,0,0,0,1,0,0
0,0,0,0,0,0,0,0,0
0,0,0,0,0,0,0,0,0
0,0,0,0,0,0,0,0,0
0,0,0,0,0,0,0,0,0
0,0,0,0,0,0,0,0,0
72819,48,4,0,0,0,1,0,0
0,0,0,0,0,0,0,0,0
18854,200,0,73,31,42,6,1,0
0,0,0,0,0,0,0,0,0
0,0,0,0,0,0,0,0,0
72820,48,4,0,0,0,1,0,0
0,0,0,0,0,0,0,0,0
72820,48,4,0,0,0,1,0,0
0,0,0,0,0,0,0,0,0
233985,865,18,41,13,28,11,1,0
72820,48,4,0,0,0,1,0,0
72820,48,4,0,0,0,1,0,0
72820,48,4,0,0,0,1,0,0
0,0,0,0,0,0,0,0,0
72820,48,4,0,0,0,1,0,0
72808,48,4,0,0,0,1,0,0
72820,48,4,0,0,0,1,0,0
674033,555,0,4,4,0,2,1,1
72819,48,4,0,0,0,1,0,0
672600,555,0,4,4,0,2,1,1
72820,48,4,0,0,0,1,0,0
0,0,0,0,0,0,0,0,0
22412,33,0,1,1,0,0,1,0
6330,64,2,6,4,2,0,1,0
6330,64,2,6,4,2,0,1,0
22396,33,0,1,1,0,0,1,0
0,0,0,0,0,0,0,0,0
8073,140,7,26,6,20,1,1,0
72820,48,4,0,0,0,1,0,0
72819,48,4,0,0,0,1,0,0
0,0,0,0,0,0,0,0,0
46,3,0,0,0,0,0,0,0
0,0,0,0,0,0,0,0,0
232818,61,4,3,3,0,2,1,0
25114,67,2,1,1,0,2,0,0
0,0,0,0,0,0,0,0,0
0,0,0,0,0,0,0,0,0
0,0,0,0,0,0,0,0,0
0,0,0,0,0,0,0,0,0
232818,61,4,3,3,0,2,1,0
232818,61,4,3,3,0,2,1,0
232818,61,4,3,3,0,2,1,0
232818,61,4,3,3,0,2,1,0
0,0,0,0,0,0,0,0,0
0,0,0,0,0,0,0,0,0
0,0,0,0,0,0,0,0,0
0,0,0,0,0,0,0,0,0
0,0,0,0,0,0,0,0,0
0,0,0,0,0,0,0,0,0
20904,234,2,48,47,1,2,1,0
20904,234,2,48,47,1,2,1,0
20904,234,2,48,47,1,2,1,0
20904,234,2,48,47,1,2,1,0
0,0,0,0,0,0,0,0,0
20904,234,2,48,47,1,2,1,0
0,0,0,0,0,0,0,0,0
0,0,0,0,0,0,0,0,0
0,0,0,0,0,0,0,0,0
232818,61,4,3,3,0,2,1,0
0,0,0,0,0,0,0,0,0
0,0,0,0,0,0,0,0,0
0,0,0,0,0,0,0,0,0
0,0,0,0,0,0,0,0,0
0,0,0,0,0,0,0,0,0
0,0,0,0,0,0,0,0,0
36427,48,1,0,0,0,0,0,0
164015,470,4,2,1,1,7,0,0
72820,48,4,0,0,0,1,0,0
70243,349,1,4,2,2,0,0,0
0,0,0,0,0,0,0,0,0
0,0,0,0,0,0,0,0,0
102681,76,4,6,6,0,5,1,0
350998,187,6,1,1,0,0,1,0
82623,238,3,20,17,3,0,0,0
0,0,0,0,0,0,0,0,0
24091,148,7,5,3,2,1,1,0
7021,30,0,3,0,3,0,1,0
0,0,0,0,0,0,0,0,0
0,0,0,0,0,0,0,0,0
0,0,0,0,0,0,0,0,0
0,0,0,0,0,0,0,0,0
0,0,0,0,0,0,0,0,0
0,0,0,0,0,0,0,0,0
0,0,0,0,0,0,0,0,0
0,0,0,0,0,0,0,0,0
0,0,0,0,0,0,0,0,0
0,0,0,0,0,0,0,0,0
0,0,0,0,0,0,0,0,0
0,0,0,0,0,0,0,0,0
0,0,0,0,0,0,0,0,0
72820,48,4,0,0,0,1,0,0
18289,267,3,26,22,4,1,0,0
13540,142,0,56,51,5,0,0,0
220383,989,2,56,15,41,6,1,0
12639,142,0,56,51,5,0,0,0
0,0,0,0,0,0,0,0,0
671385,555,0,4,4,0,2,1,1
0,0,0,0,0,0,0,0,0
0,0,0,0,0,0,0,0,0
297552,190,6,1,1,0,0,1,0
0,0,0,0,0,0,0,0,0
0,0,0,0,0,0,0,0,0
8073,140,7,26,6,20,1,1,0
0,0,0,0,0,0,0,0,0
0,0,0,0,0,0,0,0,0
9403,31,1,0,0,0,1,0,0
0,0,0,0,0,0,0,0,0
0,0,0,0,0,0,0,0,0
0,0,0,0,0,0,0,0,0
0,0,0,0,0,0,0,0,0
0,0,0,0,0,0,0,0,0
0,0,0,0,0,0,0,0,0
0,0,0,0,0,0,0,0,0
0,0,0,0,0,0,0,0,0
280785,240,6,1,1,0,0,1,0
0,0,0,0,0,0,0,0,0
0,0,0,0,0,0,0,0,0
0,0,0,0,0,0,0,0,0
4306257,56,2,2,0,2,0,1,0
34286,59,2,0,0,0,0,0,0
72820,48,4,0,0,0,1,0,0
82538,1347,2,7,7,0,1,1,0
82530,1347,2,7,7,0,1,1,0
146130,974,14,96,93,3,5,1,0
138543,1054,18,121,96,25,5,1,0
82728,238,3,20,10,10,0,0,0
82728,238,3,20,10,10,0,0,0
82728,238,3,20,17,3,0,0,0
0,0,0,0,0,0,0,0,0
0,0,0,0,0,0,0,0,0
0,0,0,0,0,0,0,0,0
0,0,0,0,0,0,0,0,0
0,0,0,0,0,0,0,0,0
0,0,0,0,0,0,0,0,0
72820,48,4,0,0,0,1,0,0
72819,48,4,0,0,0,1,0,0
0,0,0,0,0,0,0,0,0
0,0,0,0,0,0,0,0,0
33477,156,3,8,4,4,10,1,0
331104,127,4,27,18,9,1,1,0
28322,403,1,96,96,0,1,0,0
0,0,0,0,0,0,0,0,0
0,0,0,0,0,0,0,0,0
0,0,0,0,0,0,0,0,0
0,0,0,0,0,0,0,0,0
48828,319,6,1,1,0,1,0,0
48828,319,6,1,1,0,1,0,0
0,0,0,0,0,0,0,0,0
0,0,0,0,0,0,0,0,0
0,0,0,0,0,0,0,0,0
33841,46,2,0,0,0,2,0,0
0,0,0,0,0,0,0,0,0
33841,46,2,0,0,0,2,0,0
33841,46,2,0,0,0,2,0,0
0,0,0,0,0,0,0,0,0
0,0,0,0,0,0,0,0,0
0,0,0,0,0,0,0,0,0
0,0,0,0,0,0,0,0,0
0,0,0,0,0,0,0,0,0
98953,66,4,0,0,0,2,1,0
98953,66,4,0,0,0,2,1,0
0,0,0,0,0,0,0,0,0
98953,66,4,0,0,0,2,1,0
98953,66,4,0,0,0,2,1,0
0,0,0,0,0,0,0,0,0
98953,66,4,0,0,0,2,1,0
0,0,0,0,0,0,0,0,0
0,0,0,0,0,0,0,0,0
0,0,0,0,0,0,0,0,0
0,0,0,0,0,0,0,0,0
0,0,0,0,0,0,0,0,0
0,0,0,0,0,0,0,0,0
61300,5,0,0,0,0,0,0,0
0,0,0,0,0,0,0,0,0
0,0,0,0,0,0,0,0,0
0,0,0,0,0,0,0,0,0
8432,53,3,1,1,0,4,0,0
8432,53,3,1,1,0,4,0,0
8432,53,3,1,1,0,4,0,0
8432,53,3,1,1,0,4,0,0
0,0,0,0,0,0,0,0,0
8432,53,3,1,1,0,4,0,0
232796,61,4,3,3,0,2,1,0
0,0,0,0,0,0,0,0,0
219787,1790,4,298,32,266,10,1,0
219837,1790,4,298,32,266,10,1,0
219463,1790,4,298,32,266,10,1,0
219368,1790,4,298,32,266,10,1,0
219360,1791,4,298,32,266,10,1,0
220038,1796,4,298,32,266,14,1,0
685701,4,0,0,0,0,0,0,0
220658,1796,4,298,32,266,14,1,0
685701,4,0,0,0,0,0,0,0
685701,4,0,0,0,0,0,0,0
685701,4,0,0,0,0,0,0,0
0,0,0,0,0,0,0,0,0
26672,36,0,3,1,2,0,0,0
72820,48,4,0,0,0,1,0,0
0,0,0,0,0,0,0,0,0
18262,255,3,33,32,1,0,0,0
167138,495,4,6,3,3,8,1,0
169364,504,4,7,4,3,8,1,0
0,0,0,0,0,0,0,0,0
0,0,0,0,0,0,0,0,0
0,0,0,0,0,0,0,0,0
670498,555,0,4,4,0,2,1,1
296130,205,6,1,1,0,0,1,0
0,0,0,0,0,0,0,0,0
0,0,0,0,0,0,0,0,0
0,0,0,0,0,0,0,0,0
0,0,0,0,0,0,0,0,0
14855,172,1,30,6,24,0,1,0
0,0,0,0,0,0,0,0,0
0,0,0,0,0,0,0,0,0
0,0,0,0,0,0,0,0,0
165998,363,3,7,4,3,1,0,0
671290,555,0,4,4,0,2,1,1
0,0,0,0,0,0,0,0,0
8073,140,7,26,6,20,1,1,0
0,0,0,0,0,0,0,0,0
72820,48,4,0,0,0,1,0,0
72820,48,4,0,0,0,1,0,0
25659,352,6,45,43,2,0,1,0
72820,48,4,0,0,0,1,0,0
72808,48,4,0,0,0,1,0,0
0,0,0,0,0,0,0,0,0
0,0,0,0,0,0,0,0,0
670266,555,0,4,4,0,2,1,1
0,0,0,0,0,0,0,0,0
15418,71,3,3,2,1,7,1,0
72820,48,4,0,0,0,1,0,0
72820,48,4,0,0,0,1,0,0
0,0,0,0,0,0,0,0,0
672959,555,0,4,4,0,2,1,1
9706,78,1,0,0,0,0,0,0
72820,48,4,0,0,0,1,0,0
72820,48,4,0,0,0,1,0,0
72820,48,4,0,0,0,1,0,0
72820,48,4,0,0,0,1,0,0
0,0,0,0,0,0,0,0,0
0,0,0,0,0,0,0,0,0
265030,511,4,49,33,16,7,1,0
28302,160,6,4,2,2,1,0,0
4337,36,2,0,0,0,0,0,0
76633,356,8,29,3,26,1,0,0
0,0,0,0,0,0,0,0,0
22408,50,0,0,0,0,0,0,0
0,0,0,0,0,0,0,0,0
0,0,0,0,0,0,0,0,0
0,0,0,0,0,0,0,0,0
0,0,0,0,0,0,0,0,0
0,0,0,0,0,0,0,0,0
0,0,0,0,0,0,0,0,0
72820,48,4,0,0,0,1,0,0
72820,48,4,0,0,0,1,0,0
0,0,0,0,0,0,0,0,0
675316,555,0,4,0,4,2,1,1
16244,57,0,2,2,0,0,1,0
14822,104,0,4,3,1,0,1,0
281905,1179,18,90,85,5,1,1,0
0,0,0,0,0,0,0,0,0
72820,48,4,0,0,0,1,0,0
72820,48,4,0,0,0,1,0,0
72820,48,4,0,0,0,1,0,0
0,0,0,0,0,0,0,0,0
16244,57,0,2,2,0,0,1,0
16244,57,0,2,2,0,0,1,0
0,0,0,0,0,0,0,0,0
461206,523,8,34,23,11,0,1,0
72821,48,4,0,0,0,1,0,0
24137,122,5,21,17,4,9,0,0
72819,48,4,0,0,0,1,0,0
0,0,0,0,0,0,0,0,0
0,0,0,0,0,0,0,0,0
0,0,0,0,0,0,0,0,0
0,0,0,0,0,0,0,0,0
15886,259,3,53,52,1,0,1,0
15895,259,3,53,52,1,0,1,0
219552,1791,4,298,32,266,10,1,0
219466,1790,4,298,32,266,10,1,0
219944,1790,4,298,32,266,10,1,0
219844,1790,4,298,32,266,10,1,0
0,0,0,0,0,0,0,0,0
32728,67,3,5,4,1,3,0,0
0,0,0,0,0,0,0,0,0
32728,67,3,5,4,1,3,0,0
32728,67,3,5,4,1,3,0,0
220041,1796,4,298,32,266,14,1,0
220050,1796,4,298,32,266,14,1,0
0,0,0,0,0,0,0,0,0
0,0,0,0,0,0,0,0,0
220654,1796,4,298,32,266,14,1,0
13149,29,1,0,0,0,3,0,0
436907,52,2,1,1,0,0,1,0
13149,29,1,0,0,0,3,0,0
13149,29,1,0,0,0,3,0,0
25114,67,2,1,1,0,2,0,0
0,0,0,0,0,0,0,0,0
0,0,0,0,0,0,0,0,0
0,0,0,0,0,0,0,0,0
0,0,0,0,0,0,0,0,0
0,0,0,0,0,0,0,0,0
0,0,0,0,0,0,0,0,0
436907,52,2,1,1,0,0,1,0
0,0,0,0,0,0,0,0,0
233123,64,4,3,3,0,2,1,0
233123,64,4,3,3,0,2,1,0
58533,87,2,8,8,0,2,1,0
58533,87,2,8,8,0,2,1,0
0,0,0,0,0,0,0,0,0
0,0,0,0,0,0,0,0,0
72820,48,4,0,0,0,1,0,0
0,0,0,0,0,0,0,0,0
0,0,0,0,0,0,0,0,0
58533,87,2,8,8,0,2,1,0
58533,87,2,8,8,0,2,1,0
0,0,0,0,0,0,0,0,0
58533,87,2,8,8,0,2,1,0
0,0,0,0,0,0,0,0,0
58533,87,2,8,8,0,2,1,0
58533,87,2,8,8,0,2,1,0
0,0,0,0,0,0,0,0,0
0,0,0,0,0,0,0,0,0
0,0,0,0,0,0,0,0,0
0,0,0,0,0,0,0,0,0
0,0,0,0,0,0,0,0,0
0,0,0,0,0,0,0,0,0
0,0,0,0,0,0,0,0,0
0,0,0,0,0,0,0,0,0
0,0,0,0,0,0,0,0,0
0,0,0,0,0,0,0,0,0
0,0,0,0,0,0,0,0,0
0,0,0,0,0,0,0,0,0
0,0,0,0,0,0,0,0,0
0,0,0,0,0,0,0,0,0
0,0,0,0,0,0,0,0,0
0,0,0,0,0,0,0,0,0
0,0,0,0,0,0,0,0,0
0,0,0,0,0,0,0,0,0
0,0,0,0,0,0,0,0,0
0,0,0,0,0,0,0,0,0
232818,61,4,3,3,0,2,1,0
796695,93,3,6,6,0,2,1,0
0,0,0,0,0,0,0,0,0
0,0,0,0,0,0,0,0,0
232818,61,4,3,3,0,2,1,0
0,0,0,0,0,0,0,0,0
0,0,0,0,0,0,0,0,0
0,0,0,0,0,0,0,0,0
0,0,0,0,0,0,0,0,0
0,0,0,0,0,0,0,0,0
232818,61,4,3,3,0,2,1,0
796695,93,3,6,6,0,2,1,0
0,0,0,0,0,0,0,0,0
0,0,0,0,0,0,0,0,0
0,0,0,0,0,0,0,0,0
0,0,0,0,0,0,0,0,0
0,0,0,0,0,0,0,0,0
0,0,0,0,0,0,0,0,0
0,0,0,0,0,0,0,0,0
25101,67,2,1,1,0,2,0,0
0,0,0,0,0,0,0,0,0
0,0,0,0,0,0,0,0,0
0,0,0,0,0,0,0,0,0
72820,48,4,0,0,0,1,0,0
72808,48,4,0,0,0,1,0,0
72820,48,4,0,0,0,1,0,0
72820,48,4,0,0,0,1,0,0
0,0,0,0,0,0,0,0,0
0,0,0,0,0,0,0,0,0
0,0,0,0,0,0,0,0,0
0,0,0,0,0,0,0,0,0
0,0,0,0,0,0,0,0,0
0,0,0,0,0,0,0,0,0
0,0,0,0,0,0,0,0,0
0,0,0,0,0,0,0,0,0
0,0,0,0,0,0,0,0,0
45183,43,3,0,0,0,0,0,0
74748,323,9,20,15,5,1,0,0
0,0,0,0,0,0,0,0,0
0,0,0,0,0,0,0,0,0
0,0,0,0,0,0,0,0,0
8073,140,7,26,6,20,1,1,0
0,0,0,0,0,0,0,0,0
0,0,0,0,0,0,0,0,0
0,0,0,0,0,0,0,0,0
72820,48,4,0,0,0,1,0,0
0,0,0,0,0,0,0,0,0
9200,28,1,2,2,0,0,0,0
8072,140,7,26,6,20,1,1,0
72820,48,4,0,0,0,1,0,0
72820,48,4,0,0,0,1,0,0
72820,48,4,0,0,0,1,0,0
0,0,0,0,0,0,0,0,0
0,0,0,0,0,0,0,0,0
0,0,0,0,0,0,0,0,0
72820,48,4,0,0,0,1,0,0
72820,48,4,0,0,0,1,0,0
72820,48,4,0,0,0,1,0,0
0,0,0,0,0,0,0,0,0
0,0,0,0,0,0,0,0,0
0,0,0,0,0,0,0,0,0
0,0,0,0,0,0,0,0,0
135395,330,8,27,24,3,20,1,0
13116,142,0,56,51,5,0,0,0
8073,140,7,26,6,20,1,1,0
72820,48,4,0,0,0,1,0,0
0,0,0,0,0,0,0,0,0
0,0,0,0,0,0,0,0,0
0,0,0,0,0,0,0,0,0
0,0,0,0,0,0,0,0,0
0,0,0,0,0,0,0,0,0
72820,48,4,0,0,0,1,0,0
0,0,0,0,0,0,0,0,0
0,0,0,0,0,0,0,0,0
670116,555,0,4,4,0,2,1,1
673890,555,0,4,4,0,2,1,1
72820,48,4,0,0,0,1,0,0
72820,48,4,0,0,0,1,0,0
8073,140,7,26,6,20,1,1,0
0,0,0,0,0,0,0,0,0
132162,514,10,50,42,8,4,0,0
72820,48,4,0,0,0,1,0,0
8073,140,7,26,6,20,1,1,0
72819,48,4,0,0,0,1,0,0
0,0,0,0,0,0,0,0,0
0,0,0,0,0,0,0,0,0
0,0,0,0,0,0,0,0,0
0,0,0,0,0,0,0,0,0
0,0,0,0,0,0,0,0,0
0,0,0,0,0,0,0,0,0
0,0,0,0,0,0,0,0,0
0,0,0,0,0,0,0,0,0
0,0,0,0,0,0,0,0,0
0,0,0,0,0,0,0,0,0
0,0,0,0,0,0,0,0,0
0,0,0,0,0,0,0,0,0
0,0,0,0,0,0,0,0,0
0,0,0,0,0,0,0,0,0
0,0,0,0,0,0,0,0,0
0,0,0,0,0,0,0,0,0
0,0,0,0,0,0,0,0,0
0,0,0,0,0,0,0,0,0
0,0,0,0,0,0,0,0,0
0,0,0,0,0,0,0,0,0
0,0,0,0,0,0,0,0,0
0,0,0,0,0,0,0,0,0
0,0,0,0,0,0,0,0,0
111829,61,4,3,3,0,2,1,0
0,0,0,0,0,0,0,0,0
0,0,0,0,0,0,0,0,0
0,0,0,0,0,0,0,0,0
0,0,0,0,0,0,0,0,0
0,0,0,0,0,0,0,0,0
232812,61,4,3,3,0,2,1,0
232812,61,4,3,3,0,2,1,0
111829,61,4,3,3,0,2,1,0
111829,61,4,3,3,0,2,1,0
232812,61,4,3,3,0,2,1,0
111829,61,4,3,3,0,2,1,0
111829,61,4,3,3,0,2,1,0
25283,91,3,7,7,0,2,1,0
0,0,0,0,0,0,0,0,0
0,0,0,0,0,0,0,0,0
0,0,0,0,0,0,0,0,0
0,0,0,0,0,0,0,0,0
0,0,0,0,0,0,0,0,0
0,0,0,0,0,0,0,0,0
72820,48,4,0,0,0,1,0,0
72808,48,4,0,0,0,1,0,0
0,0,0,0,0,0,0,0,0
0,0,0,0,0,0,0,0,0
93181,453,5,58,52,6,14,1,0
8382,32,2,0,0,0,0,0,0
0,0,0,0,0,0,0,0,0
0,0,0,0,0,0,0,0,0
0,0,0,0,0,0,0,0,0
280195,193,6,1,1,0,0,1,0
0,0,0,0,0,0,0,0,0
0,0,0,0,0,0,0,0,0
22529,38,0,2,2,0,0,1,0
165684,477,4,4,3,1,8,0,0
15408,151,4,10,8,2,2,1,0
0,0,0,0,0,0,0,0,0
0,0,0,0,0,0,0,0,0
0,0,0,0,0,0,0,0,0
0,0,0,0,0,0,0,0,0
0,0,0,0,0,0,0,0,0
0,0,0,0,0,0,0,0,0
0,0,0,0,0,0,0,0,0
0,0,0,0,0,0,0,0,0
0,0,0,0,0,0,0,0,0
0,0,0,0,0,0,0,0,0
0,0,0,0,0,0,0,0,0
116578,54,3,0,0,0,0,0,0
116578,54,3,0,0,0,0,0,0
0,0,0,0,0,0,0,0,0
0,0,0,0,0,0,0,0,0
0,0,0,0,0,0,0,0,0
8073,140,7,26,6,20,1,1,0
0,0,0,0,0,0,0,0,0
0,0,0,0,0,0,0,0,0
8072,140,7,26,6,20,1,1,0
72820,48,4,0,0,0,1,0,0
0,0,0,0,0,0,0,0,0
72820,48,4,0,0,0,1,0,0
6330,64,2,6,4,2,0,1,0
0,0,0,0,0,0,0,0,0
0,0,0,0,0,0,0,0,0
72820,48,4,0,0,0,1,0,0
0,0,0,0,0,0,0,0,0
72820,48,4,0,0,0,1,0,0
0,0,0,0,0,0,0,0,0
72820,48,4,0,0,0,1,0,0
0,0,0,0,0,0,0,0,0
188352,382,3,25,7,18,14,1,0
672163,555,0,4,4,0,2,1,1
0,0,0,0,0,0,0,0,0
0,0,0,0,0,0,0,0,0
0,0,0,0,0,0,0,0,0
0,0,0,0,0,0,0,0,0
0,0,0,0,0,0,0,0,0
670542,555,0,4,4,0,2,1,1
42061,185,1,4,2,2,0,0,0
0,0,0,0,0,0,0,0,0
0,0,0,0,0,0,0,0,0
0,0,0,0,0,0,0,0,0
30341,74,0,7,1,6,0,0,0
0,0,0,0,0,0,0,0,0
72820,48,4,0,0,0,1,0,0
0,0,0,0,0,0,0,0,0
0,0,0,0,0,0,0,0,0
141701,419,8,27,24,3,36,1,0
8073,140,7,26,6,20,1,1,0
0,0,0,0,0,0,0,0,0
0,0,0,0,0,0,0,0,0
72820,48,4,0,0,0,1,0,0
0,0,0,0,0,0,0,0,0
72808,48,4,0,0,0,1,0,0
72820,48,4,0,0,0,1,0,0
0,0,0,0,0,0,0,0,0
0,0,0,0,0,0,0,0,0
0,0,0,0,0,0,0,0,0
0,0,0,0,0,0,0,0,0
0,0,0,0,0,0,0,0,0
0,0,0,0,0,0,0,0,0
0,0,0,0,0,0,0,0,0
0,0,0,0,0,0,0,0,0
0,0,0,0,0,0,0,0,0
0,0,0,0,0,0,0,0,0
0,0,0,0,0,0,0,0,0
0,0,0,0,0,0,0,0,0
0,0,0,0,0,0,0,0,0
0,0,0,0,0,0,0,0,0
0,0,0,0,0,0,0,0,0
678780,555,0,4,0,4,2,1,1
0,0,0,0,0,0,0,0,0
0,0,0,0,0,0,0,0,0
0,0,0,0,0,0,0,0,0
0,0,0,0,0,0,0,0,0
0,0,0,0,0,0,0,0,0
6762,28,1,2,2,0,0,0,0
670539,555,0,4,4,0,2,1,1
0,0,0,0,0,0,0,0,0
74202,48,4,0,0,0,1,0,0
74202,48,4,0,0,0,1,0,0
0,0,0,0,0,0,0,0,0
0,0,0,0,0,0,0,0,0
0,0,0,0,0,0,0,0,0
0,0,0,0,0,0,0,0,0
0,0,0,0,0,0,0,0,0
0,0,0,0,0,0,0,0,0
288129,192,6,1,1,0,0,1,0
0,0,0,0,0,0,0,0,0
0,0,0,0,0,0,0,0,0
0,0,0,0,0,0,0,0,0
305318,55,3,3,3,0,0,1,0
0,0,0,0,0,0,0,0,0
0,0,0,0,0,0,0,0,0
0,0,0,0,0,0,0,0,0
0,0,0,0,0,0,0,0,0
0,0,0,0,0,0,0,0,0
0,0,0,0,0,0,0,0,0
0,0,0,0,0,0,0,0,0
0,0,0,0,0,0,0,0,0
0,0,0,0,0,0,0,0,0
0,0,0,0,0,0,0,0,0
0,0,0,0,0,0,0,0,0
673686,555,0,4,4,0,2,1,1
6330,64,2,6,4,2,0,1,0
29376,286,5,28,25,3,0,1,0
0,0,0,0,0,0,0,0,0
296126,2352,1,251,4,247,4,1,0
0,0,0,0,0,0,0,0,0
30341,74,0,7,1,6,0,0,0
0,0,0,0,0,0,0,0,0
0,0,0,0,0,0,0,0,0
0,0,0,0,0,0,0,0,0
0,0,0,0,0,0,0,0,0
0,0,0,0,0,0,0,0,0
8072,140,7,26,6,20,1,1,0
0,0,0,0,0,0,0,0,0
0,0,0,0,0,0,0,0,0
0,0,0,0,0,0,0,0,0
0,0,0,0,0,0,0,0,0
132876,58,4,5,5,0,2,1,0
52495,111,2,11,8,3,6,0,0
52495,111,2,11,8,3,6,0,0
52495,111,2,11,8,3,6,0,0
132876,58,4,5,5,0,2,1,0
25114,67,2,1,1,0,2,0,0
132876,58,4,5,5,0,2,1,0
25114,67,2,1,1,0,2,0,0
25114,67,2,1,1,0,2,0,0
135981,42,4,1,1,0,2,0,0
25114,67,2,1,1,0,2,0,0
6006867,71,5,1,1,0,2,1,0
6006867,71,5,1,1,0,2,1,0
6006867,71,5,1,1,0,2,1,0
135981,42,4,1,1,0,2,0,0
135981,42,4,1,1,0,2,0,0
0,0,0,0,0,0,0,0,0
6006867,71,5,1,1,0,2,1,0
0,0,0,0,0,0,0,0,0
0,0,0,0,0,0,0,0,0
0,0,0,0,0,0,0,0,0
0,0,0,0,0,0,0,0,0
0,0,0,0,0,0,0,0,0
0,0,0,0,0,0,0,0,0
0,0,0,0,0,0,0,0,0
0,0,0,0,0,0,0,0,0
0,0,0,0,0,0,0,0,0
655895,28,1,0,0,0,0,0,0
655895,28,1,0,0,0,0,0,0
655895,28,1,0,0,0,0,0,0
655895,28,1,0,0,0,0,0,0
0,0,0,0,0,0,0,0,0
655895,28,1,0,0,0,0,0,0
0,0,0,0,0,0,0,0,0
0,0,0,0,0,0,0,0,0
36426,48,1,0,0,0,0,0,0
8073,140,7,26,6,20,1,1,0
0,0,0,0,0,0,0,0,0
0,0,0,0,0,0,0,0,0
0,0,0,0,0,0,0,0,0
0,0,0,0,0,0,0,0,0
0,0,0,0,0,0,0,0,0
0,0,0,0,0,0,0,0,0
0,0,0,0,0,0,0,0,0
0,0,0,0,0,0,0,0,0
0,0,0,0,0,0,0,0,0
0,0,0,0,0,0,0,0,0
1059963,101,4,5,5,0,3,1,0
0,0,0,0,0,0,0,0,0
264853,182,6,1,1,0,0,1,0
270034,223,6,1,1,0,0,1,0
271464,227,6,1,1,0,0,1,0
0,0,0,0,0,0,0,0,0
0,0,0,0,0,0,0,0,0
0,0,0,0,0,0,0,0,0
0,0,0,0,0,0,0,0,0
0,0,0,0,0,0,0,0,0
0,0,0,0,0,0,0,0,0
0,0,0,0,0,0,0,0,0
0,0,0,0,0,0,0,0,0
0,0,0,0,0,0,0,0,0
0,0,0,0,0,0,0,0,0
0,0,0,0,0,0,0,0,0
0,0,0,0,0,0,0,0,0
0,0,0,0,0,0,0,0,0
0,0,0,0,0,0,0,0,0
203991,145,3,2,1,1,18,0,0
204003,145,3,2,1,1,18,0,0
0,0,0,0,0,0,0,0,0
0,0,0,0,0,0,0,0,0
74202,48,4,0,0,0,1,0,0
671013,555,0,4,4,0,2,1,1
74202,48,4,0,0,0,1,0,0
8073,140,7,26,6,20,1,1,0
0,0,0,0,0,0,0,0,0
0,0,0,0,0,0,0,0,0
0,0,0,0,0,0,0,0,0
0,0,0,0,0,0,0,0,0
74202,48,4,0,0,0,1,0,0
0,0,0,0,0,0,0,0,0
74189,48,4,0,0,0,1,0,0
48911,855,6,72,35,37,0,0,0
28496,663,7,136,134,2,5,1,0
8073,140,7,26,10,16,1,1,0
74202,48,4,0,0,0,1,0,0
74202,48,4,0,0,0,1,0,0
673307,555,0,4,4,0,2,1,1
0,0,0,0,0,0,0,0,0
0,0,0,0,0,0,0,0,0
0,0,0,0,0,0,0,0,0
0,0,0,0,0,0,0,0,0
8073,140,7,26,6,20,1,1,0
673599,555,0,4,4,0,2,1,1
74202,48,4,0,0,0,1,0,0
0,0,0,0,0,0,0,0,0
670863,555,0,4,4,0,2,1,1
8073,140,7,26,6,20,1,1,0
74190,48,4,0,0,0,1,0,0
139614,404,8,27,24,3,35,1,0
61236,381,5,29,8,21,3,0,0
47330,204,2,1,1,0,1,0,0
0,0,0,0,0,0,0,0,0
188493,860,9,80,79,1,3,1,0
64136,56,0,2,2,0,0,1,0
64197,56,0,2,2,0,0,1,0
64197,56,0,2,2,0,0,1,0
64197,56,0,2,2,0,0,1,0
64197,56,0,2,2,0,0,1,0
0,0,0,0,0,0,0,0,0
4547,35,0,2,0,2,0,0,0
45140,122,4,6,3,3,0,1,0
0,0,0,0,0,0,0,0,0
0,0,0,0,0,0,0,0,0
0,0,0,0,0,0,0,0,0
485732,198,6,3,1,2,0,1,0
0,0,0,0,0,0,0,0,0
0,0,0,0,0,0,0,0,0
169306,2241,8,106,78,28,24,1,0
0,0,0,0,0,0,0,0,0
0,0,0,0,0,0,0,0,0
0,0,0,0,0,0,0,0,0
0,0,0,0,0,0,0,0,0
0,0,0,0,0,0,0,0,0
0,0,0,0,0,0,0,0,0
0,0,0,0,0,0,0,0,0
33568,156,3,8,4,4,10,1,0
31754,52,2,0,0,0,0,0,0
31754,52,2,0,0,0,0,0,0
31754,52,2,0,0,0,0,0,0
110412,558,8,20,12,8,1,0,0
860,29,0,0,0,0,0,0,0
0,0,0,0,0,0,0,0,0
0,0,0,0,0,0,0,0,0
0,0,0,0,0,0,0,0,0
0,0,0,0,0,0,0,0,0
0,0,0,0,0,0,0,0,0
0,0,0,0,0,0,0,0,0
0,0,0,0,0,0,0,0,0
0,0,0,0,0,0,0,0,0
0,0,0,0,0,0,0,0,0
0,0,0,0,0,0,0,0,0
0,0,0,0,0,0,0,0,0
840,26,0,0,0,0,0,0,0
74201,48,4,0,0,0,1,0,0
0,0,0,0,0,0,0,0,0
0,0,0,0,0,0,0,0,0
0,0,0,0,0,0,0,0,0
30295,75,0,7,1,6,0,0,0
0,0,0,0,0,0,0,0,0
0,0,0,0,0,0,0,0,0
0,0,0,0,0,0,0,0,0
0,0,0,0,0,0,0,0,0
0,0,0,0,0,0,0,0,0
233116,64,4,3,3,0,2,1,0
233116,64,4,3,3,0,2,1,0
233116,64,4,3,3,0,2,1,0
233116,64,4,3,3,0,2,1,0
233116,64,4,3,3,0,2,1,0
232779,61,4,3,3,0,2,1,0
0,0,0,0,0,0,0,0,0
0,0,0,0,0,0,0,0,0
0,0,0,0,0,0,0,0,0
0,0,0,0,0,0,0,0,0
281518,181,6,1,1,0,0,1,0
0,0,0,0,0,0,0,0,0
0,0,0,0,0,0,0,0,0
0,0,0,0,0,0,0,0,0
0,0,0,0,0,0,0,0,0
7234,44,1,0,0,0,2,0,0
0,0,0,0,0,0,0,0,0
0,0,0,0,0,0,0,0,0
673426,555,0,4,4,0,2,1,1
0,0,0,0,0,0,0,0,0
0,0,0,0,0,0,0,0,0
508528,48,2,2,2,0,2,0,0
171360,172,0,6,6,0,1,1,1
0,0,0,0,0,0,0,0,0
12768,217,0,72,2,70,0,1,0
6330,64,2,6,4,2,0,1,0
114109,775,1,47,45,2,18,1,0
0,0,0,0,0,0,0,0,0
74202,48,4,0,0,0,1,0,0
0,0,0,0,0,0,0,0,0
62083,339,6,41,41,0,2,0,0
0,0,0,0,0,0,0,0,0
0,0,0,0,0,0,0,0,0
74200,48,4,0,0,0,1,0,0
11288,60,5,0,0,0,4,1,0
436892,52,2,1,1,0,0,1,0
436892,52,2,1,1,0,0,1,0
0,0,0,0,0,0,0,0,0
436892,52,2,1,1,0,0,1,0
436892,52,2,1,1,0,0,1,0
436892,52,2,1,1,0,0,1,0
436892,52,2,1,1,0,0,1,0
11288,60,5,0,0,0,4,1,0
11516,131,4,4,1,3,1,1,0
436892,52,2,1,1,0,0,1,0
0,0,0,0,0,0,0,0,0
0,0,0,0,0,0,0,0,0
0,0,0,0,0,0,0,0,0
25114,67,2,1,1,0,2,0,0
0,0,0,0,0,0,0,0,0
0,0,0,0,0,0,0,0,0
0,0,0,0,0,0,0,0,0
25114,67,2,1,1,0,2,0,0
25114,67,2,1,1,0,2,0,0
0,0,0,0,0,0,0,0,0
0,0,0,0,0,0,0,0,0
25114,67,2,1,1,0,2,0,0
0,0,0,0,0,0,0,0,0
33921,67,3,5,4,1,3,0,0
33921,67,3,5,4,1,3,0,0
33921,67,3,5,4,1,3,0,0
33921,67,3,5,4,1,3,0,0
7234,44,1,0,0,0,2,0,0
0,0,0,0,0,0,0,0,0
0,0,0,0,0,0,0,0,0
0,0,0,0,0,0,0,0,0
0,0,0,0,0,0,0,0,0
0,0,0,0,0,0,0,0,0
0,0,0,0,0,0,0,0,0
0,0,0,0,0,0,0,0,0
0,0,0,0,0,0,0,0,0
16038,72,4,0,0,0,0,1,0
0,0,0,0,0,0,0,0,0
0,0,0,0,0,0,0,0,0
0,0,0,0,0,0,0,0,0
0,0,0,0,0,0,0,0,0
0,0,0,0,0,0,0,0,0
0,0,0,0,0,0,0,0,0
0,0,0,0,0,0,0,0,0
0,0,0,0,0,0,0,0,0
74202,48,4,0,0,0,1,0,0
0,0,0,0,0,0,0,0,0
0,0,0,0,0,0,0,0,0
0,0,0,0,0,0,0,0,0
0,0,0,0,0,0,0,0,0
0,0,0,0,0,0,0,0,0
0,0,0,0,0,0,0,0,0
0,0,0,0,0,0,0,0,0
0,0,0,0,0,0,0,0,0
6584,71,3,1,0,1,0,0,0
0,0,0,0,0,0,0,0,0
0,0,0,0,0,0,0,0,0
0,0,0,0,0,0,0,0,0
0,0,0,0,0,0,0,0,0
0,0,0,0,0,0,0,0,0
0,0,0,0,0,0,0,0,0
266981,1732,6,340,299,41,1,1,0
266983,1732,6,340,300,40,1,1,0
0,0,0,0,0,0,0,0,0
0,0,0,0,0,0,0,0,0
0,0,0,0,0,0,0,0,0
0,0,0,0,0,0,0,0,0
0,0,0,0,0,0,0,0,0
0,0,0,0,0,0,0,0,0
9212,28,1,2,2,0,0,0,0
0,0,0,0,0,0,0,0,0
0,0,0,0,0,0,0,0,0
74204,48,4,0,0,0,1,0,0
25302,361,6,11,2,9,0,1,0
0,0,0,0,0,0,0,0,0
13120,142,0,56,51,5,0,0,0
0,0,0,0,0,0,0,0,0
0,0,0,0,0,0,0,0,0
0,0,0,0,0,0,0,0,0
10698,117,0,5,4,1,4,1,0
137961,397,8,26,24,2,35,1,0
0,0,0,0,0,0,0,0,0
141564,416,8,26,24,2,35,1,0
8073,140,7,26,6,20,1,1,0
8073,140,7,26,6,20,1,1,0
139824,406,8,27,24,3,34,1,0
0,0,0,0,0,0,0,0,0
0,0,0,0,0,0,0,0,0
672052,555,0,4,4,0,2,1,1
0,0,0,0,0,0,0,0,0
0,0,0,0,0,0,0,0,0
0,0,0,0,0,0,0,0,0
0,0,0,0,0,0,0,0,0
0,0,0,0,0,0,0,0,0
10686,162,7,26,17,9,0,1,0
12435,142,0,56,52,4,0,0,0
10686,162,7,26,17,9,0,1,0
10686,162,7,26,17,9,0,1,0
6330,64,2,6,4,2,0,1,0
0,0,0,0,0,0,0,0,0
0,0,0,0,0,0,0,0,0
0,0,0,0,0,0,0,0,0
10378,85,1,0,0,0,0,0,0
0,0,0,0,0,0,0,0,0
0,0,0,0,0,0,0,0,0
0,0,0,0,0,0,0,0,0
0,0,0,0,0,0,0,0,0
280003,196,6,1,1,0,0,1,0
506409,271,6,3,1,2,0,1,0
0,0,0,0,0,0,0,0,0
505628,271,6,3,1,2,0,1,0
0,0,0,0,0,0,0,0,0
673024,555,0,4,4,0,2,1,1
670619,555,0,4,4,0,2,1,1
0,0,0,0,0,0,0,0,0
104991,65,4,9,9,0,2,1,0
0,0,0,0,0,0,0,0,0
0,0,0,0,0,0,0,0,0
0,0,0,0,0,0,0,0,0
0,0,0,0,0,0,0,0,0
0,0,0,0,0,0,0,0,0
0,0,0,0,0,0,0,0,0
0,0,0,0,0,0,0,0,0
0,0,0,0,0,0,0,0,0
0,0,0,0,0,0,0,0,0
0,0,0,0,0,0,0,0,0
0,0,0,0,0,0,0,0,0
0,0,0,0,0,0,0,0,0
0,0,0,0,0,0,0,0,0
0,0,0,0,0,0,0,0,0
0,0,0,0,0,0,0,0,0
0,0,0,0,0,0,0,0,0
0,0,0,0,0,0,0,0,0
0,0,0,0,0,0,0,0,0
135970,42,4,1,1,0,2,0,0
233114,64,4,3,3,0,2,1,0
0,0,0,0,0,0,0,0,0
34493,50,2,0,0,0,2,0,0
0,0,0,0,0,0,0,0,0
226664,71,3,2,1,1,2,1,0
0,0,0,0,0,0,0,0,0
0,0,0,0,0,0,0,0,0
0,0,0,0,0,0,0,0,0
0,0,0,0,0,0,0,0,0
0,0,0,0,0,0,0,0,0
135970,42,4,1,1,0,2,0,0
0,0,0,0,0,0,0,0,0
233114,64,4,3,3,0,2,1,0
0,0,0,0,0,0,0,0,0
0,0,0,0,0,0,0,0,0
0,0,0,0,0,0,0,0,0
0,0,0,0,0,0,0,0,0
135970,42,4,1,1,0,2,0,0
233114,64,4,3,3,0,2,1,0
0,0,0,0,0,0,0,0,0
0,0,0,0,0,0,0,0,0
0,0,0,0,0,0,0,0,0
0,0,0,0,0,0,0,0,0
0,0,0,0,0,0,0,0,0
226664,71,3,2,1,1,2,1,0
0,0,0,0,0,0,0,0,0
420901,62,4,3,3,0,2,1,0
0,0,0,0,0,0,0,0,0
0,0,0,0,0,0,0,0,0
420901,62,4,3,3,0,2,1,0
0,0,0,0,0,0,0,0,0
0,0,0,0,0,0,0,0,0
420901,62,4,3,3,0,2,1,0
0,0,0,0,0,0,0,0,0
0,0,0,0,0,0,0,0,0
0,0,0,0,0,0,0,0,0
0,0,0,0,0,0,0,0,0
0,0,0,0,0,0,0,0,0
0,0,0,0,0,0,0,0,0
0,0,0,0,0,0,0,0,0
164464,475,4,4,1,3,7,0,0
0,0,0,0,0,0,0,0,0
0,0,0,0,0,0,0,0,0
0,0,0,0,0,0,0,0,0
0,0,0,0,0,0,0,0,0
0,0,0,0,0,0,0,0,0
0,0,0,0,0,0,0,0,0
0,0,0,0,0,0,0,0,0
0,0,0,0,0,0,0,0,0
388623,218,6,1,1,0,0,1,0
393992,225,6,1,1,0,0,1,0
0,0,0,0,0,0,0,0,0
0,0,0,0,0,0,0,0,0
226809,947,6,104,84,20,14,1,0
0,0,0,0,0,0,0,0,0
0,0,0,0,0,0,0,0,0
20771,158,0,1,0,1,0,1,0
20771,158,0,1,0,1,0,1,0
0,0,0,0,0,0,0,0,0
0,0,0,0,0,0,0,0,0
0,0,0,0,0,0,0,0,0
0,0,0,0,0,0,0,0,0
1005103,3937,4,123,2,121,18,1,0
1005135,3937,4,123,0,123,18,1,0
64136,56,0,2,2,0,0,1,0
64197,56,0,2,2,0,0,1,0
64197,56,0,2,2,0,0,1,0
64197,56,0,2,2,0,0,1,0
64197,56,0,2,2,0,0,1,0
8073,140,7,26,9,17,1,1,0
0,0,0,0,0,0,0,0,0
675722,555,0,4,0,4,2,1,1
0,0,0,0,0,0,0,0,0
0,0,0,0,0,0,0,0,0
64197,56,0,2,2,0,0,1,0
64136,56,0,2,2,0,0,1,0
64136,56,0,2,2,0,0,1,0
64136,56,0,2,2,0,0,1,0
64197,56,0,2,2,0,0,1,0
73152,48,4,0,0,0,1,0,0
8073,140,7,26,6,20,1,1,0
23291,225,3,24,24,0,0,1,0
0,0,0,0,0,0,0,0,0
0,0,0,0,0,0,0,0,0
0,0,0,0,0,0,0,0,0
8073,140,7,26,6,20,1,1,0
306969,197,7,1,1,0,0,1,0
0,0,0,0,0,0,0,0,0
0,0,0,0,0,0,0,0,0
139864,412,8,29,24,5,35,1,0
8073,140,7,26,6,20,1,1,0
8073,140,7,26,8,18,1,1,0
0,0,0,0,0,0,0,0,0
0,0,0,0,0,0,0,0,0
0,0,0,0,0,0,0,0,0
0,0,0,0,0,0,0,0,0
0,0,0,0,0,0,0,0,0
0,0,0,0,0,0,0,0,0
21798,33,0,1,1,0,0,1,0
138011,392,6,28,24,4,24,1,0
16329,142,0,56,51,5,0,0,0
0,0,0,0,0,0,0,0,0
0,0,0,0,0,0,0,0,0
0,0,0,0,0,0,0,0,0
0,0,0,0,0,0,0,0,0
1537,16,0,0,0,0,0,0,0
0,0,0,0,0,0,0,0,0
0,0,0,0,0,0,0,0,0
292874,188,2,43,9,34,3,1,0
292874,188,2,43,9,34,3,1,0
292874,188,2,43,9,34,3,1,0
13732,40,2,0,0,0,0,0,0
292874,188,2,43,9,34,3,1,0
0,0,0,0,0,0,0,0,0
0,0,0,0,0,0,0,0,0
0,0,0,0,0,0,0,0,0
0,0,0,0,0,0,0,0,0
0,0,0,0,0,0,0,0,0
0,0,0,0,0,0,0,0,0
25094,67,2,1,1,0,2,0,0
25094,67,2,1,1,0,2,0,0
25094,67,2,1,1,0,2,0,0
0,0,0,0,0,0,0,0,0
0,0,0,0,0,0,0,0,0
0,0,0,0,0,0,0,0,0
0,0,0,0,0,0,0,0,0
0,0,0,0,0,0,0,0,0
0,0,0,0,0,0,0,0,0
0,0,0,0,0,0,0,0,0
0,0,0,0,0,0,0,0,0
0,0,0,0,0,0,0,0,0
0,0,0,0,0,0,0,0,0
0,0,0,0,0,0,0,0,0
0,0,0,0,0,0,0,0,0
0,0,0,0,0,0,0,0,0
0,0,0,0,0,0,0,0,0
0,0,0,0,0,0,0,0,0
0,0,0,0,0,0,0,0,0
0,0,0,0,0,0,0,0,0
0,0,0,0,0,0,0,0,0
0,0,0,0,0,0,0,0,0
0,0,0,0,0,0,0,0,0
0,0,0,0,0,0,0,0,0
0,0,0,0,0,0,0,0,0
0,0,0,0,0,0,0,0,0
0,0,0,0,0,0,0,0,0
0,0,0,0,0,0,0,0,0
0,0,0,0,0,0,0,0,0
0,0,0,0,0,0,0,0,0
0,0,0,0,0,0,0,0,0
0,0,0,0,0,0,0,0,0
0,0,0,0,0,0,0,0,0
0,0,0,0,0,0,0,0,0
0,0,0,0,0,0,0,0,0
0,0,0,0,0,0,0,0,0
6328,64,2,6,4,2,0,1,0
0,0,0,0,0,0,0,0,0
0,0,0,0,0,0,0,0,0
0,0,0,0,0,0,0,0,0
0,0,0,0,0,0,0,0,0
0,0,0,0,0,0,0,0,0
0,0,0,0,0,0,0,0,0
0,0,0,0,0,0,0,0,0
0,0,0,0,0,0,0,0,0
0,0,0,0,0,0,0,0,0
0,0,0,0,0,0,0,0,0
0,0,0,0,0,0,0,0,0
0,0,0,0,0,0,0,0,0
0,0,0,0,0,0,0,0,0
243181,132,4,7,7,0,5,1,0
0,0,0,0,0,0,0,0,0
164116,79,1,9,0,9,0,1,0
102673,76,4,6,6,0,5,1,0
0,0,0,0,0,0,0,0,0
0,0,0,0,0,0,0,0,0
0,0,0,0,0,0,0,0,0
0,0,0,0,0,0,0,0,0
0,0,0,0,0,0,0,0,0
0,0,0,0,0,0,0,0,0
0,0,0,0,0,0,0,0,0
0,0,0,0,0,0,0,0,0
0,0,0,0,0,0,0,0,0
0,0,0,0,0,0,0,0,0
0,0,0,0,0,0,0,0,0
0,0,0,0,0,0,0,0,0
0,0,0,0,0,0,0,0,0
0,0,0,0,0,0,0,0,0
0,0,0,0,0,0,0,0,0
0,0,0,0,0,0,0,0,0
0,0,0,0,0,0,0,0,0
0,0,0,0,0,0,0,0,0
0,0,0,0,0,0,0,0,0
0,0,0,0,0,0,0,0,0
0,0,0,0,0,0,0,0,0
0,0,0,0,0,0,0,0,0
0,0,0,0,0,0,0,0,0
0,0,0,0,0,0,0,0,0
0,0,0,0,0,0,0,0,0
0,0,0,0,0,0,0,0,0
0,0,0,0,0,0,0,0,0
0,0,0,0,0,0,0,0,0
0,0,0,0,0,0,0,0,0
19016,179,1,25,25,0,2,1,0
19016,179,1,25,25,0,2,1,0
0,0,0,0,0,0,0,0,0
0,0,0,0,0,0,0,0,0
0,0,0,0,0,0,0,0,0
0,0,0,0,0,0,0,0,0
0,0,0,0,0,0,0,0,0
0,0,0,0,0,0,0,0,0
0,0,0,0,0,0,0,0,0
673484,555,0,4,4,0,2,1,1
40574,42,0,5,5,0,0,0,0
0,0,0,0,0,0,0,0,0
0,0,0,0,0,0,0,0,0
0,0,0,0,0,0,0,0,0
9215,28,1,2,2,0,0,0,0
0,0,0,0,0,0,0,0,0
0,0,0,0,0,0,0,0,0
0,0,0,0,0,0,0,0,0
0,0,0,0,0,0,0,0,0
0,0,0,0,0,0,0,0,0
0,0,0,0,0,0,0,0,0
0,0,0,0,0,0,0,0,0
0,0,0,0,0,0,0,0,0
0,0,0,0,0,0,0,0,0
670548,555,0,4,4,0,2,1,1
0,0,0,0,0,0,0,0,0
0,0,0,0,0,0,0,0,0
0,0,0,0,0,0,0,0,0
0,0,0,0,0,0,0,0,0
15869,115,2,12,11,1,3,1,0
0,0,0,0,0,0,0,0,0
0,0,0,0,0,0,0,0,0
0,0,0,0,0,0,0,0,0
73151,48,4,0,0,0,1,0,0
73152,48,4,0,0,0,1,0,0
73152,48,4,0,0,0,1,0,0
0,0,0,0,0,0,0,0,0
0,0,0,0,0,0,0,0,0
176949,2140,6,76,60,16,37,1,0
0,0,0,0,0,0,0,0,0
0,0,0,0,0,0,0,0,0
0,0,0,0,0,0,0,0,0
0,0,0,0,0,0,0,0,0
0,0,0,0,0,0,0,0,0
0,0,0,0,0,0,0,0,0
0,0,0,0,0,0,0,0,0
0,0,0,0,0,0,0,0,0
9202,28,1,2,2,0,0,0,0
6330,64,2,6,4,2,0,1,0
529251,300,6,11,1,10,0,1,0
7975,81,1,8,6,2,2,0,0
0,0,0,0,0,0,0,0,0
8967,47,3,1,1,0,2,0,0
0,0,0,0,0,0,0,0,0
226689,71,3,2,1,1,2,1,0
226689,71,3,2,1,1,2,1,0
0,0,0,0,0,0,0,0,0
0,0,0,0,0,0,0,0,0
0,0,0,0,0,0,0,0,0
0,0,0,0,0,0,0,0,0
0,0,0,0,0,0,0,0,0
0,0,0,0,0,0,0,0,0
0,0,0,0,0,0,0,0,0
0,0,0,0,0,0,0,0,0
0,0,0,0,0,0,0,0,0
0,0,0,0,0,0,0,0,0
0,0,0,0,0,0,0,0,0
0,0,0,0,0,0,0,0,0
0,0,0,0,0,0,0,0,0
0,0,0,0,0,0,0,0,0
109932,49,3,0,0,0,0,0,0
109932,49,3,0,0,0,0,0,0
109932,49,3,0,0,0,0,0,0
109932,49,3,0,0,0,0,0,0
0,0,0,0,0,0,0,0,0
0,0,0,0,0,0,0,0,0
13732,40,2,0,0,0,0,0,0
13732,40,2,0,0,0,0,0,0
13732,40,2,0,0,0,0,0,0
13732,40,2,0,0,0,0,0,0
0,0,0,0,0,0,0,0,0
0,0,0,0,0,0,0,0,0
0,0,0,0,0,0,0,0,0
0,0,0,0,0,0,0,0,0
22412,50,0,0,0,0,0,0,0
0,0,0,0,0,0,0,0,0
0,0,0,0,0,0,0,0,0
17725,55,6,0,0,0,2,1,0
0,0,0,0,0,0,0,0,0
0,0,0,0,0,0,0,0,0
0,0,0,0,0,0,0,0,0
0,0,0,0,0,0,0,0,0
0,0,0,0,0,0,0,0,0
277747,165,6,0,0,0,0,1,0
188967,64,1,5,5,0,0,1,0
380622,1868,10,423,418,5,1,1,0
0,0,0,0,0,0,0,0,0
0,0,0,0,0,0,0,0,0
0,0,0,0,0,0,0,0,0
0,0,0,0,0,0,0,0,0
0,0,0,0,0,0,0,0,0
0,0,0,0,0,0,0,0,0
0,0,0,0,0,0,0,0,0
0,0,0,0,0,0,0,0,0
0,0,0,0,0,0,0,0,0
0,0,0,0,0,0,0,0,0
0,0,0,0,0,0,0,0,0
0,0,0,0,0,0,0,0,0
0,0,0,0,0,0,0,0,0
0,0,0,0,0,0,0,0,0
0,0,0,0,0,0,0,0,0
73152,48,4,0,0,0,1,0,0
44380,47,3,2,2,0,0,0,0
0,0,0,0,0,0,0,0,0
73152,48,4,0,0,0,1,0,0
0,0,0,0,0,0,0,0,0
0,0,0,0,0,0,0,0,0
0,0,0,0,0,0,0,0,0
0,0,0,0,0,0,0,0,0
0,0,0,0,0,0,0,0,0
0,0,0,0,0,0,0,0,0
61717,420,2,0,0,0,6,0,0
21473,61,0,2,2,0,0,0,0
21473,61,0,2,2,0,0,0,0
0,0,0,0,0,0,0,0,0
15910,339,4,31,28,3,0,1,0
0,0,0,0,0,0,0,0,0
0,0,0,0,0,0,0,0,0
9209,28,1,2,2,0,0,0,0
0,0,0,0,0,0,0,0,0
0,0,0,0,0,0,0,0,0
0,0,0,0,0,0,0,0,0
73152,48,4,0,0,0,1,0,0
0,0,0,0,0,0,0,0,0
54784,114,1,4,4,0,0,0,0
0,0,0,0,0,0,0,0,0
0,0,0,0,0,0,0,0,0
0,0,0,0,0,0,0,0,0
0,0,0,0,0,0,0,0,0
0,0,0,0,0,0,0,0,0
0,0,0,0,0,0,0,0,0
0,0,0,0,0,0,0,0,0
0,0,0,0,0,0,0,0,0
477809,480,6,4,4,0,0,1,0
0,0,0,0,0,0,0,0,0
0,0,0,0,0,0,0,0,0
0,0,0,0,0,0,0,0,0
0,0,0,0,0,0,0,0,0
0,0,0,0,0,0,0,0,0
8073,140,7,26,6,20,1,1,0
0,0,0,0,0,0,0,0,0
0,0,0,0,0,0,0,0,0
0,0,0,0,0,0,0,0,0
287465,195,6,1,1,0,0,1,0
117367,845,3,75,74,1,0,1,0
21692,33,0,1,1,0,0,1,0
0,0,0,0,0,0,0,0,0
0,0,0,0,0,0,0,0,0
29243,77,3,0,0,0,3,0,0
0,0,0,0,0,0,0,0,0
696711,175,4,18,17,1,3,0,0
0,0,0,0,0,0,0,0,0
696711,175,4,18,17,1,3,0,0
696711,175,4,18,17,1,3,0,0
30816,163,4,17,16,1,4,0,0
30816,163,4,17,16,1,4,0,0
0,0,0,0,0,0,0,0,0
0,0,0,0,0,0,0,0,0
0,0,0,0,0,0,0,0,0
13121,29,1,0,0,0,3,0,0
0,0,0,0,0,0,0,0,0
0,0,0,0,0,0,0,0,0
13121,29,1,0,0,0,3,0,0
13121,29,1,0,0,0,3,0,0
0,0,0,0,0,0,0,0,0
0,0,0,0,0,0,0,0,0
0,0,0,0,0,0,0,0,0
0,0,0,0,0,0,0,0,0
135974,42,4,1,1,0,2,0,0
135974,42,4,1,1,0,2,0,0
0,0,0,0,0,0,0,0,0
135974,42,4,1,1,0,2,0,0
0,0,0,0,0,0,0,0,0
135974,42,4,1,1,0,2,0,0
135974,42,4,1,1,0,2,0,0
557257,43,4,1,1,0,2,0,0
557257,43,4,1,1,0,2,0,0
83226,132,2,10,10,0,0,1,0
0,0,0,0,0,0,0,0,0
10971,56,3,0,0,0,2,0,0
0,0,0,0,0,0,0,0,0
0,0,0,0,0,0,0,0,0
0,0,0,0,0,0,0,0,0
0,0,0,0,0,0,0,0,0
0,0,0,0,0,0,0,0,0
0,0,0,0,0,0,0,0,0
0,0,0,0,0,0,0,0,0
0,0,0,0,0,0,0,0,0
0,0,0,0,0,0,0,0,0
0,0,0,0,0,0,0,0,0
0,0,0,0,0,0,0,0,0
5054,24,3,0,0,0,0,0,0
5054,24,3,0,0,0,0,0,0
5054,24,3,0,0,0,0,0,0
5054,24,3,0,0,0,0,0,0
5054,24,3,0,0,0,0,0,0
0,0,0,0,0,0,0,0,0
0,0,0,0,0,0,0,0,0
0,0,0,0,0,0,0,0,0
0,0,0,0,0,0,0,0,0
36591,221,2,49,3,46,0,1,0
672065,26,1,0,0,0,0,0,0
0,0,0,0,0,0,0,0,0
91881,512,3,26,12,14,1,1,0
0,0,0,0,0,0,0,0,0
0,0,0,0,0,0,0,0,0
0,0,0,0,0,0,0,0,0
0,0,0,0,0,0,0,0,0
0,0,0,0,0,0,0,0,0
166061,486,4,4,3,1,8,0,0
0,0,0,0,0,0,0,0,0
270768,183,6,1,1,0,0,1,0
0,0,0,0,0,0,0,0,0
0,0,0,0,0,0,0,0,0
0,0,0,0,0,0,0,0,0
0,0,0,0,0,0,0,0,0
0,0,0,0,0,0,0,0,0
0,0,0,0,0,0,0,0,0
0,0,0,0,0,0,0,0,0
0,0,0,0,0,0,0,0,0
0,0,0,0,0,0,0,0,0
0,0,0,0,0,0,0,0,0
0,0,0,0,0,0,0,0,0
0,0,0,0,0,0,0,0,0
0,0,0,0,0,0,0,0,0
0,0,0,0,0,0,0,0,0
0,0,0,0,0,0,0,0,0
0,0,0,0,0,0,0,0,0
0,0,0,0,0,0,0,0,0
0,0,0,0,0,0,0,0,0
5800,76,1,2,2,0,0,0,0
5800,76,1,2,2,0,0,0,0
0,0,0,0,0,0,0,0,0
0,0,0,0,0,0,0,0,0
0,0,0,0,0,0,0,0,0
0,0,0,0,0,0,0,0,0
0,0,0,0,0,0,0,0,0
0,0,0,0,0,0,0,0,0
0,0,0,0,0,0,0,0,0
203983,145,3,2,1,1,18,0,0
203996,145,3,2,1,1,18,0,0
0,0,0,0,0,0,0,0,0
0,0,0,0,0,0,0,0,0
57146,78,2,4,1,3,0,0,0
0,0,0,0,0,0,0,0,0
0,0,0,0,0,0,0,0,0
0,0,0,0,0,0,0,0,0
0,0,0,0,0,0,0,0,0
0,0,0,0,0,0,0,0,0
0,0,0,0,0,0,0,0,0
0,0,0,0,0,0,0,0,0
0,0,0,0,0,0,0,0,0
5067,70,3,0,0,0,0,0,0
20965,259,7,9,8,1,4,0,0
0,0,0,0,0,0,0,0,0
0,0,0,0,0,0,0,0,0
9684,93,0,12,11,1,0,0,0
48354,562,3,120,117,3,9,0,0
48189,561,3,120,117,3,8,0,0
0,0,0,0,0,0,0,0,0
0,0,0,0,0,0,0,0,0
0,0,0,0,0,0,0,0,0
0,0,0,0,0,0,0,0,0
0,0,0,0,0,0,0,0,0
73152,48,4,0,0,0,1,0,0
0,0,0,0,0,0,0,0,0
212901,1261,5,215,179,36,1,0,0
73138,48,4,0,0,0,1,0,0
0,0,0,0,0,0,0,0,0
0,0,0,0,0,0,0,0,0
0,0,0,0,0,0,0,0,0
73152,48,4,0,0,0,1,0,0
0,0,0,0,0,0,0,0,0
0,0,0,0,0,0,0,0,0
12590,142,0,56,51,5,0,0,0
12908,142,0,56,51,5,0,0,0
0,0,0,0,0,0,0,0,0
0,0,0,0,0,0,0,0,0
652642,195,6,1,1,0,0,1,0
0,0,0,0,0,0,0,0,0
0,0,0,0,0,0,0,0,0
670624,555,0,4,4,0,2,1,1
672641,555,0,4,4,0,2,1,1
670680,555,0,4,4,0,2,1,1
45723,185,2,1,0,1,1,0,0
0,0,0,0,0,0,0,0,0
141836,419,8,27,24,3,35,1,0
0,0,0,0,0,0,0,0,0
0,0,0,0,0,0,0,0,0
0,0,0,0,0,0,0,0,0
0,0,0,0,0,0,0,0,0
0,0,0,0,0,0,0,0,0
0,0,0,0,0,0,0,0,0
0,0,0,0,0,0,0,0,0
0,0,0,0,0,0,0,0,0
0,0,0,0,0,0,0,0,0
0,0,0,0,0,0,0,0,0
0,0,0,0,0,0,0,0,0
0,0,0,0,0,0,0,0,0
0,0,0,0,0,0,0,0,0
0,0,0,0,0,0,0,0,0
0,0,0,0,0,0,0,0,0
0,0,0,0,0,0,0,0,0
0,0,0,0,0,0,0,0,0
0,0,0,0,0,0,0,0,0
0,0,0,0,0,0,0,0,0
33345,102,2,8,1,7,0,1,0
6330,64,2,6,4,2,0,1,0
0,0,0,0,0,0,0,0,0
0,0,0,0,0,0,0,0,0
672689,555,0,4,4,0,2,1,1
142380,419,8,27,24,3,35,1,0
683892,271,6,2,2,0,0,1,0
0,0,0,0,0,0,0,0,0
47615,210,2,2,1,1,1,0,0
0,0,0,0,0,0,0,0,0
0,0,0,0,0,0,0,0,0
1258675,2123,0,98,44,54,2,1,1
0,0,0,0,0,0,0,0,0
625194,199,6,1,1,0,0,1,0
670328,555,0,4,4,0,2,1,1
0,0,0,0,0,0,0,0,0
257590,1033,15,64,58,6,8,1,0
0,0,0,0,0,0,0,0,0
142408,423,8,28,24,4,35,1,0
0,0,0,0,0,0,0,0,0
0,0,0,0,0,0,0,0,0
0,0,0,0,0,0,0,0,0
0,0,0,0,0,0,0,0,0
0,0,0,0,0,0,0,0,0
0,0,0,0,0,0,0,0,0
0,0,0,0,0,0,0,0,0
28052,97,0,2,0,2,2,0,0
0,0,0,0,0,0,0,0,0
0,0,0,0,0,0,0,0,0
623818,200,7,1,1,0,0,1,0
0,0,0,0,0,0,0,0,0
0,0,0,0,0,0,0,0,0
0,0,0,0,0,0,0,0,0
4404,25,0,1,0,1,0,0,0
4404,25,0,1,0,1,0,0,0
0,0,0,0,0,0,0,0,0
0,0,0,0,0,0,0,0,0
0,0,0,0,0,0,0,0,0
0,0,0,0,0,0,0,0,0
0,0,0,0,0,0,0,0,0
8073,140,7,26,6,20,1,1,0
8073,140,7,26,6,20,1,1,0
73152,48,4,0,0,0,1,0,0
73152,48,4,0,0,0,1,0,0
0,0,0,0,0,0,0,0,0
12768,217,0,72,2,70,0,1,0
0,0,0,0,0,0,0,0,0
0,0,0,0,0,0,0,0,0
122656,867,8,102,42,60,1,1,0
163296,469,4,4,1,3,7,0,0
166432,473,4,4,3,1,8,0,0
166013,479,4,4,3,1,8,0,0
0,0,0,0,0,0,0,0,0
0,0,0,0,0,0,0,0,0
0,0,0,0,0,0,0,0,0
0,0,0,0,0,0,0,0,0
0,0,0,0,0,0,0,0,0
0,0,0,0,0,0,0,0,0
1059921,101,4,5,5,0,3,1,0
0,0,0,0,0,0,0,0,0
16244,57,0,2,2,0,0,1,0
0,0,0,0,0,0,0,0,0
0,0,0,0,0,0,0,0,0
137051,42,4,1,1,0,2,0,0
137051,42,4,1,1,0,2,0,0
137051,42,4,1,1,0,2,0,0
137051,42,4,1,1,0,2,0,0
0,0,0,0,0,0,0,0,0
127293,579,2,90,5,85,1,0,0
0,0,0,0,0,0,0,0,0
47622,75,2,1,1,0,3,1,0
0,0,0,0,0,0,0,0,0
0,0,0,0,0,0,0,0,0
0,0,0,0,0,0,0,0,0
0,0,0,0,0,0,0,0,0
0,0,0,0,0,0,0,0,0
37743,35,4,0,0,0,0,0,0
0,0,0,0,0,0,0,0,0
37743,35,4,0,0,0,0,0,0
37743,35,4,0,0,0,0,0,0
0,0,0,0,0,0,0,0,0
0,0,0,0,0,0,0,0,0
0,0,0,0,0,0,0,0,0
0,0,0,0,0,0,0,0,0
0,0,0,0,0,0,0,0,0
0,0,0,0,0,0,0,0,0
0,0,0,0,0,0,0,0,0
0,0,0,0,0,0,0,0,0
119623,52,0,0,0,0,0,0,0
0,0,0,0,0,0,0,0,0
0,0,0,0,0,0,0,0,0
0,0,0,0,0,0,0,0,0
0,0,0,0,0,0,0,0,0
0,0,0,0,0,0,0,0,0
0,0,0,0,0,0,0,0,0
5118,28,1,2,2,0,0,0,0
0,0,0,0,0,0,0,0,0
0,0,0,0,0,0,0,0,0
573316,631,4,36,10,26,2,1,0
573316,631,4,36,10,26,2,1,0
0,0,0,0,0,0,0,0,0
0,0,0,0,0,0,0,0,0
0,0,0,0,0,0,0,0,0
46819,204,2,1,1,0,1,0,0
365244,2544,10,215,208,7,10,1,0
365243,2544,10,215,208,7,10,1,0
365243,2544,10,215,208,7,10,1,0
365244,2544,10,215,208,7,10,1,0
0,0,0,0,0,0,0,0,0
365221,2543,10,215,208,7,10,1,0
365221,2543,10,215,208,7,10,1,0
365221,2543,10,215,208,7,10,1,0
365221,2543,10,215,208,7,10,1,0
365302,2545,10,215,208,7,10,1,0
0,0,0,0,0,0,0,0,0
672821,555,0,4,4,0,2,1,1
8073,140,7,26,7,19,1,1,0
0,0,0,0,0,0,0,0,0
0,0,0,0,0,0,0,0,0
0,0,0,0,0,0,0,0,0
0,0,0,0,0,0,0,0,0
0,0,0,0,0,0,0,0,0
0,0,0,0,0,0,0,0,0
0,0,0,0,0,0,0,0,0
0,0,0,0,0,0,0,0,0
0,0,0,0,0,0,0,0,0
0,0,0,0,0,0,0,0,0
0,0,0,0,0,0,0,0,0
0,0,0,0,0,0,0,0,0
0,0,0,0,0,0,0,0,0
0,0,0,0,0,0,0,0,0
0,0,0,0,0,0,0,0,0
0,0,0,0,0,0,0,0,0
0,0,0,0,0,0,0,0,0
20942,234,2,48,47,1,2,1,0
0,0,0,0,0,0,0,0,0
0,0,0,0,0,0,0,0,0
0,0,0,0,0,0,0,0,0
0,0,0,0,0,0,0,0,0
0,0,0,0,0,0,0,0,0
0,0,0,0,0,0,0,0,0
0,0,0,0,0,0,0,0,0
0,0,0,0,0,0,0,0,0
0,0,0,0,0,0,0,0,0
232871,64,4,3,3,0,2,1,0
232871,64,4,3,3,0,2,1,0
232871,64,4,3,3,0,2,1,0
232871,64,4,3,3,0,2,1,0
232871,64,4,3,3,0,2,1,0
0,0,0,0,0,0,0,0,0
0,0,0,0,0,0,0,0,0
436144,35,2,1,1,0,0,1,0
0,0,0,0,0,0,0,0,0
0,0,0,0,0,0,0,0,0
0,0,0,0,0,0,0,0,0
0,0,0,0,0,0,0,0,0
0,0,0,0,0,0,0,0,0
0,0,0,0,0,0,0,0,0
0,0,0,0,0,0,0,0,0
0,0,0,0,0,0,0,0,0
0,0,0,0,0,0,0,0,0
0,0,0,0,0,0,0,0,0
0,0,0,0,0,0,0,0,0
0,0,0,0,0,0,0,0,0
0,0,0,0,0,0,0,0,0
0,0,0,0,0,0,0,0,0
0,0,0,0,0,0,0,0,0
0,0,0,0,0,0,0,0,0
0,0,0,0,0,0,0,0,0
0,0,0,0,0,0,0,0,0
0,0,0,0,0,0,0,0,0
0,0,0,0,0,0,0,0,0
0,0,0,0,0,0,0,0,0
0,0,0,0,0,0,0,0,0
0,0,0,0,0,0,0,0,0
0,0,0,0,0,0,0,0,0
0,0,0,0,0,0,0,0,0
0,0,0,0,0,0,0,0,0
0,0,0,0,0,0,0,0,0
0,0,0,0,0,0,0,0,0
0,0,0,0,0,0,0,0,0
0,0,0,0,0,0,0,0,0
0,0,0,0,0,0,0,0,0
0,0,0,0,0,0,0,0,0
0,0,0,0,0,0,0,0,0
0,0,0,0,0,0,0,0,0
0,0,0,0,0,0,0,0,0
0,0,0,0,0,0,0,0,0
0,0,0,0,0,0,0,0,0
0,0,0,0,0,0,0,0,0
1060484,101,4,5,5,0,3,1,0
1059922,101,4,5,5,0,3,1,0
1060484,101,4,5,5,0,3,1,0
1059955,101,4,5,5,0,3,1,0
0,0,0,0,0,0,0,0,0
0,0,0,0,0,0,0,0,0
0,0,0,0,0,0,0,0,0
0,0,0,0,0,0,0,0,0
0,0,0,0,0,0,0,0,0
0,0,0,0,0,0,0,0,0
0,0,0,0,0,0,0,0,0
0,0,0,0,0,0,0,0,0
0,0,0,0,0,0,0,0,0
0,0,0,0,0,0,0,0,0
0,0,0,0,0,0,0,0,0
0,0,0,0,0,0,0,0,0
0,0,0,0,0,0,0,0,0
0,0,0,0,0,0,0,0,0
0,0,0,0,0,0,0,0,0
0,0,0,0,0,0,0,0,0
0,0,0,0,0,0,0,0,0
0,0,0,0,0,0,0,0,0
0,0,0,0,0,0,0,0,0
0,0,0,0,0,0,0,0,0
0,0,0,0,0,0,0,0,0
0,0,0,0,0,0,0,0,0
0,0,0,0,0,0,0,0,0
0,0,0,0,0,0,0,0,0
0,0,0,0,0,0,0,0,0
0,0,0,0,0,0,0,0,0
0,0,0,0,0,0,0,0,0
0,0,0,0,0,0,0,0,0
0,0,0,0,0,0,0,0,0
1130,19,1,1,0,1,0,0,0
1130,19,1,1,0,1,0,0,0
0,0,0,0,0,0,0,0,0
0,0,0,0,0,0,0,0,0
0,0,0,0,0,0,0,0,0
0,0,0,0,0,0,0,0,0
73152,48,4,0,0,0,1,0,0
0,0,0,0,0,0,0,0,0
0,0,0,0,0,0,0,0,0
0,0,0,0,0,0,0,0,0
0,0,0,0,0,0,0,0,0
0,0,0,0,0,0,0,0,0
0,0,0,0,0,0,0,0,0
64197,56,0,2,2,0,0,1,0
64136,56,0,2,2,0,0,1,0
64197,56,0,2,2,0,0,1,0
3519,60,4,3,3,0,0,0,0
0,0,0,0,0,0,0,0,0
0,0,0,0,0,0,0,0,0
0,0,0,0,0,0,0,0,0
123902,28,1,2,2,0,0,0,0
21875,33,0,1,1,0,0,1,0
0,0,0,0,0,0,0,0,0
73152,48,4,0,0,0,1,0,0
0,0,0,0,0,0,0,0,0
0,0,0,0,0,0,0,0,0
0,0,0,0,0,0,0,0,0
0,0,0,0,0,0,0,0,0
73152,48,4,0,0,0,1,0,0
0,0,0,0,0,0,0,0,0
0,0,0,0,0,0,0,0,0
0,0,0,0,0,0,0,0,0
0,0,0,0,0,0,0,0,0
0,0,0,0,0,0,0,0,0
0,0,0,0,0,0,0,0,0
0,0,0,0,0,0,0,0,0
0,0,0,0,0,0,0,0,0
0,0,0,0,0,0,0,0,0
0,0,0,0,0,0,0,0,0
138566,347,8,30,24,6,20,1,0
107479,280,3,17,2,15,0,0,0
0,0,0,0,0,0,0,0,0
670639,555,0,4,4,0,2,1,1
0,0,0,0,0,0,0,0,0
280076,1172,12,25,22,3,1,1,0
64197,56,0,2,2,0,0,1,0
64136,56,0,2,2,0,0,1,0
64197,56,0,2,2,0,0,1,0
64136,56,0,2,2,0,0,1,0
0,0,0,0,0,0,0,0,0
0,0,0,0,0,0,0,0,0
0,0,0,0,0,0,0,0,0
0,0,0,0,0,0,0,0,0
0,0,0,0,0,0,0,0,0
0,0,0,0,0,0,0,0,0
0,0,0,0,0,0,0,0,0
0,0,0,0,0,0,0,0,0
0,0,0,0,0,0,0,0,0
0,0,0,0,0,0,0,0,0
0,0,0,0,0,0,0,0,0
0,0,0,0,0,0,0,0,0
0,0,0,0,0,0,0,0,0
0,0,0,0,0,0,0,0,0
0,0,0,0,0,0,0,0,0
0,0,0,0,0,0,0,0,0
0,0,0,0,0,0,0,0,0
0,0,0,0,0,0,0,0,0
0,0,0,0,0,0,0,0,0
0,0,0,0,0,0,0,0,0
263184,100,4,5,5,0,3,1,0
141747,422,8,29,24,5,36,1,0
0,0,0,0,0,0,0,0,0
0,0,0,0,0,0,0,0,0
52985,610,2,41,8,33,1,1,0
0,0,0,0,0,0,0,0,0
0,0,0,0,0,0,0,0,0
0,0,0,0,0,0,0,0,0
0,0,0,0,0,0,0,0,0
301875,267,6,4,4,0,0,1,0
455318,183,6,1,1,0,0,1,0
241527,2150,9,266,256,10,4,1,0
49701,205,3,7,4,3,3,1,0
0,0,0,0,0,0,0,0,0
88601,50,2,0,0,0,2,0,0
0,0,0,0,0,0,0,0,0
88601,50,2,0,0,0,2,0,0
0,0,0,0,0,0,0,0,0
0,0,0,0,0,0,0,0,0
0,0,0,0,0,0,0,0,0
88601,50,2,0,0,0,2,0,0
0,0,0,0,0,0,0,0,0
88601,50,2,0,0,0,2,0,0
0,0,0,0,0,0,0,0,0
88601,50,2,0,0,0,2,0,0
88601,50,2,0,0,0,2,0,0
88601,50,2,0,0,0,2,0,0
0,0,0,0,0,0,0,0,0
0,0,0,0,0,0,0,0,0
0,0,0,0,0,0,0,0,0
0,0,0,0,0,0,0,0,0
0,0,0,0,0,0,0,0,0
0,0,0,0,0,0,0,0,0
0,0,0,0,0,0,0,0,0
0,0,0,0,0,0,0,0,0
0,0,0,0,0,0,0,0,0
0,0,0,0,0,0,0,0,0
50303,713,4,163,0,163,3,1,0
0,0,0,0,0,0,0,0,0
0,0,0,0,0,0,0,0,0
0,0,0,0,0,0,0,0,0
0,0,0,0,0,0,0,0,0
0,0,0,0,0,0,0,0,0
0,0,0,0,0,0,0,0,0
9406,31,1,0,0,0,1,0,0
292857,188,2,43,9,34,3,1,0
0,0,0,0,0,0,0,0,0
0,0,0,0,0,0,0,0,0
0,0,0,0,0,0,0,0,0
0,0,0,0,0,0,0,0,0
0,0,0,0,0,0,0,0,0
0,0,0,0,0,0,0,0,0
0,0,0,0,0,0,0,0,0
0,0,0,0,0,0,0,0,0
0,0,0,0,0,0,0,0,0
0,0,0,0,0,0,0,0,0
0,0,0,0,0,0,0,0,0
114023,72,4,2,1,1,2,1,0
0,0,0,0,0,0,0,0,0
135943,42,4,1,1,0,2,0,0
17745,61,3,2,2,0,2,1,0
0,0,0,0,0,0,0,0,0
0,0,0,0,0,0,0,0,0
0,0,0,0,0,0,0,0,0
0,0,0,0,0,0,0,0,0
0,0,0,0,0,0,0,0,0
0,0,0,0,0,0,0,0,0
0,0,0,0,0,0,0,0,0
73152,48,4,0,0,0,1,0,0
0,0,0,0,0,0,0,0,0
0,0,0,0,0,0,0,0,0
0,0,0,0,0,0,0,0,0
0,0,0,0,0,0,0,0,0
0,0,0,0,0,0,0,0,0
0,0,0,0,0,0,0,0,0
0,0,0,0,0,0,0,0,0
0,0,0,0,0,0,0,0,0
0,0,0,0,0,0,0,0,0
0,0,0,0,0,0,0,0,0
0,0,0,0,0,0,0,0,0
0,0,0,0,0,0,0,0,0
0,0,0,0,0,0,0,0,0
0,0,0,0,0,0,0,0,0
0,0,0,0,0,0,0,0,0
0,0,0,0,0,0,0,0,0
0,0,0,0,0,0,0,0,0
0,0,0,0,0,0,0,0,0
0,0,0,0,0,0,0,0,0
0,0,0,0,0,0,0,0,0
0,0,0,0,0,0,0,0,0
0,0,0,0,0,0,0,0,0
0,0,0,0,0,0,0,0,0
673362,555,0,4,4,0,2,1,1
0,0,0,0,0,0,0,0,0
20771,158,0,1,0,1,0,1,0
20771,158,0,1,0,1,0,1,0
0,0,0,0,0,0,0,0,0
0,0,0,0,0,0,0,0,0
0,0,0,0,0,0,0,0,0
0,0,0,0,0,0,0,0,0
0,0,0,0,0,0,0,0,0
0,0,0,0,0,0,0,0,0
0,0,0,0,0,0,0,0,0
0,0,0,0,0,0,0,0,0
0,0,0,0,0,0,0,0,0
0,0,0,0,0,0,0,0,0
0,0,0,0,0,0,0,0,0
0,0,0,0,0,0,0,0,0
0,0,0,0,0,0,0,0,0
64136,56,0,2,2,0,0,1,0
64197,56,0,2,2,0,0,1,0
64197,56,0,2,2,0,0,1,0
64136,56,0,2,2,0,0,1,0
0,0,0,0,0,0,0,0,0
0,0,0,0,0,0,0,0,0
0,0,0,0,0,0,0,0,0
11221,79,0,4,3,1,0,0,0
0,0,0,0,0,0,0,0,0
32165,89,0,3,1,2,0,0,0
0,0,0,0,0,0,0,0,0
0,0,0,0,0,0,0,0,0
0,0,0,0,0,0,0,0,0
0,0,0,0,0,0,0,0,0
0,0,0,0,0,0,0,0,0
8073,140,7,26,10,16,1,1,0
0,0,0,0,0,0,0,0,0
8073,140,7,26,6,20,1,1,0
264536,507,4,48,32,16,7,1,0
0,0,0,0,0,0,0,0,0
0,0,0,0,0,0,0,0,0
0,0,0,0,0,0,0,0,0
14119,142,0,56,52,4,0,0,0
0,0,0,0,0,0,0,0,0
0,0,0,0,0,0,0,0,0
0,0,0,0,0,0,0,0,0
165127,472,4,2,1,1,7,0,0
0,0,0,0,0,0,0,0,0
0,0,0,0,0,0,0,0,0
0,0,0,0,0,0,0,0,0
0,0,0,0,0,0,0,0,0
64197,56,0,2,2,0,0,1,0
64197,56,0,2,2,0,0,1,0
0,0,0,0,0,0,0,0,0
0,0,0,0,0,0,0,0,0
0,0,0,0,0,0,0,0,0
0,0,0,0,0,0,0,0,0
0,0,0,0,0,0,0,0,0
0,0,0,0,0,0,0,0,0
0,0,0,0,0,0,0,0,0
0,0,0,0,0,0,0,0,0
0,0,0,0,0,0,0,0,0
0,0,0,0,0,0,0,0,0
0,0,0,0,0,0,0,0,0
670239,555,0,4,4,0,2,1,1
0,0,0,0,0,0,0,0,0
0,0,0,0,0,0,0,0,0
0,0,0,0,0,0,0,0,0
0,0,0,0,0,0,0,0,0
0,0,0,0,0,0,0,0,0
142373,422,8,28,1,27,35,1,0
0,0,0,0,0,0,0,0,0
673522,555,0,4,4,0,2,1,1
0,0,0,0,0,0,0,0,0
3229,19,1,0,0,0,0,0,0
0,0,0,0,0,0,0,0,0
137744,437,10,127,119,8,10,0,0
73152,48,4,0,0,0,1,0,0
0,0,0,0,0,0,0,0,0
0,0,0,0,0,0,0,0,0
286900,187,6,1,1,0,0,1,0
0,0,0,0,0,0,0,0,0
141869,419,8,30,24,6,35,1,0
0,0,0,0,0,0,0,0,0
0,0,0,0,0,0,0,0,0
0,0,0,0,0,0,0,0,0
289122,331,3,9,9,0,3,1,0
0,0,0,0,0,0,0,0,0
0,0,0,0,0,0,0,0,0
0,0,0,0,0,0,0,0,0
0,0,0,0,0,0,0,0,0
7771,65,2,1,1,0,2,1,0
7771,65,2,1,1,0,2,1,0
7771,65,2,1,1,0,2,1,0
7771,65,2,1,1,0,2,1,0
7771,65,2,1,1,0,2,1,0
77709,47,2,0,0,0,2,0,0
36360,50,2,0,0,0,2,0,0
36360,50,2,0,0,0,2,0,0
36360,50,2,0,0,0,2,0,0
36401,50,2,0,0,0,2,0,0
36401,50,2,0,0,0,2,0,0
36360,50,2,0,0,0,2,0,0
246828,59,3,1,1,0,2,1,0
246828,59,3,1,1,0,2,1,0
36401,50,2,0,0,0,2,0,0
36401,50,2,0,0,0,2,0,0
6010146,71,5,1,1,0,2,1,0
246828,59,3,1,1,0,2,1,0
246828,59,3,1,1,0,2,1,0
246828,59,3,1,1,0,2,1,0
0,0,0,0,0,0,0,0,0
0,0,0,0,0,0,0,0,0
6010146,71,5,1,1,0,2,1,0
0,0,0,0,0,0,0,0,0
0,0,0,0,0,0,0,0,0
0,0,0,0,0,0,0,0,0
0,0,0,0,0,0,0,0,0
0,0,0,0,0,0,0,0,0
0,0,0,0,0,0,0,0,0
0,0,0,0,0,0,0,0,0
0,0,0,0,0,0,0,0,0
0,0,0,0,0,0,0,0,0
0,0,0,0,0,0,0,0,0
0,0,0,0,0,0,0,0,0
6010146,71,5,1,1,0,2,1,0
6010146,71,5,1,1,0,2,1,0
32101,163,4,17,16,1,4,0,0
32101,163,4,17,16,1,4,0,0
0,0,0,0,0,0,0,0,0
32101,163,4,17,16,1,4,0,0
32101,163,4,17,16,1,4,0,0
0,0,0,0,0,0,0,0,0
32101,163,4,17,16,1,4,0,0
32101,163,4,17,16,1,4,0,0
0,0,0,0,0,0,0,0,0
0,0,0,0,0,0,0,0,0
0,0,0,0,0,0,0,0,0
0,0,0,0,0,0,0,0,0
0,0,0,0,0,0,0,0,0
0,0,0,0,0,0,0,0,0
0,0,0,0,0,0,0,0,0
0,0,0,0,0,0,0,0,0
0,0,0,0,0,0,0,0,0
32101,163,4,17,16,1,4,0,0
0,0,0,0,0,0,0,0,0
0,0,0,0,0,0,0,0,0
0,0,0,0,0,0,0,0,0
0,0,0,0,0,0,0,0,0
0,0,0,0,0,0,0,0,0
0,0,0,0,0,0,0,0,0
0,0,0,0,0,0,0,0,0
145886,42,4,1,1,0,2,0,0
145886,42,4,1,1,0,2,0,0
0,0,0,0,0,0,0,0,0
0,0,0,0,0,0,0,0,0
145886,42,4,1,1,0,2,0,0
0,0,0,0,0,0,0,0,0
145886,42,4,1,1,0,2,0,0
0,0,0,0,0,0,0,0,0
15818,140,0,14,14,0,2,0,0
0,0,0,0,0,0,0,0,0
22416,50,0,0,0,0,0,0,0
0,0,0,0,0,0,0,0,0
0,0,0,0,0,0,0,0,0
67976,58,3,1,1,0,4,1,0
0,0,0,0,0,0,0,0,0
0,0,0,0,0,0,0,0,0
0,0,0,0,0,0,0,0,0
0,0,0,0,0,0,0,0,0
0,0,0,0,0,0,0,0,0
0,0,0,0,0,0,0,0,0
246347,122,4,7,7,0,3,1,0
263187,100,4,5,5,0,3,1,0
0,0,0,0,0,0,0,0,0
669500,64,4,3,3,0,2,1,0
6710,59,3,2,2,0,2,1,0
2781,24,1,3,0,3,0,0,0
534846,43,4,1,1,0,2,0,0
0,0,0,0,0,0,0,0,0
0,0,0,0,0,0,0,0,0
120176,370,2,11,1,10,0,1,0
0,0,0,0,0,0,0,0,0
0,0,0,0,0,0,0,0,0
301818,212,6,3,2,1,0,1,0
0,0,0,0,0,0,0,0,0
0,0,0,0,0,0,0,0,0
0,0,0,0,0,0,0,0,0
0,0,0,0,0,0,0,0,0
0,0,0,0,0,0,0,0,0
0,0,0,0,0,0,0,0,0
0,0,0,0,0,0,0,0,0
0,0,0,0,0,0,0,0,0
0,0,0,0,0,0,0,0,0
0,0,0,0,0,0,0,0,0
0,0,0,0,0,0,0,0,0
0,0,0,0,0,0,0,0,0
64136,56,0,2,2,0,0,1,0
64197,56,0,2,2,0,0,1,0
0,0,0,0,0,0,0,0,0
0,0,0,0,0,0,0,0,0
0,0,0,0,0,0,0,0,0
0,0,0,0,0,0,0,0,0
0,0,0,0,0,0,0,0,0
0,0,0,0,0,0,0,0,0
46690,47,2,3,0,3,2,0,0
46690,47,2,3,2,1,2,0,0
22353,147,1,1,0,1,0,1,0
22353,147,1,1,0,1,0,1,0
0,0,0,0,0,0,0,0,0
0,0,0,0,0,0,0,0,0
0,0,0,0,0,0,0,0,0
0,0,0,0,0,0,0,0,0
6330,64,2,6,4,2,0,1,0
9399,31,1,0,0,0,1,0,0
141192,412,8,29,24,5,32,1,0
0,0,0,0,0,0,0,0,0
0,0,0,0,0,0,0,0,0
0,0,0,0,0,0,0,0,0
64136,56,0,2,2,0,0,1,0
64136,56,0,2,2,0,0,1,0
64136,56,0,2,2,0,0,1,0
64136,56,0,2,2,0,0,1,0
73152,48,4,0,0,0,1,0,0
0,0,0,0,0,0,0,0,0
0,0,0,0,0,0,0,0,0
0,0,0,0,0,0,0,0,0
0,0,0,0,0,0,0,0,0
676917,555,0,4,0,4,2,1,1
676924,555,0,4,0,4,2,1,1
675886,555,0,4,0,4,2,1,1
21860,33,0,1,1,0,0,1,0
63105,406,3,52,51,1,3,1,0
2781,24,1,3,0,3,0,0,0
3701,34,1,6,0,6,0,0,0
0,0,0,0,0,0,0,0,0
0,0,0,0,0,0,0,0,0
0,0,0,0,0,0,0,0,0
339052,101,8,0,0,0,0,1,0
0,0,0,0,0,0,0,0,0
13275,142,0,56,51,5,0,0,0
25101,67,2,1,1,0,2,0,0
25101,67,2,1,1,0,2,0,0
33657,46,2,0,0,0,2,0,0
33657,46,2,0,0,0,2,0,0
33657,46,2,0,0,0,2,0,0
25094,67,2,1,1,0,2,0,0
25101,67,2,1,1,0,2,0,0
25101,67,2,1,1,0,2,0,0
25101,67,2,1,1,0,2,0,0
25101,67,2,1,1,0,2,0,0
0,0,0,0,0,0,0,0,0
0,0,0,0,0,0,0,0,0
0,0,0,0,0,0,0,0,0
0,0,0,0,0,0,0,0,0
0,0,0,0,0,0,0,0,0
0,0,0,0,0,0,0,0,0
0,0,0,0,0,0,0,0,0
0,0,0,0,0,0,0,0,0
0,0,0,0,0,0,0,0,0
0,0,0,0,0,0,0,0,0
415549,74,4,3,3,0,2,1,0
415549,74,4,3,3,0,2,1,0
0,0,0,0,0,0,0,0,0
0,0,0,0,0,0,0,0,0
0,0,0,0,0,0,0,0,0
0,0,0,0,0,0,0,0,0
0,0,0,0,0,0,0,0,0
415549,74,4,3,3,0,2,1,0
0,0,0,0,0,0,0,0,0
137433,67,4,0,0,0,2,1,0
415549,74,4,3,3,0,2,1,0
415549,74,4,3,3,0,2,1,0
415549,74,4,3,3,0,2,1,0
5050,24,3,0,0,0,0,0,0
137433,67,4,0,0,0,2,1,0
137433,67,4,0,0,0,2,1,0
137433,67,4,0,0,0,2,1,0
137433,67,4,0,0,0,2,1,0
5050,24,3,0,0,0,0,0,0
5050,24,3,0,0,0,0,0,0
5050,24,3,0,0,0,0,0,0
0,0,0,0,0,0,0,0,0
0,0,0,0,0,0,0,0,0
232782,61,4,3,3,0,2,1,0
232782,61,4,3,3,0,2,1,0
0,0,0,0,0,0,0,0,0
0,0,0,0,0,0,0,0,0
0,0,0,0,0,0,0,0,0
0,0,0,0,0,0,0,0,0
0,0,0,0,0,0,0,0,0
34447,50,2,0,0,0,2,0,0
34447,50,2,0,0,0,2,0,0
34447,50,2,0,0,0,2,0,0
34447,50,2,0,0,0,2,0,0
232782,61,4,3,3,0,2,1,0
232782,61,4,3,3,0,2,1,0
232782,61,4,3,3,0,2,1,0
232782,61,4,3,3,0,2,1,0
0,0,0,0,0,0,0,0,0
232782,61,4,3,3,0,2,1,0
0,0,0,0,0,0,0,0,0
16105,72,4,0,0,0,0,1,0
0,0,0,0,0,0,0,0,0
16105,72,4,0,0,0,0,1,0
16105,72,4,0,0,0,0,1,0
0,0,0,0,0,0,0,0,0
0,0,0,0,0,0,0,0,0
0,0,0,0,0,0,0,0,0
28102,173,0,9,9,0,0,0,0
0,0,0,0,0,0,0,0,0
0,0,0,0,0,0,0,0,0
7159,152,0,24,23,1,2,1,0
0,0,0,0,0,0,0,0,0
0,0,0,0,0,0,0,0,0
15227,35,0,2,2,0,0,0,0
0,0,0,0,0,0,0,0,0
54441,406,0,78,3,75,0,1,0
0,0,0,0,0,0,0,0,0
0,0,0,0,0,0,0,0,0
0,0,0,0,0,0,0,0,0
0,0,0,0,0,0,0,0,0
0,0,0,0,0,0,0,0,0
1072996,438,5,21,20,1,0,1,0
0,0,0,0,0,0,0,0,0
211760,46,5,0,0,0,0,0,0
211760,46,5,0,0,0,0,0,0
0,0,0,0,0,0,0,0,0
0,0,0,0,0,0,0,0,0
278611,180,6,1,1,0,0,1,0
0,0,0,0,0,0,0,0,0
0,0,0,0,0,0,0,0,0
13668,78,0,7,7,0,0,1,0
2752347,34,4,0,0,0,0,1,0
0,0,0,0,0,0,0,0,0
0,0,0,0,0,0,0,0,0
0,0,0,0,0,0,0,0,0
0,0,0,0,0,0,0,0,0
0,0,0,0,0,0,0,0,0
0,0,0,0,0,0,0,0,0
0,0,0,0,0,0,0,0,0
0,0,0,0,0,0,0,0,0
0,0,0,0,0,0,0,0,0
0,0,0,0,0,0,0,0,0
23219,177,0,2,0,2,0,0,0
23219,177,0,2,0,2,0,0,0
0,0,0,0,0,0,0,0,0
0,0,0,0,0,0,0,0,0
0,0,0,0,0,0,0,0,0
0,0,0,0,0,0,0,0,0
135167,814,0,151,149,2,14,1,0
0,0,0,0,0,0,0,0,0
73152,48,4,0,0,0,1,0,0
0,0,0,0,0,0,0,0,0
0,0,0,0,0,0,0,0,0
0,0,0,0,0,0,0,0,0
0,0,0,0,0,0,0,0,0
0,0,0,0,0,0,0,0,0
17962,218,0,23,23,0,0,1,0
0,0,0,0,0,0,0,0,0
138600,403,6,27,24,3,24,1,0
138293,338,8,28,24,4,20,1,0
66984,307,8,26,24,2,19,1,0
142204,418,8,27,24,3,35,1,0
0,0,0,0,0,0,0,0,0
83256,273,4,13,12,1,3,1,0
142682,424,8,28,24,4,36,1,0
0,0,0,0,0,0,0,0,0
0,0,0,0,0,0,0,0,0
141323,419,8,28,24,4,35,1,0
142959,427,8,29,24,5,35,1,0
53418,474,8,84,68,16,0,1,0
0,0,0,0,0,0,0,0,0
0,0,0,0,0,0,0,0,0
35062,432,5,131,8,123,5,0,0
0,0,0,0,0,0,0,0,0
0,0,0,0,0,0,0,0,0
315988,218,7,1,1,0,0,1,0
0,0,0,0,0,0,0,0,0
670638,555,0,4,4,0,2,1,1
0,0,0,0,0,0,0,0,0
0,0,0,0,0,0,0,0,0
64136,56,0,2,2,0,0,1,0
64336,56,0,2,2,0,0,1,0
0,0,0,0,0,0,0,0,0
0,0,0,0,0,0,0,0,0
0,0,0,0,0,0,0,0,0
3304,29,1,1,1,0,0,0,0
3304,29,1,1,1,0,0,0,0
0,0,0,0,0,0,0,0,0
0,0,0,0,0,0,0,0,0
0,0,0,0,0,0,0,0,0
73152,48,4,0,0,0,1,0,0
0,0,0,0,0,0,0,0,0
140143,408,8,28,24,4,34,1,0
0,0,0,0,0,0,0,0,0
33969,175,5,4,1,3,1,0,0
0,0,0,0,0,0,0,0,0
0,0,0,0,0,0,0,0,0
78309,836,7,140,127,13,2,1,0
0,0,0,0,0,0,0,0,0
0,0,0,0,0,0,0,0,0
144394,42,4,1,1,0,2,0,0
0,0,0,0,0,0,0,0,0
0,0,0,0,0,0,0,0,0
0,0,0,0,0,0,0,0,0
0,0,0,0,0,0,0,0,0
0,0,0,0,0,0,0,0,0
144394,42,4,1,1,0,2,0,0
144394,42,4,1,1,0,2,0,0
0,0,0,0,0,0,0,0,0
0,0,0,0,0,0,0,0,0
0,0,0,0,0,0,0,0,0
140685,49,3,5,5,0,0,0,0
140685,49,3,5,5,0,0,0,0
140685,49,3,5,5,0,0,0,0
140685,49,3,5,5,0,0,0,0
140685,49,3,5,5,0,0,0,0
0,0,0,0,0,0,0,0,0
0,0,0,0,0,0,0,0,0
0,0,0,0,0,0,0,0,0
0,0,0,0,0,0,0,0,0
0,0,0,0,0,0,0,0,0
0,0,0,0,0,0,0,0,0
0,0,0,0,0,0,0,0,0
0,0,0,0,0,0,0,0,0
0,0,0,0,0,0,0,0,0
0,0,0,0,0,0,0,0,0
0,0,0,0,0,0,0,0,0
0,0,0,0,0,0,0,0,0
0,0,0,0,0,0,0,0,0
0,0,0,0,0,0,0,0,0
0,0,0,0,0,0,0,0,0
233108,64,4,3,3,0,2,1,0
47194,54,2,0,0,0,1,0,0
47194,54,2,0,0,0,1,0,0
0,0,0,0,0,0,0,0,0
0,0,0,0,0,0,0,0,0
233108,64,4,3,3,0,2,1,0
47194,54,2,0,0,0,1,0,0
47194,54,2,0,0,0,1,0,0
233108,64,4,3,3,0,2,1,0
47194,54,2,0,0,0,1,0,0
47194,54,2,0,0,0,1,0,0
6978,50,2,1,1,0,0,1,0
6978,50,2,1,1,0,0,1,0
47194,54,2,0,0,0,1,0,0
6978,50,2,1,1,0,0,1,0
6978,50,2,1,1,0,0,1,0
1155456,62,4,3,3,0,2,1,0
6978,50,2,1,1,0,0,1,0
0,0,0,0,0,0,0,0,0
137035,42,4,1,1,0,2,0,0
137035,42,4,1,1,0,2,0,0
137035,42,4,1,1,0,2,0,0
137035,42,4,1,1,0,2,0,0
0,0,0,0,0,0,0,0,0
0,0,0,0,0,0,0,0,0
0,0,0,0,0,0,0,0,0
0,0,0,0,0,0,0,0,0
0,0,0,0,0,0,0,0,0
0,0,0,0,0,0,0,0,0
0,0,0,0,0,0,0,0,0
0,0,0,0,0,0,0,0,0
0,0,0,0,0,0,0,0,0
0,0,0,0,0,0,0,0,0
0,0,0,0,0,0,0,0,0
0,0,0,0,0,0,0,0,0
0,0,0,0,0,0,0,0,0
0,0,0,0,0,0,0,0,0
0,0,0,0,0,0,0,0,0
0,0,0,0,0,0,0,0,0
0,0,0,0,0,0,0,0,0
22353,147,1,1,0,1,0,1,0
22353,147,1,1,0,1,0,1,0
0,0,0,0,0,0,0,0,0
0,0,0,0,0,0,0,0,0
0,0,0,0,0,0,0,0,0
22440,50,0,0,0,0,0,0,0
0,0,0,0,0,0,0,0,0
0,0,0,0,0,0,0,0,0
32304,181,5,8,5,3,1,0,0
0,0,0,0,0,0,0,0,0
8389,93,1,4,0,4,2,1,0
28436,42,3,1,1,0,0,0,0
0,0,0,0,0,0,0,0,0
0,0,0,0,0,0,0,0,0
0,0,0,0,0,0,0,0,0
0,0,0,0,0,0,0,0,0
0,0,0,0,0,0,0,0,0
0,0,0,0,0,0,0,0,0
0,0,0,0,0,0,0,0,0
0,0,0,0,0,0,0,0,0
0,0,0,0,0,0,0,0,0
0,0,0,0,0,0,0,0,0
0,0,0,0,0,0,0,0,0
0,0,0,0,0,0,0,0,0
5460,45,0,0,0,0,0,0,0
5028,53,0,9,0,9,0,0,0
0,0,0,0,0,0,0,0,0
388001,1266,12,103,13,90,8,0,0
0,0,0,0,0,0,0,0,0
0,0,0,0,0,0,0,0,0
9212,28,1,2,2,0,0,0,0
238397,619,0,49,44,5,0,1,0
26677,36,0,3,1,2,0,0,0
0,0,0,0,0,0,0,0,0
0,0,0,0,0,0,0,0,0
73041,47,4,0,0,0,1,0,0
0,0,0,0,0,0,0,0,0
0,0,0,0,0,0,0,0,0
0,0,0,0,0,0,0,0,0
281871,196,6,1,1,0,0,1,0
15721,249,1,6,5,1,0,1,0
141806,420,8,28,24,4,36,1,0
0,0,0,0,0,0,0,0,0
0,0,0,0,0,0,0,0,0
0,0,0,0,0,0,0,0,0
0,0,0,0,0,0,0,0,0
0,0,0,0,0,0,0,0,0
0,0,0,0,0,0,0,0,0
0,0,0,0,0,0,0,0,0
0,0,0,0,0,0,0,0,0
0,0,0,0,0,0,0,0,0
0,0,0,0,0,0,0,0,0
0,0,0,0,0,0,0,0,0
0,0,0,0,0,0,0,0,0
0,0,0,0,0,0,0,0,0
0,0,0,0,0,0,0,0,0
0,0,0,0,0,0,0,0,0
0,0,0,0,0,0,0,0,0
0,0,0,0,0,0,0,0,0
0,0,0,0,0,0,0,0,0
0,0,0,0,0,0,0,0,0
0,0,0,0,0,0,0,0,0
674757,555,0,4,0,4,2,1,1
677199,555,0,4,0,4,2,1,1
0,0,0,0,0,0,0,0,0
32882,241,7,2,2,0,9,0,0
0,0,0,0,0,0,0,0,0
0,0,0,0,0,0,0,0,0
0,0,0,0,0,0,0,0,0
543,30,0,5,5,0,0,0,0
0,0,0,0,0,0,0,0,0
0,0,0,0,0,0,0,0,0
35477,167,7,20,17,3,1,1,0
0,0,0,0,0,0,0,0,0
141162,416,8,29,24,5,34,1,0
136860,332,8,27,24,3,20,1,0
0,0,0,0,0,0,0,0,0
0,0,0,0,0,0,0,0,0
0,0,0,0,0,0,0,0,0
0,0,0,0,0,0,0,0,0
0,0,0,0,0,0,0,0,0
0,0,0,0,0,0,0,0,0
0,0,0,0,0,0,0,0,0
0,0,0,0,0,0,0,0,0
855,14,0,1,1,0,0,0,0
0,0,0,0,0,0,0,0,0
0,0,0,0,0,0,0,0,0
0,0,0,0,0,0,0,0,0
0,0,0,0,0,0,0,0,0
0,0,0,0,0,0,0,0,0
0,0,0,0,0,0,0,0,0
10854,80,2,12,11,1,0,1,0
10854,80,2,12,11,1,0,1,0
10854,80,2,12,11,1,0,1,0
0,0,0,0,0,0,0,0,0
0,0,0,0,0,0,0,0,0
0,0,0,0,0,0,0,0,0
0,0,0,0,0,0,0,0,0
0,0,0,0,0,0,0,0,0
0,0,0,0,0,0,0,0,0
0,0,0,0,0,0,0,0,0
0,0,0,0,0,0,0,0,0
0,0,0,0,0,0,0,0,0
0,0,0,0,0,0,0,0,0
0,0,0,0,0,0,0,0,0
0,0,0,0,0,0,0,0,0
2369,33,1,3,0,3,0,0,0
7009,113,1,5,0,5,2,1,0
0,0,0,0,0,0,0,0,0
0,0,0,0,0,0,0,0,0
0,0,0,0,0,0,0,0,0
0,0,0,0,0,0,0,0,0
0,0,0,0,0,0,0,0,0
0,0,0,0,0,0,0,0,0
0,0,0,0,0,0,0,0,0
0,0,0,0,0,0,0,0,0
0,0,0,0,0,0,0,0,0
167003,1625,5,154,89,65,4,1,0
0,0,0,0,0,0,0,0,0
0,0,0,0,0,0,0,0,0
0,0,0,0,0,0,0,0,0
0,0,0,0,0,0,0,0,0
0,0,0,0,0,0,0,0,0
73162,48,4,0,0,0,1,0,0
28479,45,0,4,1,3,0,0,0
0,0,0,0,0,0,0,0,0
0,0,0,0,0,0,0,0,0
0,0,0,0,0,0,0,0,0
188021,70,4,0,0,0,2,1,0
188021,70,4,0,0,0,2,1,0
188021,70,4,0,0,0,2,1,0
0,0,0,0,0,0,0,0,0
0,0,0,0,0,0,0,0,0
0,0,0,0,0,0,0,0,0
0,0,0,0,0,0,0,0,0
0,0,0,0,0,0,0,0,0
0,0,0,0,0,0,0,0,0
0,0,0,0,0,0,0,0,0
0,0,0,0,0,0,0,0,0
0,0,0,0,0,0,0,0,0
0,0,0,0,0,0,0,0,0
12006,47,3,5,5,0,1,0,0
12006,47,3,5,5,0,1,0,0
135974,42,4,1,1,0,2,0,0
135974,42,4,1,1,0,2,0,0
12006,47,3,5,5,0,1,0,0
135974,42,4,1,1,0,2,0,0
135974,42,4,1,1,0,2,0,0
135974,42,4,1,1,0,2,0,0
0,0,0,0,0,0,0,0,0
0,0,0,0,0,0,0,0,0
0,0,0,0,0,0,0,0,0
0,0,0,0,0,0,0,0,0
0,0,0,0,0,0,0,0,0
0,0,0,0,0,0,0,0,0
0,0,0,0,0,0,0,0,0
0,0,0,0,0,0,0,0,0
534846,43,4,1,1,0,2,0,0
0,0,0,0,0,0,0,0,0
0,0,0,0,0,0,0,0,0
16928,69,3,5,5,0,0,0,0
0,0,0,0,0,0,0,0,0
8507,49,2,7,5,2,2,0,0
0,0,0,0,0,0,0,0,0
0,0,0,0,0,0,0,0,0
0,0,0,0,0,0,0,0,0
0,0,0,0,0,0,0,0,0
0,0,0,0,0,0,0,0,0
0,0,0,0,0,0,0,0,0
0,0,0,0,0,0,0,0,0
0,0,0,0,0,0,0,0,0
0,0,0,0,0,0,0,0,0
0,0,0,0,0,0,0,0,0
9734,106,2,6,1,5,5,1,0
1374403,7586,2,339,330,9,1,1,0
15909,339,4,31,28,3,0,1,0
0,0,0,0,0,0,0,0,0
0,0,0,0,0,0,0,0,0
0,0,0,0,0,0,0,0,0
0,0,0,0,0,0,0,0,0
0,0,0,0,0,0,0,0,0
0,0,0,0,0,0,0,0,0
263974,176,6,1,1,0,0,1,0
0,0,0,0,0,0,0,0,0
0,0,0,0,0,0,0,0,0
41167,175,1,4,2,2,0,0,0
0,0,0,0,0,0,0,0,0
0,0,0,0,0,0,0,0,0
0,0,0,0,0,0,0,0,0
0,0,0,0,0,0,0,0,0
0,0,0,0,0,0,0,0,0
25094,67,2,1,1,0,2,0,0
0,0,0,0,0,0,0,0,0
0,0,0,0,0,0,0,0,0
0,0,0,0,0,0,0,0,0
0,0,0,0,0,0,0,0,0
0,0,0,0,0,0,0,0,0
0,0,0,0,0,0,0,0,0
0,0,0,0,0,0,0,0,0
0,0,0,0,0,0,0,0,0
0,0,0,0,0,0,0,0,0
0,0,0,0,0,0,0,0,0
0,0,0,0,0,0,0,0,0
0,0,0,0,0,0,0,0,0
0,0,0,0,0,0,0,0,0
0,0,0,0,0,0,0,0,0
0,0,0,0,0,0,0,0,0
0,0,0,0,0,0,0,0,0
0,0,0,0,0,0,0,0,0
0,0,0,0,0,0,0,0,0
0,0,0,0,0,0,0,0,0
0,0,0,0,0,0,0,0,0
0,0,0,0,0,0,0,0,0
0,0,0,0,0,0,0,0,0
126209,56,4,2,1,1,0,1,0
126209,56,4,2,1,1,0,1,0
126187,56,4,2,1,1,0,1,0
126209,56,4,2,1,1,0,1,0
126187,56,4,2,1,1,0,1,0
126187,56,4,2,1,1,0,1,0
0,0,0,0,0,0,0,0,0
0,0,0,0,0,0,0,0,0
0,0,0,0,0,0,0,0,0
8432,53,3,1,1,0,4,0,0
8432,53,3,1,1,0,4,0,0
8432,53,3,1,1,0,4,0,0
0,0,0,0,0,0,0,0,0
0,0,0,0,0,0,0,0,0
415720,62,4,3,3,0,2,1,0
415720,62,4,3,3,0,2,1,0
8432,53,3,1,1,0,4,0,0
167640,63,4,0,0,0,2,0,0
167640,63,4,0,0,0,2,0,0
0,0,0,0,0,0,0,0,0
254921,159,0,41,39,2,0,0,0
0,0,0,0,0,0,0,0,0
0,0,0,0,0,0,0,0,0
301157,49,4,0,0,0,2,1,0
301157,49,4,0,0,0,2,1,0
415720,62,4,3,3,0,2,1,0
415720,62,4,3,3,0,2,1,0
415720,62,4,3,3,0,2,1,0
415720,62,4,3,3,0,2,1,0
0,0,0,0,0,0,0,0,0
0,0,0,0,0,0,0,0,0
167640,63,4,0,0,0,2,0,0
167640,63,4,0,0,0,2,0,0
98953,66,4,0,0,0,2,1,0
250228,75,0,17,15,2,0,0,0
250228,75,0,17,15,2,0,0,0
255896,159,0,41,39,2,0,0,0
255896,159,0,41,39,2,0,0,0
0,0,0,0,0,0,0,0,0
0,0,0,0,0,0,0,0,0
415720,62,4,3,3,0,2,1,0
98953,66,4,0,0,0,2,1,0
249877,75,0,17,15,2,0,0,0
249877,75,0,17,15,2,0,0,0
254921,159,0,41,39,2,0,0,0
254921,159,0,41,39,2,0,0,0
0,0,0,0,0,0,0,0,0
0,0,0,0,0,0,0,0,0
0,0,0,0,0,0,0,0,0
0,0,0,0,0,0,0,0,0
0,0,0,0,0,0,0,0,0
0,0,0,0,0,0,0,0,0
10181,151,2,28,23,5,0,0,0
10181,151,2,28,23,5,0,0,0
0,0,0,0,0,0,0,0,0
0,0,0,0,0,0,0,0,0
0,0,0,0,0,0,0,0,0
0,0,0,0,0,0,0,0,0
0,0,0,0,0,0,0,0,0
1183197,1267,1,44,29,15,7,1,0
0,0,0,0,0,0,0,0,0
0,0,0,0,0,0,0,0,0
0,0,0,0,0,0,0,0,0
0,0,0,0,0,0,0,0,0
0,0,0,0,0,0,0,0,0
0,0,0,0,0,0,0,0,0
0,0,0,0,0,0,0,0,0
0,0,0,0,0,0,0,0,0
0,0,0,0,0,0,0,0,0
0,0,0,0,0,0,0,0,0
0,0,0,0,0,0,0,0,0
0,0,0,0,0,0,0,0,0
0,0,0,0,0,0,0,0,0
0,0,0,0,0,0,0,0,0
0,0,0,0,0,0,0,0,0
0,0,0,0,0,0,0,0,0
0,0,0,0,0,0,0,0,0
0,0,0,0,0,0,0,0,0
0,0,0,0,0,0,0,0,0
0,0,0,0,0,0,0,0,0
0,0,0,0,0,0,0,0,0
0,0,0,0,0,0,0,0,0
0,0,0,0,0,0,0,0,0
0,0,0,0,0,0,0,0,0
0,0,0,0,0,0,0,0,0
0,0,0,0,0,0,0,0,0
0,0,0,0,0,0,0,0,0
0,0,0,0,0,0,0,0,0
0,0,0,0,0,0,0,0,0
0,0,0,0,0,0,0,0,0
0,0,0,0,0,0,0,0,0
0,0,0,0,0,0,0,0,0
29168,62,4,2,2,0,2,0,0
29168,62,4,2,2,0,2,0,0
17324,138,0,1,0,1,0,1,0
17324,138,0,1,0,1,0,1,0
0,0,0,0,0,0,0,0,0
8073,140,7,26,7,19,1,1,0
0,0,0,0,0,0,0,0,0
0,0,0,0,0,0,0,0,0
15910,339,4,31,28,3,0,1,0
0,0,0,0,0,0,0,0,0
0,0,0,0,0,0,0,0,0
0,0,0,0,0,0,0,0,0
0,0,0,0,0,0,0,0,0
0,0,0,0,0,0,0,0,0
0,0,0,0,0,0,0,0,0
0,0,0,0,0,0,0,0,0
0,0,0,0,0,0,0,0,0
8073,140,7,26,6,20,1,1,0
0,0,0,0,0,0,0,0,0
671170,555,0,4,4,0,2,1,1
0,0,0,0,0,0,0,0,0
0,0,0,0,0,0,0,0,0
0,0,0,0,0,0,0,0,0
10913,14,0,1,0,1,0,0,0
0,0,0,0,0,0,0,0,0
0,0,0,0,0,0,0,0,0
0,0,0,0,0,0,0,0,0
0,0,0,0,0,0,0,0,0
0,0,0,0,0,0,0,0,0
0,0,0,0,0,0,0,0,0
0,0,0,0,0,0,0,0,0
0,0,0,0,0,0,0,0,0
366668,188,6,1,1,0,0,1,0
7246,52,0,6,6,0,0,1,0
21301,261,7,30,30,0,0,1,0
0,0,0,0,0,0,0,0,0
109636,469,2,13,5,8,7,1,0
21873,303,4,51,50,1,2,1,0
0,0,0,0,0,0,0,0,0
0,0,0,0,0,0,0,0,0
191276,607,4,14,1,13,7,0,0
0,0,0,0,0,0,0,0,0
0,0,0,0,0,0,0,0,0
0,0,0,0,0,0,0,0,0
0,0,0,0,0,0,0,0,0
37351,53,3,0,0,0,2,0,0
0,0,0,0,0,0,0,0,0
0,0,0,0,0,0,0,0,0
14449,41,2,0,0,0,2,0,0
0,0,0,0,0,0,0,0,0
14449,41,2,0,0,0,2,0,0
144391,42,4,1,1,0,2,0,0
14449,41,2,0,0,0,2,0,0
0,0,0,0,0,0,0,0,0
0,0,0,0,0,0,0,0,0
37351,53,3,0,0,0,2,0,0
37351,53,3,0,0,0,2,0,0
37351,53,3,0,0,0,2,0,0
14449,41,2,0,0,0,2,0,0
37351,53,3,0,0,0,2,0,0
0,0,0,0,0,0,0,0,0
0,0,0,0,0,0,0,0,0
0,0,0,0,0,0,0,0,0
0,0,0,0,0,0,0,0,0
16759,33,1,0,0,0,1,0,0
16759,33,1,0,0,0,1,0,0
144391,42,4,1,1,0,2,0,0
144391,42,4,1,1,0,2,0,0
0,0,0,0,0,0,0,0,0
0,0,0,0,0,0,0,0,0
0,0,0,0,0,0,0,0,0
0,0,0,0,0,0,0,0,0
0,0,0,0,0,0,0,0,0
0,0,0,0,0,0,0,0,0
0,0,0,0,0,0,0,0,0
0,0,0,0,0,0,0,0,0
0,0,0,0,0,0,0,0,0
0,0,0,0,0,0,0,0,0
0,0,0,0,0,0,0,0,0
0,0,0,0,0,0,0,0,0
0,0,0,0,0,0,0,0,0
0,0,0,0,0,0,0,0,0
0,0,0,0,0,0,0,0,0
0,0,0,0,0,0,0,0,0
0,0,0,0,0,0,0,0,0
0,0,0,0,0,0,0,0,0
0,0,0,0,0,0,0,0,0
0,0,0,0,0,0,0,0,0
144384,42,4,1,1,0,2,0,0
0,0,0,0,0,0,0,0,0
292836,63,2,0,0,0,4,0,0
292836,63,2,0,0,0,4,0,0
0,0,0,0,0,0,0,0,0
0,0,0,0,0,0,0,0,0
0,0,0,0,0,0,0,0,0
0,0,0,0,0,0,0,0,0
0,0,0,0,0,0,0,0,0
0,0,0,0,0,0,0,0,0
0,0,0,0,0,0,0,0,0
292836,63,2,0,0,0,4,0,0
0,0,0,0,0,0,0,0,0
301157,49,4,0,0,0,2,1,0
301157,49,4,0,0,0,2,1,0
5989111,71,5,1,1,0,2,1,0
5989111,71,5,1,1,0,2,1,0
144384,42,4,1,1,0,2,0,0
144384,42,4,1,1,0,2,0,0
41500,76,3,0,0,0,0,0,0
0,0,0,0,0,0,0,0,0
41500,76,3,0,0,0,0,0,0
41500,76,3,0,0,0,0,0,0
301157,49,4,0,0,0,2,1,0
301157,49,4,0,0,0,2,1,0
0,0,0,0,0,0,0,0,0
5989111,71,5,1,1,0,2,1,0
0,0,0,0,0,0,0,0,0
301157,49,4,0,0,0,2,1,0
41500,76,3,0,0,0,0,0,0
41500,76,3,0,0,0,0,0,0
5989111,71,5,1,1,0,2,1,0
0,0,0,0,0,0,0,0,0
0,0,0,0,0,0,0,0,0
0,0,0,0,0,0,0,0,0
0,0,0,0,0,0,0,0,0
0,0,0,0,0,0,0,0,0
19857,155,2,28,23,5,0,0,0
19857,155,2,28,23,5,0,0,0
19857,155,2,28,23,5,0,0,0
19857,155,2,28,23,5,0,0,0
19857,155,2,28,23,5,0,0,0
0,0,0,0,0,0,0,0,0
0,0,0,0,0,0,0,0,0
0,0,0,0,0,0,0,0,0
0,0,0,0,0,0,0,0,0
0,0,0,0,0,0,0,0,0
343753,76,3,0,0,0,0,1,0
64912,56,0,2,2,0,0,1,0
64912,56,0,2,2,0,0,1,0
77747,101,1,4,2,2,0,0,0
64973,56,0,2,2,0,0,1,0
0,0,0,0,0,0,0,0,0
0,0,0,0,0,0,0,0,0
0,0,0,0,0,0,0,0,0
0,0,0,0,0,0,0,0,0
0,0,0,0,0,0,0,0,0
0,0,0,0,0,0,0,0,0
0,0,0,0,0,0,0,0,0
0,0,0,0,0,0,0,0,0
0,0,0,0,0,0,0,0,0
167215,557,4,4,3,1,8,1,0
36283,182,6,4,1,3,1,0,0
0,0,0,0,0,0,0,0,0
170459,559,5,4,3,1,11,1,0
167329,528,4,4,3,1,8,0,0
0,0,0,0,0,0,0,0,0
0,0,0,0,0,0,0,0,0
0,0,0,0,0,0,0,0,0
0,0,0,0,0,0,0,0,0
0,0,0,0,0,0,0,0,0
0,0,0,0,0,0,0,0,0
0,0,0,0,0,0,0,0,0
0,0,0,0,0,0,0,0,0
0,0,0,0,0,0,0,0,0
0,0,0,0,0,0,0,0,0
6330,64,2,6,4,2,0,1,0
0,0,0,0,0,0,0,0,0
0,0,0,0,0,0,0,0,0
0,0,0,0,0,0,0,0,0
0,0,0,0,0,0,0,0,0
0,0,0,0,0,0,0,0,0
0,0,0,0,0,0,0,0,0
0,0,0,0,0,0,0,0,0
0,0,0,0,0,0,0,0,0
0,0,0,0,0,0,0,0,0
0,0,0,0,0,0,0,0,0
0,0,0,0,0,0,0,0,0
0,0,0,0,0,0,0,0,0
0,0,0,0,0,0,0,0,0
0,0,0,0,0,0,0,0,0
0,0,0,0,0,0,0,0,0
0,0,0,0,0,0,0,0,0
0,0,0,0,0,0,0,0,0
0,0,0,0,0,0,0,0,0
123911,28,1,2,1,1,0,0,0
0,0,0,0,0,0,0,0,0
0,0,0,0,0,0,0,0,0
0,0,0,0,0,0,0,0,0
0,0,0,0,0,0,0,0,0
0,0,0,0,0,0,0,0,0
0,0,0,0,0,0,0,0,0
0,0,0,0,0,0,0,0,0
64973,56,0,2,2,0,0,1,0
64912,56,0,2,2,0,0,1,0
0,0,0,0,0,0,0,0,0
101782,529,8,53,48,5,2,0,0
16729,263,0,6,6,0,1,0,0
0,0,0,0,0,0,0,0,0
8073,140,7,26,6,20,1,1,0
0,0,0,0,0,0,0,0,0
0,0,0,0,0,0,0,0,0
0,0,0,0,0,0,0,0,0
0,0,0,0,0,0,0,0,0
0,0,0,0,0,0,0,0,0
0,0,0,0,0,0,0,0,0
0,0,0,0,0,0,0,0,0
0,0,0,0,0,0,0,0,0
675631,555,0,4,0,4,2,1,1
35845,61,3,3,3,0,0,0,0
72725,47,4,0,0,0,1,0,0
0,0,0,0,0,0,0,0,0
9328,81,1,0,0,0,0,0,0
0,0,0,0,0,0,0,0,0
123911,28,1,2,2,0,0,0,0
0,0,0,0,0,0,0,0,0
0,0,0,0,0,0,0,0,0
674488,555,0,4,0,4,2,1,1
0,0,0,0,0,0,0,0,0
0,0,0,0,0,0,0,0,0
0,0,0,0,0,0,0,0,0
0,0,0,0,0,0,0,0,0
72836,48,4,0,0,0,1,0,0
0,0,0,0,0,0,0,0,0
28660,164,6,4,1,3,1,0,0
28666,164,6,4,1,3,1,0,0
165262,477,4,4,3,1,8,0,0
29010,176,6,4,2,2,1,0,0
169758,504,4,7,4,3,8,1,0
37123,209,6,4,1,3,1,0,0
0,0,0,0,0,0,0,0,0
0,0,0,0,0,0,0,0,0
0,0,0,0,0,0,0,0,0
6760,30,2,0,0,0,1,0,0
6760,30,2,0,0,0,1,0,0
6760,30,2,0,0,0,1,0,0
6760,30,2,0,0,0,1,0,0
0,0,0,0,0,0,0,0,0
293458,42,4,0,0,0,3,0,0
0,0,0,0,0,0,0,0,0
293458,42,4,0,0,0,3,0,0
293458,42,4,0,0,0,3,0,0
0,0,0,0,0,0,0,0,0
293458,42,4,0,0,0,3,0,0
7021,30,0,3,0,3,0,1,0
0,0,0,0,0,0,0,0,0
0,0,0,0,0,0,0,0,0
109932,49,3,0,0,0,0,0,0
0,0,0,0,0,0,0,0,0
0,0,0,0,0,0,0,0,0
109932,49,3,0,0,0,0,0,0
109932,49,3,0,0,0,0,0,0
0,0,0,0,0,0,0,0,0
0,0,0,0,0,0,0,0,0
0,0,0,0,0,0,0,0,0
0,0,0,0,0,0,0,0,0
0,0,0,0,0,0,0,0,0
0,0,0,0,0,0,0,0,0
0,0,0,0,0,0,0,0,0
0,0,0,0,0,0,0,0,0
0,0,0,0,0,0,0,0,0
0,0,0,0,0,0,0,0,0
233108,64,4,3,3,0,2,1,0
17246,21,0,0,0,0,0,0,0
233108,64,4,3,3,0,2,1,0
17246,21,0,0,0,0,0,0,0
0,0,0,0,0,0,0,0,0
0,0,0,0,0,0,0,0,0
0,0,0,0,0,0,0,0,0
0,0,0,0,0,0,0,0,0
0,0,0,0,0,0,0,0,0
0,0,0,0,0,0,0,0,0
0,0,0,0,0,0,0,0,0
0,0,0,0,0,0,0,0,0
0,0,0,0,0,0,0,0,0
0,0,0,0,0,0,0,0,0
0,0,0,0,0,0,0,0,0
0,0,0,0,0,0,0,0,0
0,0,0,0,0,0,0,0,0
0,0,0,0,0,0,0,0,0
0,0,0,0,0,0,0,0,0
0,0,0,0,0,0,0,0,0
0,0,0,0,0,0,0,0,0
0,0,0,0,0,0,0,0,0
0,0,0,0,0,0,0,0,0
0,0,0,0,0,0,0,0,0
0,0,0,0,0,0,0,0,0
0,0,0,0,0,0,0,0,0
0,0,0,0,0,0,0,0,0
0,0,0,0,0,0,0,0,0
0,0,0,0,0,0,0,0,0
0,0,0,0,0,0,0,0,0
233109,64,4,3,3,0,2,1,0
233104,64,4,3,3,0,2,1,0
233109,64,4,3,3,0,2,1,0
0,0,0,0,0,0,0,0,0
0,0,0,0,0,0,0,0,0
0,0,0,0,0,0,0,0,0
0,0,0,0,0,0,0,0,0
0,0,0,0,0,0,0,0,0
0,0,0,0,0,0,0,0,0
0,0,0,0,0,0,0,0,0
0,0,0,0,0,0,0,0,0
0,0,0,0,0,0,0,0,0
0,0,0,0,0,0,0,0,0
655887,28,1,0,0,0,0,0,0
0,0,0,0,0,0,0,0,0
0,0,0,0,0,0,0,0,0
655887,28,1,0,0,0,0,0,0
655887,28,1,0,0,0,0,0,0
0,0,0,0,0,0,0,0,0
0,0,0,0,0,0,0,0,0
233104,64,4,3,3,0,2,1,0
0,0,0,0,0,0,0,0,0
0,0,0,0,0,0,0,0,0
233104,64,4,3,3,0,2,1,0
0,0,0,0,0,0,0,0,0
0,0,0,0,0,0,0,0,0
0,0,0,0,0,0,0,0,0
0,0,0,0,0,0,0,0,0
0,0,0,0,0,0,0,0,0
0,0,0,0,0,0,0,0,0
0,0,0,0,0,0,0,0,0
0,0,0,0,0,0,0,0,0
0,0,0,0,0,0,0,0,0
0,0,0,0,0,0,0,0,0
0,0,0,0,0,0,0,0,0
0,0,0,0,0,0,0,0,0
0,0,0,0,0,0,0,0,0
0,0,0,0,0,0,0,0,0
0,0,0,0,0,0,0,0,0
0,0,0,0,0,0,0,0,0
556242,631,6,21,21,0,0,1,0
0,0,0,0,0,0,0,0,0
0,0,0,0,0,0,0,0,0
0,0,0,0,0,0,0,0,0
0,0,0,0,0,0,0,0,0
0,0,0,0,0,0,0,0,0
0,0,0,0,0,0,0,0,0
0,0,0,0,0,0,0,0,0
0,0,0,0,0,0,0,0,0
0,0,0,0,0,0,0,0,0
0,0,0,0,0,0,0,0,0
0,0,0,0,0,0,0,0,0
0,0,0,0,0,0,0,0,0
0,0,0,0,0,0,0,0,0
0,0,0,0,0,0,0,0,0
192498,48,0,2,1,1,0,1,0
0,0,0,0,0,0,0,0,0
0,0,0,0,0,0,0,0,0
0,0,0,0,0,0,0,0,0
0,0,0,0,0,0,0,0,0
0,0,0,0,0,0,0,0,0
0,0,0,0,0,0,0,0,0
0,0,0,0,0,0,0,0,0
0,0,0,0,0,0,0,0,0
0,0,0,0,0,0,0,0,0
0,0,0,0,0,0,0,0,0
0,0,0,0,0,0,0,0,0
0,0,0,0,0,0,0,0,0
0,0,0,0,0,0,0,0,0
0,0,0,0,0,0,0,0,0
0,0,0,0,0,0,0,0,0
0,0,0,0,0,0,0,0,0
0,0,0,0,0,0,0,0,0
0,0,0,0,0,0,0,0,0
64912,56,0,2,2,0,0,1,0
64912,56,0,2,2,0,0,1,0
16282,89,0,15,1,14,0,1,0
0,0,0,0,0,0,0,0,0
2145,38,4,2,1,1,1,1,0
123917,28,1,2,1,1,0,0,0
123917,28,1,2,2,0,0,0,0
101782,529,8,53,48,5,2,0,0
64973,56,0,2,2,0,0,1,0
64973,56,0,2,2,0,0,1,0
117283,870,8,69,60,9,1,0,0
0,0,0,0,0,0,0,0,0
0,0,0,0,0,0,0,0,0
8072,140,7,26,6,20,1,1,0
8072,140,7,26,6,20,1,1,0
0,0,0,0,0,0,0,0,0
0,0,0,0,0,0,0,0,0
141113,69,1,3,3,0,0,1,0
26797,36,0,3,1,2,0,0,0
0,0,0,0,0,0,0,0,0
0,0,0,0,0,0,0,0,0
0,0,0,0,0,0,0,0,0
0,0,0,0,0,0,0,0,0
6685,70,1,1,1,0,0,0,0
6685,70,1,1,1,0,0,0,0
159042,1166,5,272,190,82,9,1,0
16509,79,3,4,3,1,1,0,0
165153,472,4,2,1,1,7,0,0
48351,562,3,120,117,3,9,0,0
23253,33,0,1,1,0,0,1,0
0,0,0,0,0,0,0,0,0
23356,33,0,1,1,0,0,1,0
0,0,0,0,0,0,0,0,0
0,0,0,0,0,0,0,0,0
0,0,0,0,0,0,0,0,0
0,0,0,0,0,0,0,0,0
0,0,0,0,0,0,0,0,0
23772,37,0,3,1,2,0,0,0
72768,47,4,0,0,0,1,0,0
0,0,0,0,0,0,0,0,0
0,0,0,0,0,0,0,0,0
0,0,0,0,0,0,0,0,0
0,0,0,0,0,0,0,0,0
0,0,0,0,0,0,0,0,0
0,0,0,0,0,0,0,0,0
0,0,0,0,0,0,0,0,0
0,0,0,0,0,0,0,0,0
0,0,0,0,0,0,0,0,0
0,0,0,0,0,0,0,0,0
0,0,0,0,0,0,0,0,0
0,0,0,0,0,0,0,0,0
0,0,0,0,0,0,0,0,0
0,0,0,0,0,0,0,0,0
140061,405,8,27,24,3,35,1,0
221778,1363,14,40,35,5,18,0,0
220214,1361,14,40,35,5,18,0,0
14910,142,0,56,52,4,0,0,0
72878,48,4,0,0,0,1,0,0
0,0,0,0,0,0,0,0,0
0,0,0,0,0,0,0,0,0
72879,48,4,0,0,0,1,0,0
0,0,0,0,0,0,0,0,0
0,0,0,0,0,0,0,0,0
0,0,0,0,0,0,0,0,0
0,0,0,0,0,0,0,0,0
0,0,0,0,0,0,0,0,0
0,0,0,0,0,0,0,0,0
450909,336,6,9,4,5,0,1,0
0,0,0,0,0,0,0,0,0
0,0,0,0,0,0,0,0,0
0,0,0,0,0,0,0,0,0
0,0,0,0,0,0,0,0,0
0,0,0,0,0,0,0,0,0
0,0,0,0,0,0,0,0,0
0,0,0,0,0,0,0,0,0
0,0,0,0,0,0,0,0,0
0,0,0,0,0,0,0,0,0
0,0,0,0,0,0,0,0,0
0,0,0,0,0,0,0,0,0
297369,223,6,1,1,0,0,1,0
0,0,0,0,0,0,0,0,0
0,0,0,0,0,0,0,0,0
108065,483,1,3,3,0,4,0,0
5639,72,5,3,1,2,0,1,0
0,0,0,0,0,0,0,0,0
45268,178,2,1,1,0,1,0,0
3304,29,1,1,1,0,0,0,0
0,0,0,0,0,0,0,0,0
0,0,0,0,0,0,0,0,0
25061,67,2,1,1,0,2,0,0
88784,60,0,5,5,0,0,1,0
37357,53,3,0,0,0,2,0,0
293458,42,4,0,0,0,3,0,0
88784,60,0,5,5,0,0,1,0
37357,53,3,0,0,0,2,0,0
88784,60,0,5,5,0,0,1,0
37357,53,3,0,0,0,2,0,0
37357,53,3,0,0,0,2,0,0
37357,53,3,0,0,0,2,0,0
25061,67,2,1,1,0,2,0,0
0,0,0,0,0,0,0,0,0
0,0,0,0,0,0,0,0,0
111860,61,4,3,3,0,2,1,0
111860,61,4,3,3,0,2,1,0
0,0,0,0,0,0,0,0,0
0,0,0,0,0,0,0,0,0
0,0,0,0,0,0,0,0,0
0,0,0,0,0,0,0,0,0
25061,67,2,1,1,0,2,0,0
0,0,0,0,0,0,0,0,0
0,0,0,0,0,0,0,0,0
0,0,0,0,0,0,0,0,0
0,0,0,0,0,0,0,0,0
0,0,0,0,0,0,0,0,0
0,0,0,0,0,0,0,0,0
0,0,0,0,0,0,0,0,0
0,0,0,0,0,0,0,0,0
0,0,0,0,0,0,0,0,0
0,0,0,0,0,0,0,0,0
0,0,0,0,0,0,0,0,0
0,0,0,0,0,0,0,0,0
0,0,0,0,0,0,0,0,0
0,0,0,0,0,0,0,0,0
111860,61,4,3,3,0,2,1,0
0,0,0,0,0,0,0,0,0
111860,61,4,3,3,0,2,1,0
0,0,0,0,0,0,0,0,0
0,0,0,0,0,0,0,0,0
233106,64,4,3,3,0,2,1,0
233106,64,4,3,3,0,2,1,0
0,0,0,0,0,0,0,0,0
0,0,0,0,0,0,0,0,0
233106,64,4,3,3,0,2,1,0
135965,42,4,1,1,0,2,0,0
135965,42,4,1,1,0,2,0,0
0,0,0,0,0,0,0,0,0
0,0,0,0,0,0,0,0,0
0,0,0,0,0,0,0,0,0
0,0,0,0,0,0,0,0,0
0,0,0,0,0,0,0,0,0
329719,78,4,0,0,0,2,1,0
329719,78,4,0,0,0,2,1,0
0,0,0,0,0,0,0,0,0
0,0,0,0,0,0,0,0,0
0,0,0,0,0,0,0,0,0
0,0,0,0,0,0,0,0,0
0,0,0,0,0,0,0,0,0
0,0,0,0,0,0,0,0,0
0,0,0,0,0,0,0,0,0
0,0,0,0,0,0,0,0,0
0,0,0,0,0,0,0,0,0
34479,50,2,0,0,0,2,0,0
34479,50,2,0,0,0,2,0,0
0,0,0,0,0,0,0,0,0
468176,1047,0,52,6,46,0,0,0
77722,101,1,4,2,2,0,0,0
0,0,0,0,0,0,0,0,0
143046,326,3,6,6,0,0,1,0
0,0,0,0,0,0,0,0,0
0,0,0,0,0,0,0,0,0
0,0,0,0,0,0,0,0,0
164097,79,1,9,0,9,0,1,0
0,0,0,0,0,0,0,0,0
0,0,0,0,0,0,0,0,0
0,0,0,0,0,0,0,0,0
0,0,0,0,0,0,0,0,0
0,0,0,0,0,0,0,0,0
0,0,0,0,0,0,0,0,0
0,0,0,0,0,0,0,0,0
0,0,0,0,0,0,0,0,0
0,0,0,0,0,0,0,0,0
0,0,0,0,0,0,0,0,0
0,0,0,0,0,0,0,0,0
0,0,0,0,0,0,0,0,0
0,0,0,0,0,0,0,0,0
0,0,0,0,0,0,0,0,0
0,0,0,0,0,0,0,0,0
0,0,0,0,0,0,0,0,0
15592,124,2,25,24,1,2,1,0
15596,124,2,25,24,1,2,1,0
0,0,0,0,0,0,0,0,0
0,0,0,0,0,0,0,0,0
0,0,0,0,0,0,0,0,0
0,0,0,0,0,0,0,0,0
0,0,0,0,0,0,0,0,0
11578,85,0,15,14,1,0,1,0
0,0,0,0,0,0,0,0,0
0,0,0,0,0,0,0,0,0
0,0,0,0,0,0,0,0,0
0,0,0,0,0,0,0,0,0
0,0,0,0,0,0,0,0,0
0,0,0,0,0,0,0,0,0
0,0,0,0,0,0,0,0,0
48176,562,3,120,117,3,9,0,0
48260,562,3,120,117,3,9,0,0
0,0,0,0,0,0,0,0,0
48280,562,3,120,117,3,9,0,0
0,0,0,0,0,0,0,0,0
0,0,0,0,0,0,0,0,0
0,0,0,0,0,0,0,0,0
0,0,0,0,0,0,0,0,0
0,0,0,0,0,0,0,0,0
0,0,0,0,0,0,0,0,0
0,0,0,0,0,0,0,0,0
7703,69,2,1,1,0,2,1,0
64973,56,0,2,2,0,0,1,0
8073,140,7,26,6,20,1,1,0
8073,140,7,26,6,20,1,1,0
0,0,0,0,0,0,0,0,0
35689,28,1,2,2,0,0,0,0
0,0,0,0,0,0,0,0,0
0,0,0,0,0,0,0,0,0
0,0,0,0,0,0,0,0,0
0,0,0,0,0,0,0,0,0
0,0,0,0,0,0,0,0,0
0,0,0,0,0,0,0,0,0
0,0,0,0,0,0,0,0,0
72879,48,4,0,0,0,1,0,0
0,0,0,0,0,0,0,0,0
0,0,0,0,0,0,0,0,0
0,0,0,0,0,0,0,0,0
62189,377,1,6,4,2,0,0,0
0,0,0,0,0,0,0,0,0
0,0,0,0,0,0,0,0,0
8669,47,1,3,3,0,0,0,0
0,0,0,0,0,0,0,0,0
12914,113,1,1,1,0,0,0,0
12912,113,1,1,1,0,0,0,0
0,0,0,0,0,0,0,0,0
0,0,0,0,0,0,0,0,0
0,0,0,0,0,0,0,0,0
0,0,0,0,0,0,0,0,0
10855,33,1,0,0,0,1,0,0
10855,33,1,0,0,0,1,0,0
10855,33,1,0,0,0,1,0,0
0,0,0,0,0,0,0,0,0
10855,33,1,0,0,0,1,0,0
0,0,0,0,0,0,0,0,0
0,0,0,0,0,0,0,0,0
0,0,0,0,0,0,0,0,0
0,0,0,0,0,0,0,0,0
0,0,0,0,0,0,0,0,0
0,0,0,0,0,0,0,0,0
0,0,0,0,0,0,0,0,0
415617,62,4,3,3,0,2,1,0
415617,62,4,3,3,0,2,1,0
5067,24,3,0,0,0,0,0,0
0,0,0,0,0,0,0,0,0
21860,33,0,1,1,0,0,1,0
415617,62,4,3,3,0,2,1,0
415617,62,4,3,3,0,2,1,0
415617,62,4,3,3,0,2,1,0
415617,62,4,3,3,0,2,1,0
415617,62,4,3,3,0,2,1,0
5067,24,3,0,0,0,0,0,0
5067,24,3,0,0,0,0,0,0
5067,24,3,0,0,0,0,0,0
5067,24,3,0,0,0,0,0,0
5067,24,3,0,0,0,0,0,0
5067,24,3,0,0,0,0,0,0
5067,24,3,0,0,0,0,0,0
5067,24,3,0,0,0,0,0,0
5067,24,3,0,0,0,0,0,0
5067,24,3,0,0,0,0,0,0
0,0,0,0,0,0,0,0,0
0,0,0,0,0,0,0,0,0
0,0,0,0,0,0,0,0,0
0,0,0,0,0,0,0,0,0
0,0,0,0,0,0,0,0,0
0,0,0,0,0,0,0,0,0
0,0,0,0,0,0,0,0,0
0,0,0,0,0,0,0,0,0
0,0,0,0,0,0,0,0,0
0,0,0,0,0,0,0,0,0
0,0,0,0,0,0,0,0,0
0,0,0,0,0,0,0,0,0
16202,85,3,6,5,1,4,0,0
0,0,0,0,0,0,0,0,0
0,0,0,0,0,0,0,0,0
0,0,0,0,0,0,0,0,0
0,0,0,0,0,0,0,0,0
0,0,0,0,0,0,0,0,0
0,0,0,0,0,0,0,0,0
0,0,0,0,0,0,0,0,0
0,0,0,0,0,0,0,0,0
0,0,0,0,0,0,0,0,0
0,0,0,0,0,0,0,0,0
0,0,0,0,0,0,0,0,0
0,0,0,0,0,0,0,0,0
0,0,0,0,0,0,0,0,0
0,0,0,0,0,0,0,0,0
0,0,0,0,0,0,0,0,0
0,0,0,0,0,0,0,0,0
0,0,0,0,0,0,0,0,0
0,0,0,0,0,0,0,0,0
25225,57,0,9,4,5,0,0,0
186905,379,3,25,7,18,14,1,0
28052,97,0,2,0,2,2,0,0
35674,28,1,2,2,0,0,0,0
35674,28,1,2,1,1,0,0,0
0,0,0,0,0,0,0,0,0
11321,266,3,24,24,0,1,1,0
192760,519,10,63,60,3,4,1,0
3385,41,0,6,0,6,0,0,0
72879,48,4,0,0,0,1,0,0
72877,48,4,0,0,0,1,0,0
1028,28,0,2,2,0,0,0,0
1028,28,0,2,2,0,0,0,0
0,0,0,0,0,0,0,0,0
21752,110,2,11,8,3,6,0,0
27797,153,6,2,1,1,1,0,0
0,0,0,0,0,0,0,0,0
0,0,0,0,0,0,0,0,0
0,0,0,0,0,0,0,0,0
0,0,0,0,0,0,0,0,0
0,0,0,0,0,0,0,0,0
276286,176,6,1,1,0,0,1,0
0,0,0,0,0,0,0,0,0
0,0,0,0,0,0,0,0,0
49581,566,3,120,117,3,9,0,0
0,0,0,0,0,0,0,0,0
0,0,0,0,0,0,0,0,0
0,0,0,0,0,0,0,0,0
0,0,0,0,0,0,0,0,0
7424,164,0,26,26,0,0,0,0
0,0,0,0,0,0,0,0,0
0,0,0,0,0,0,0,0,0
74462,434,10,35,32,3,1,1,0
35674,28,1,2,2,0,0,0,0
35675,28,1,2,1,1,0,0,0
48474,562,3,120,117,3,9,0,0
35675,28,1,2,2,0,0,0,0
35674,28,1,2,1,1,0,0,0
0,0,0,0,0,0,0,0,0
675140,555,0,4,2,2,2,1,1
9197,28,1,2,2,0,0,0,0
0,0,0,0,0,0,0,0,0
0,0,0,0,0,0,0,0,0
0,0,0,0,0,0,0,0,0
0,0,0,0,0,0,0,0,0
0,0,0,0,0,0,0,0,0
0,0,0,0,0,0,0,0,0
0,0,0,0,0,0,0,0,0
0,0,0,0,0,0,0,0,0
0,0,0,0,0,0,0,0,0
0,0,0,0,0,0,0,0,0
0,0,0,0,0,0,0,0,0
72879,48,4,0,0,0,1,0,0
0,0,0,0,0,0,0,0,0
0,0,0,0,0,0,0,0,0
142142,420,8,27,24,3,35,1,0
0,0,0,0,0,0,0,0,0
0,0,0,0,0,0,0,0,0
21703,33,0,1,1,0,0,1,0
0,0,0,0,0,0,0,0,0
0,0,0,0,0,0,0,0,0
0,0,0,0,0,0,0,0,0
23739,37,0,3,1,2,0,0,0
8508,120,4,23,23,0,0,1,0
0,0,0,0,0,0,0,0,0
0,0,0,0,0,0,0,0,0
0,0,0,0,0,0,0,0,0
0,0,0,0,0,0,0,0,0
0,0,0,0,0,0,0,0,0
0,0,0,0,0,0,0,0,0
26057,206,2,50,49,1,0,1,0
26057,206,2,50,49,1,0,1,0
26057,206,2,50,49,1,0,1,0
20893,234,2,48,47,1,2,1,0
20893,234,2,48,47,1,2,1,0
0,0,0,0,0,0,0,0,0
0,0,0,0,0,0,0,0,0
135971,42,4,1,1,0,2,0,0
20893,234,2,48,47,1,2,1,0
20893,234,2,48,47,1,2,1,0
20893,234,2,48,47,1,2,1,0
0,0,0,0,0,0,0,0,0
0,0,0,0,0,0,0,0,0
0,0,0,0,0,0,0,0,0
135971,42,4,1,1,0,2,0,0
135971,42,4,1,1,0,2,0,0
0,0,0,0,0,0,0,0,0
0,0,0,0,0,0,0,0,0
0,0,0,0,0,0,0,0,0
3685,19,1,0,0,0,0,0,0
34591,51,2,0,0,0,2,0,0
23537,39,2,0,0,0,0,1,0
0,0,0,0,0,0,0,0,0
0,0,0,0,0,0,0,0,0
0,0,0,0,0,0,0,0,0
0,0,0,0,0,0,0,0,0
0,0,0,0,0,0,0,0,0
0,0,0,0,0,0,0,0,0
0,0,0,0,0,0,0,0,0
0,0,0,0,0,0,0,0,0
0,0,0,0,0,0,0,0,0
0,0,0,0,0,0,0,0,0
0,0,0,0,0,0,0,0,0
0,0,0,0,0,0,0,0,0
0,0,0,0,0,0,0,0,0
0,0,0,0,0,0,0,0,0
0,0,0,0,0,0,0,0,0
0,0,0,0,0,0,0,0,0
0,0,0,0,0,0,0,0,0
0,0,0,0,0,0,0,0,0
53511,725,7,193,159,34,4,1,0
0,0,0,0,0,0,0,0,0
0,0,0,0,0,0,0,0,0
0,0,0,0,0,0,0,0,0
671064,555,0,4,4,0,2,1,1
0,0,0,0,0,0,0,0,0
0,0,0,0,0,0,0,0,0
0,0,0,0,0,0,0,0,0
0,0,0,0,0,0,0,0,0
0,0,0,0,0,0,0,0,0
0,0,0,0,0,0,0,0,0
0,0,0,0,0,0,0,0,0
0,0,0,0,0,0,0,0,0
0,0,0,0,0,0,0,0,0
0,0,0,0,0,0,0,0,0
0,0,0,0,0,0,0,0,0
0,0,0,0,0,0,0,0,0
0,0,0,0,0,0,0,0,0
0,0,0,0,0,0,0,0,0
0,0,0,0,0,0,0,0,0
0,0,0,0,0,0,0,0,0
0,0,0,0,0,0,0,0,0
0,0,0,0,0,0,0,0,0
0,0,0,0,0,0,0,0,0
0,0,0,0,0,0,0,0,0
144631,57,3,0,0,0,0,1,0
0,0,0,0,0,0,0,0,0
0,0,0,0,0,0,0,0,0
0,0,0,0,0,0,0,0,0
0,0,0,0,0,0,0,0,0
0,0,0,0,0,0,0,0,0
0,0,0,0,0,0,0,0,0
0,0,0,0,0,0,0,0,0
0,0,0,0,0,0,0,0,0
0,0,0,0,0,0,0,0,0
145124,192,6,5,5,0,1,0,0
0,0,0,0,0,0,0,0,0
332015,2519,1,477,411,66,34,0,0
0,0,0,0,0,0,0,0,0
0,0,0,0,0,0,0,0,0
0,0,0,0,0,0,0,0,0
0,0,0,0,0,0,0,0,0
11335,266,3,24,24,0,1,1,0
0,0,0,0,0,0,0,0,0
11341,266,3,24,24,0,1,1,0
0,0,0,0,0,0,0,0,0
23619,116,1,0,0,0,1,0,0
329707,78,4,0,0,0,2,1,0
7466,103,1,0,0,0,0,0,0
7466,103,1,0,0,0,0,0,0
0,0,0,0,0,0,0,0,0
0,0,0,0,0,0,0,0,0
0,0,0,0,0,0,0,0,0
0,0,0,0,0,0,0,0,0
0,0,0,0,0,0,0,0,0
0,0,0,0,0,0,0,0,0
0,0,0,0,0,0,0,0,0
0,0,0,0,0,0,0,0,0
0,0,0,0,0,0,0,0,0
0,0,0,0,0,0,0,0,0
0,0,0,0,0,0,0,0,0
0,0,0,0,0,0,0,0,0
0,0,0,0,0,0,0,0,0
0,0,0,0,0,0,0,0,0
0,0,0,0,0,0,0,0,0
0,0,0,0,0,0,0,0,0
125456,204,2,50,49,1,0,1,0
0,0,0,0,0,0,0,0,0
0,0,0,0,0,0,0,0,0
773,17,0,0,0,0,0,0,0
143053,326,3,6,6,0,0,1,0
181301,1289,12,168,163,5,6,1,0
0,0,0,0,0,0,0,0,0
0,0,0,0,0,0,0,0,0
0,0,0,0,0,0,0,0,0
0,0,0,0,0,0,0,0,0
3246,51,3,1,1,0,1,0,0
0,0,0,0,0,0,0,0,0
0,0,0,0,0,0,0,0,0
0,0,0,0,0,0,0,0,0
0,0,0,0,0,0,0,0,0
0,0,0,0,0,0,0,0,0
0,0,0,0,0,0,0,0,0
0,0,0,0,0,0,0,0,0
0,0,0,0,0,0,0,0,0
0,0,0,0,0,0,0,0,0
0,0,0,0,0,0,0,0,0
0,0,0,0,0,0,0,0,0
13173,142,0,56,51,5,0,0,0
0,0,0,0,0,0,0,0,0
0,0,0,0,0,0,0,0,0
65011,56,0,2,2,0,0,1,0
64950,56,0,2,2,0,0,1,0
65011,56,0,2,2,0,0,1,0
65011,56,0,2,2,0,0,1,0
65011,56,0,2,2,0,0,1,0
65011,56,0,2,2,0,0,1,0
65011,56,0,2,2,0,0,1,0
64950,56,0,2,2,0,0,1,0
65011,56,0,2,2,0,0,1,0
65225,56,0,2,2,0,0,1,0
0,0,0,0,0,0,0,0,0
8073,140,7,26,6,20,1,1,0
0,0,0,0,0,0,0,0,0
0,0,0,0,0,0,0,0,0
0,0,0,0,0,0,0,0,0
0,0,0,0,0,0,0,0,0
29228,42,0,1,1,0,1,0,0
10785,77,5,8,0,8,0,1,0
0,0,0,0,0,0,0,0,0
8073,140,7,26,6,20,1,1,0
0,0,0,0,0,0,0,0,0
0,0,0,0,0,0,0,0,0
0,0,0,0,0,0,0,0,0
674051,555,0,4,4,0,2,1,1
0,0,0,0,0,0,0,0,0
20508,408,7,69,69,0,0,0,0
72102,48,4,0,0,0,1,0,0
72088,48,4,0,0,0,1,0,0
272954,598,4,57,48,9,17,1,0
0,0,0,0,0,0,0,0,0
0,0,0,0,0,0,0,0,0
0,0,0,0,0,0,0,0,0
18307,71,6,4,4,0,0,0,0
0,0,0,0,0,0,0,0,0
17979,198,5,28,28,0,2,1,0
0,0,0,0,0,0,0,0,0
17979,198,5,28,28,0,2,1,0
0,0,0,0,0,0,0,0,0
0,0,0,0,0,0,0,0,0
0,0,0,0,0,0,0,0,0
43526,181,4,1,1,0,4,1,0
0,0,0,0,0,0,0,0,0
0,0,0,0,0,0,0,0,0
0,0,0,0,0,0,0,0,0
0,0,0,0,0,0,0,0,0
0,0,0,0,0,0,0,0,0
0,0,0,0,0,0,0,0,0
0,0,0,0,0,0,0,0,0
238967,1244,1,168,18,150,6,1,0
240843,1258,1,169,18,151,7,1,0
0,0,0,0,0,0,0,0,0
0,0,0,0,0,0,0,0,0
0,0,0,0,0,0,0,0,0
0,0,0,0,0,0,0,0,0
22738,148,1,1,0,1,0,1,0
22738,148,1,1,0,1,0,1,0
0,0,0,0,0,0,0,0,0
0,0,0,0,0,0,0,0,0
0,0,0,0,0,0,0,0,0
0,0,0,0,0,0,0,0,0
0,0,0,0,0,0,0,0,0
0,0,0,0,0,0,0,0,0
0,0,0,0,0,0,0,0,0
0,0,0,0,0,0,0,0,0
4221,31,0,0,0,0,0,0,0
4221,31,0,0,0,0,0,0,0
4404,25,0,1,0,1,0,0,0
4404,25,0,1,0,1,0,0,0
0,0,0,0,0,0,0,0,0
0,0,0,0,0,0,0,0,0
0,0,0,0,0,0,0,0,0
0,0,0,0,0,0,0,0,0
0,0,0,0,0,0,0,0,0
0,0,0,0,0,0,0,0,0
0,0,0,0,0,0,0,0,0
0,0,0,0,0,0,0,0,0
9403,31,1,0,0,0,1,0,0
9403,31,1,0,0,0,1,0,0
9403,31,1,0,0,0,1,0,0
0,0,0,0,0,0,0,0,0
0,0,0,0,0,0,0,0,0
0,0,0,0,0,0,0,0,0
0,0,0,0,0,0,0,0,0
0,0,0,0,0,0,0,0,0
0,0,0,0,0,0,0,0,0
0,0,0,0,0,0,0,0,0
278113,70,2,11,11,0,0,1,0
0,0,0,0,0,0,0,0,0
0,0,0,0,0,0,0,0,0
77738,101,1,4,2,2,0,0,0
8072,140,7,26,6,20,1,1,0
0,0,0,0,0,0,0,0,0
0,0,0,0,0,0,0,0,0
0,0,0,0,0,0,0,0,0
0,0,0,0,0,0,0,0,0
0,0,0,0,0,0,0,0,0
0,0,0,0,0,0,0,0,0
0,0,0,0,0,0,0,0,0
0,0,0,0,0,0,0,0,0
0,0,0,0,0,0,0,0,0
0,0,0,0,0,0,0,0,0
0,0,0,0,0,0,0,0,0
0,0,0,0,0,0,0,0,0
0,0,0,0,0,0,0,0,0
0,0,0,0,0,0,0,0,0
0,0,0,0,0,0,0,0,0
0,0,0,0,0,0,0,0,0
0,0,0,0,0,0,0,0,0
0,0,0,0,0,0,0,0,0
0,0,0,0,0,0,0,0,0
0,0,0,0,0,0,0,0,0
0,0,0,0,0,0,0,0,0
0,0,0,0,0,0,0,0,0
0,0,0,0,0,0,0,0,0
0,0,0,0,0,0,0,0,0
0,0,0,0,0,0,0,0,0
0,0,0,0,0,0,0,0,0
0,0,0,0,0,0,0,0,0
0,0,0,0,0,0,0,0,0
0,0,0,0,0,0,0,0,0
137308,331,8,26,24,2,20,1,0
0,0,0,0,0,0,0,0,0
48293,562,3,120,117,3,9,0,0
88061,219,7,11,4,7,2,0,0
77036,606,6,119,95,24,7,1,0
17985,218,0,23,0,23,0,1,0
17962,218,0,23,23,0,0,1,0
0,0,0,0,0,0,0,0,0
41482,398,4,79,78,1,3,0,0
31473,20,1,0,0,0,0,0,0
0,0,0,0,0,0,0,0,0
0,0,0,0,0,0,0,0,0
0,0,0,0,0,0,0,0,0
0,0,0,0,0,0,0,0,0
0,0,0,0,0,0,0,0,0
0,0,0,0,0,0,0,0,0
675219,555,0,4,0,4,2,1,1
183430,118,2,7,0,7,2,1,0
183430,118,2,7,0,7,2,1,0
0,0,0,0,0,0,0,0,0
11554,251,5,35,35,0,0,1,0
0,0,0,0,0,0,0,0,0
0,0,0,0,0,0,0,0,0
0,0,0,0,0,0,0,0,0
109903,518,11,98,95,3,5,1,0
147028,931,12,69,5,64,11,1,0
0,0,0,0,0,0,0,0,0
13010,142,0,56,51,5,0,0,0
1537,16,0,0,0,0,0,0,0
0,0,0,0,0,0,0,0,0
72100,48,4,0,0,0,1,0,0
7786,145,2,21,21,0,0,0,0
1537,16,0,0,0,0,0,0,0
0,0,0,0,0,0,0,0,0
0,0,0,0,0,0,0,0,0
6330,64,2,6,4,2,0,1,0
0,0,0,0,0,0,0,0,0
0,0,0,0,0,0,0,0,0
0,0,0,0,0,0,0,0,0
0,0,0,0,0,0,0,0,0
329717,78,4,0,0,0,2,1,0
329705,78,4,0,0,0,2,1,0
329719,78,4,0,0,0,2,1,0
263938,2153,4,278,37,241,16,1,0
263929,2153,4,278,37,241,16,1,0
66581,80,3,0,0,0,4,0,0
707994,1344,1,182,9,173,0,1,0
707994,1344,1,182,4,178,0,1,0
0,0,0,0,0,0,0,0,0
0,0,0,0,0,0,0,0,0
20771,158,0,1,0,1,0,1,0
20771,158,0,1,0,1,0,1,0
0,0,0,0,0,0,0,0,0
0,0,0,0,0,0,0,0,0
15639,259,3,53,52,1,0,1,0
15639,259,3,53,52,1,0,1,0
0,0,0,0,0,0,0,0,0
0,0,0,0,0,0,0,0,0
0,0,0,0,0,0,0,0,0
0,0,0,0,0,0,0,0,0
0,0,0,0,0,0,0,0,0
0,0,0,0,0,0,0,0,0
0,0,0,0,0,0,0,0,0
0,0,0,0,0,0,0,0,0
0,0,0,0,0,0,0,0,0
27265,27,2,0,0,0,0,0,0
27265,27,2,0,0,0,0,0,0
27265,27,2,0,0,0,0,0,0
0,0,0,0,0,0,0,0,0
0,0,0,0,0,0,0,0,0
0,0,0,0,0,0,0,0,0
0,0,0,0,0,0,0,0,0
0,0,0,0,0,0,0,0,0
0,0,0,0,0,0,0,0,0
0,0,0,0,0,0,0,0,0
0,0,0,0,0,0,0,0,0
0,0,0,0,0,0,0,0,0
0,0,0,0,0,0,0,0,0
0,0,0,0,0,0,0,0,0
0,0,0,0,0,0,0,0,0
0,0,0,0,0,0,0,0,0
0,0,0,0,0,0,0,0,0
0,0,0,0,0,0,0,0,0
0,0,0,0,0,0,0,0,0
0,0,0,0,0,0,0,0,0
0,0,0,0,0,0,0,0,0
0,0,0,0,0,0,0,0,0
0,0,0,0,0,0,0,0,0
0,0,0,0,0,0,0,0,0
0,0,0,0,0,0,0,0,0
0,0,0,0,0,0,0,0,0
0,0,0,0,0,0,0,0,0
0,0,0,0,0,0,0,0,0
0,0,0,0,0,0,0,0,0
0,0,0,0,0,0,0,0,0
0,0,0,0,0,0,0,0,0
0,0,0,0,0,0,0,0,0
66581,80,3,0,0,0,4,0,0
111859,61,4,3,3,0,2,1,0
0,0,0,0,0,0,0,0,0
66581,80,3,0,0,0,4,0,0
111859,61,4,3,3,0,2,1,0
66581,80,3,0,0,0,4,0,0
66581,80,3,0,0,0,4,0,0
111859,61,4,3,3,0,2,1,0
111859,61,4,3,3,0,2,1,0
0,0,0,0,0,0,0,0,0
66581,80,3,0,0,0,4,0,0
111859,61,4,3,3,0,2,1,0
0,0,0,0,0,0,0,0,0
0,0,0,0,0,0,0,0,0
0,0,0,0,0,0,0,0,0
0,0,0,0,0,0,0,0,0
0,0,0,0,0,0,0,0,0
0,0,0,0,0,0,0,0,0
0,0,0,0,0,0,0,0,0
0,0,0,0,0,0,0,0,0
0,0,0,0,0,0,0,0,0
0,0,0,0,0,0,0,0,0
21515,171,1,7,6,1,0,0,0
21515,171,1,7,6,1,0,0,0
21515,171,1,7,6,1,0,0,0
21515,171,1,7,6,1,0,0,0
0,0,0,0,0,0,0,0,0
0,0,0,0,0,0,0,0,0
0,0,0,0,0,0,0,0,0
21515,171,1,7,6,1,0,0,0
0,0,0,0,0,0,0,0,0
0,0,0,0,0,0,0,0,0
0,0,0,0,0,0,0,0,0
0,0,0,0,0,0,0,0,0
0,0,0,0,0,0,0,0,0
0,0,0,0,0,0,0,0,0
0,0,0,0,0,0,0,0,0
0,0,0,0,0,0,0,0,0
0,0,0,0,0,0,0,0,0
0,0,0,0,0,0,0,0,0
0,0,0,0,0,0,0,0,0
0,0,0,0,0,0,0,0,0
0,0,0,0,0,0,0,0,0
0,0,0,0,0,0,0,0,0
0,0,0,0,0,0,0,0,0
193290,39,6,1,1,0,0,0,0
46076,66,1,2,0,2,4,0,0
0,0,0,0,0,0,0,0,0
0,0,0,0,0,0,0,0,0
0,0,0,0,0,0,0,0,0
0,0,0,0,0,0,0,0,0
0,0,0,0,0,0,0,0,0
0,0,0,0,0,0,0,0,0
0,0,0,0,0,0,0,0,0
0,0,0,0,0,0,0,0,0
0,0,0,0,0,0,0,0,0
0,0,0,0,0,0,0,0,0
0,0,0,0,0,0,0,0,0
0,0,0,0,0,0,0,0,0
0,0,0,0,0,0,0,0,0
0,0,0,0,0,0,0,0,0
0,0,0,0,0,0,0,0,0
0,0,0,0,0,0,0,0,0
0,0,0,0,0,0,0,0,0
0,0,0,0,0,0,0,0,0
193290,39,6,1,1,0,0,0,0
46076,66,1,2,0,2,4,0,0
0,0,0,0,0,0,0,0,0
56375,52,2,0,0,0,0,0,0
0,0,0,0,0,0,0,0,0
193290,39,6,1,1,0,0,0,0
46076,66,1,2,0,2,4,0,0
0,0,0,0,0,0,0,0,0
0,0,0,0,0,0,0,0,0
56375,52,2,0,0,0,0,0,0
0,0,0,0,0,0,0,0,0
0,0,0,0,0,0,0,0,0
0,0,0,0,0,0,0,0,0
0,0,0,0,0,0,0,0,0
0,0,0,0,0,0,0,0,0
0,0,0,0,0,0,0,0,0
0,0,0,0,0,0,0,0,0
193290,39,6,1,1,0,0,0,0
46076,66,1,2,0,2,4,0,0
0,0,0,0,0,0,0,0,0
0,0,0,0,0,0,0,0,0
0,0,0,0,0,0,0,0,0
2000169,186,1,19,2,17,3,0,0
0,0,0,0,0,0,0,0,0
2000169,186,1,19,2,17,3,0,0
2000169,186,1,19,2,17,3,0,0
2000169,186,1,19,2,17,3,0,0
0,0,0,0,0,0,0,0,0
0,0,0,0,0,0,0,0,0
0,0,0,0,0,0,0,0,0
0,0,0,0,0,0,0,0,0
0,0,0,0,0,0,0,0,0
0,0,0,0,0,0,0,0,0
0,0,0,0,0,0,0,0,0
0,0,0,0,0,0,0,0,0
0,0,0,0,0,0,0,0,0
0,0,0,0,0,0,0,0,0
0,0,0,0,0,0,0,0,0
0,0,0,0,0,0,0,0,0
0,0,0,0,0,0,0,0,0
13010,142,0,56,51,5,0,0,0
0,0,0,0,0,0,0,0,0
0,0,0,0,0,0,0,0,0
0,0,0,0,0,0,0,0,0
0,0,0,0,0,0,0,0,0
0,0,0,0,0,0,0,0,0
0,0,0,0,0,0,0,0,0
0,0,0,0,0,0,0,0,0
0,0,0,0,0,0,0,0,0
1584,36,0,4,3,1,0,0,0
3193,72,2,20,20,0,0,1,0
0,0,0,0,0,0,0,0,0
0,0,0,0,0,0,0,0,0
0,0,0,0,0,0,0,0,0
0,0,0,0,0,0,0,0,0
2939,16,2,1,0,1,0,0,0
53494,59,1,3,3,0,0,1,0
37395,181,6,5,2,3,1,0,0
89603,67,0,9,4,5,5,0,0
674857,556,0,4,4,0,2,1,1
0,0,0,0,0,0,0,0,0
0,0,0,0,0,0,0,0,0
0,0,0,0,0,0,0,0,0
0,0,0,0,0,0,0,0,0
0,0,0,0,0,0,0,0,0
9196,28,1,2,2,0,0,0,0
672892,555,0,4,4,0,2,1,1
9202,28,1,2,2,0,0,0,0
35430,175,6,12,11,1,1,0,0
21487,100,2,0,0,0,0,1,0
0,0,0,0,0,0,0,0,0
0,0,0,0,0,0,0,0,0
0,0,0,0,0,0,0,0,0
0,0,0,0,0,0,0,0,0
0,0,0,0,0,0,0,0,0
0,0,0,0,0,0,0,0,0
0,0,0,0,0,0,0,0,0
0,0,0,0,0,0,0,0,0
3657,19,1,0,0,0,0,0,0
0,0,0,0,0,0,0,0,0
72101,48,4,0,0,0,1,0,0
0,0,0,0,0,0,0,0,0
674629,556,0,4,4,0,2,1,1
13387,61,0,2,1,1,0,0,0
37561,129,2,4,2,2,1,1,0
0,0,0,0,0,0,0,0,0
0,0,0,0,0,0,0,0,0
134095,318,8,27,24,3,20,1,0
142286,421,8,26,24,2,35,1,0
135341,321,6,28,24,4,9,1,0
0,0,0,0,0,0,0,0,0
0,0,0,0,0,0,0,0,0
0,0,0,0,0,0,0,0,0
0,0,0,0,0,0,0,0,0
0,0,0,0,0,0,0,0,0
0,0,0,0,0,0,0,0,0
0,0,0,0,0,0,0,0,0
0,0,0,0,0,0,0,0,0
0,0,0,0,0,0,0,0,0
0,0,0,0,0,0,0,0,0
0,0,0,0,0,0,0,0,0
0,0,0,0,0,0,0,0,0
0,0,0,0,0,0,0,0,0
0,0,0,0,0,0,0,0,0
0,0,0,0,0,0,0,0,0
0,0,0,0,0,0,0,0,0
109934,49,3,0,0,0,0,0,0
232811,61,4,3,3,0,2,1,0
0,0,0,0,0,0,0,0,0
0,0,0,0,0,0,0,0,0
13475208,47,6,0,0,0,3,0,0
0,0,0,0,0,0,0,0,0
0,0,0,0,0,0,0,0,0
0,0,0,0,0,0,0,0,0
0,0,0,0,0,0,0,0,0
0,0,0,0,0,0,0,0,0
0,0,0,0,0,0,0,0,0
109934,49,3,0,0,0,0,0,0
0,0,0,0,0,0,0,0,0
232811,61,4,3,3,0,2,1,0
11203,77,3,2,2,0,4,0,0
0,0,0,0,0,0,0,0,0
0,0,0,0,0,0,0,0,0
13475208,47,6,0,0,0,3,0,0
8320,146,0,15,15,0,5,1,0
135557,42,4,1,1,0,2,0,0
0,0,0,0,0,0,0,0,0
0,0,0,0,0,0,0,0,0
232811,61,4,3,3,0,2,1,0
0,0,0,0,0,0,0,0,0
11203,77,3,2,2,0,4,0,0
0,0,0,0,0,0,0,0,0
0,0,0,0,0,0,0,0,0
109934,49,3,0,0,0,0,0,0
0,0,0,0,0,0,0,0,0
8320,146,0,15,15,0,5,1,0
135557,42,4,1,1,0,2,0,0
0,0,0,0,0,0,0,0,0
0,0,0,0,0,0,0,0,0
0,0,0,0,0,0,0,0,0
0,0,0,0,0,0,0,0,0
0,0,0,0,0,0,0,0,0
0,0,0,0,0,0,0,0,0
0,0,0,0,0,0,0,0,0
0,0,0,0,0,0,0,0,0
0,0,0,0,0,0,0,0,0
0,0,0,0,0,0,0,0,0
0,0,0,0,0,0,0,0,0
0,0,0,0,0,0,0,0,0
0,0,0,0,0,0,0,0,0
0,0,0,0,0,0,0,0,0
0,0,0,0,0,0,0,0,0
0,0,0,0,0,0,0,0,0
0,0,0,0,0,0,0,0,0
0,0,0,0,0,0,0,0,0
0,0,0,0,0,0,0,0,0
0,0,0,0,0,0,0,0,0
0,0,0,0,0,0,0,0,0
0,0,0,0,0,0,0,0,0
0,0,0,0,0,0,0,0,0
0,0,0,0,0,0,0,0,0
0,0,0,0,0,0,0,0,0
0,0,0,0,0,0,0,0,0
0,0,0,0,0,0,0,0,0
0,0,0,0,0,0,0,0,0
232811,61,4,3,3,0,2,1,0
11203,77,3,2,2,0,4,0,0
0,0,0,0,0,0,0,0,0
0,0,0,0,0,0,0,0,0
11335,118,2,0,0,0,0,0,0
0,0,0,0,0,0,0,0,0
13475208,47,6,0,0,0,3,0,0
0,0,0,0,0,0,0,0,0
0,0,0,0,0,0,0,0,0
0,0,0,0,0,0,0,0,0
0,0,0,0,0,0,0,0,0
0,0,0,0,0,0,0,0,0
0,0,0,0,0,0,0,0,0
0,0,0,0,0,0,0,0,0
0,0,0,0,0,0,0,0,0
0,0,0,0,0,0,0,0,0
0,0,0,0,0,0,0,0,0
0,0,0,0,0,0,0,0,0
0,0,0,0,0,0,0,0,0
0,0,0,0,0,0,0,0,0
356233,240,6,5,2,3,0,1,0
0,0,0,0,0,0,0,0,0
0,0,0,0,0,0,0,0,0
0,0,0,0,0,0,0,0,0
0,0,0,0,0,0,0,0,0
0,0,0,0,0,0,0,0,0
0,0,0,0,0,0,0,0,0
0,0,0,0,0,0,0,0,0
0,0,0,0,0,0,0,0,0
0,0,0,0,0,0,0,0,0
0,0,0,0,0,0,0,0,0
0,0,0,0,0,0,0,0,0
0,0,0,0,0,0,0,0,0
0,0,0,0,0,0,0,0,0
0,0,0,0,0,0,0,0,0
0,0,0,0,0,0,0,0,0
0,0,0,0,0,0,0,0,0
0,0,0,0,0,0,0,0,0
0,0,0,0,0,0,0,0,0
0,0,0,0,0,0,0,0,0
0,0,0,0,0,0,0,0,0
0,0,0,0,0,0,0,0,0
0,0,0,0,0,0,0,0,0
0,0,0,0,0,0,0,0,0
0,0,0,0,0,0,0,0,0
0,0,0,0,0,0,0,0,0
0,0,0,0,0,0,0,0,0
0,0,0,0,0,0,0,0,0
0,0,0,0,0,0,0,0,0
0,0,0,0,0,0,0,0,0
0,0,0,0,0,0,0,0,0
0,0,0,0,0,0,0,0,0
0,0,0,0,0,0,0,0,0
0,0,0,0,0,0,0,0,0
0,0,0,0,0,0,0,0,0
0,0,0,0,0,0,0,0,0
0,0,0,0,0,0,0,0,0
0,0,0,0,0,0,0,0,0
0,0,0,0,0,0,0,0,0
8073,140,7,26,8,18,1,1,0
320006,328,6,13,7,6,0,1,0
0,0,0,0,0,0,0,0,0
138948,349,8,30,1,29,20,1,0
0,0,0,0,0,0,0,0,0
9201,28,1,2,2,0,0,0,0
0,0,0,0,0,0,0,0,0
0,0,0,0,0,0,0,0,0
0,0,0,0,0,0,0,0,0
15739,253,1,6,6,0,0,0,0
8073,140,7,26,6,20,1,1,0
6330,64,2,6,4,2,0,1,0
8073,140,7,26,6,20,1,1,0
8072,140,7,26,6,20,1,1,0
0,0,0,0,0,0,0,0,0
28418,44,0,4,3,1,0,0,0
0,0,0,0,0,0,0,0,0
0,0,0,0,0,0,0,0,0
0,0,0,0,0,0,0,0,0
0,0,0,0,0,0,0,0,0
0,0,0,0,0,0,0,0,0
0,0,0,0,0,0,0,0,0
31619,228,11,19,18,1,6,1,0
6590,35,0,7,0,7,0,1,0
0,0,0,0,0,0,0,0,0
0,0,0,0,0,0,0,0,0
0,0,0,0,0,0,0,0,0
0,0,0,0,0,0,0,0,0
0,0,0,0,0,0,0,0,0
0,0,0,0,0,0,0,0,0
0,0,0,0,0,0,0,0,0
0,0,0,0,0,0,0,0,0
0,0,0,0,0,0,0,0,0
0,0,0,0,0,0,0,0,0
0,0,0,0,0,0,0,0,0
0,0,0,0,0,0,0,0,0
0,0,0,0,0,0,0,0,0
0,0,0,0,0,0,0,0,0
0,0,0,0,0,0,0,0,0
0,0,0,0,0,0,0,0,0
0,0,0,0,0,0,0,0,0
0,0,0,0,0,0,0,0,0
0,0,0,0,0,0,0,0,0
0,0,0,0,0,0,0,0,0
0,0,0,0,0,0,0,0,0
0,0,0,0,0,0,0,0,0
0,0,0,0,0,0,0,0,0
0,0,0,0,0,0,0,0,0
0,0,0,0,0,0,0,0,0
0,0,0,0,0,0,0,0,0
0,0,0,0,0,0,0,0,0
0,0,0,0,0,0,0,0,0
0,0,0,0,0,0,0,0,0
0,0,0,0,0,0,0,0,0
0,0,0,0,0,0,0,0,0
81338,45,1,0,0,0,0,0,0
81338,45,1,0,0,0,0,0,0
81338,45,1,0,0,0,0,0,0
81338,45,1,0,0,0,0,0,0
81338,45,1,0,0,0,0,0,0
0,0,0,0,0,0,0,0,0
0,0,0,0,0,0,0,0,0
0,0,0,0,0,0,0,0,0
0,0,0,0,0,0,0,0,0
0,0,0,0,0,0,0,0,0
0,0,0,0,0,0,0,0,0
0,0,0,0,0,0,0,0,0
0,0,0,0,0,0,0,0,0
0,0,0,0,0,0,0,0,0
0,0,0,0,0,0,0,0,0
0,0,0,0,0,0,0,0,0
0,0,0,0,0,0,0,0,0
0,0,0,0,0,0,0,0,0
232804,61,4,3,3,0,2,1,0
232804,61,4,3,3,0,2,1,0
232804,61,4,3,3,0,2,1,0
0,0,0,0,0,0,0,0,0
0,0,0,0,0,0,0,0,0
0,0,0,0,0,0,0,0,0
0,0,0,0,0,0,0,0,0
0,0,0,0,0,0,0,0,0
0,0,0,0,0,0,0,0,0
0,0,0,0,0,0,0,0,0
0,0,0,0,0,0,0,0,0
0,0,0,0,0,0,0,0,0
0,0,0,0,0,0,0,0,0
0,0,0,0,0,0,0,0,0
3677,19,1,0,0,0,0,0,0
12653,44,0,0,0,0,0,0,0
0,0,0,0,0,0,0,0,0
9191,28,1,2,2,0,0,0,0
8072,140,7,26,6,20,1,1,0
0,0,0,0,0,0,0,0,0
193750,92,1,3,1,2,5,0,0
0,0,0,0,0,0,0,0,0
0,0,0,0,0,0,0,0,0
0,0,0,0,0,0,0,0,0
0,0,0,0,0,0,0,0,0
0,0,0,0,0,0,0,0,0
0,0,0,0,0,0,0,0,0
0,0,0,0,0,0,0,0,0
0,0,0,0,0,0,0,0,0
0,0,0,0,0,0,0,0,0
0,0,0,0,0,0,0,0,0
0,0,0,0,0,0,0,0,0
0,0,0,0,0,0,0,0,0
0,0,0,0,0,0,0,0,0
0,0,0,0,0,0,0,0,0
22550,38,0,2,2,0,0,1,0
0,0,0,0,0,0,0,0,0
0,0,0,0,0,0,0,0,0
0,0,0,0,0,0,0,0,0
0,0,0,0,0,0,0,0,0
0,0,0,0,0,0,0,0,0
73700,48,4,0,0,0,1,0,0
80568,135,6,8,7,1,9,1,0
0,0,0,0,0,0,0,0,0
0,0,0,0,0,0,0,0,0
0,0,0,0,0,0,0,0,0
8073,140,7,26,10,16,1,1,0
65215,315,1,4,1,3,0,0,0
65183,315,1,4,2,2,0,0,0
0,0,0,0,0,0,0,0,0
0,0,0,0,0,0,0,0,0
0,0,0,0,0,0,0,0,0
0,0,0,0,0,0,0,0,0
672784,552,0,4,0,4,2,1,1
676260,553,0,4,0,4,2,1,1
0,0,0,0,0,0,0,0,0
0,0,0,0,0,0,0,0,0
0,0,0,0,0,0,0,0,0
0,0,0,0,0,0,0,0,0
0,0,0,0,0,0,0,0,0
233108,64,4,3,3,0,2,1,0
233108,64,4,3,3,0,2,1,0
233108,64,4,3,3,0,2,1,0
0,0,0,0,0,0,0,0,0
0,0,0,0,0,0,0,0,0
0,0,0,0,0,0,0,0,0
0,0,0,0,0,0,0,0,0
0,0,0,0,0,0,0,0,0
0,0,0,0,0,0,0,0,0
0,0,0,0,0,0,0,0,0
77774,101,1,4,2,2,0,0,0
0,0,0,0,0,0,0,0,0
0,0,0,0,0,0,0,0,0
0,0,0,0,0,0,0,0,0
0,0,0,0,0,0,0,0,0
0,0,0,0,0,0,0,0,0
0,0,0,0,0,0,0,0,0
8028,103,3,3,3,0,0,1,0
0,0,0,0,0,0,0,0,0
0,0,0,0,0,0,0,0,0
0,0,0,0,0,0,0,0,0
0,0,0,0,0,0,0,0,0
29270,77,3,0,0,0,3,0,0
29270,77,3,0,0,0,3,0,0
29270,77,3,0,0,0,3,0,0
420882,62,4,3,3,0,2,1,0
420882,62,4,3,3,0,2,1,0
0,0,0,0,0,0,0,0,0
0,0,0,0,0,0,0,0,0
0,0,0,0,0,0,0,0,0
0,0,0,0,0,0,0,0,0
0,0,0,0,0,0,0,0,0
0,0,0,0,0,0,0,0,0
0,0,0,0,0,0,0,0,0
0,0,0,0,0,0,0,0,0
0,0,0,0,0,0,0,0,0
0,0,0,0,0,0,0,0,0
0,0,0,0,0,0,0,0,0
77778,101,1,4,2,2,0,0,0
0,0,0,0,0,0,0,0,0
8073,140,7,26,6,20,1,1,0
0,0,0,0,0,0,0,0,0
0,0,0,0,0,0,0,0,0
9403,31,1,0,0,0,1,0,0
1442,19,4,0,0,0,0,0,0
0,0,0,0,0,0,0,0,0
0,0,0,0,0,0,0,0,0
0,0,0,0,0,0,0,0,0
0,0,0,0,0,0,0,0,0
0,0,0,0,0,0,0,0,0
0,0,0,0,0,0,0,0,0
8073,140,7,26,6,20,1,1,0
0,0,0,0,0,0,0,0,0
0,0,0,0,0,0,0,0,0
135119,218,4,26,18,8,2,1,0
0,0,0,0,0,0,0,0,0
2752351,34,4,0,0,0,0,1,0
0,0,0,0,0,0,0,0,0
0,0,0,0,0,0,0,0,0
0,0,0,0,0,0,0,0,0
0,0,0,0,0,0,0,0,0
0,0,0,0,0,0,0,0,0
0,0,0,0,0,0,0,0,0
0,0,0,0,0,0,0,0,0
0,0,0,0,0,0,0,0,0
0,0,0,0,0,0,0,0,0
0,0,0,0,0,0,0,0,0
0,0,0,0,0,0,0,0,0
0,0,0,0,0,0,0,0,0
0,0,0,0,0,0,0,0,0
0,0,0,0,0,0,0,0,0
0,0,0,0,0,0,0,0,0
0,0,0,0,0,0,0,0,0
0,0,0,0,0,0,0,0,0
0,0,0,0,0,0,0,0,0
0,0,0,0,0,0,0,0,0
0,0,0,0,0,0,0,0,0
0,0,0,0,0,0,0,0,0
0,0,0,0,0,0,0,0,0
0,0,0,0,0,0,0,0,0
0,0,0,0,0,0,0,0,0
0,0,0,0,0,0,0,0,0
0,0,0,0,0,0,0,0,0
0,0,0,0,0,0,0,0,0
0,0,0,0,0,0,0,0,0
0,0,0,0,0,0,0,0,0
0,0,0,0,0,0,0,0,0
0,0,0,0,0,0,0,0,0
0,0,0,0,0,0,0,0,0
0,0,0,0,0,0,0,0,0
0,0,0,0,0,0,0,0,0
0,0,0,0,0,0,0,0,0
126175,56,4,2,1,1,0,1,0
126175,56,4,2,1,1,0,1,0
0,0,0,0,0,0,0,0,0
0,0,0,0,0,0,0,0,0
126175,56,4,2,1,1,0,1,0
126175,56,4,2,1,1,0,1,0
415463,62,4,3,3,0,2,1,0
415463,62,4,3,3,0,2,1,0
126175,56,4,2,1,1,0,1,0
415463,62,4,3,3,0,2,1,0
415463,62,4,3,3,0,2,1,0
415463,62,4,3,3,0,2,1,0
415463,62,4,3,3,0,2,1,0
0,0,0,0,0,0,0,0,0
415463,62,4,3,3,0,2,1,0
0,0,0,0,0,0,0,0,0
0,0,0,0,0,0,0,0,0
0,0,0,0,0,0,0,0,0
0,0,0,0,0,0,0,0,0
0,0,0,0,0,0,0,0,0
162995,218,4,26,18,8,2,1,0
34302,160,5,23,12,11,1,0,0
9193,28,1,2,2,0,0,0,0
216879,1188,12,77,64,13,2,1,0
145194,831,9,133,126,7,0,1,0
0,0,0,0,0,0,0,0,0
677051,556,0,4,0,4,2,1,1
0,0,0,0,0,0,0,0,0
0,0,0,0,0,0,0,0,0
216754,1187,12,77,64,13,2,1,0
0,0,0,0,0,0,0,0,0
28415,45,0,4,1,3,0,0,0
135498,814,0,151,149,2,14,1,0
409399,675,4,1,1,0,1,0,0
76144,432,1,6,4,2,0,0,0
0,0,0,0,0,0,0,0,0
3736,24,0,1,0,1,0,1,0
3735,24,0,1,0,1,0,1,0
0,0,0,0,0,0,0,0,0
0,0,0,0,0,0,0,0,0
0,0,0,0,0,0,0,0,0
3171,51,0,7,7,0,0,0,0
0,0,0,0,0,0,0,0,0
73714,48,4,0,0,0,1,0,0
0,0,0,0,0,0,0,0,0
0,0,0,0,0,0,0,0,0
0,0,0,0,0,0,0,0,0
137717,461,3,9,6,3,10,1,0
0,0,0,0,0,0,0,0,0
0,0,0,0,0,0,0,0,0
8073,140,7,26,6,20,1,1,0
8072,140,7,26,6,20,1,1,0
0,0,0,0,0,0,0,0,0
0,0,0,0,0,0,0,0,0
0,0,0,0,0,0,0,0,0
6330,64,2,6,4,2,0,1,0
0,0,0,0,0,0,0,0,0
0,0,0,0,0,0,0,0,0
0,0,0,0,0,0,0,0,0
0,0,0,0,0,0,0,0,0
572,14,1,0,0,0,0,0,0
0,0,0,0,0,0,0,0,0
0,0,0,0,0,0,0,0,0
0,0,0,0,0,0,0,0,0
89661,382,8,66,65,1,3,0,0
0,0,0,0,0,0,0,0,0
0,0,0,0,0,0,0,0,0
0,0,0,0,0,0,0,0,0
0,0,0,0,0,0,0,0,0
0,0,0,0,0,0,0,0,0
0,0,0,0,0,0,0,0,0
0,0,0,0,0,0,0,0,0
0,0,0,0,0,0,0,0,0
0,0,0,0,0,0,0,0,0
0,0,0,0,0,0,0,0,0
8248,146,0,15,15,0,5,1,0
8248,146,0,15,15,0,5,1,0
12006,47,3,5,5,0,1,0,0
8248,146,0,15,15,0,5,1,0
33614,46,2,0,0,0,2,0,0
12006,47,3,5,5,0,1,0,0
0,0,0,0,0,0,0,0,0
0,0,0,0,0,0,0,0,0
0,0,0,0,0,0,0,0,0
0,0,0,0,0,0,0,0,0
0,0,0,0,0,0,0,0,0
0,0,0,0,0,0,0,0,0
0,0,0,0,0,0,0,0,0
0,0,0,0,0,0,0,0,0
0,0,0,0,0,0,0,0,0
0,0,0,0,0,0,0,0,0
0,0,0,0,0,0,0,0,0
0,0,0,0,0,0,0,0,0
0,0,0,0,0,0,0,0,0
232787,61,4,3,3,0,2,1,0
232787,61,4,3,3,0,2,1,0
0,0,0,0,0,0,0,0,0
0,0,0,0,0,0,0,0,0
232787,61,4,3,3,0,2,1,0
232787,61,4,3,3,0,2,1,0
233113,64,4,3,3,0,2,1,0
233113,64,4,3,3,0,2,1,0
232787,61,4,3,3,0,2,1,0
233113,64,4,3,3,0,2,1,0
0,0,0,0,0,0,0,0,0
0,0,0,0,0,0,0,0,0
0,0,0,0,0,0,0,0,0
0,0,0,0,0,0,0,0,0
0,0,0,0,0,0,0,0,0
0,0,0,0,0,0,0,0,0
0,0,0,0,0,0,0,0,0
0,0,0,0,0,0,0,0,0
0,0,0,0,0,0,0,0,0
0,0,0,0,0,0,0,0,0
0,0,0,0,0,0,0,0,0
233109,64,4,3,3,0,2,1,0
233109,64,4,3,3,0,2,1,0
0,0,0,0,0,0,0,0,0
0,0,0,0,0,0,0,0,0
136016,42,4,1,1,0,2,0,0
136016,42,4,1,1,0,2,0,0
0,0,0,0,0,0,0,0,0
233109,64,4,3,3,0,2,1,0
136016,42,4,1,1,0,2,0,0
136016,42,4,1,1,0,2,0,0
0,0,0,0,0,0,0,0,0
47610,75,2,1,1,0,3,1,0
10343,184,6,20,19,1,1,1,0
0,0,0,0,0,0,0,0,0
0,0,0,0,0,0,0,0,0
0,0,0,0,0,0,0,0,0
1537,16,0,0,0,0,0,0,0
0,0,0,0,0,0,0,0,0
679514,556,0,4,0,4,2,1,1
0,0,0,0,0,0,0,0,0
0,0,0,0,0,0,0,0,0
0,0,0,0,0,0,0,0,0
0,0,0,0,0,0,0,0,0
0,0,0,0,0,0,0,0,0
3733,24,0,1,0,1,0,1,0
0,0,0,0,0,0,0,0,0
0,0,0,0,0,0,0,0,0
35101,123,3,15,0,15,0,0,0
0,0,0,0,0,0,0,0,0
0,0,0,0,0,0,0,0,0
22427,34,0,1,1,0,0,1,0
0,0,0,0,0,0,0,0,0
0,0,0,0,0,0,0,0,0
0,0,0,0,0,0,0,0,0
0,0,0,0,0,0,0,0,0
8073,140,7,26,6,20,1,1,0
8073,140,7,26,6,20,1,1,0
8072,140,7,26,6,20,1,1,0
0,0,0,0,0,0,0,0,0
4547,35,0,2,0,2,0,0,0
0,0,0,0,0,0,0,0,0
73713,48,4,0,0,0,1,0,0
2830,21,2,0,0,0,0,0,0
0,0,0,0,0,0,0,0,0
28640,45,0,4,1,3,0,0,0
0,0,0,0,0,0,0,0,0
0,0,0,0,0,0,0,0,0
2024862,61,4,1,1,0,2,1,0
0,0,0,0,0,0,0,0,0
0,0,0,0,0,0,0,0,0
0,0,0,0,0,0,0,0,0
0,0,0,0,0,0,0,0,0
0,0,0,0,0,0,0,0,0
0,0,0,0,0,0,0,0,0
0,0,0,0,0,0,0,0,0
0,0,0,0,0,0,0,0,0
0,0,0,0,0,0,0,0,0
0,0,0,0,0,0,0,0,0
0,0,0,0,0,0,0,0,0
0,0,0,0,0,0,0,0,0
33614,46,2,0,0,0,2,0,0
0,0,0,0,0,0,0,0,0
0,0,0,0,0,0,0,0,0
33614,46,2,0,0,0,2,0,0
0,0,0,0,0,0,0,0,0
0,0,0,0,0,0,0,0,0
0,0,0,0,0,0,0,0,0
2024862,61,4,1,1,0,2,1,0
2024862,61,4,1,1,0,2,1,0
0,0,0,0,0,0,0,0,0
0,0,0,0,0,0,0,0,0
233101,64,4,3,3,0,2,1,0
0,0,0,0,0,0,0,0,0
0,0,0,0,0,0,0,0,0
303389,60,4,2,2,0,2,1,0
233101,64,4,3,3,0,2,1,0
0,0,0,0,0,0,0,0,0
0,0,0,0,0,0,0,0,0
0,0,0,0,0,0,0,0,0
233101,64,4,3,3,0,2,1,0
0,0,0,0,0,0,0,0,0
184778,15,0,0,0,0,0,0,0
184778,15,0,0,0,0,0,0,0
184778,15,0,0,0,0,0,0,0
0,0,0,0,0,0,0,0,0
31754,52,2,0,0,0,0,0,0
31754,52,2,0,0,0,0,0,0
0,0,0,0,0,0,0,0,0
0,0,0,0,0,0,0,0,0
31754,52,2,0,0,0,0,0,0
31754,52,2,0,0,0,0,0,0
0,0,0,0,0,0,0,0,0
31754,52,2,0,0,0,0,0,0
0,0,0,0,0,0,0,0,0
31754,52,2,0,0,0,0,0,0
233115,64,4,3,3,0,2,1,0
233115,64,4,3,3,0,2,1,0
233115,64,4,3,3,0,2,1,0
0,0,0,0,0,0,0,0,0
0,0,0,0,0,0,0,0,0
0,0,0,0,0,0,0,0,0
0,0,0,0,0,0,0,0,0
0,0,0,0,0,0,0,0,0
0,0,0,0,0,0,0,0,0
0,0,0,0,0,0,0,0,0
0,0,0,0,0,0,0,0,0
0,0,0,0,0,0,0,0,0
0,0,0,0,0,0,0,0,0
0,0,0,0,0,0,0,0,0
0,0,0,0,0,0,0,0,0
0,0,0,0,0,0,0,0,0
0,0,0,0,0,0,0,0,0
0,0,0,0,0,0,0,0,0
0,0,0,0,0,0,0,0,0
0,0,0,0,0,0,0,0,0
0,0,0,0,0,0,0,0,0
0,0,0,0,0,0,0,0,0
0,0,0,0,0,0,0,0,0
0,0,0,0,0,0,0,0,0
0,0,0,0,0,0,0,0,0
0,0,0,0,0,0,0,0,0
0,0,0,0,0,0,0,0,0
0,0,0,0,0,0,0,0,0
0,0,0,0,0,0,0,0,0
0,0,0,0,0,0,0,0,0
20773,206,4,21,21,0,2,0,0
20783,206,4,21,21,0,2,0,0
0,0,0,0,0,0,0,0,0
0,0,0,0,0,0,0,0,0
10446,150,5,11,11,0,0,1,0
10446,150,5,11,11,0,0,1,0
0,0,0,0,0,0,0,0,0
0,0,0,0,0,0,0,0,0
0,0,0,0,0,0,0,0,0
0,0,0,0,0,0,0,0,0
34469,50,2,0,0,0,2,0,0
0,0,0,0,0,0,0,0,0
0,0,0,0,0,0,0,0,0
0,0,0,0,0,0,0,0,0
0,0,0,0,0,0,0,0,0
0,0,0,0,0,0,0,0,0
0,0,0,0,0,0,0,0,0
14123,142,0,56,52,4,0,0,0
0,0,0,0,0,0,0,0,0
0,0,0,0,0,0,0,0,0
0,0,0,0,0,0,0,0,0
0,0,0,0,0,0,0,0,0
0,0,0,0,0,0,0,0,0
12406,28,1,2,2,0,0,0,0
63044,166,2,21,21,0,2,1,0
9690,28,1,2,2,0,0,0,0
9687,28,1,2,2,0,0,0,0
8073,140,7,26,6,20,1,1,0
0,0,0,0,0,0,0,0,0
11348,266,3,24,24,0,1,1,0
9250,130,0,18,1,17,9,0,0
73701,48,4,0,0,0,1,0,0
142966,426,8,28,24,4,36,1,0
0,0,0,0,0,0,0,0,0
0,0,0,0,0,0,0,0,0
0,0,0,0,0,0,0,0,0
0,0,0,0,0,0,0,0,0
0,0,0,0,0,0,0,0,0
0,0,0,0,0,0,0,0,0
0,0,0,0,0,0,0,0,0
0,0,0,0,0,0,0,0,0
0,0,0,0,0,0,0,0,0
1537,16,0,0,0,0,0,0,0
14975,28,1,2,2,0,0,0,0
0,0,0,0,0,0,0,0,0
0,0,0,0,0,0,0,0,0
0,0,0,0,0,0,0,0,0
673496,555,0,4,4,0,2,1,1
0,0,0,0,0,0,0,0,0
670894,555,0,4,4,0,2,1,1
0,0,0,0,0,0,0,0,0
0,0,0,0,0,0,0,0,0
0,0,0,0,0,0,0,0,0
0,0,0,0,0,0,0,0,0
0,0,0,0,0,0,0,0,0
0,0,0,0,0,0,0,0,0
0,0,0,0,0,0,0,0,0
0,0,0,0,0,0,0,0,0
0,0,0,0,0,0,0,0,0
0,0,0,0,0,0,0,0,0
0,0,0,0,0,0,0,0,0
0,0,0,0,0,0,0,0,0
0,0,0,0,0,0,0,0,0
0,0,0,0,0,0,0,0,0
0,0,0,0,0,0,0,0,0
0,0,0,0,0,0,0,0,0
0,0,0,0,0,0,0,0,0
0,0,0,0,0,0,0,0,0
0,0,0,0,0,0,0,0,0
0,0,0,0,0,0,0,0,0
0,0,0,0,0,0,0,0,0
0,0,0,0,0,0,0,0,0
0,0,0,0,0,0,0,0,0
0,0,0,0,0,0,0,0,0
0,0,0,0,0,0,0,0,0
0,0,0,0,0,0,0,0,0
0,0,0,0,0,0,0,0,0
0,0,0,0,0,0,0,0,0
0,0,0,0,0,0,0,0,0
0,0,0,0,0,0,0,0,0
0,0,0,0,0,0,0,0,0
0,0,0,0,0,0,0,0,0
0,0,0,0,0,0,0,0,0
0,0,0,0,0,0,0,0,0
33622,46,2,0,0,0,2,0,0
33622,46,2,0,0,0,2,0,0
0,0,0,0,0,0,0,0,0
0,0,0,0,0,0,0,0,0
0,0,0,0,0,0,0,0,0
0,0,0,0,0,0,0,0,0
0,0,0,0,0,0,0,0,0
135968,42,4,1,1,0,2,0,0
135968,42,4,1,1,0,2,0,0
135968,42,4,1,1,0,2,0,0
0,0,0,0,0,0,0,0,0
0,0,0,0,0,0,0,0,0
0,0,0,0,0,0,0,0,0
0,0,0,0,0,0,0,0,0
0,0,0,0,0,0,0,0,0
0,0,0,0,0,0,0,0,0
0,0,0,0,0,0,0,0,0
0,0,0,0,0,0,0,0,0
0,0,0,0,0,0,0,0,0
0,0,0,0,0,0,0,0,0
0,0,0,0,0,0,0,0,0
0,0,0,0,0,0,0,0,0
234106,74,4,3,3,0,2,1,0
0,0,0,0,0,0,0,0,0
0,0,0,0,0,0,0,0,0
0,0,0,0,0,0,0,0,0
0,0,0,0,0,0,0,0,0
0,0,0,0,0,0,0,0,0
0,0,0,0,0,0,0,0,0
0,0,0,0,0,0,0,0,0
0,0,0,0,0,0,0,0,0
0,0,0,0,0,0,0,0,0
0,0,0,0,0,0,0,0,0
0,0,0,0,0,0,0,0,0
144400,42,4,1,1,0,2,0,0
144400,42,4,1,1,0,2,0,0
0,0,0,0,0,0,0,0,0
0,0,0,0,0,0,0,0,0
0,0,0,0,0,0,0,0,0
0,0,0,0,0,0,0,0,0
0,0,0,0,0,0,0,0,0
415576,62,4,3,3,0,2,1,0
415576,62,4,3,3,0,2,1,0
415576,62,4,3,3,0,2,1,0
0,0,0,0,0,0,0,0,0
415576,62,4,3,3,0,2,1,0
0,0,0,0,0,0,0,0,0
0,0,0,0,0,0,0,0,0
0,0,0,0,0,0,0,0,0
0,0,0,0,0,0,0,0,0
0,0,0,0,0,0,0,0,0
29853,70,1,0,0,0,1,0,0
1026053,104,0,17,3,14,2,1,0
1026053,104,0,17,3,14,2,1,0
0,0,0,0,0,0,0,0,0
0,0,0,0,0,0,0,0,0
129677,768,7,18,11,7,4,1,0
129707,768,7,18,11,7,4,1,0
0,0,0,0,0,0,0,0,0
0,0,0,0,0,0,0,0,0
0,0,0,0,0,0,0,0,0
15016,142,0,56,51,5,0,0,0
0,0,0,0,0,0,0,0,0
102670,76,4,6,6,0,5,1,0
0,0,0,0,0,0,0,0,0
0,0,0,0,0,0,0,0,0
8073,140,7,26,8,18,1,1,0
0,0,0,0,0,0,0,0,0
70077,12,0,0,0,0,0,0,0
0,0,0,0,0,0,0,0,0
0,0,0,0,0,0,0,0,0
0,0,0,0,0,0,0,0,0
0,0,0,0,0,0,0,0,0
38578,145,1,4,2,2,0,0,0
0,0,0,0,0,0,0,0,0
13028,108,1,5,5,0,0,1,0
0,0,0,0,0,0,0,0,0
0,0,0,0,0,0,0,0,0
136726,334,8,27,24,3,20,1,0
63633,367,6,70,56,14,3,1,0
0,0,0,0,0,0,0,0,0
8073,140,7,26,6,20,1,1,0
0,0,0,0,0,0,0,0,0
0,0,0,0,0,0,0,0,0
0,0,0,0,0,0,0,0,0
0,0,0,0,0,0,0,0,0
0,0,0,0,0,0,0,0,0
73713,48,4,0,0,0,1,0,0
106063,588,10,16,4,12,1,1,0
0,0,0,0,0,0,0,0,0
0,0,0,0,0,0,0,0,0
52449,87,2,0,0,0,1,0,0
52449,87,2,0,0,0,1,0,0
13141,29,1,0,0,0,3,0,0
13141,29,1,0,0,0,3,0,0
0,0,0,0,0,0,0,0,0
0,0,0,0,0,0,0,0,0
0,0,0,0,0,0,0,0,0
0,0,0,0,0,0,0,0,0
0,0,0,0,0,0,0,0,0
0,0,0,0,0,0,0,0,0
0,0,0,0,0,0,0,0,0
0,0,0,0,0,0,0,0,0
0,0,0,0,0,0,0,0,0
0,0,0,0,0,0,0,0,0
0,0,0,0,0,0,0,0,0
0,0,0,0,0,0,0,0,0
0,0,0,0,0,0,0,0,0
0,0,0,0,0,0,0,0,0
0,0,0,0,0,0,0,0,0
0,0,0,0,0,0,0,0,0
51854,51,3,0,0,0,2,0,0
51854,51,3,0,0,0,2,0,0
0,0,0,0,0,0,0,0,0
0,0,0,0,0,0,0,0,0
0,0,0,0,0,0,0,0,0
0,0,0,0,0,0,0,0,0
0,0,0,0,0,0,0,0,0
0,0,0,0,0,0,0,0,0
0,0,0,0,0,0,0,0,0
0,0,0,0,0,0,0,0,0
0,0,0,0,0,0,0,0,0
0,0,0,0,0,0,0,0,0
0,0,0,0,0,0,0,0,0
0,0,0,0,0,0,0,0,0
26054,206,2,50,49,1,0,1,0
26054,206,2,50,49,1,0,1,0
26054,206,2,50,49,1,0,1,0
26054,206,2,50,49,1,0,1,0
26054,206,2,50,49,1,0,1,0
0,0,0,0,0,0,0,0,0
0,0,0,0,0,0,0,0,0
0,0,0,0,0,0,0,0,0
0,0,0,0,0,0,0,0,0
0,0,0,0,0,0,0,0,0
0,0,0,0,0,0,0,0,0
0,0,0,0,0,0,0,0,0
0,0,0,0,0,0,0,0,0
0,0,0,0,0,0,0,0,0
0,0,0,0,0,0,0,0,0
0,0,0,0,0,0,0,0,0
0,0,0,0,0,0,0,0,0
0,0,0,0,0,0,0,0,0
0,0,0,0,0,0,0,0,0
0,0,0,0,0,0,0,0,0
0,0,0,0,0,0,0,0,0
0,0,0,0,0,0,0,0,0
0,0,0,0,0,0,0,0,0
0,0,0,0,0,0,0,0,0
0,0,0,0,0,0,0,0,0
0,0,0,0,0,0,0,0,0
0,0,0,0,0,0,0,0,0
0,0,0,0,0,0,0,0,0
0,0,0,0,0,0,0,0,0
6978,50,2,1,1,0,0,1,0
0,0,0,0,0,0,0,0,0
6978,50,2,1,1,0,0,1,0
6978,50,2,1,1,0,0,1,0
0,0,0,0,0,0,0,0,0
415579,62,4,3,3,0,2,1,0
415579,62,4,3,3,0,2,1,0
415579,62,4,3,3,0,2,1,0
415579,62,4,3,3,0,2,1,0
415579,62,4,3,3,0,2,1,0
6978,50,2,1,1,0,0,1,0
6978,50,2,1,1,0,0,1,0
0,0,0,0,0,0,0,0,0
6978,50,2,1,1,0,0,1,0
0,0,0,0,0,0,0,0,0
0,0,0,0,0,0,0,0,0
0,0,0,0,0,0,0,0,0
6978,50,2,1,1,0,0,1,0
6978,50,2,1,1,0,0,1,0
0,0,0,0,0,0,0,0,0
0,0,0,0,0,0,0,0,0
6978,50,2,1,1,0,0,1,0
6978,50,2,1,1,0,0,1,0
0,0,0,0,0,0,0,0,0
0,0,0,0,0,0,0,0,0
0,0,0,0,0,0,0,0,0
0,0,0,0,0,0,0,0,0
0,0,0,0,0,0,0,0,0
0,0,0,0,0,0,0,0,0
111084,361,16,28,24,4,2,1,0
111084,361,16,28,24,4,2,1,0
0,0,0,0,0,0,0,0,0
0,0,0,0,0,0,0,0,0
0,0,0,0,0,0,0,0,0
0,0,0,0,0,0,0,0,0
0,0,0,0,0,0,0,0,0
0,0,0,0,0,0,0,0,0
0,0,0,0,0,0,0,0,0
0,0,0,0,0,0,0,0,0
1181634,9368,5,2033,1969,64,5,1,0
0,0,0,0,0,0,0,0,0
0,0,0,0,0,0,0,0,0
0,0,0,0,0,0,0,0,0
0,0,0,0,0,0,0,0,0
0,0,0,0,0,0,0,0,0
0,0,0,0,0,0,0,0,0
0,0,0,0,0,0,0,0,0
0,0,0,0,0,0,0,0,0
0,0,0,0,0,0,0,0,0
0,0,0,0,0,0,0,0,0
0,0,0,0,0,0,0,0,0
0,0,0,0,0,0,0,0,0
0,0,0,0,0,0,0,0,0
33309,156,3,8,3,5,10,1,0
0,0,0,0,0,0,0,0,0
142941,431,8,28,24,4,35,1,0
0,0,0,0,0,0,0,0,0
8073,140,7,26,10,16,1,1,0
0,0,0,0,0,0,0,0,0
0,0,0,0,0,0,0,0,0
22963,202,0,0,0,0,1,1,0
0,0,0,0,0,0,0,0,0
0,0,0,0,0,0,0,0,0
0,0,0,0,0,0,0,0,0
0,0,0,0,0,0,0,0,0
359244,3455,13,676,603,73,44,1,0
12768,217,0,72,2,70,0,1,0
0,0,0,0,0,0,0,0,0
17096,77,2,1,1,0,0,0,0
0,0,0,0,0,0,0,0,0
29336,63,3,1,1,0,0,0,0
58226,392,4,56,10,46,0,1,0
0,0,0,0,0,0,0,0,0
8593,129,2,11,11,0,0,1,0
8593,129,2,11,11,0,0,1,0
0,0,0,0,0,0,0,0,0
0,0,0,0,0,0,0,0,0
0,0,0,0,0,0,0,0,0
0,0,0,0,0,0,0,0,0
0,0,0,0,0,0,0,0,0
0,0,0,0,0,0,0,0,0
0,0,0,0,0,0,0,0,0
0,0,0,0,0,0,0,0,0
0,0,0,0,0,0,0,0,0
0,0,0,0,0,0,0,0,0
0,0,0,0,0,0,0,0,0
0,0,0,0,0,0,0,0,0
36408,50,2,0,0,0,2,0,0
0,0,0,0,0,0,0,0,0
0,0,0,0,0,0,0,0,0
0,0,0,0,0,0,0,0,0
0,0,0,0,0,0,0,0,0
283212,196,6,1,1,0,0,1,0
0,0,0,0,0,0,0,0,0
0,0,0,0,0,0,0,0,0
0,0,0,0,0,0,0,0,0
0,0,0,0,0,0,0,0,0
0,0,0,0,0,0,0,0,0
0,0,0,0,0,0,0,0,0
0,0,0,0,0,0,0,0,0
0,0,0,0,0,0,0,0,0
0,0,0,0,0,0,0,0,0
0,0,0,0,0,0,0,0,0
0,0,0,0,0,0,0,0,0
0,0,0,0,0,0,0,0,0
0,0,0,0,0,0,0,0,0
80718,135,6,8,7,1,9,1,0
0,0,0,0,0,0,0,0,0
12768,217,0,72,2,70,0,1,0
0,0,0,0,0,0,0,0,0
680116,556,0,4,0,4,2,1,1
0,0,0,0,0,0,0,0,0
0,0,0,0,0,0,0,0,0
73856,48,4,0,0,0,1,0,0
0,0,0,0,0,0,0,0,0
0,0,0,0,0,0,0,0,0
0,0,0,0,0,0,0,0,0
677437,556,0,4,4,0,2,1,1
0,0,0,0,0,0,0,0,0
0,0,0,0,0,0,0,0,0
2014,100,0,15,15,0,0,0,0
2014,100,0,15,15,0,0,0,0
0,0,0,0,0,0,0,0,0
0,0,0,0,0,0,0,0,0
0,0,0,0,0,0,0,0,0
0,0,0,0,0,0,0,0,0
0,0,0,0,0,0,0,0,0
0,0,0,0,0,0,0,0,0
0,0,0,0,0,0,0,0,0
0,0,0,0,0,0,0,0,0
0,0,0,0,0,0,0,0,0
0,0,0,0,0,0,0,0,0
0,0,0,0,0,0,0,0,0
0,0,0,0,0,0,0,0,0
13173,142,0,56,52,4,0,0,0
14123,142,0,56,52,4,0,0,0
0,0,0,0,0,0,0,0,0
0,0,0,0,0,0,0,0,0
0,0,0,0,0,0,0,0,0
0,0,0,0,0,0,0,0,0
0,0,0,0,0,0,0,0,0
0,0,0,0,0,0,0,0,0
0,0,0,0,0,0,0,0,0
8073,140,7,26,6,20,1,1,0
0,0,0,0,0,0,0,0,0
12768,217,0,72,72,0,0,1,0
12768,217,0,72,72,0,0,1,0
0,0,0,0,0,0,0,0,0
0,0,0,0,0,0,0,0,0
0,0,0,0,0,0,0,0,0
0,0,0,0,0,0,0,0,0
0,0,0,0,0,0,0,0,0
0,0,0,0,0,0,0,0,0
0,0,0,0,0,0,0,0,0
0,0,0,0,0,0,0,0,0
0,0,0,0,0,0,0,0,0
0,0,0,0,0,0,0,0,0
0,0,0,0,0,0,0,0,0
0,0,0,0,0,0,0,0,0
0,0,0,0,0,0,0,0,0
0,0,0,0,0,0,0,0,0
0,0,0,0,0,0,0,0,0
0,0,0,0,0,0,0,0,0
0,0,0,0,0,0,0,0,0
0,0,0,0,0,0,0,0,0
10871,33,1,0,0,0,1,0,0
0,0,0,0,0,0,0,0,0
0,0,0,0,0,0,0,0,0
0,0,0,0,0,0,0,0,0
0,0,0,0,0,0,0,0,0
6277,46,1,0,0,0,0,0,0
6277,46,1,0,0,0,0,0,0
6253,46,1,0,0,0,0,0,0
6269,46,1,0,0,0,0,0,0
6253,46,1,0,0,0,0,0,0
0,0,0,0,0,0,0,0,0
0,0,0,0,0,0,0,0,0
0,0,0,0,0,0,0,0,0
0,0,0,0,0,0,0,0,0
0,0,0,0,0,0,0,0,0
0,0,0,0,0,0,0,0,0
0,0,0,0,0,0,0,0,0
0,0,0,0,0,0,0,0,0
0,0,0,0,0,0,0,0,0
0,0,0,0,0,0,0,0,0
0,0,0,0,0,0,0,0,0
0,0,0,0,0,0,0,0,0
0,0,0,0,0,0,0,0,0
0,0,0,0,0,0,0,0,0
0,0,0,0,0,0,0,0,0
0,0,0,0,0,0,0,0,0
0,0,0,0,0,0,0,0,0
0,0,0,0,0,0,0,0,0
0,0,0,0,0,0,0,0,0
0,0,0,0,0,0,0,0,0
0,0,0,0,0,0,0,0,0
0,0,0,0,0,0,0,0,0
0,0,0,0,0,0,0,0,0
0,0,0,0,0,0,0,0,0
5406,45,4,0,0,0,3,0,0
415588,62,4,3,3,0,2,1,0
415588,62,4,3,3,0,2,1,0
5406,45,4,0,0,0,3,0,0
5406,45,4,0,0,0,3,0,0
5406,45,4,0,0,0,3,0,0
0,0,0,0,0,0,0,0,0
0,0,0,0,0,0,0,0,0
415588,62,4,3,3,0,2,1,0
415588,62,4,3,3,0,2,1,0
0,0,0,0,0,0,0,0,0
0,0,0,0,0,0,0,0,0
0,0,0,0,0,0,0,0,0
0,0,0,0,0,0,0,0,0
0,0,0,0,0,0,0,0,0
0,0,0,0,0,0,0,0,0
0,0,0,0,0,0,0,0,0
0,0,0,0,0,0,0,0,0
0,0,0,0,0,0,0,0,0
0,0,0,0,0,0,0,0,0
0,0,0,0,0,0,0,0,0
0,0,0,0,0,0,0,0,0
0,0,0,0,0,0,0,0,0
0,0,0,0,0,0,0,0,0
0,0,0,0,0,0,0,0,0
0,0,0,0,0,0,0,0,0
0,0,0,0,0,0,0,0,0
0,0,0,0,0,0,0,0,0
0,0,0,0,0,0,0,0,0
98962,66,4,0,0,0,2,1,0
98962,66,4,0,0,0,2,1,0
0,0,0,0,0,0,0,0,0
98962,66,4,0,0,0,2,1,0
98962,66,4,0,0,0,2,1,0
0,0,0,0,0,0,0,0,0
8250,146,0,15,15,0,5,1,0
8250,146,0,15,15,0,5,1,0
0,0,0,0,0,0,0,0,0
0,0,0,0,0,0,0,0,0
77798,101,1,4,2,2,0,0,0
411857,207,6,2,1,1,0,1,0
139824,414,8,28,24,4,34,1,0
0,0,0,0,0,0,0,0,0
0,0,0,0,0,0,0,0,0
0,0,0,0,0,0,0,0,0
0,0,0,0,0,0,0,0,0
0,0,0,0,0,0,0,0,0
0,0,0,0,0,0,0,0,0
0,0,0,0,0,0,0,0,0
0,0,0,0,0,0,0,0,0
0,0,0,0,0,0,0,0,0
0,0,0,0,0,0,0,0,0
87787,311,5,23,0,23,3,1,0
0,0,0,0,0,0,0,0,0
0,0,0,0,0,0,0,0,0
0,0,0,0,0,0,0,0,0
0,0,0,0,0,0,0,0,0
0,0,0,0,0,0,0,0,0
675590,556,0,4,4,0,2,1,1
0,0,0,0,0,0,0,0,0
37962,176,6,7,5,2,1,0,0
0,0,0,0,0,0,0,0,0
0,0,0,0,0,0,0,0,0
1319033,3321,12,157,143,14,31,1,0
2214,16,0,0,0,0,0,0,0
0,0,0,0,0,0,0,0,0
0,0,0,0,0,0,0,0,0
288191,194,6,1,1,0,0,1,0
0,0,0,0,0,0,0,0,0
582154,208,6,1,1,0,1,1,0
295509,196,6,1,1,0,0,1,0
0,0,0,0,0,0,0,0,0
0,0,0,0,0,0,0,0,0
0,0,0,0,0,0,0,0,0
0,0,0,0,0,0,0,0,0
0,0,0,0,0,0,0,0,0
0,0,0,0,0,0,0,0,0
0,0,0,0,0,0,0,0,0
0,0,0,0,0,0,0,0,0
0,0,0,0,0,0,0,0,0
37140,484,7,65,64,1,0,1,0
55885,753,2,137,131,6,0,1,0
0,0,0,0,0,0,0,0,0
0,0,0,0,0,0,0,0,0
0,0,0,0,0,0,0,0,0
0,0,0,0,0,0,0,0,0
0,0,0,0,0,0,0,0,0
0,0,0,0,0,0,0,0,0
0,0,0,0,0,0,0,0,0
0,0,0,0,0,0,0,0,0
159380,1390,7,171,156,15,1,1,0
0,0,0,0,0,0,0,0,0
0,0,0,0,0,0,0,0,0
0,0,0,0,0,0,0,0,0
0,0,0,0,0,0,0,0,0
0,0,0,0,0,0,0,0,0
0,0,0,0,0,0,0,0,0
67521,81,3,0,0,0,4,0,0
0,0,0,0,0,0,0,0,0
0,0,0,0,0,0,0,0,0
0,0,0,0,0,0,0,0,0
0,0,0,0,0,0,0,0,0
0,0,0,0,0,0,0,0,0
0,0,0,0,0,0,0,0,0
67521,81,3,0,0,0,4,0,0
0,0,0,0,0,0,0,0,0
0,0,0,0,0,0,0,0,0
0,0,0,0,0,0,0,0,0
0,0,0,0,0,0,0,0,0
0,0,0,0,0,0,0,0,0
0,0,0,0,0,0,0,0,0
0,0,0,0,0,0,0,0,0
0,0,0,0,0,0,0,0,0
0,0,0,0,0,0,0,0,0
0,0,0,0,0,0,0,0,0
10981,56,3,0,0,0,2,0,0
10981,56,3,0,0,0,2,0,0
0,0,0,0,0,0,0,0,0
0,0,0,0,0,0,0,0,0
0,0,0,0,0,0,0,0,0
39972,52,2,2,2,0,3,0,0
0,0,0,0,0,0,0,0,0
0,0,0,0,0,0,0,0,0
10981,56,3,0,0,0,2,0,0
10981,56,3,0,0,0,2,0,0
10981,56,3,0,0,0,2,0,0
0,0,0,0,0,0,0,0,0
56662,56,0,0,0,0,0,1,0
0,0,0,0,0,0,0,0,0
0,0,0,0,0,0,0,0,0
0,0,0,0,0,0,0,0,0
0,0,0,0,0,0,0,0,0
0,0,0,0,0,0,0,0,0
77742,101,1,4,2,2,0,0,0
22963,205,2,11,11,0,3,1,0
0,0,0,0,0,0,0,0,0
35896,159,3,8,4,4,11,1,0
5894,91,6,19,19,0,0,0,0
0,0,0,0,0,0,0,0,0
276611,1136,15,81,76,5,3,1,0
0,0,0,0,0,0,0,0,0
420886,62,4,3,3,0,2,1,0
0,0,0,0,0,0,0,0,0
0,0,0,0,0,0,0,0,0
1245989,188,3,25,3,22,4,1,0
0,0,0,0,0,0,0,0,0
0,0,0,0,0,0,0,0,0
53223,174,3,8,6,2,0,0,0
0,0,0,0,0,0,0,0,0
305671,247,6,1,1,0,0,1,0
0,0,0,0,0,0,0,0,0
0,0,0,0,0,0,0,0,0
0,0,0,0,0,0,0,0,0
0,0,0,0,0,0,0,0,0
0,0,0,0,0,0,0,0,0
0,0,0,0,0,0,0,0,0
0,0,0,0,0,0,0,0,0
0,0,0,0,0,0,0,0,0
0,0,0,0,0,0,0,0,0
0,0,0,0,0,0,0,0,0
0,0,0,0,0,0,0,0,0
0,0,0,0,0,0,0,0,0
0,0,0,0,0,0,0,0,0
49437,240,2,1,1,0,1,0,0
0,0,0,0,0,0,0,0,0
675740,556,0,4,4,0,2,1,1
8073,140,7,26,6,20,1,1,0
0,0,0,0,0,0,0,0,0
0,0,0,0,0,0,0,0,0
10301,95,1,0,0,0,0,0,0
27315,36,0,3,1,2,0,0,0
0,0,0,0,0,0,0,0,0
0,0,0,0,0,0,0,0,0
56628,124,1,1,1,0,1,0,0
71648,48,4,0,0,0,1,0,0
1094690,117,2,4,0,4,0,1,0
0,0,0,0,0,0,0,0,0
183430,118,2,7,0,7,2,1,0
14975,28,1,2,2,0,0,0,0
9502,84,1,0,0,0,0,0,0
675458,556,0,4,4,0,2,1,1
119269,816,17,36,27,9,8,1,0
0,0,0,0,0,0,0,0,0
0,0,0,0,0,0,0,0,0
0,0,0,0,0,0,0,0,0
0,0,0,0,0,0,0,0,0
0,0,0,0,0,0,0,0,0
98307,597,9,84,75,9,1,1,0
0,0,0,0,0,0,0,0,0
0,0,0,0,0,0,0,0,0
680562,74,3,2,1,1,1,1,0
0,0,0,0,0,0,0,0,0
0,0,0,0,0,0,0,0,0
3413,49,4,0,0,0,0,0,0
0,0,0,0,0,0,0,0,0
0,0,0,0,0,0,0,0,0
0,0,0,0,0,0,0,0,0
0,0,0,0,0,0,0,0,0
0,0,0,0,0,0,0,0,0
0,0,0,0,0,0,0,0,0
0,0,0,0,0,0,0,0,0
15886,259,3,53,52,1,0,1,0
15886,259,3,53,52,1,0,1,0
0,0,0,0,0,0,0,0,0
0,0,0,0,0,0,0,0,0
0,0,0,0,0,0,0,0,0
0,0,0,0,0,0,0,0,0
430145,1544,2,196,194,2,25,1,0
0,0,0,0,0,0,0,0,0
568598,48,2,0,0,0,2,0,0
0,0,0,0,0,0,0,0,0
0,0,0,0,0,0,0,0,0
0,0,0,0,0,0,0,0,0
0,0,0,0,0,0,0,0,0
0,0,0,0,0,0,0,0,0
0,0,0,0,0,0,0,0,0
0,0,0,0,0,0,0,0,0
0,0,0,0,0,0,0,0,0
0,0,0,0,0,0,0,0,0
568598,48,2,0,0,0,2,0,0
0,0,0,0,0,0,0,0,0
104990,65,4,9,9,0,2,1,0
0,0,0,0,0,0,0,0,0
0,0,0,0,0,0,0,0,0
0,0,0,0,0,0,0,0,0
0,0,0,0,0,0,0,0,0
0,0,0,0,0,0,0,0,0
0,0,0,0,0,0,0,0,0
0,0,0,0,0,0,0,0,0
0,0,0,0,0,0,0,0,0
0,0,0,0,0,0,0,0,0
0,0,0,0,0,0,0,0,0
0,0,0,0,0,0,0,0,0
0,0,0,0,0,0,0,0,0
0,0,0,0,0,0,0,0,0
106559,49,3,0,0,0,3,0,0
0,0,0,0,0,0,0,0,0
0,0,0,0,0,0,0,0,0
0,0,0,0,0,0,0,0,0
0,0,0,0,0,0,0,0,0
106555,49,3,0,0,0,3,0,0
106548,49,3,0,0,0,3,0,0
0,0,0,0,0,0,0,0,0
106548,49,3,0,0,0,3,0,0
415465,62,4,3,3,0,2,1,0
415465,62,4,3,3,0,2,1,0
0,0,0,0,0,0,0,0,0
0,0,0,0,0,0,0,0,0
0,0,0,0,0,0,0,0,0
415465,62,4,3,3,0,2,1,0
415465,62,4,3,3,0,2,1,0
415465,62,4,3,3,0,2,1,0
415465,62,4,3,3,0,2,1,0
415465,62,4,3,3,0,2,1,0
0,0,0,0,0,0,0,0,0
0,0,0,0,0,0,0,0,0
0,0,0,0,0,0,0,0,0
0,0,0,0,0,0,0,0,0
0,0,0,0,0,0,0,0,0
0,0,0,0,0,0,0,0,0
0,0,0,0,0,0,0,0,0
0,0,0,0,0,0,0,0,0
0,0,0,0,0,0,0,0,0
0,0,0,0,0,0,0,0,0
0,0,0,0,0,0,0,0,0
0,0,0,0,0,0,0,0,0
0,0,0,0,0,0,0,0,0
0,0,0,0,0,0,0,0,0
0,0,0,0,0,0,0,0,0
0,0,0,0,0,0,0,0,0
0,0,0,0,0,0,0,0,0
0,0,0,0,0,0,0,0,0
0,0,0,0,0,0,0,0,0
0,0,0,0,0,0,0,0,0
0,0,0,0,0,0,0,0,0
0,0,0,0,0,0,0,0,0
0,0,0,0,0,0,0,0,0
0,0,0,0,0,0,0,0,0
188544,218,0,52,51,1,1,1,0
77730,101,1,4,2,2,0,0,0
222254,92,1,4,1,3,2,0,0
193740,92,1,3,1,2,5,0,0
0,0,0,0,0,0,0,0,0
0,0,0,0,0,0,0,0,0
0,0,0,0,0,0,0,0,0
0,0,0,0,0,0,0,0,0
19209,226,3,0,0,0,4,1,0
0,0,0,0,0,0,0,0,0
0,0,0,0,0,0,0,0,0
0,0,0,0,0,0,0,0,0
0,0,0,0,0,0,0,0,0
0,0,0,0,0,0,0,0,0
5081,74,2,6,6,0,0,0,0
0,0,0,0,0,0,0,0,0
0,0,0,0,0,0,0,0,0
0,0,0,0,0,0,0,0,0
0,0,0,0,0,0,0,0,0
0,0,0,0,0,0,0,0,0
0,0,0,0,0,0,0,0,0
0,0,0,0,0,0,0,0,0
0,0,0,0,0,0,0,0,0
0,0,0,0,0,0,0,0,0
0,0,0,0,0,0,0,0,0
0,0,0,0,0,0,0,0,0
0,0,0,0,0,0,0,0,0
0,0,0,0,0,0,0,0,0
106354,1467,8,386,386,0,6,1,0
0,0,0,0,0,0,0,0,0
0,0,0,0,0,0,0,0,0
0,0,0,0,0,0,0,0,0
0,0,0,0,0,0,0,0,0
16335,89,0,15,1,14,0,1,0
0,0,0,0,0,0,0,0,0
0,0,0,0,0,0,0,0,0
0,0,0,0,0,0,0,0,0
0,0,0,0,0,0,0,0,0
0,0,0,0,0,0,0,0,0
82623,238,3,20,17,3,0,0,0
0,0,0,0,0,0,0,0,0
0,0,0,0,0,0,0,0,0
55885,753,2,137,131,6,0,1,0
261445,646,0,0,0,0,2,1,0
675627,556,0,4,4,0,2,1,1
0,0,0,0,0,0,0,0,0
136709,814,0,151,149,2,14,1,0
225493,1573,4,38,31,7,0,1,0
52495,361,6,70,56,14,3,1,0
0,0,0,0,0,0,0,0,0
0,0,0,0,0,0,0,0,0
192576,378,3,25,7,18,15,1,0
0,0,0,0,0,0,0,0,0
140558,411,8,27,24,3,35,1,0
0,0,0,0,0,0,0,0,0
0,0,0,0,0,0,0,0,0
104307,85,0,13,13,0,6,0,0
94325,84,0,15,15,0,6,0,0
103783,86,0,13,13,0,6,0,0
0,0,0,0,0,0,0,0,0
231848,729,3,3,3,0,26,1,0
89339,546,9,46,45,1,2,1,0
13468,113,1,0,0,0,0,0,0
0,0,0,0,0,0,0,0,0
0,0,0,0,0,0,0,0,0
0,0,0,0,0,0,0,0,0
0,0,0,0,0,0,0,0,0
0,0,0,0,0,0,0,0,0
0,0,0,0,0,0,0,0,0
0,0,0,0,0,0,0,0,0
0,0,0,0,0,0,0,0,0
0,0,0,0,0,0,0,0,0
0,0,0,0,0,0,0,0,0
0,0,0,0,0,0,0,0,0
0,0,0,0,0,0,0,0,0
0,0,0,0,0,0,0,0,0
0,0,0,0,0,0,0,0,0
0,0,0,0,0,0,0,0,0
36414,50,2,0,0,0,2,0,0
12216,51,3,0,0,0,2,0,0
0,0,0,0,0,0,0,0,0
36414,50,2,0,0,0,2,0,0
0,0,0,0,0,0,0,0,0
0,0,0,0,0,0,0,0,0
0,0,0,0,0,0,0,0,0
0,0,0,0,0,0,0,0,0
0,0,0,0,0,0,0,0,0
0,0,0,0,0,0,0,0,0
0,0,0,0,0,0,0,0,0
0,0,0,0,0,0,0,0,0
0,0,0,0,0,0,0,0,0
0,0,0,0,0,0,0,0,0
0,0,0,0,0,0,0,0,0
0,0,0,0,0,0,0,0,0
0,0,0,0,0,0,0,0,0
0,0,0,0,0,0,0,0,0
0,0,0,0,0,0,0,0,0
0,0,0,0,0,0,0,0,0
0,0,0,0,0,0,0,0,0
0,0,0,0,0,0,0,0,0
0,0,0,0,0,0,0,0,0
0,0,0,0,0,0,0,0,0
0,0,0,0,0,0,0,0,0
0,0,0,0,0,0,0,0,0
0,0,0,0,0,0,0,0,0
0,0,0,0,0,0,0,0,0
0,0,0,0,0,0,0,0,0
0,0,0,0,0,0,0,0,0
0,0,0,0,0,0,0,0,0
0,0,0,0,0,0,0,0,0
0,0,0,0,0,0,0,0,0
0,0,0,0,0,0,0,0,0
0,0,0,0,0,0,0,0,0
0,0,0,0,0,0,0,0,0
0,0,0,0,0,0,0,0,0
0,0,0,0,0,0,0,0,0
0,0,0,0,0,0,0,0,0
0,0,0,0,0,0,0,0,0
0,0,0,0,0,0,0,0,0
0,0,0,0,0,0,0,0,0
0,0,0,0,0,0,0,0,0
0,0,0,0,0,0,0,0,0
0,0,0,0,0,0,0,0,0
0,0,0,0,0,0,0,0,0
0,0,0,0,0,0,0,0,0
0,0,0,0,0,0,0,0,0
0,0,0,0,0,0,0,0,0
0,0,0,0,0,0,0,0,0
0,0,0,0,0,0,0,0,0
0,0,0,0,0,0,0,0,0
0,0,0,0,0,0,0,0,0
0,0,0,0,0,0,0,0,0
0,0,0,0,0,0,0,0,0
0,0,0,0,0,0,0,0,0
0,0,0,0,0,0,0,0,0
0,0,0,0,0,0,0,0,0
0,0,0,0,0,0,0,0,0
0,0,0,0,0,0,0,0,0
0,0,0,0,0,0,0,0,0
0,0,0,0,0,0,0,0,0
0,0,0,0,0,0,0,0,0
0,0,0,0,0,0,0,0,0
0,0,0,0,0,0,0,0,0
0,0,0,0,0,0,0,0,0
0,0,0,0,0,0,0,0,0
0,0,0,0,0,0,0,0,0
0,0,0,0,0,0,0,0,0
135993,42,4,1,1,0,2,0,0
0,0,0,0,0,0,0,0,0
0,0,0,0,0,0,0,0,0
0,0,0,0,0,0,0,0,0
0,0,0,0,0,0,0,0,0
0,0,0,0,0,0,0,0,0
0,0,0,0,0,0,0,0,0
28052,97,0,2,0,2,2,0,0
0,0,0,0,0,0,0,0,0
112082,1446,2,14,1,13,0,0,0
0,0,0,0,0,0,0,0,0
0,0,0,0,0,0,0,0,0
0,0,0,0,0,0,0,0,0
0,0,0,0,0,0,0,0,0
77790,101,1,4,2,2,0,0,0
77768,101,1,4,2,2,0,0,0
0,0,0,0,0,0,0,0,0
0,0,0,0,0,0,0,0,0
0,0,0,0,0,0,0,0,0
0,0,0,0,0,0,0,0,0
0,0,0,0,0,0,0,0,0
0,0,0,0,0,0,0,0,0
0,0,0,0,0,0,0,0,0
0,0,0,0,0,0,0,0,0
0,0,0,0,0,0,0,0,0
0,0,0,0,0,0,0,0,0
0,0,0,0,0,0,0,0,0
0,0,0,0,0,0,0,0,0
508520,48,2,2,2,0,2,0,0
0,0,0,0,0,0,0,0,0
0,0,0,0,0,0,0,0,0
0,0,0,0,0,0,0,0,0
0,0,0,0,0,0,0,0,0
0,0,0,0,0,0,0,0,0
0,0,0,0,0,0,0,0,0
0,0,0,0,0,0,0,0,0
0,0,0,0,0,0,0,0,0
0,0,0,0,0,0,0,0,0
0,0,0,0,0,0,0,0,0
0,0,0,0,0,0,0,0,0
0,0,0,0,0,0,0,0,0
0,0,0,0,0,0,0,0,0
0,0,0,0,0,0,0,0,0
0,0,0,0,0,0,0,0,0
0,0,0,0,0,0,0,0,0
0,0,0,0,0,0,0,0,0
0,0,0,0,0,0,0,0,0
0,0,0,0,0,0,0,0,0
0,0,0,0,0,0,0,0,0
0,0,0,0,0,0,0,0,0
0,0,0,0,0,0,0,0,0
0,0,0,0,0,0,0,0,0
0,0,0,0,0,0,0,0,0
0,0,0,0,0,0,0,0,0
0,0,0,0,0,0,0,0,0
0,0,0,0,0,0,0,0,0
0,0,0,0,0,0,0,0,0
0,0,0,0,0,0,0,0,0
276611,1136,15,81,76,5,3,1,0
0,0,0,0,0,0,0,0,0
0,0,0,0,0,0,0,0,0
0,0,0,0,0,0,0,0,0
0,0,0,0,0,0,0,0,0
304421,304,6,11,6,5,0,1,0
0,0,0,0,0,0,0,0,0
0,0,0,0,0,0,0,0,0
1711658,53,1,5,4,1,2,1,0
0,0,0,0,0,0,0,0,0
46670,203,2,1,1,0,1,0,0
49332,235,2,1,0,1,3,0,0
7740,58,4,7,1,6,0,0,0
0,0,0,0,0,0,0,0,0
3644,47,1,2,2,0,0,0,0
0,0,0,0,0,0,0,0,0
9643,28,1,2,2,0,0,0,0
71646,48,4,0,0,0,1,0,0
0,0,0,0,0,0,0,0,0
171053,503,4,2,1,1,7,1,0
0,0,0,0,0,0,0,0,0
28319,377,1,17,17,0,0,1,0
0,0,0,0,0,0,0,0,0
0,0,0,0,0,0,0,0,0
55642,73,1,8,2,6,0,0,0
0,0,0,0,0,0,0,0,0
0,0,0,0,0,0,0,0,0
0,0,0,0,0,0,0,0,0
22083,33,0,1,1,0,0,1,0
0,0,0,0,0,0,0,0,0
55654,73,1,8,2,6,0,0,0
123812,1499,11,278,267,11,18,1,0
78265,260,1,10,10,0,0,0,0
0,0,0,0,0,0,0,0,0
0,0,0,0,0,0,0,0,0
0,0,0,0,0,0,0,0,0
0,0,0,0,0,0,0,0,0
0,0,0,0,0,0,0,0,0
147842,917,14,41,36,5,0,1,0
0,0,0,0,0,0,0,0,0
0,0,0,0,0,0,0,0,0
0,0,0,0,0,0,0,0,0
0,0,0,0,0,0,0,0,0
0,0,0,0,0,0,0,0,0
186644,208,0,52,51,1,0,1,0
186644,208,0,52,51,1,0,1,0
0,0,0,0,0,0,0,0,0
0,0,0,0,0,0,0,0,0
186644,208,0,52,51,1,0,1,0
0,0,0,0,0,0,0,0,0
186644,208,0,52,51,1,0,1,0
186644,208,0,52,51,1,0,1,0
0,0,0,0,0,0,0,0,0
0,0,0,0,0,0,0,0,0
0,0,0,0,0,0,0,0,0
0,0,0,0,0,0,0,0,0
0,0,0,0,0,0,0,0,0
0,0,0,0,0,0,0,0,0
0,0,0,0,0,0,0,0,0
0,0,0,0,0,0,0,0,0
0,0,0,0,0,0,0,0,0
0,0,0,0,0,0,0,0,0
0,0,0,0,0,0,0,0,0
0,0,0,0,0,0,0,0,0
0,0,0,0,0,0,0,0,0
0,0,0,0,0,0,0,0,0
0,0,0,0,0,0,0,0,0
0,0,0,0,0,0,0,0,0
0,0,0,0,0,0,0,0,0
0,0,0,0,0,0,0,0,0
0,0,0,0,0,0,0,0,0
0,0,0,0,0,0,0,0,0
0,0,0,0,0,0,0,0,0
0,0,0,0,0,0,0,0,0
0,0,0,0,0,0,0,0,0
0,0,0,0,0,0,0,0,0
0,0,0,0,0,0,0,0,0
0,0,0,0,0,0,0,0,0
0,0,0,0,0,0,0,0,0
0,0,0,0,0,0,0,0,0
0,0,0,0,0,0,0,0,0
0,0,0,0,0,0,0,0,0
0,0,0,0,0,0,0,0,0
0,0,0,0,0,0,0,0,0
0,0,0,0,0,0,0,0,0
0,0,0,0,0,0,0,0,0
0,0,0,0,0,0,0,0,0
0,0,0,0,0,0,0,0,0
0,0,0,0,0,0,0,0,0
0,0,0,0,0,0,0,0,0
0,0,0,0,0,0,0,0,0
0,0,0,0,0,0,0,0,0
0,0,0,0,0,0,0,0,0
0,0,0,0,0,0,0,0,0
127634,68,3,1,0,1,0,1,0
127634,68,3,1,0,1,0,1,0
0,0,0,0,0,0,0,0,0
0,0,0,0,0,0,0,0,0
0,0,0,0,0,0,0,0,0
0,0,0,0,0,0,0,0,0
0,0,0,0,0,0,0,0,0
0,0,0,0,0,0,0,0,0
0,0,0,0,0,0,0,0,0
24542,67,2,1,1,0,2,0,0
0,0,0,0,0,0,0,0,0
0,0,0,0,0,0,0,0,0
0,0,0,0,0,0,0,0,0
0,0,0,0,0,0,0,0,0
0,0,0,0,0,0,0,0,0
0,0,0,0,0,0,0,0,0
24542,67,2,1,1,0,2,0,0
24542,67,2,1,1,0,2,0,0
415463,62,4,3,3,0,2,1,0
415463,62,4,3,3,0,2,1,0
0,0,0,0,0,0,0,0,0
0,0,0,0,0,0,0,0,0
0,0,0,0,0,0,0,0,0
0,0,0,0,0,0,0,0,0
233110,64,4,3,3,0,2,1,0
0,0,0,0,0,0,0,0,0
0,0,0,0,0,0,0,0,0
0,0,0,0,0,0,0,0,0
0,0,0,0,0,0,0,0,0
0,0,0,0,0,0,0,0,0
0,0,0,0,0,0,0,0,0
0,0,0,0,0,0,0,0,0
0,0,0,0,0,0,0,0,0
0,0,0,0,0,0,0,0,0
0,0,0,0,0,0,0,0,0
0,0,0,0,0,0,0,0,0
0,0,0,0,0,0,0,0,0
0,0,0,0,0,0,0,0,0
0,0,0,0,0,0,0,0,0
0,0,0,0,0,0,0,0,0
0,0,0,0,0,0,0,0,0
0,0,0,0,0,0,0,0,0
0,0,0,0,0,0,0,0,0
0,0,0,0,0,0,0,0,0
0,0,0,0,0,0,0,0,0
0,0,0,0,0,0,0,0,0
0,0,0,0,0,0,0,0,0
415463,62,4,3,3,0,2,1,0
415463,62,4,3,3,0,2,1,0
0,0,0,0,0,0,0,0,0
0,0,0,0,0,0,0,0,0
0,0,0,0,0,0,0,0,0
77798,101,1,4,2,2,0,0,0
193740,92,1,3,1,2,5,0,0
0,0,0,0,0,0,0,0,0
0,0,0,0,0,0,0,0,0
0,0,0,0,0,0,0,0,0
719557,186,2,4,0,4,1,0,0
0,0,0,0,0,0,0,0,0
0,0,0,0,0,0,0,0,0
53729,93,3,8,6,2,0,0,0
0,0,0,0,0,0,0,0,0
0,0,0,0,0,0,0,0,0
0,0,0,0,0,0,0,0,0
0,0,0,0,0,0,0,0,0
0,0,0,0,0,0,0,0,0
0,0,0,0,0,0,0,0,0
0,0,0,0,0,0,0,0,0
0,0,0,0,0,0,0,0,0
0,0,0,0,0,0,0,0,0
0,0,0,0,0,0,0,0,0
0,0,0,0,0,0,0,0,0
0,0,0,0,0,0,0,0,0
0,0,0,0,0,0,0,0,0
0,0,0,0,0,0,0,0,0
0,0,0,0,0,0,0,0,0
0,0,0,0,0,0,0,0,0
0,0,0,0,0,0,0,0,0
0,0,0,0,0,0,0,0,0
0,0,0,0,0,0,0,0,0
0,0,0,0,0,0,0,0,0
45961,325,7,36,25,11,2,1,0
305230,961,8,98,97,1,13,1,0
0,0,0,0,0,0,0,0,0
0,0,0,0,0,0,0,0,0
0,0,0,0,0,0,0,0,0
0,0,0,0,0,0,0,0,0
0,0,0,0,0,0,0,0,0
675543,556,0,4,4,0,2,1,1
0,0,0,0,0,0,0,0,0
0,0,0,0,0,0,0,0,0
0,0,0,0,0,0,0,0,0
136705,814,0,151,149,2,14,1,0
23724,113,3,8,8,0,0,0,0
23724,113,3,8,8,0,0,0,0
35253,144,0,1,0,1,0,0,0
47025,203,2,1,1,0,1,0,0
0,0,0,0,0,0,0,0,0
0,0,0,0,0,0,0,0,0
0,0,0,0,0,0,0,0,0
0,0,0,0,0,0,0,0,0
0,0,0,0,0,0,0,0,0
0,0,0,0,0,0,0,0,0
1100039,409,9,45,36,9,1,1,0
0,0,0,0,0,0,0,0,0
0,0,0,0,0,0,0,0,0
0,0,0,0,0,0,0,0,0
0,0,0,0,0,0,0,0,0
0,0,0,0,0,0,0,0,0
0,0,0,0,0,0,0,0,0
0,0,0,0,0,0,0,0,0
319017,2153,11,169,125,44,1,1,0
192140,378,3,25,7,18,14,1,0
0,0,0,0,0,0,0,0,0
0,0,0,0,0,0,0,0,0
0,0,0,0,0,0,0,0,0
0,0,0,0,0,0,0,0,0
0,0,0,0,0,0,0,0,0
0,0,0,0,0,0,0,0,0
0,0,0,0,0,0,0,0,0
0,0,0,0,0,0,0,0,0
0,0,0,0,0,0,0,0,0
0,0,0,0,0,0,0,0,0
47284,204,2,2,2,0,1,0,0
422670,63,6,1,1,0,2,0,0
422670,63,6,1,1,0,2,0,0
422670,63,6,1,1,0,2,0,0
422670,63,6,1,1,0,2,0,0
422670,63,6,1,1,0,2,0,0
422670,63,6,1,1,0,2,0,0
422670,63,6,1,1,0,2,0,0
0,0,0,0,0,0,0,0,0
0,0,0,0,0,0,0,0,0
0,0,0,0,0,0,0,0,0
0,0,0,0,0,0,0,0,0
0,0,0,0,0,0,0,0,0
0,0,0,0,0,0,0,0,0
73020,160,2,30,7,23,0,1,0
73020,160,2,30,7,23,0,1,0
73020,160,2,30,7,23,0,1,0
23304,210,1,51,50,1,0,1,0
23304,210,1,51,50,1,0,1,0
0,0,0,0,0,0,0,0,0
0,0,0,0,0,0,0,0,0
0,0,0,0,0,0,0,0,0
0,0,0,0,0,0,0,0,0
0,0,0,0,0,0,0,0,0
0,0,0,0,0,0,0,0,0
4599,53,0,1,1,0,0,0,0
0,0,0,0,0,0,0,0,0
0,0,0,0,0,0,0,0,0
4599,53,0,1,1,0,0,0,0
4599,53,0,1,1,0,0,0,0
330677,84,4,1,1,0,5,1,0
330677,84,4,1,1,0,5,1,0
330677,84,4,1,1,0,5,1,0
0,0,0,0,0,0,0,0,0
77746,101,1,4,2,2,0,0,0
0,0,0,0,0,0,0,0,0
709,37,0,6,6,0,0,0,0
709,37,0,6,6,0,0,0,0
0,0,0,0,0,0,0,0,0
67302,58,3,1,1,0,4,1,0
0,0,0,0,0,0,0,0,0
15334,142,0,56,52,4,0,0,0
7056,81,1,8,8,0,0,0,0
0,0,0,0,0,0,0,0,0
15334,142,0,56,52,4,0,0,0
0,0,0,0,0,0,0,0,0
0,0,0,0,0,0,0,0,0
55200,401,7,23,17,6,6,1,0
239479,402,2,25,18,7,17,0,0
1612,21,4,1,0,1,0,0,0
34634,224,2,16,8,8,9,1,0
0,0,0,0,0,0,0,0,0
210463,997,4,186,42,144,21,1,0
0,0,0,0,0,0,0,0,0
0,0,0,0,0,0,0,0,0
16251,57,0,2,1,1,0,1,0
0,0,0,0,0,0,0,0,0
0,0,0,0,0,0,0,0,0
14652,123,8,5,2,3,2,0,0
0,0,0,0,0,0,0,0,0
0,0,0,0,0,0,0,0,0
0,0,0,0,0,0,0,0,0
0,0,0,0,0,0,0,0,0
0,0,0,0,0,0,0,0,0
36407,50,2,0,0,0,2,0,0
36407,50,2,0,0,0,2,0,0
36407,50,2,0,0,0,2,0,0
36407,50,2,0,0,0,2,0,0
23304,210,1,51,50,1,0,1,0
23304,210,1,51,50,1,0,1,0
36407,50,2,0,0,0,2,0,0
23304,210,1,51,50,1,0,1,0
23304,210,1,51,50,1,0,1,0
23304,210,1,51,50,1,0,1,0
109931,49,3,0,0,0,0,0,0
109931,49,3,0,0,0,0,0,0
109931,49,3,0,0,0,0,0,0
109931,49,3,0,0,0,0,0,0
109931,49,3,0,0,0,0,0,0
0,0,0,0,0,0,0,0,0
0,0,0,0,0,0,0,0,0
0,0,0,0,0,0,0,0,0
0,0,0,0,0,0,0,0,0
0,0,0,0,0,0,0,0,0
0,0,0,0,0,0,0,0,0
0,0,0,0,0,0,0,0,0
0,0,0,0,0,0,0,0,0
0,0,0,0,0,0,0,0,0
0,0,0,0,0,0,0,0,0
0,0,0,0,0,0,0,0,0
12168,122,0,5,0,5,0,0,0
12168,122,0,5,0,5,0,0,0
0,0,0,0,0,0,0,0,0
0,0,0,0,0,0,0,0,0
0,0,0,0,0,0,0,0,0
0,0,0,0,0,0,0,0,0
0,0,0,0,0,0,0,0,0
77710,101,1,4,2,2,0,0,0
0,0,0,0,0,0,0,0,0
0,0,0,0,0,0,0,0,0
0,0,0,0,0,0,0,0,0
13173,142,0,56,52,4,0,0,0
0,0,0,0,0,0,0,0,0
209104,1489,13,201,198,3,1,0,0
0,0,0,0,0,0,0,0,0
0,0,0,0,0,0,0,0,0
3736,24,0,1,0,1,0,1,0
1738,25,0,0,0,0,0,0,0
13063,142,0,56,51,5,0,0,0
54633,230,9,44,43,1,2,0,0
0,0,0,0,0,0,0,0,0
12768,217,0,72,72,0,0,1,0
4118,52,0,1,0,1,1,0,0
0,0,0,0,0,0,0,0,0
0,0,0,0,0,0,0,0,0
0,0,0,0,0,0,0,0,0
3405,46,4,3,2,1,0,1,0
0,0,0,0,0,0,0,0,0
0,0,0,0,0,0,0,0,0
0,0,0,0,0,0,0,0,0
0,0,0,0,0,0,0,0,0
0,0,0,0,0,0,0,0,0
80707,135,6,8,7,1,9,1,0
0,0,0,0,0,0,0,0,0
0,0,0,0,0,0,0,0,0
0,0,0,0,0,0,0,0,0
0,0,0,0,0,0,0,0,0
0,0,0,0,0,0,0,0,0
0,0,0,0,0,0,0,0,0
0,0,0,0,0,0,0,0,0
0,0,0,0,0,0,0,0,0
0,0,0,0,0,0,0,0,0
0,0,0,0,0,0,0,0,0
0,0,0,0,0,0,0,0,0
0,0,0,0,0,0,0,0,0
0,0,0,0,0,0,0,0,0
0,0,0,0,0,0,0,0,0
0,0,0,0,0,0,0,0,0
0,0,0,0,0,0,0,0,0
0,0,0,0,0,0,0,0,0
0,0,0,0,0,0,0,0,0
0,0,0,0,0,0,0,0,0
0,0,0,0,0,0,0,0,0
0,0,0,0,0,0,0,0,0
0,0,0,0,0,0,0,0,0
12003,47,3,5,5,0,1,0,0
12003,47,3,5,5,0,1,0,0
12003,47,3,5,5,0,1,0,0
0,0,0,0,0,0,0,0,0
415542,62,4,3,3,0,2,1,0
415542,62,4,3,3,0,2,1,0
0,0,0,0,0,0,0,0,0
0,0,0,0,0,0,0,0,0
415542,62,4,3,3,0,2,1,0
415542,62,4,3,3,0,2,1,0
415542,62,4,3,3,0,2,1,0
415542,62,4,3,3,0,2,1,0
415542,62,4,3,3,0,2,1,0
0,0,0,0,0,0,0,0,0
0,0,0,0,0,0,0,0,0
0,0,0,0,0,0,0,0,0
0,0,0,0,0,0,0,0,0
0,0,0,0,0,0,0,0,0
0,0,0,0,0,0,0,0,0
0,0,0,0,0,0,0,0,0
0,0,0,0,0,0,0,0,0
0,0,0,0,0,0,0,0,0
0,0,0,0,0,0,0,0,0
0,0,0,0,0,0,0,0,0
0,0,0,0,0,0,0,0,0
25093,67,2,1,1,0,2,0,0
0,0,0,0,0,0,0,0,0
25093,67,2,1,1,0,2,0,0
0,0,0,0,0,0,0,0,0
25093,67,2,1,1,0,2,0,0
0,0,0,0,0,0,0,0,0
0,0,0,0,0,0,0,0,0
0,0,0,0,0,0,0,0,0
0,0,0,0,0,0,0,0,0
0,0,0,0,0,0,0,0,0
0,0,0,0,0,0,0,0,0
0,0,0,0,0,0,0,0,0
0,0,0,0,0,0,0,0,0
46972,444,3,105,34,71,8,1,0
77710,101,1,4,2,2,0,0,0
0,0,0,0,0,0,0,0,0
24886,82,1,7,3,4,3,0,0
222254,92,1,4,1,3,2,0,0
193728,92,1,3,1,2,5,0,0
57195,147,2,4,3,1,0,0,0
0,0,0,0,0,0,0,0,0
0,0,0,0,0,0,0,0,0
0,0,0,0,0,0,0,0,0
0,0,0,0,0,0,0,0,0
12435,142,0,56,52,4,0,0,0
0,0,0,0,0,0,0,0,0
0,0,0,0,0,0,0,0,0
0,0,0,0,0,0,0,0,0
0,0,0,0,0,0,0,0,0
0,0,0,0,0,0,0,0,0
0,0,0,0,0,0,0,0,0
0,0,0,0,0,0,0,0,0
0,0,0,0,0,0,0,0,0
0,0,0,0,0,0,0,0,0
0,0,0,0,0,0,0,0,0
0,0,0,0,0,0,0,0,0
0,0,0,0,0,0,0,0,0
0,0,0,0,0,0,0,0,0
0,0,0,0,0,0,0,0,0
0,0,0,0,0,0,0,0,0
0,0,0,0,0,0,0,0,0
0,0,0,0,0,0,0,0,0
0,0,0,0,0,0,0,0,0
0,0,0,0,0,0,0,0,0
0,0,0,0,0,0,0,0,0
0,0,0,0,0,0,0,0,0
0,0,0,0,0,0,0,0,0
0,0,0,0,0,0,0,0,0
0,0,0,0,0,0,0,0,0
136705,814,0,151,10,141,14,1,0
0,0,0,0,0,0,0,0,0
0,0,0,0,0,0,0,0,0
3802,48,0,3,0,3,1,0,0
28304,44,0,4,3,1,0,0,0
0,0,0,0,0,0,0,0,0
63744,657,9,49,35,14,6,1,0
0,0,0,0,0,0,0,0,0
0,0,0,0,0,0,0,0,0
0,0,0,0,0,0,0,0,0
136707,814,0,151,149,2,14,1,0
98910,438,10,33,33,0,0,1,0
0,0,0,0,0,0,0,0,0
0,0,0,0,0,0,0,0,0
0,0,0,0,0,0,0,0,0
0,0,0,0,0,0,0,0,0
0,0,0,0,0,0,0,0,0
0,0,0,0,0,0,0,0,0
0,0,0,0,0,0,0,0,0
0,0,0,0,0,0,0,0,0
0,0,0,0,0,0,0,0,0
0,0,0,0,0,0,0,0,0
0,0,0,0,0,0,0,0,0
169314,2241,8,106,78,28,24,1,0
0,0,0,0,0,0,0,0,0
0,0,0,0,0,0,0,0,0
0,0,0,0,0,0,0,0,0
0,0,0,0,0,0,0,0,0
0,0,0,0,0,0,0,0,0
21792,33,0,1,1,0,0,1,0
28052,97,0,2,0,2,2,0,0
580953,84,3,1,1,0,3,1,0
580942,84,3,1,1,0,3,1,0
580949,84,3,1,1,0,3,1,0
580942,84,3,1,1,0,3,1,0
580942,84,3,1,1,0,3,1,0
131809,66,4,9,9,0,2,1,0
135990,42,4,1,1,0,2,0,0
0,0,0,0,0,0,0,0,0
0,0,0,0,0,0,0,0,0
36407,50,2,0,0,0,2,0,0
36407,50,2,0,0,0,2,0,0
0,0,0,0,0,0,0,0,0
0,0,0,0,0,0,0,0,0
0,0,0,0,0,0,0,0,0
2276652,547,0,1,0,1,4,0,0
2276652,547,0,1,0,1,4,0,0
2276652,547,0,1,0,1,4,0,0
2276652,547,0,1,0,1,4,0,0
2276652,547,0,1,0,1,4,0,0
0,0,0,0,0,0,0,0,0
0,0,0,0,0,0,0,0,0
0,0,0,0,0,0,0,0,0
0,0,0,0,0,0,0,0,0
25481,48,3,1,1,0,2,0,0
25481,48,3,1,1,0,2,0,0
0,0,0,0,0,0,0,0,0
0,0,0,0,0,0,0,0,0
0,0,0,0,0,0,0,0,0
0,0,0,0,0,0,0,0,0
295545,744,0,59,10,49,0,1,0
295546,744,0,59,10,49,0,1,0
0,0,0,0,0,0,0,0,0
0,0,0,0,0,0,0,0,0
295546,744,0,59,10,49,0,1,0
295546,744,0,59,10,49,0,1,0
295546,744,0,59,10,49,0,1,0
295546,744,0,59,10,49,0,1,0
0,0,0,0,0,0,0,0,0
295546,744,0,59,10,49,0,1,0
0,0,0,0,0,0,0,0,0
0,0,0,0,0,0,0,0,0
0,0,0,0,0,0,0,0,0
0,0,0,0,0,0,0,0,0
0,0,0,0,0,0,0,0,0
0,0,0,0,0,0,0,0,0
0,0,0,0,0,0,0,0,0
0,0,0,0,0,0,0,0,0
0,0,0,0,0,0,0,0,0
0,0,0,0,0,0,0,0,0
0,0,0,0,0,0,0,0,0
0,0,0,0,0,0,0,0,0
0,0,0,0,0,0,0,0,0
0,0,0,0,0,0,0,0,0
0,0,0,0,0,0,0,0,0
0,0,0,0,0,0,0,0,0
0,0,0,0,0,0,0,0,0
0,0,0,0,0,0,0,0,0
0,0,0,0,0,0,0,0,0
0,0,0,0,0,0,0,0,0
0,0,0,0,0,0,0,0,0
0,0,0,0,0,0,0,0,0
0,0,0,0,0,0,0,0,0
0,0,0,0,0,0,0,0,0
0,0,0,0,0,0,0,0,0
0,0,0,0,0,0,0,0,0
0,0,0,0,0,0,0,0,0
0,0,0,0,0,0,0,0,0
0,0,0,0,0,0,0,0,0
0,0,0,0,0,0,0,0,0
0,0,0,0,0,0,0,0,0
0,0,0,0,0,0,0,0,0
0,0,0,0,0,0,0,0,0
0,0,0,0,0,0,0,0,0
0,0,0,0,0,0,0,0,0
0,0,0,0,0,0,0,0,0
0,0,0,0,0,0,0,0,0
77734,101,1,4,2,2,0,0,0
77730,101,1,4,2,2,0,0,0
77758,101,1,4,2,2,0,0,0
0,0,0,0,0,0,0,0,0
71035,250,8,21,21,0,2,0,0
0,0,0,0,0,0,0,0,0
0,0,0,0,0,0,0,0,0
0,0,0,0,0,0,0,0,0
0,0,0,0,0,0,0,0,0
0,0,0,0,0,0,0,0,0
0,0,0,0,0,0,0,0,0
0,0,0,0,0,0,0,0,0
0,0,0,0,0,0,0,0,0
0,0,0,0,0,0,0,0,0
0,0,0,0,0,0,0,0,0
0,0,0,0,0,0,0,0,0
0,0,0,0,0,0,0,0,0
0,0,0,0,0,0,0,0,0
0,0,0,0,0,0,0,0,0
0,0,0,0,0,0,0,0,0
0,0,0,0,0,0,0,0,0
0,0,0,0,0,0,0,0,0
0,0,0,0,0,0,0,0,0
55178,609,5,27,16,11,0,1,0
0,0,0,0,0,0,0,0,0
0,0,0,0,0,0,0,0,0
0,0,0,0,0,0,0,0,0
0,0,0,0,0,0,0,0,0
0,0,0,0,0,0,0,0,0
0,0,0,0,0,0,0,0,0
15040,120,4,0,0,0,0,1,0
0,0,0,0,0,0,0,0,0
0,0,0,0,0,0,0,0,0
243972,28,1,2,2,0,0,1,0
0,0,0,0,0,0,0,0,0
0,0,0,0,0,0,0,0,0
0,0,0,0,0,0,0,0,0
0,0,0,0,0,0,0,0,0
7636,85,4,9,4,5,1,0,0
6330,64,2,6,4,2,0,1,0
0,0,0,0,0,0,0,0,0
0,0,0,0,0,0,0,0,0
0,0,0,0,0,0,0,0,0
6206,84,3,8,8,0,3,0,0
0,0,0,0,0,0,0,0,0
0,0,0,0,0,0,0,0,0
0,0,0,0,0,0,0,0,0
0,0,0,0,0,0,0,0,0
394825,85,3,6,5,1,0,1,0
0,0,0,0,0,0,0,0,0
0,0,0,0,0,0,0,0,0
0,0,0,0,0,0,0,0,0
0,0,0,0,0,0,0,0,0
0,0,0,0,0,0,0,0,0
0,0,0,0,0,0,0,0,0
0,0,0,0,0,0,0,0,0
0,0,0,0,0,0,0,0,0
0,0,0,0,0,0,0,0,0
0,0,0,0,0,0,0,0,0
0,0,0,0,0,0,0,0,0
0,0,0,0,0,0,0,0,0
0,0,0,0,0,0,0,0,0
0,0,0,0,0,0,0,0,0
0,0,0,0,0,0,0,0,0
0,0,0,0,0,0,0,0,0
0,0,0,0,0,0,0,0,0
0,0,0,0,0,0,0,0,0
0,0,0,0,0,0,0,0,0
0,0,0,0,0,0,0,0,0
32256,37,1,0,0,0,1,0,0
32256,37,1,0,0,0,1,0,0
32256,37,1,0,0,0,1,0,0
32256,37,1,0,0,0,1,0,0
0,0,0,0,0,0,0,0,0
0,0,0,0,0,0,0,0,0
32256,37,1,0,0,0,1,0,0
0,0,0,0,0,0,0,0,0
0,0,0,0,0,0,0,0,0
0,0,0,0,0,0,0,0,0
232867,64,4,3,3,0,2,1,0
0,0,0,0,0,0,0,0,0
127634,68,3,1,0,1,0,1,0
127634,68,3,1,0,1,0,1,0
127634,68,3,1,0,1,0,1,0
127634,68,3,1,0,1,0,1,0
81336,45,1,0,0,0,0,0,0
81336,45,1,0,0,0,0,0,0
81336,45,1,0,0,0,0,0,0
81336,45,1,0,0,0,0,0,0
81336,45,1,0,0,0,0,0,0
73017,160,2,30,7,23,0,1,0
73017,160,2,30,7,23,0,1,0
73017,160,2,30,7,23,0,1,0
0,0,0,0,0,0,0,0,0
0,0,0,0,0,0,0,0,0
0,0,0,0,0,0,0,0,0
11587,57,3,0,0,0,3,1,0
0,0,0,0,0,0,0,0,0
11587,57,3,0,0,0,3,1,0
0,0,0,0,0,0,0,0,0
11587,57,3,0,0,0,3,1,0
11587,57,3,0,0,0,3,1,0
11587,57,3,0,0,0,3,1,0
0,0,0,0,0,0,0,0,0
0,0,0,0,0,0,0,0,0
0,0,0,0,0,0,0,0,0
0,0,0,0,0,0,0,0,0
0,0,0,0,0,0,0,0,0
110247,173,1,20,0,20,1,0,0
110247,173,1,20,0,20,1,0,0
0,0,0,0,0,0,0,0,0
0,0,0,0,0,0,0,0,0
110247,173,1,20,0,20,1,0,0
105006,65,4,9,9,0,2,1,0
0,0,0,0,0,0,0,0,0
0,0,0,0,0,0,0,0,0
0,0,0,0,0,0,0,0,0
0,0,0,0,0,0,0,0,0
0,0,0,0,0,0,0,0,0
0,0,0,0,0,0,0,0,0
0,0,0,0,0,0,0,0,0
0,0,0,0,0,0,0,0,0
0,0,0,0,0,0,0,0,0
0,0,0,0,0,0,0,0,0
0,0,0,0,0,0,0,0,0
0,0,0,0,0,0,0,0,0
0,0,0,0,0,0,0,0,0
0,0,0,0,0,0,0,0,0
0,0,0,0,0,0,0,0,0
0,0,0,0,0,0,0,0,0
0,0,0,0,0,0,0,0,0
0,0,0,0,0,0,0,0,0
0,0,0,0,0,0,0,0,0
0,0,0,0,0,0,0,0,0
415473,62,4,3,3,0,2,1,0
415473,62,4,3,3,0,2,1,0
0,0,0,0,0,0,0,0,0
0,0,0,0,0,0,0,0,0
0,0,0,0,0,0,0,0,0
0,0,0,0,0,0,0,0,0
415473,62,4,3,3,0,2,1,0
0,0,0,0,0,0,0,0,0
415473,62,4,3,3,0,2,1,0
55825,73,4,0,0,0,0,1,0
55825,73,4,0,0,0,0,1,0
55825,73,4,0,0,0,0,1,0
0,0,0,0,0,0,0,0,0
0,0,0,0,0,0,0,0,0
0,0,0,0,0,0,0,0,0
0,0,0,0,0,0,0,0,0
0,0,0,0,0,0,0,0,0
0,0,0,0,0,0,0,0,0
0,0,0,0,0,0,0,0,0
0,0,0,0,0,0,0,0,0
0,0,0,0,0,0,0,0,0
0,0,0,0,0,0,0,0,0
0,0,0,0,0,0,0,0,0
0,0,0,0,0,0,0,0,0
0,0,0,0,0,0,0,0,0
0,0,0,0,0,0,0,0,0
0,0,0,0,0,0,0,0,0
0,0,0,0,0,0,0,0,0
4125,11,0,0,0,0,0,0,0
0,0,0,0,0,0,0,0,0
0,0,0,0,0,0,0,0,0
0,0,0,0,0,0,0,0,0
0,0,0,0,0,0,0,0,0
0,0,0,0,0,0,0,0,0
4751759,106,4,5,5,0,3,1,0
0,0,0,0,0,0,0,0,0
422649,197,8,2,2,0,0,1,0
0,0,0,0,0,0,0,0,0
0,0,0,0,0,0,0,0,0
0,0,0,0,0,0,0,0,0
0,0,0,0,0,0,0,0,0
0,0,0,0,0,0,0,0,0
0,0,0,0,0,0,0,0,0
0,0,0,0,0,0,0,0,0
0,0,0,0,0,0,0,0,0
0,0,0,0,0,0,0,0,0
0,0,0,0,0,0,0,0,0
0,0,0,0,0,0,0,0,0
0,0,0,0,0,0,0,0,0
8073,140,7,26,6,20,1,1,0
0,0,0,0,0,0,0,0,0
22555,33,0,1,1,0,0,1,0
136707,814,0,151,149,2,14,1,0
2870,31,0,2,1,1,0,0,0
0,0,0,0,0,0,0,0,0
0,0,0,0,0,0,0,0,0
0,0,0,0,0,0,0,0,0
14119,142,0,56,52,4,0,0,0
0,0,0,0,0,0,0,0,0
55965,509,10,68,59,9,0,1,0
0,0,0,0,0,0,0,0,0
0,0,0,0,0,0,0,0,0
0,0,0,0,0,0,0,0,0
0,0,0,0,0,0,0,0,0
0,0,0,0,0,0,0,0,0
0,0,0,0,0,0,0,0,0
0,0,0,0,0,0,0,0,0
8073,140,7,26,7,19,1,1,0
0,0,0,0,0,0,0,0,0
0,0,0,0,0,0,0,0,0
230508,1287,9,107,25,82,7,1,0
10724,28,1,2,2,0,0,0,0
169051,489,4,2,1,1,7,1,0
0,0,0,0,0,0,0,0,0
0,0,0,0,0,0,0,0,0
110247,173,1,20,0,20,1,0,0
0,0,0,0,0,0,0,0,0
0,0,0,0,0,0,0,0,0
0,0,0,0,0,0,0,0,0
0,0,0,0,0,0,0,0,0
0,0,0,0,0,0,0,0,0
0,0,0,0,0,0,0,0,0
0,0,0,0,0,0,0,0,0
0,0,0,0,0,0,0,0,0
164287,475,4,2,1,1,7,0,0
0,0,0,0,0,0,0,0,0
165369,477,4,2,1,1,7,0,0
165369,477,4,2,1,1,7,0,0
165154,476,4,4,3,1,8,0,0
164464,475,4,2,1,1,7,0,0
165689,523,4,2,1,1,7,0,0
0,0,0,0,0,0,0,0,0
0,0,0,0,0,0,0,0,0
165367,477,4,2,1,1,7,0,0
165367,477,4,2,1,1,7,0,0
169816,514,4,4,3,1,9,0,0
166312,477,4,4,3,1,8,0,0
170711,503,4,5,4,1,8,1,0
165632,480,4,6,3,3,8,0,0
164256,473,4,4,3,1,8,0,0
166371,477,4,4,3,1,8,0,0
0,0,0,0,0,0,0,0,0
164586,473,4,4,3,1,8,0,0
166006,478,4,4,3,1,8,0,0
164445,470,4,2,1,1,7,0,0
0,0,0,0,0,0,0,0,0
169199,477,4,2,1,1,7,0,0
165586,476,4,2,1,1,7,0,0
177779,559,4,2,1,1,7,0,0
177779,559,4,2,1,1,7,0,0
166638,475,4,2,1,1,7,0,0
166638,475,4,2,1,1,7,0,0
165556,480,4,2,1,1,7,0,0
202874,686,4,14,7,7,9,0,0
202875,686,4,14,7,7,9,0,0
190797,609,4,15,14,1,7,1,0
190797,609,4,15,14,1,7,1,0
164874,478,4,2,1,1,7,0,0
164874,478,4,2,1,1,7,0,0
165530,480,4,2,1,1,7,0,0
165717,484,4,4,1,3,8,0,0
0,0,0,0,0,0,0,0,0
166893,470,4,9,8,1,6,0,0
166893,470,4,9,8,1,6,0,0
0,0,0,0,0,0,0,0,0
0,0,0,0,0,0,0,0,0
0,0,0,0,0,0,0,0,0
0,0,0,0,0,0,0,0,0
165272,479,4,4,3,1,8,0,0
164786,470,4,2,1,1,7,0,0
168804,484,4,2,1,1,7,0,0
164953,472,4,2,1,1,7,0,0
164469,471,4,2,1,1,7,0,0
177554,565,4,8,5,3,9,1,0
164433,471,4,2,1,1,7,0,0
164459,471,4,2,1,1,7,0,0
165229,479,4,3,2,1,7,0,0
166090,475,4,2,1,1,7,0,0
166090,475,4,2,1,1,7,0,0
164485,471,4,2,1,1,7,0,0
164398,471,4,2,1,1,7,0,0
164306,471,4,2,1,1,7,0,0
166555,479,4,2,1,1,7,0,0
166555,479,4,2,1,1,7,0,0
165745,478,4,4,3,1,8,0,0
165715,478,4,4,3,1,8,0,0
0,0,0,0,0,0,0,0,0
171500,982,4,2,1,1,7,0,0
164751,470,4,2,1,1,7,0,0
165673,483,4,2,1,1,7,1,0
165664,476,4,4,1,3,7,0,0
164456,471,4,2,1,1,7,0,0
163496,470,4,2,1,1,7,0,0
164334,471,4,2,1,1,7,0,0
168396,578,4,2,1,1,7,0,0
163644,473,4,2,1,1,7,0,0
164699,473,4,2,1,1,7,0,0
164699,473,4,2,1,1,7,0,0
165287,474,4,2,1,1,7,0,0
164677,478,4,4,3,1,8,0,0
168371,514,4,6,3,3,9,0,0
165657,478,4,4,3,1,8,0,0
163468,473,4,2,1,1,7,0,0
171488,502,4,2,1,1,7,1,0
164764,471,4,2,1,1,7,0,0
163615,470,4,2,1,1,7,0,0
0,0,0,0,0,0,0,0,0
164524,478,4,4,3,1,8,0,0
164454,471,4,2,1,1,7,0,0
165715,478,4,4,3,1,8,0,0
164446,471,4,2,1,1,7,0,0
164469,471,4,2,1,1,7,0,0
164853,473,4,2,1,1,7,0,0
164853,473,4,2,1,1,7,0,0
164758,470,4,2,1,1,7,0,0
0,0,0,0,0,0,0,0,0
166394,486,4,2,1,1,7,1,0
164326,471,4,2,1,1,7,0,0
163662,470,4,2,1,1,7,0,0
169885,760,4,2,1,1,7,0,0
163458,471,4,2,1,1,7,0,0
165715,478,4,4,3,1,8,0,0
165695,478,4,4,3,1,8,0,0
0,0,0,0,0,0,0,0,0
163248,459,4,3,2,1,7,0,0
169817,726,4,4,3,1,8,1,0
169622,685,4,4,3,1,8,1,0
169287,645,4,4,3,1,8,1,0
168071,643,4,2,1,1,7,1,0
168342,682,4,2,1,1,7,1,0
168209,663,4,2,1,1,7,1,0
168151,656,4,2,1,1,7,1,0
167699,639,4,2,1,1,7,1,0
167733,553,4,2,1,1,7,1,0
168293,672,4,2,1,1,7,1,0
166429,477,4,4,1,3,7,0,0
166429,477,4,4,1,3,7,0,0
174301,566,4,13,12,1,6,1,0
296851,1222,4,17,9,8,11,0,0
296851,1222,4,17,9,8,11,0,0
164729,479,4,2,1,1,7,0,0
167068,488,4,4,3,1,8,0,0
167085,488,4,4,3,1,8,0,0
166831,488,4,4,3,1,8,0,0
165971,482,4,2,1,1,7,0,0
165971,482,4,2,1,1,7,0,0
0,0,0,0,0,0,0,0,0
169723,505,4,2,0,2,7,0,0
170120,505,4,2,0,2,7,0,0
169778,505,4,2,0,2,7,0,0
171223,509,4,2,0,2,7,0,0
171223,509,4,2,0,2,7,0,0
170124,505,4,2,0,2,7,0,0
171191,509,4,2,0,2,7,0,0
171191,509,4,2,0,2,7,0,0
169680,505,4,2,0,2,7,0,0
168609,499,4,5,4,1,8,1,0
165600,480,4,6,3,3,8,0,0
177905,575,4,11,6,5,9,1,0
165841,477,4,4,3,1,8,0,0
167178,485,4,4,3,1,8,0,0
3772,44,0,2,0,2,1,0,0
0,0,0,0,0,0,0,0,0
165326,476,4,6,3,3,8,0,0
166755,478,4,4,3,1,8,0,0
167627,489,4,4,3,1,8,1,0
166633,478,4,4,3,1,8,0,0
164406,471,4,2,1,1,7,0,0
167034,478,4,4,3,1,8,0,0
164395,471,4,2,1,1,7,0,0
164535,472,4,2,1,1,7,0,0
166740,478,4,4,3,1,8,0,0
166671,478,4,4,3,1,8,0,0
164368,471,4,2,1,1,7,0,0
164321,471,4,2,1,1,7,0,0
164389,471,4,2,1,1,7,0,0
164333,473,4,2,1,1,7,0,0
164393,471,4,2,1,1,7,0,0
166721,478,4,4,3,1,8,0,0
164366,471,4,2,1,1,7,0,0
0,0,0,0,0,0,0,0,0
0,0,0,0,0,0,0,0,0
0,0,0,0,0,0,0,0,0
0,0,0,0,0,0,0,0,0
0,0,0,0,0,0,0,0,0
13838,69,0,6,2,4,0,1,0
13838,69,0,6,2,4,0,1,0
13838,69,0,6,2,4,0,1,0
0,0,0,0,0,0,0,0,0
0,0,0,0,0,0,0,0,0
0,0,0,0,0,0,0,0,0
0,0,0,0,0,0,0,0,0
0,0,0,0,0,0,0,0,0
0,0,0,0,0,0,0,0,0
8235,146,0,15,15,0,5,1,0
8235,146,0,15,15,0,5,1,0
13838,69,0,6,2,4,0,1,0
8235,146,0,15,15,0,5,1,0
0,0,0,0,0,0,0,0,0
8235,146,0,15,15,0,5,1,0
0,0,0,0,0,0,0,0,0
0,0,0,0,0,0,0,0,0
0,0,0,0,0,0,0,0,0
34489,50,2,0,0,0,2,0,0
0,0,0,0,0,0,0,0,0
0,0,0,0,0,0,0,0,0
0,0,0,0,0,0,0,0,0
13838,69,0,6,2,4,0,1,0
0,0,0,0,0,0,0,0,0
34489,50,2,0,0,0,2,0,0
0,0,0,0,0,0,0,0,0
34489,50,2,0,0,0,2,0,0
0,0,0,0,0,0,0,0,0
0,0,0,0,0,0,0,0,0
0,0,0,0,0,0,0,0,0
0,0,0,0,0,0,0,0,0
0,0,0,0,0,0,0,0,0
0,0,0,0,0,0,0,0,0
0,0,0,0,0,0,0,0,0
0,0,0,0,0,0,0,0,0
0,0,0,0,0,0,0,0,0
0,0,0,0,0,0,0,0,0
0,0,0,0,0,0,0,0,0
0,0,0,0,0,0,0,0,0
0,0,0,0,0,0,0,0,0
0,0,0,0,0,0,0,0,0
97011,250,0,0,0,0,0,0,0
0,0,0,0,0,0,0,0,0
0,0,0,0,0,0,0,0,0
0,0,0,0,0,0,0,0,0
0,0,0,0,0,0,0,0,0
0,0,0,0,0,0,0,0,0
644858,72,3,2,1,1,2,1,0
644858,72,3,2,1,1,2,1,0
64133,80,3,0,0,0,4,0,0
0,0,0,0,0,0,0,0,0
0,0,0,0,0,0,0,0,0
0,0,0,0,0,0,0,0,0
0,0,0,0,0,0,0,0,0
0,0,0,0,0,0,0,0,0
0,0,0,0,0,0,0,0,0
0,0,0,0,0,0,0,0,0
0,0,0,0,0,0,0,0,0
0,0,0,0,0,0,0,0,0
0,0,0,0,0,0,0,0,0
0,0,0,0,0,0,0,0,0
0,0,0,0,0,0,0,0,0
0,0,0,0,0,0,0,0,0
0,0,0,0,0,0,0,0,0
0,0,0,0,0,0,0,0,0
0,0,0,0,0,0,0,0,0
0,0,0,0,0,0,0,0,0
0,0,0,0,0,0,0,0,0
0,0,0,0,0,0,0,0,0
77735,101,1,4,2,2,0,0,0
0,0,0,0,0,0,0,0,0
0,0,0,0,0,0,0,0,0
77786,101,1,4,2,2,0,0,0
77738,101,1,4,2,2,0,0,0
77706,101,1,4,2,2,0,0,0
0,0,0,0,0,0,0,0,0
0,0,0,0,0,0,0,0,0
0,0,0,0,0,0,0,0,0
0,0,0,0,0,0,0,0,0
0,0,0,0,0,0,0,0,0
0,0,0,0,0,0,0,0,0
88789,332,4,22,20,2,3,1,0
88737,332,4,22,20,2,3,1,0
0,0,0,0,0,0,0,0,0
0,0,0,0,0,0,0,0,0
84870,79,1,8,0,8,0,1,0
0,0,0,0,0,0,0,0,0
0,0,0,0,0,0,0,0,0
0,0,0,0,0,0,0,0,0
22114,35,0,1,1,0,0,1,0
28243,42,0,2,1,1,0,0,0
0,0,0,0,0,0,0,0,0
0,0,0,0,0,0,0,0,0
0,0,0,0,0,0,0,0,0
0,0,0,0,0,0,0,0,0
0,0,0,0,0,0,0,0,0
0,0,0,0,0,0,0,0,0
0,0,0,0,0,0,0,0,0
0,0,0,0,0,0,0,0,0
0,0,0,0,0,0,0,0,0
0,0,0,0,0,0,0,0,0
0,0,0,0,0,0,0,0,0
47504,296,5,23,9,14,0,0,0
29316,140,5,17,11,6,0,0,0
1605,44,0,3,2,1,0,0,0
1584,49,0,1,1,0,0,0,0
0,0,0,0,0,0,0,0,0
0,0,0,0,0,0,0,0,0
98456,284,0,0,0,0,0,0,0
63561,162,1,5,1,4,0,0,0
26052,347,1,2,1,1,2,0,0
4009,101,0,9,9,0,0,0,0
3972,101,0,9,9,0,0,0,0
3972,101,0,9,9,0,0,0,0
21583,201,5,3,2,1,3,1,0
97004,250,0,0,0,0,0,0,0
47504,296,5,23,9,14,0,0,0
20286,251,3,65,63,2,1,1,0
0,0,0,0,0,0,0,0,0
14642,271,1,2,2,0,0,1,0
15199,130,1,6,5,1,3,1,0
49406,215,5,3,1,2,7,1,0
101885,317,0,1,1,0,0,0,0
82599,211,0,24,23,1,6,1,0
12363,75,1,6,0,6,1,0,0
87054,226,0,0,0,0,0,0,0
99811,284,0,0,0,0,0,0,0
13202,125,5,1,0,1,3,0,0
99577,299,0,1,1,0,0,1,0
89770,217,0,0,0,0,0,0,0
85639,215,0,0,0,0,0,0,0
91180,246,0,0,0,0,0,0,0
18020,169,5,2,1,1,1,1,0
26107,347,1,2,1,1,3,0,0
94143,234,0,0,0,0,0,0,0
2864,28,2,1,0,1,0,0,0
46718,6537,0,1,1,0,0,0,0
46718,6537,0,1,1,0,0,0,0
0,0,0,0,0,0,0,0,0
91532,222,0,0,0,0,0,0,0
92099,239,0,0,0,0,0,0,0
124353,394,0,5,5,0,0,0,0
94143,234,0,0,0,0,0,0,0
23292,332,6,24,20,4,0,1,0
11999,133,3,0,0,0,0,1,0
15914,246,5,30,28,2,0,1,0
0,0,0,0,0,0,0,0,0
91346,244,0,0,0,0,0,0,0
0,0,0,0,0,0,0,0,0
0,0,0,0,0,0,0,0,0
7882,77,0,10,9,1,0,1,0
23857,270,3,16,15,1,0,1,0
420,10,0,0,0,0,0,0,0
3183,72,1,1,1,0,0,0,0
3183,72,1,1,1,0,0,0,0
2590359,2393,1,204,6,198,3,1,0
48931,129,0,5,5,0,1,0,0
12418,127,0,26,24,2,2,1,0
4632,69,4,9,5,4,0,1,0
0,0,0,0,0,0,0,0,0
0,0,0,0,0,0,0,0,0
0,0,0,0,0,0,0,0,0
5051,81,0,15,14,1,0,1,0
44635,248,5,15,4,11,1,0,0
72057,344,1,5,1,4,1,0,0
75758,227,4,2,1,1,4,0,0
0,0,0,0,0,0,0,0,0
81402,92,1,23,22,1,0,1,0
0,0,0,0,0,0,0,0,0
49017,233,0,11,2,9,5,1,0
0,0,0,0,0,0,0,0,0
0,0,0,0,0,0,0,0,0
0,0,0,0,0,0,0,0,0
0,0,0,0,0,0,0,0,0
56917,281,1,5,1,4,1,0,0
0,0,0,0,0,0,0,0,0
674195,555,0,4,4,0,2,1,1
0,0,0,0,0,0,0,0,0
0,0,0,0,0,0,0,0,0
0,0,0,0,0,0,0,0,0
0,0,0,0,0,0,0,0,0
0,0,0,0,0,0,0,0,0
4435,85,0,3,3,0,0,0,0
0,0,0,0,0,0,0,0,0
4302,50,0,9,9,0,0,0,0
4302,50,0,9,9,0,0,0,0
0,0,0,0,0,0,0,0,0
59251,443,2,19,19,0,1,0,0
20286,251,3,65,63,2,1,1,0
13004,184,1,64,60,4,0,1,0
0,0,0,0,0,0,0,0,0
0,0,0,0,0,0,0,0,0
0,0,0,0,0,0,0,0,0
0,0,0,0,0,0,0,0,0
54997,140,0,1,1,0,3,0,0
0,0,0,0,0,0,0,0,0
0,0,0,0,0,0,0,0,0
0,0,0,0,0,0,0,0,0
0,0,0,0,0,0,0,0,0
0,0,0,0,0,0,0,0,0
0,0,0,0,0,0,0,0,0
5502,203,0,47,47,0,0,1,0
5502,203,0,47,47,0,0,1,0
5502,203,0,47,47,0,0,1,0
5502,203,0,47,47,0,0,1,0
0,0,0,0,0,0,0,0,0
115464,633,2,64,0,64,0,1,0
0,0,0,0,0,0,0,0,0
131026,195,8,16,10,6,1,1,0
12398,94,6,7,5,2,2,1,0
0,0,0,0,0,0,0,0,0
687850,1036,7,149,53,96,6,1,0
5077,47,4,0,0,0,0,1,0
15014,120,4,1,1,0,0,1,0
93638,552,2,55,1,54,0,1,0
0,0,0,0,0,0,0,0,0
0,0,0,0,0,0,0,0,0
0,0,0,0,0,0,0,0,0
0,0,0,0,0,0,0,0,0
111847,82,0,3,2,1,0,1,0
8073,140,7,26,6,20,1,1,0
0,0,0,0,0,0,0,0,0
0,0,0,0,0,0,0,0,0
215036,172,3,2,1,1,2,0,0
10010,38,4,0,0,0,0,1,0
59903,73,3,4,1,3,0,1,0
31266,481,3,31,31,0,18,1,0
79339,528,3,86,10,76,18,0,0
99488,66,4,9,9,0,2,1,0
99488,66,4,9,9,0,2,1,0
79336,528,3,86,10,76,18,0,0
0,0,0,0,0,0,0,0,0
0,0,0,0,0,0,0,0,0
9840,77,6,5,4,1,0,0,0
9840,77,6,5,4,1,0,0,0
1756,24,6,1,0,1,0,0,0
15287,231,7,38,31,7,3,0,0
0,0,0,0,0,0,0,0,0
5392,39,2,1,0,1,0,0,0
4279,45,3,3,0,3,0,0,0
13910,41,1,1,0,1,0,0,0
4259,81,2,1,0,1,0,0,0
0,0,0,0,0,0,0,0,0
0,0,0,0,0,0,0,0,0
26779,129,0,21,21,0,0,0,0
0,0,0,0,0,0,0,0,0
52799,45,3,5,1,4,0,0,0
0,0,0,0,0,0,0,0,0
39809,261,6,42,35,7,0,1,0
117145,641,3,65,0,65,0,1,0
99577,299,0,1,1,0,0,1,0
85639,215,0,0,0,0,0,0,0
0,0,0,0,0,0,0,0,0
0,0,0,0,0,0,0,0,0
0,0,0,0,0,0,0,0,0
0,0,0,0,0,0,0,0,0
0,0,0,0,0,0,0,0,0
0,0,0,0,0,0,0,0,0
0,0,0,0,0,0,0,0,0
0,0,0,0,0,0,0,0,0
0,0,0,0,0,0,0,0,0
631237,1853,12,51,48,3,20,1,0
39860,168,7,2,1,1,0,0,0
112067,691,3,18,12,6,1,0,0
95328,578,3,20,7,13,1,0,0
0,0,0,0,0,0,0,0,0
64499,56,0,2,2,0,0,1,0
64438,56,0,2,0,2,0,1,0
230291,340,0,16,4,12,0,1,0
5392,39,2,1,0,1,0,0,0
5392,39,2,1,0,1,0,0,0
0,0,0,0,0,0,0,0,0
0,0,0,0,0,0,0,0,0
672639,555,0,4,4,0,2,1,1
673638,555,0,4,4,0,2,1,1
0,0,0,0,0,0,0,0,0
641284,2835,7,168,163,5,6,1,0
7882,77,0,10,9,1,0,1,0
3859,53,3,0,0,0,0,0,0
0,0,0,0,0,0,0,0,0
9726,62,5,2,2,0,1,0,0
11586,216,4,33,30,3,0,1,0
0,0,0,0,0,0,0,0,0
673173,555,0,4,4,0,2,1,1
672203,555,0,4,4,0,2,1,1
4131,52,0,1,0,1,1,0,0
211793,3640,2,299,299,0,2,0,0
0,0,0,0,0,0,0,0,0
0,0,0,0,0,0,0,0,0
0,0,0,0,0,0,0,0,0
670813,555,0,4,4,0,2,1,1
0,0,0,0,0,0,0,0,0
103460,278,7,54,52,2,4,1,0
671117,555,0,4,4,0,2,1,1
0,0,0,0,0,0,0,0,0
0,0,0,0,0,0,0,0,0
131438,981,12,119,116,3,1,0,0
182200,1226,1,10,0,10,0,0,0
0,0,0,0,0,0,0,0,0
670992,555,0,4,4,0,2,1,1
693,22,0,3,3,0,0,0,0
0,0,0,0,0,0,0,0,0
47808,512,7,82,82,0,7,1,0
47738,512,7,82,82,0,7,1,0
671333,555,0,4,4,0,2,1,1
0,0,0,0,0,0,0,0,0
45174,176,2,0,0,0,2,0,0
45218,176,2,0,0,0,2,0,0
670948,555,0,4,4,0,2,1,1
0,0,0,0,0,0,0,0,0
673544,555,0,4,4,0,2,1,1
0,0,0,0,0,0,0,0,0
26416,127,5,21,16,5,10,0,0
672889,555,0,4,4,0,2,1,1
671187,555,0,4,4,0,2,1,1
670834,555,0,4,4,0,2,1,1
670713,555,0,4,4,0,2,1,1
0,0,0,0,0,0,0,0,0
673695,555,0,4,4,0,2,1,1
698249,551,0,5,5,0,2,1,1
671037,555,0,4,4,0,2,1,1
673125,555,0,4,4,0,2,1,1
674007,555,0,4,4,0,2,1,1
672526,555,0,4,4,0,2,1,1
73736,87,1,5,4,1,0,0,0
73736,87,1,5,4,1,0,0,0
45748,183,2,1,1,0,2,0,0
0,0,0,0,0,0,0,0,0
64438,56,0,2,0,2,0,1,0
15287,231,7,38,31,7,3,0,0
0,0,0,0,0,0,0,0,0
5271,37,2,0,0,0,0,0,0
0,0,0,0,0,0,0,0,0
300585,355,5,12,8,4,6,1,0
10499,77,4,1,1,0,2,1,0
0,0,0,0,0,0,0,0,0
86019,540,9,119,97,22,2,1,0
0,0,0,0,0,0,0,0,0
25502,307,6,38,5,33,7,1,0
0,0,0,0,0,0,0,0,0
0,0,0,0,0,0,0,0,0
0,0,0,0,0,0,0,0,0
0,0,0,0,0,0,0,0,0
227547,624,9,125,101,24,2,1,0
227547,624,9,125,101,24,2,1,0
227546,624,9,125,101,24,2,1,0
227557,624,9,125,101,24,2,1,0
54583,504,2,46,17,29,0,0,0
54583,504,2,46,17,29,0,0,0
673505,555,0,4,4,0,2,1,1
671100,555,0,4,4,0,2,1,1
673944,555,0,4,4,0,2,1,1
0,0,0,0,0,0,0,0,0
0,0,0,0,0,0,0,0,0
0,0,0,0,0,0,0,0,0
0,0,0,0,0,0,0,0,0
87489,368,5,26,17,9,29,1,0
267082,353,7,10,5,5,4,0,0
24307,71,4,2,2,0,0,0,0
673706,555,0,4,4,0,2,1,1
674138,555,0,4,4,0,2,1,1
54016,276,2,2,1,1,1,0,0
674434,555,0,4,4,0,2,1,1
4874,77,0,15,2,13,0,1,0
4874,77,0,15,2,13,0,1,0
0,0,0,0,0,0,0,0,0
32392,204,0,47,45,2,1,1,0
0,0,0,0,0,0,0,0,0
0,0,0,0,0,0,0,0,0
0,0,0,0,0,0,0,0,0
671319,555,0,4,4,0,2,1,1
187000,651,4,7,5,2,7,1,0
2970,59,1,3,2,1,0,1,0
10411,117,1,4,4,0,0,0,0
0,0,0,0,0,0,0,0,0
8945,257,0,16,16,0,0,1,0
8945,257,0,16,16,0,0,1,0
8945,257,0,16,16,0,0,1,0
23805,189,0,3,0,3,2,0,0
23805,189,0,3,0,3,2,0,0
23805,189,0,3,0,3,2,0,0
54612,301,1,12,9,3,0,0,0
674511,555,0,4,4,0,2,1,1
115171,70,0,7,2,5,0,1,0
0,0,0,0,0,0,0,0,0
671742,555,0,4,4,0,2,1,1
23805,189,0,3,0,3,2,0,0
674015,555,0,4,4,0,2,1,1
674230,555,0,4,4,0,2,1,1
674152,555,0,4,4,0,2,1,1
671627,555,0,4,4,0,2,1,1
0,0,0,0,0,0,0,0,0
674309,555,0,4,4,0,2,1,1
672099,555,0,4,4,0,2,1,1
2521,36,2,1,1,0,0,0,0
2521,36,2,1,1,0,0,0,0
0,0,0,0,0,0,0,0,0
672312,555,0,4,4,0,2,1,1
671779,555,0,4,4,0,2,1,1
78263,248,0,4,2,2,0,1,0
5010,164,1,22,22,0,0,0,0
5010,164,1,22,22,0,0,0,0
0,0,0,0,0,0,0,0,0
0,0,0,0,0,0,0,0,0
56453,293,2,14,12,2,3,0,0
0,0,0,0,0,0,0,0,0
0,0,0,0,0,0,0,0,0
1084,28,0,3,3,0,0,0,0
1084,28,0,3,3,0,0,0,0
1084,28,0,3,3,0,0,0,0
8459,217,1,5,5,0,0,0,0
8459,217,1,5,5,0,0,0,0
94574,42,4,3,3,0,0,1,0
0,0,0,0,0,0,0,0,0
4658,133,0,3,3,0,0,0,0
17173,109,1,7,6,1,0,0,0
5010,164,1,22,22,0,0,0,0
0,0,0,0,0,0,0,0,0
0,0,0,0,0,0,0,0,0
100163,173,1,17,17,0,0,1,0
2044,38,1,0,0,0,0,0,0
9179,139,2,0,0,0,0,0,0
0,0,0,0,0,0,0,0,0
9825,156,2,0,0,0,0,0,0
0,0,0,0,0,0,0,0,0
5387,165,0,22,22,0,0,0,0
8459,217,1,5,5,0,0,0,0
8459,217,1,5,5,0,0,0,0
0,0,0,0,0,0,0,0,0
6769,126,1,0,0,0,0,0,0
147768,924,8,77,63,14,3,1,0
94284,55,1,6,6,0,0,1,0
48931,129,0,5,5,0,1,0,0
0,0,0,0,0,0,0,0,0
0,0,0,0,0,0,0,0,0
0,0,0,0,0,0,0,0,0
0,0,0,0,0,0,0,0,0
0,0,0,0,0,0,0,0,0
9825,156,2,0,0,0,0,0,0
6927,138,1,0,0,0,0,0,0
6927,138,1,0,0,0,0,0,0
6769,126,1,0,0,0,0,0,0
0,0,0,0,0,0,0,0,0
670761,555,0,4,4,0,2,1,1
65162,325,7,8,4,4,1,0,0
19953,250,3,65,63,2,1,1,0
3140,43,0,6,3,3,0,0,0
9825,156,2,0,0,0,0,0,0
5010,164,1,22,22,0,0,0,0
3140,43,0,6,3,3,0,0,0
6769,126,1,0,0,0,0,0,0
100163,173,1,17,17,0,0,1,0
94284,55,1,6,6,0,0,1,0
6769,126,1,0,0,0,0,0,0
94284,55,1,6,6,0,0,1,0
9825,156,2,0,0,0,0,0,0
0,0,0,0,0,0,0,0,0
94284,55,1,6,6,0,0,1,0
94574,42,4,3,3,0,0,1,0
100163,173,1,17,17,0,0,1,0
100163,173,1,17,17,0,0,1,0
0,0,0,0,0,0,0,0,0
5387,165,0,22,22,0,0,0,0
5387,165,0,22,22,0,0,0,0
6927,138,1,0,0,0,0,0,0
0,0,0,0,0,0,0,0,0
0,0,0,0,0,0,0,0,0
0,0,0,0,0,0,0,0,0
0,0,0,0,0,0,0,0,0
0,0,0,0,0,0,0,0,0
672089,555,0,4,4,0,2,1,1
8711,75,5,2,2,0,0,0,0
8711,75,5,2,2,0,0,0,0
8945,257,0,16,16,0,0,1,0
1068,28,0,2,2,0,0,0,0
1068,28,0,2,2,0,0,0,0
1068,28,0,2,2,0,0,0,0
671248,555,0,4,4,0,2,1,1
1068,28,0,2,2,0,0,0,0
0,0,0,0,0,0,0,0,0
0,0,0,0,0,0,0,0,0
11113,77,3,1,1,0,2,1,0
11099,77,3,1,1,0,2,1,0
11099,77,3,1,1,0,2,1,0
0,0,0,0,0,0,0,0,0
0,0,0,0,0,0,0,0,0
0,0,0,0,0,0,0,0,0
0,0,0,0,0,0,0,0,0
0,0,0,0,0,0,0,0,0
673907,555,0,4,4,0,2,1,1
2455,64,0,2,2,0,0,0,0
2455,64,0,2,2,0,0,0,0
673391,555,0,4,4,0,2,1,1
673509,555,0,4,4,0,2,1,1
4142,52,0,1,0,1,1,0,0
10441,138,0,19,19,0,0,0,0
14793,137,3,4,4,0,0,0,0
1858,48,1,9,6,3,0,0,0
7517,136,0,19,2,17,0,0,0
7517,136,0,19,2,17,0,0,0
7966,142,0,16,1,15,0,1,0
0,0,0,0,0,0,0,0,0
0,0,0,0,0,0,0,0,0
0,0,0,0,0,0,0,0,0
60107,113,0,5,1,4,1,0,0
4712,68,0,20,20,0,0,0,0
58099,110,0,4,1,3,1,0,0
0,0,0,0,0,0,0,0,0
671077,555,0,4,4,0,2,1,1
48755,216,2,3,3,0,1,0,0
673031,555,0,4,4,0,2,1,1
0,0,0,0,0,0,0,0,0
671732,555,0,4,4,0,2,1,1
5090,165,0,22,22,0,0,0,0
673420,555,0,4,0,4,2,1,1
45706,183,2,1,1,0,2,0,0
0,0,0,0,0,0,0,0,0
0,0,0,0,0,0,0,0,0
0,0,0,0,0,0,0,0,0
45473,103,2,10,8,2,0,1,0
95380,59,1,2,2,0,0,1,0
95380,59,1,2,2,0,0,1,0
0,0,0,0,0,0,0,0,0
0,0,0,0,0,0,0,0,0
674162,555,0,4,4,0,2,1,1
671601,555,0,4,4,0,2,1,1
0,0,0,0,0,0,0,0,0
0,0,0,0,0,0,0,0,0
675384,555,0,4,4,0,2,1,1
2455,64,0,2,2,0,0,0,0
2455,64,0,2,2,0,0,0,0
0,0,0,0,0,0,0,0,0
69564,236,5,17,8,9,23,0,0
0,0,0,0,0,0,0,0,0
10441,138,0,19,19,0,0,0,0
674283,555,0,4,4,0,2,1,1
674154,555,0,4,4,0,2,1,1
10591,163,2,2,2,0,0,0,0
10591,163,2,2,2,0,0,0,0
0,0,0,0,0,0,0,0,0
0,0,0,0,0,0,0,0,0
0,0,0,0,0,0,0,0,0
0,0,0,0,0,0,0,0,0
45473,103,2,10,8,2,0,1,0
0,0,0,0,0,0,0,0,0
5094,165,1,22,22,0,0,0,0
5092,165,1,22,22,0,0,0,0
5094,165,1,22,22,0,0,0,0
5092,165,1,22,22,0,0,0,0
5094,165,1,22,22,0,0,0,0
5092,165,1,22,22,0,0,0,0
11305,107,4,15,14,1,0,0,0
89744,383,8,66,65,1,3,0,0
1858,48,1,9,6,3,0,0,0
0,0,0,0,0,0,0,0,0
671107,555,0,4,0,4,2,1,1
13931,122,2,4,4,0,0,0,0
48875,237,2,2,1,1,1,0,0
2650,111,0,41,41,0,0,1,0
3119,24,0,1,1,0,0,0,0
3119,24,0,1,1,0,0,0,0
672858,555,0,4,4,0,2,1,1
5094,165,1,22,22,0,0,0,0
0,0,0,0,0,0,0,0,0
5092,165,1,22,22,0,0,0,0
0,0,0,0,0,0,0,0,0
0,0,0,0,0,0,0,0,0
0,0,0,0,0,0,0,0,0
0,0,0,0,0,0,0,0,0
1854,44,0,2,2,0,0,0,0
10837,124,5,7,6,1,0,0,0
3140,43,0,6,3,3,0,0,0
10591,163,2,2,2,0,0,0,0
1854,44,0,2,2,0,0,0,0
0,0,0,0,0,0,0,0,0
10441,138,0,19,19,0,0,0,0
95380,59,1,2,2,0,0,1,0
3140,43,0,6,3,3,0,0,0
0,0,0,0,0,0,0,0,0
2259,63,0,5,5,0,0,0,0
0,0,0,0,0,0,0,0,0
0,0,0,0,0,0,0,0,0
10084,83,4,2,1,1,0,0,0
16100,35,0,5,1,4,0,0,0
0,0,0,0,0,0,0,0,0
0,0,0,0,0,0,0,0,0
0,0,0,0,0,0,0,0,0
0,0,0,0,0,0,0,0,0
0,0,0,0,0,0,0,0,0
15744,345,4,52,52,0,2,1,0
0,0,0,0,0,0,0,0,0
788372,405,1,63,38,25,0,0,0
0,0,0,0,0,0,0,0,0
673444,555,0,4,4,0,2,1,1
159455,436,2,6,5,1,21,0,0
3049,92,0,17,17,0,0,0,0
20578,94,0,2,2,0,0,0,0
20578,94,0,2,2,0,0,0,0
0,0,0,0,0,0,0,0,0
0,0,0,0,0,0,0,0,0
52726,250,2,2,1,1,1,0,0
6586,58,1,1,1,0,0,0,0
0,0,0,0,0,0,0,0,0
0,0,0,0,0,0,0,0,0
0,0,0,0,0,0,0,0,0
0,0,0,0,0,0,0,0,0
54316,258,2,3,2,1,1,0,0
58564,300,2,5,5,0,9,1,0
0,0,0,0,0,0,0,0,0
127372,117,2,1,1,0,5,0,0
127215,116,2,1,0,1,5,0,0
0,0,0,0,0,0,0,0,0
19945,96,2,1,1,0,0,0,0
121955,154,2,2,1,1,8,0,0
0,0,0,0,0,0,0,0,0
0,0,0,0,0,0,0,0,0
164221,632,17,36,32,4,3,1,0
0,0,0,0,0,0,0,0,0
0,0,0,0,0,0,0,0,0
48361,220,2,1,0,1,1,0,0
10463,122,2,6,6,0,0,1,0
17096,77,2,1,1,0,0,0,0
26651,129,0,21,21,0,0,0,0
26775,129,0,21,21,0,0,0,0
26815,129,0,21,21,0,0,0,0
671595,555,0,4,4,0,2,1,1
5613,66,1,1,0,1,1,0,0
0,0,0,0,0,0,0,0,0
38758,333,1,31,0,31,2,0,0
47031,204,2,2,1,1,1,0,0
131828,206,3,4,2,2,8,0,0
0,0,0,0,0,0,0,0,0
0,0,0,0,0,0,0,0,0
39984,340,1,33,0,33,2,0,0
0,0,0,0,0,0,0,0,0
2637,27,3,0,0,0,0,0,0
1623,30,4,1,1,0,0,0,0
207337,536,0,75,49,26,5,1,0
0,0,0,0,0,0,0,0,0
0,0,0,0,0,0,0,0,0
103068,377,4,45,6,39,0,1,0
0,0,0,0,0,0,0,0,0
0,0,0,0,0,0,0,0,0
0,0,0,0,0,0,0,0,0
0,0,0,0,0,0,0,0,0
31620,123,3,4,2,2,1,0,0
0,0,0,0,0,0,0,0,0
0,0,0,0,0,0,0,0,0
0,0,0,0,0,0,0,0,0
0,0,0,0,0,0,0,0,0
29747,201,1,21,4,17,2,0,0
0,0,0,0,0,0,0,0,0
0,0,0,0,0,0,0,0,0
15242,125,0,12,0,12,0,0,0
0,0,0,0,0,0,0,0,0
0,0,0,0,0,0,0,0,0
0,0,0,0,0,0,0,0,0
0,0,0,0,0,0,0,0,0
0,0,0,0,0,0,0,0,0
157999,302,1,5,1,4,44,1,0
157999,302,1,5,1,4,44,1,0
121068,140,2,1,0,1,8,0,0
121066,140,2,1,0,1,8,0,0
0,0,0,0,0,0,0,0,0
218284,238,0,2,2,0,2,1,0
288949,377,1,15,4,11,2,0,0
44955,174,2,1,0,1,1,0,0
0,0,0,0,0,0,0,0,0
0,0,0,0,0,0,0,0,0
0,0,0,0,0,0,0,0,0
0,0,0,0,0,0,0,0,0
0,0,0,0,0,0,0,0,0
0,0,0,0,0,0,0,0,0
0,0,0,0,0,0,0,0,0
24424,78,1,3,2,1,0,1,0
0,0,0,0,0,0,0,0,0
48098,220,2,1,0,1,1,0,0
137699,439,6,2,1,1,8,0,0
0,0,0,0,0,0,0,0,0
0,0,0,0,0,0,0,0,0
50699,209,2,3,1,2,1,0,0
40537,426,1,15,4,11,0,1,0
0,0,0,0,0,0,0,0,0
92467,1041,2,60,33,27,2,1,0
121376,143,2,2,0,2,8,0,0
81805,197,3,13,8,5,5,1,0
0,0,0,0,0,0,0,0,0
0,0,0,0,0,0,0,0,0
0,0,0,0,0,0,0,0,0
126996,183,2,3,2,1,11,0,0
671226,555,0,4,4,0,2,1,1
47212,207,2,2,2,0,1,0,0
47654,213,2,1,0,1,1,0,0
674183,555,0,4,4,0,2,1,1
47048,203,2,2,1,1,1,0,0
59643,456,8,38,1,37,7,1,0
0,0,0,0,0,0,0,0,0
0,0,0,0,0,0,0,0,0
0,0,0,0,0,0,0,0,0
0,0,0,0,0,0,0,0,0
0,0,0,0,0,0,0,0,0
0,0,0,0,0,0,0,0,0
0,0,0,0,0,0,0,0,0
30468,93,1,3,3,0,2,0,0
30655,95,1,3,3,0,2,0,0
10834,72,0,0,0,0,0,0,0
0,0,0,0,0,0,0,0,0
0,0,0,0,0,0,0,0,0
0,0,0,0,0,0,0,0,0
0,0,0,0,0,0,0,0,0
49048,211,2,2,1,1,1,0,0
0,0,0,0,0,0,0,0,0
17745,61,3,2,2,0,2,1,0
1339,17,1,0,0,0,0,0,0
0,0,0,0,0,0,0,0,0
0,0,0,0,0,0,0,0,0
0,0,0,0,0,0,0,0,0
0,0,0,0,0,0,0,0,0
9336,58,0,0,0,0,0,0,0
9336,58,0,0,0,0,0,0,0
150986,560,1,25,14,11,4,1,0
0,0,0,0,0,0,0,0,0
0,0,0,0,0,0,0,0,0
0,0,0,0,0,0,0,0,0
0,0,0,0,0,0,0,0,0
102205,589,4,42,42,0,13,0,0
2930,56,0,1,1,0,0,0,0
79181,1623,6,730,730,0,0,1,0
32634,222,3,0,0,0,0,1,0
250,8,0,0,0,0,0,0,0
673635,555,0,4,4,0,2,1,1
14291,120,2,0,0,0,0,0,0
124174,180,2,1,0,1,8,0,0
0,0,0,0,0,0,0,0,0
3338,28,1,0,0,0,0,0,0
0,0,0,0,0,0,0,0,0
0,0,0,0,0,0,0,0,0
0,0,0,0,0,0,0,0,0
0,0,0,0,0,0,0,0,0
0,0,0,0,0,0,0,0,0
32575,804,6,114,113,1,3,1,0
46084,182,3,0,0,0,2,0,0
46083,182,3,0,0,0,2,0,0
8714,97,3,16,10,6,1,1,0
0,0,0,0,0,0,0,0,0
363,10,0,1,0,1,0,0,0
51353,236,2,2,2,0,1,1,0
48482,198,2,2,2,0,1,0,0
0,0,0,0,0,0,0,0,0
121921,146,2,3,1,2,8,0,0
0,0,0,0,0,0,0,0,0
0,0,0,0,0,0,0,0,0
10289,42,0,0,0,0,0,0,0
10289,42,0,0,0,0,0,0,0
0,0,0,0,0,0,0,0,0
0,0,0,0,0,0,0,0,0
47493,210,2,1,0,1,1,0,0
0,0,0,0,0,0,0,0,0
17745,61,3,2,2,0,2,1,0
0,0,0,0,0,0,0,0,0
0,0,0,0,0,0,0,0,0
0,0,0,0,0,0,0,0,0
0,0,0,0,0,0,0,0,0
0,0,0,0,0,0,0,0,0
0,0,0,0,0,0,0,0,0
0,0,0,0,0,0,0,0,0
0,0,0,0,0,0,0,0,0
0,0,0,0,0,0,0,0,0
0,0,0,0,0,0,0,0,0
0,0,0,0,0,0,0,0,0
0,0,0,0,0,0,0,0,0
0,0,0,0,0,0,0,0,0
0,0,0,0,0,0,0,0,0
0,0,0,0,0,0,0,0,0
10519,19,1,2,0,2,0,0,0
10519,19,1,2,0,2,0,0,0
0,0,0,0,0,0,0,0,0
220952,278,0,4,0,4,2,1,0
0,0,0,0,0,0,0,0,0
0,0,0,0,0,0,0,0,0
0,0,0,0,0,0,0,0,0
0,0,0,0,0,0,0,0,0
0,0,0,0,0,0,0,0,0
0,0,0,0,0,0,0,0,0
0,0,0,0,0,0,0,0,0
671288,555,0,4,4,0,2,1,1
70914,111,3,7,2,5,3,1,0
70914,111,3,7,6,1,3,1,0
50256,125,0,14,11,3,0,0,0
0,0,0,0,0,0,0,0,0
0,0,0,0,0,0,0,0,0
5546,43,2,0,0,0,0,0,0
0,0,0,0,0,0,0,0,0
20320,149,1,13,8,5,5,0,0
20320,149,1,13,8,5,5,0,0
0,0,0,0,0,0,0,0,0
0,0,0,0,0,0,0,0,0
0,0,0,0,0,0,0,0,0
0,0,0,0,0,0,0,0,0
0,0,0,0,0,0,0,0,0
0,0,0,0,0,0,0,0,0
33556,210,0,51,51,0,0,1,0
0,0,0,0,0,0,0,0,0
338027,43,4,1,1,0,2,0,0
338027,43,4,1,1,0,2,0,0
0,0,0,0,0,0,0,0,0
671892,555,0,4,4,0,2,1,1
0,0,0,0,0,0,0,0,0
17745,61,3,2,2,0,2,1,0
17745,61,3,2,2,0,2,1,0
0,0,0,0,0,0,0,0,0
0,0,0,0,0,0,0,0,0
0,0,0,0,0,0,0,0,0
26119,138,3,7,4,3,1,0,0
470011,2982,3,344,12,332,4,0,0
470011,2982,3,344,12,332,4,0,0
0,0,0,0,0,0,0,0,0
0,0,0,0,0,0,0,0,0
676538,555,0,4,0,4,2,1,1
0,0,0,0,0,0,0,0,0
0,0,0,0,0,0,0,0,0
0,0,0,0,0,0,0,0,0
2289,29,0,0,0,0,0,0,0
2602,38,0,0,0,0,0,0,0
105729,377,3,27,2,25,3,1,0
89658,382,8,66,65,1,3,0,0
0,0,0,0,0,0,0,0,0
92638,933,5,228,206,22,5,1,0
0,0,0,0,0,0,0,0,0
0,0,0,0,0,0,0,0,0
0,0,0,0,0,0,0,0,0
97872,449,8,32,29,3,6,1,0
672962,555,0,4,4,0,2,1,1
162005,111,3,18,9,9,4,1,0
0,0,0,0,0,0,0,0,0
0,0,0,0,0,0,0,0,0
0,0,0,0,0,0,0,0,0
0,0,0,0,0,0,0,0,0
0,0,0,0,0,0,0,0,0
0,0,0,0,0,0,0,0,0
0,0,0,0,0,0,0,0,0
0,0,0,0,0,0,0,0,0
0,0,0,0,0,0,0,0,0
0,0,0,0,0,0,0,0,0
0,0,0,0,0,0,0,0,0
0,0,0,0,0,0,0,0,0
9364,49,5,0,0,0,3,1,0
0,0,0,0,0,0,0,0,0
0,0,0,0,0,0,0,0,0
0,0,0,0,0,0,0,0,0
0,0,0,0,0,0,0,0,0
0,0,0,0,0,0,0,0,0
0,0,0,0,0,0,0,0,0
0,0,0,0,0,0,0,0,0
0,0,0,0,0,0,0,0,0
0,0,0,0,0,0,0,0,0
54304,822,4,163,27,136,3,1,0
54501,823,4,163,27,136,3,1,0
0,0,0,0,0,0,0,0,0
0,0,0,0,0,0,0,0,0
0,0,0,0,0,0,0,0,0
0,0,0,0,0,0,0,0,0
320578,473,9,59,52,7,3,1,0
0,0,0,0,0,0,0,0,0
37514,445,5,81,78,3,2,1,0
0,0,0,0,0,0,0,0,0
4394,25,0,1,0,1,0,0,0
215583,122,4,2,1,1,0,0,0
673021,555,0,4,4,0,2,1,1
1691,65,0,16,16,0,0,1,0
0,0,0,0,0,0,0,0,0
0,0,0,0,0,0,0,0,0
674097,555,0,4,4,0,2,1,1
5153,45,0,2,1,1,1,0,0
0,0,0,0,0,0,0,0,0
219933,794,3,93,22,71,6,1,0
221066,797,3,93,21,72,6,1,0
7033,55,0,2,2,0,0,0,0
7033,55,0,2,2,0,0,0,0
673528,555,0,4,4,0,2,1,1
43735,30,1,0,0,0,0,0,0
97712,770,2,7,7,0,1,0,0
33948,168,6,6,4,2,1,0,0
0,0,0,0,0,0,0,0,0
0,0,0,0,0,0,0,0,0
32392,204,0,47,45,2,1,1,0
26000,149,6,4,3,1,1,0,0
0,0,0,0,0,0,0,0,0
0,0,0,0,0,0,0,0,0
23507,108,6,5,5,0,2,0,0
672427,555,0,4,4,0,2,1,1
0,0,0,0,0,0,0,0,0
0,0,0,0,0,0,0,0,0
18712,90,1,2,1,1,0,1,0
0,0,0,0,0,0,0,0,0
0,0,0,0,0,0,0,0,0
0,0,0,0,0,0,0,0,0
47098,202,2,1,0,1,1,0,0
15030,77,1,2,0,2,0,0,0
69395,98,3,4,2,2,3,1,0
113809,840,8,127,125,2,3,1,0
113833,840,8,127,125,2,3,1,0
0,0,0,0,0,0,0,0,0
319296,214,1,10,6,4,2,0,0
0,0,0,0,0,0,0,0,0
128689,359,5,0,0,0,5,0,0
0,0,0,0,0,0,0,0,0
16057,162,5,30,28,2,0,1,0
0,0,0,0,0,0,0,0,0
0,0,0,0,0,0,0,0,0
8974,65,3,0,0,0,0,0,0
0,0,0,0,0,0,0,0,0
673005,555,0,4,0,4,2,1,1
72137,284,10,11,0,11,5,1,0
697919,2604,2,300,258,42,38,1,0
697923,2604,2,300,258,42,38,1,0
2012,20,0,4,0,4,0,0,0
57488,883,4,163,26,137,3,1,0
0,0,0,0,0,0,0,0,0
0,0,0,0,0,0,0,0,0
14346,98,1,1,1,0,3,0,0
639083,107,4,4,4,0,4,1,0
0,0,0,0,0,0,0,0,0
0,0,0,0,0,0,0,0,0
0,0,0,0,0,0,0,0,0
0,0,0,0,0,0,0,0,0
639099,107,4,4,4,0,4,1,0
28914,160,6,1,0,1,1,0,0
0,0,0,0,0,0,0,0,0
0,0,0,0,0,0,0,0,0
0,0,0,0,0,0,0,0,0
0,0,0,0,0,0,0,0,0
0,0,0,0,0,0,0,0,0
673471,555,0,4,4,0,2,1,1
34446,219,3,44,36,8,0,0,0
46903,199,2,1,0,1,1,0,0
133954,236,2,26,25,1,3,1,0
671030,555,0,4,4,0,2,1,1
98700,566,11,18,12,6,5,1,0
0,0,0,0,0,0,0,0,0
0,0,0,0,0,0,0,0,0
699422,551,0,5,5,0,2,1,1
0,0,0,0,0,0,0,0,0
8545,57,4,2,2,0,2,1,0
8545,57,4,2,2,0,2,1,0
0,0,0,0,0,0,0,0,0
674342,555,0,4,4,0,2,1,1
385,23,0,4,4,0,0,0,0
0,0,0,0,0,0,0,0,0
331664,612,3,65,51,14,3,1,0
19554,372,8,34,32,2,0,1,0
47779,504,7,99,90,9,0,1,0
8943,76,5,4,0,4,0,0,0
4114,52,0,1,0,1,1,0,0
0,0,0,0,0,0,0,0,0
80538,583,8,37,31,6,4,1,0
115464,171,0,10,7,3,1,1,0
79764,191,3,12,11,1,5,1,0
0,0,0,0,0,0,0,0,0
673861,555,0,4,4,0,2,1,1
285781,1872,12,321,307,14,5,1,0
2119,40,2,5,3,2,0,0,0
61581,317,2,5,5,0,11,1,0
0,0,0,0,0,0,0,0,0
14214,34,0,1,1,0,1,0,0
70161,650,5,119,71,48,3,1,0
116083,407,7,24,1,23,10,0,0
69713,644,5,118,71,47,3,1,0
211760,46,5,0,0,0,0,0,0
0,0,0,0,0,0,0,0,0
0,0,0,0,0,0,0,0,0
79705,570,7,55,42,13,3,0,0
153313,679,9,42,41,1,1,0,0
0,0,0,0,0,0,0,0,0
0,0,0,0,0,0,0,0,0
0,0,0,0,0,0,0,0,0
0,0,0,0,0,0,0,0,0
39475,588,4,75,72,3,0,1,0
0,0,0,0,0,0,0,0,0
48746,141,9,13,5,8,0,0,0
44692,45,6,1,1,0,1,0,0
185310,2265,1,243,164,79,11,1,0
21338,244,5,22,11,11,0,1,0
204283,848,9,142,21,121,9,1,0
79545,181,3,10,8,2,6,1,0
128530,370,5,2,2,0,5,0,0
0,0,0,0,0,0,0,0,0
0,0,0,0,0,0,0,0,0
0,0,0,0,0,0,0,0,0
0,0,0,0,0,0,0,0,0
74252,892,3,80,76,4,5,1,0
61533,315,2,5,5,0,11,1,0
0,0,0,0,0,0,0,0,0
0,0,0,0,0,0,0,0,0
0,0,0,0,0,0,0,0,0
140281,454,6,2,1,1,8,0,0
19239,218,5,40,40,0,0,0,0
0,0,0,0,0,0,0,0,0
88475,565,6,93,88,5,2,1,0
0,0,0,0,0,0,0,0,0
0,0,0,0,0,0,0,0,0
0,0,0,0,0,0,0,0,0
65903,546,7,136,124,12,2,0,0
31759,121,1,3,3,0,0,0,0
7910,52,6,1,1,0,0,0,0
217276,344,2,0,0,0,0,0,0
0,0,0,0,0,0,0,0,0
121682,146,2,3,1,2,8,0,0
48074,220,2,1,1,0,1,0,0
0,0,0,0,0,0,0,0,0
109129,2515,3,364,264,100,0,1,0
593,11,0,0,0,0,0,0,0
71927,480,6,25,20,5,2,1,0
0,0,0,0,0,0,0,0,0
639,6,0,0,0,0,0,0,0
0,0,0,0,0,0,0,0,0
0,0,0,0,0,0,0,0,0
35991,171,0,1,0,1,0,0,0
13711,332,2,77,77,0,1,0,0
164684,604,2,45,21,24,0,1,0
0,0,0,0,0,0,0,0,0
0,0,0,0,0,0,0,0,0
0,0,0,0,0,0,0,0,0
53811,265,3,31,22,9,6,0,0
53810,265,3,31,22,9,6,0,0
53811,265,3,31,22,9,6,0,0
0,0,0,0,0,0,0,0,0
128150,362,5,1,1,0,5,0,0
0,0,0,0,0,0,0,0,0
0,0,0,0,0,0,0,0,0
0,0,0,0,0,0,0,0,0
0,0,0,0,0,0,0,0,0
0,0,0,0,0,0,0,0,0
339982,653,3,88,85,3,7,1,0
0,0,0,0,0,0,0,0,0
128180,360,5,1,1,0,5,0,0
0,0,0,0,0,0,0,0,0
38718,163,3,3,1,2,3,1,0
37673,251,6,46,37,9,2,1,0
932604,1047,0,44,16,28,4,1,0
128185,360,5,1,0,1,5,0,0
0,0,0,0,0,0,0,0,0
0,0,0,0,0,0,0,0,0
673394,555,0,4,4,0,2,1,1
4547,35,0,2,2,0,0,0,0
0,0,0,0,0,0,0,0,0
0,0,0,0,0,0,0,0,0
0,0,0,0,0,0,0,0,0
0,0,0,0,0,0,0,0,0
0,0,0,0,0,0,0,0,0
0,0,0,0,0,0,0,0,0
0,0,0,0,0,0,0,0,0
0,0,0,0,0,0,0,0,0
0,0,0,0,0,0,0,0,0
0,0,0,0,0,0,0,0,0
0,0,0,0,0,0,0,0,0
0,0,0,0,0,0,0,0,0
0,0,0,0,0,0,0,0,0
0,0,0,0,0,0,0,0,0
0,0,0,0,0,0,0,0,0
0,0,0,0,0,0,0,0,0
0,0,0,0,0,0,0,0,0
0,0,0,0,0,0,0,0,0
0,0,0,0,0,0,0,0,0
0,0,0,0,0,0,0,0,0
0,0,0,0,0,0,0,0,0
0,0,0,0,0,0,0,0,0
0,0,0,0,0,0,0,0,0
0,0,0,0,0,0,0,0,0
0,0,0,0,0,0,0,0,0
0,0,0,0,0,0,0,0,0
0,0,0,0,0,0,0,0,0
0,0,0,0,0,0,0,0,0
0,0,0,0,0,0,0,0,0
0,0,0,0,0,0,0,0,0
0,0,0,0,0,0,0,0,0
0,0,0,0,0,0,0,0,0
0,0,0,0,0,0,0,0,0
0,0,0,0,0,0,0,0,0
0,0,0,0,0,0,0,0,0
0,0,0,0,0,0,0,0,0
0,0,0,0,0,0,0,0,0
0,0,0,0,0,0,0,0,0
0,0,0,0,0,0,0,0,0
0,0,0,0,0,0,0,0,0
0,0,0,0,0,0,0,0,0
0,0,0,0,0,0,0,0,0
0,0,0,0,0,0,0,0,0
0,0,0,0,0,0,0,0,0
0,0,0,0,0,0,0,0,0
0,0,0,0,0,0,0,0,0
0,0,0,0,0,0,0,0,0
0,0,0,0,0,0,0,0,0
0,0,0,0,0,0,0,0,0
0,0,0,0,0,0,0,0,0
36136,166,6,3,1,2,1,0,0
673224,555,0,4,4,0,2,1,1
416497,1119,0,1,0,1,0,0,0
0,0,0,0,0,0,0,0,0
147109,755,8,93,92,1,6,1,0
0,0,0,0,0,0,0,0,0
330724,1552,5,150,10,140,0,1,0
0,0,0,0,0,0,0,0,0
3691,50,3,6,6,0,0,0,0
0,0,0,0,0,0,0,0,0
162539,600,12,20,18,2,4,1,0
0,0,0,0,0,0,0,0,0
128693,364,5,2,2,0,5,0,0
498887,1831,3,19,14,5,0,0,0
33078,284,2,6,5,1,3,0,0
671222,555,0,4,4,0,2,1,1
407996,704,6,63,12,51,2,1,0
674417,555,0,4,4,0,2,1,1
259207,685,7,106,5,101,7,1,0
0,0,0,0,0,0,0,0,0
106793,1058,9,312,305,7,0,1,0
2224015,267,4,6,6,0,0,1,0
0,0,0,0,0,0,0,0,0
0,0,0,0,0,0,0,0,0
0,0,0,0,0,0,0,0,0
0,0,0,0,0,0,0,0,0
23504,48,1,1,0,1,0,0,0
2790,19,0,0,0,0,0,0,0
6631,63,6,4,0,4,0,0,0
6631,63,6,4,3,1,0,0,0
673357,555,0,4,4,0,2,1,1
13796,49,0,0,0,0,2,1,0
54912,59,1,1,1,0,7,0,0
233493,1507,13,336,332,4,8,1,0
13942,138,7,2,1,1,0,0,0
0,0,0,0,0,0,0,0,0
54921,59,1,1,1,0,7,0,0
128151,360,5,1,1,0,5,0,0
0,0,0,0,0,0,0,0,0
0,0,0,0,0,0,0,0,0
9526,180,5,34,31,3,0,1,0
670812,555,0,4,0,4,2,1,1
670914,555,0,4,0,4,2,1,1
0,0,0,0,0,0,0,0,0
128317,364,5,2,0,2,5,0,0
674237,555,0,4,0,4,2,1,1
287661,953,4,6,0,6,5,0,0
33196,278,1,29,24,5,0,0,0
33196,278,1,29,24,5,0,0,0
0,0,0,0,0,0,0,0,0
4311654,267,4,6,6,0,0,1,0
23488,48,1,1,0,1,0,0,0
8704,70,2,0,0,0,0,0,0
0,0,0,0,0,0,0,0,0
0,0,0,0,0,0,0,0,0
33556,156,5,2,0,2,4,0,0
1275,29,0,2,1,1,0,0,0
0,0,0,0,0,0,0,0,0
84402,1183,4,249,244,5,2,1,0
11647,125,0,1,0,1,0,0,0
24213,363,7,58,55,3,1,0,0
0,0,0,0,0,0,0,0,0
3201,28,0,2,0,2,0,0,0
48210,214,2,2,2,0,1,0,0
0,0,0,0,0,0,0,0,0
0,0,0,0,0,0,0,0,0
0,0,0,0,0,0,0,0,0
0,0,0,0,0,0,0,0,0
0,0,0,0,0,0,0,0,0
0,0,0,0,0,0,0,0,0
0,0,0,0,0,0,0,0,0
0,0,0,0,0,0,0,0,0
10546,75,0,0,0,0,0,0,0
137473,939,3,2,1,1,166,0,0
0,0,0,0,0,0,0,0,0
0,0,0,0,0,0,0,0,0
473970,917,9,136,114,22,8,1,0
0,0,0,0,0,0,0,0,0
437964,636,9,104,83,21,9,1,0
55,3,0,0,0,0,0,0,0
2037428,3059,5,154,139,15,0,1,0
0,0,0,0,0,0,0,0,0
16462,248,3,11,2,9,0,1,0
170001,747,0,71,4,67,1,1,1
903285,1018,0,43,16,27,4,1,0
13355,178,1,9,9,0,2,1,0
94138,378,5,34,31,3,0,1,0
94141,378,5,34,31,3,0,1,0
0,0,0,0,0,0,0,0,0
0,0,0,0,0,0,0,0,0
4281,36,1,0,0,0,0,0,0
35328,350,12,90,78,12,0,1,0
287378,1158,3,203,104,99,4,1,0
0,0,0,0,0,0,0,0,0
6909,94,1,4,3,1,0,0,0
0,0,0,0,0,0,0,0,0
0,0,0,0,0,0,0,0,0
673202,555,0,4,4,0,2,1,1
0,0,0,0,0,0,0,0,0
7457,29,4,1,1,0,0,0,0
98690,561,6,75,69,6,11,0,0
173253,422,7,36,28,8,4,0,0
135498,814,0,151,10,141,14,1,0
64939,320,1,5,5,0,0,0,0
516090,1502,8,92,81,11,6,1,0
145797,537,6,2,1,1,8,0,0
0,0,0,0,0,0,0,0,0
0,0,0,0,0,0,0,0,0
0,0,0,0,0,0,0,0,0
0,0,0,0,0,0,0,0,0
48012,220,2,1,1,0,1,0,0
0,0,0,0,0,0,0,0,0
0,0,0,0,0,0,0,0,0
0,0,0,0,0,0,0,0,0
0,0,0,0,0,0,0,0,0
48216,214,2,2,2,0,1,0,0
0,0,0,0,0,0,0,0,0
54772,58,1,1,1,0,6,0,0
7492,57,6,3,2,1,0,0,0
673254,555,0,4,4,0,2,1,1
0,0,0,0,0,0,0,0,0
0,0,0,0,0,0,0,0,0
0,0,0,0,0,0,0,0,0
0,0,0,0,0,0,0,0,0
0,0,0,0,0,0,0,0,0
0,0,0,0,0,0,0,0,0
0,0,0,0,0,0,0,0,0
0,0,0,0,0,0,0,0,0
0,0,0,0,0,0,0,0,0
667318,62,4,3,3,0,2,1,0
0,0,0,0,0,0,0,0,0
0,0,0,0,0,0,0,0,0
0,0,0,0,0,0,0,0,0
69764,192,0,33,29,4,0,0,0
57813,772,7,96,84,12,0,1,0
673931,555,0,4,4,0,2,1,1
0,0,0,0,0,0,0,0,0
128237,363,5,1,1,0,5,0,0
0,0,0,0,0,0,0,0,0
0,0,0,0,0,0,0,0,0
64579,624,3,2,2,0,3,0,0
672496,555,0,4,0,4,2,1,1
2025652,3059,5,154,139,15,0,1,0
0,0,0,0,0,0,0,0,0
0,0,0,0,0,0,0,0,0
59375,297,1,5,5,0,0,0,0
0,0,0,0,0,0,0,0,0
37884,259,11,32,28,4,0,0,0
0,0,0,0,0,0,0,0,0
0,0,0,0,0,0,0,0,0
0,0,0,0,0,0,0,0,0
46539,195,2,2,1,1,1,0,0
0,0,0,0,0,0,0,0,0
38908,211,7,23,23,0,0,1,0
0,0,0,0,0,0,0,0,0
0,0,0,0,0,0,0,0,0
32530,206,0,48,46,2,1,1,0
134007,236,2,26,25,1,3,1,0
0,0,0,0,0,0,0,0,0
0,0,0,0,0,0,0,0,0
0,0,0,0,0,0,0,0,0
179235,725,11,65,54,11,0,1,0
0,0,0,0,0,0,0,0,0
902926,2948,5,547,441,106,1,1,0
0,0,0,0,0,0,0,0,0
0,0,0,0,0,0,0,0,0
564937,1849,0,85,36,49,2,1,1
562582,1824,0,85,36,49,2,1,1
0,0,0,0,0,0,0,0,0
0,0,0,0,0,0,0,0,0
2190,29,7,1,1,0,0,0,0
212754,670,14,61,40,21,7,1,0
212610,670,14,61,12,49,7,1,0
902926,2948,5,547,441,106,1,1,0
0,0,0,0,0,0,0,0,0
5103,57,6,3,2,1,0,0,0
0,0,0,0,0,0,0,0,0
0,0,0,0,0,0,0,0,0
671262,555,0,4,4,0,2,1,1
222223,189,2,6,3,3,1,0,0
670818,555,0,4,4,0,2,1,1
0,0,0,0,0,0,0,0,0
0,0,0,0,0,0,0,0,0
0,0,0,0,0,0,0,0,0
2010464,175,1,3,0,3,3,1,0
52655,353,9,80,40,40,9,1,0
0,0,0,0,0,0,0,0,0
0,0,0,0,0,0,0,0,0
0,0,0,0,0,0,0,0,0
7238,35,2,0,0,0,0,0,0
5155,45,0,2,1,1,1,0,0
0,0,0,0,0,0,0,0,0
673374,555,0,4,4,0,2,1,1
0,0,0,0,0,0,0,0,0
31951,57,1,4,4,0,0,0,0
0,0,0,0,0,0,0,0,0
24080,177,1,19,19,0,1,0,0
13938,150,0,7,5,2,4,1,0
83324,571,13,75,5,70,4,1,0
0,0,0,0,0,0,0,0,0
0,0,0,0,0,0,0,0,0
0,0,0,0,0,0,0,0,0
0,0,0,0,0,0,0,0,0
0,0,0,0,0,0,0,0,0
46258,365,2,0,0,0,12,1,0
0,0,0,0,0,0,0,0,0
0,0,0,0,0,0,0,0,0
288500,1160,3,203,28,175,4,1,0
0,0,0,0,0,0,0,0,0
21028,231,0,23,11,12,0,1,0
675246,555,0,4,0,4,2,1,1
54263,287,1,5,5,0,0,0,0
0,0,0,0,0,0,0,0,0
19816,209,7,20,20,0,0,1,0
0,0,0,0,0,0,0,0,0
0,0,0,0,0,0,0,0,0
131351,204,3,3,3,0,8,0,0
28579,144,3,2,0,2,8,0,0
0,0,0,0,0,0,0,0,0
670708,555,0,4,4,0,2,1,1
26507,315,7,57,57,0,0,0,0
0,0,0,0,0,0,0,0,0
0,0,0,0,0,0,0,0,0
0,0,0,0,0,0,0,0,0
0,0,0,0,0,0,0,0,0
0,0,0,0,0,0,0,0,0
0,0,0,0,0,0,0,0,0
0,0,0,0,0,0,0,0,0
0,0,0,0,0,0,0,0,0
152888,154,6,0,0,0,0,0,0
673631,555,0,4,4,0,2,1,1
0,0,0,0,0,0,0,0,0
0,0,0,0,0,0,0,0,0
116406,698,16,68,62,6,7,1,0
0,0,0,0,0,0,0,0,0
0,0,0,0,0,0,0,0,0
0,0,0,0,0,0,0,0,0
0,0,0,0,0,0,0,0,0
0,0,0,0,0,0,0,0,0
0,0,0,0,0,0,0,0,0
0,0,0,0,0,0,0,0,0
1761,28,0,1,0,1,0,0,0
1761,28,0,1,0,1,0,0,0
0,0,0,0,0,0,0,0,0
0,0,0,0,0,0,0,0,0
0,0,0,0,0,0,0,0,0
0,0,0,0,0,0,0,0,0
0,0,0,0,0,0,0,0,0
2123,40,2,5,3,2,0,0,0
670417,555,0,4,4,0,2,1,1
227452,1692,9,583,533,50,14,1,0
0,0,0,0,0,0,0,0,0
7722,52,2,0,0,0,0,0,0
7722,52,2,0,0,0,0,0,0
644841,80,0,2,1,1,1,1,0
644841,80,0,2,1,1,1,1,0
672205,555,0,4,4,0,2,1,1
0,0,0,0,0,0,0,0,0
0,0,0,0,0,0,0,0,0
0,0,0,0,0,0,0,0,0
0,0,0,0,0,0,0,0,0
672623,555,0,4,0,4,2,1,1
39483,222,2,73,72,1,5,1,0
0,0,0,0,0,0,0,0,0
0,0,0,0,0,0,0,0,0
0,0,0,0,0,0,0,0,0
0,0,0,0,0,0,0,0,0
0,0,0,0,0,0,0,0,0
0,0,0,0,0,0,0,0,0
0,0,0,0,0,0,0,0,0
0,0,0,0,0,0,0,0,0
0,0,0,0,0,0,0,0,0
0,0,0,0,0,0,0,0,0
0,0,0,0,0,0,0,0,0
0,0,0,0,0,0,0,0,0
0,0,0,0,0,0,0,0,0
672978,555,0,4,4,0,2,1,1
59862,414,3,137,6,131,5,0,1
83666,179,3,8,6,2,6,1,0
0,0,0,0,0,0,0,0,0
0,0,0,0,0,0,0,0,0
288137,762,3,224,113,111,0,1,0
0,0,0,0,0,0,0,0,0
45419,46,1,0,0,0,1,0,0
45419,46,1,0,0,0,1,0,0
0,0,0,0,0,0,0,0,0
0,0,0,0,0,0,0,0,0
0,0,0,0,0,0,0,0,0
0,0,0,0,0,0,0,0,0
0,0,0,0,0,0,0,0,0
0,0,0,0,0,0,0,0,0
0,0,0,0,0,0,0,0,0
0,0,0,0,0,0,0,0,0
0,0,0,0,0,0,0,0,0
0,0,0,0,0,0,0,0,0
0,0,0,0,0,0,0,0,0
0,0,0,0,0,0,0,0,0
0,0,0,0,0,0,0,0,0
0,0,0,0,0,0,0,0,0
0,0,0,0,0,0,0,0,0
0,0,0,0,0,0,0,0,0
254169,1082,1,259,221,38,3,0,0
254169,1082,1,259,220,39,3,0,0
0,0,0,0,0,0,0,0,0
136322,318,11,12,11,1,2,0,0
124068,771,9,61,53,8,2,1,0
0,0,0,0,0,0,0,0,0
0,0,0,0,0,0,0,0,0
0,0,0,0,0,0,0,0,0
0,0,0,0,0,0,0,0,0
0,0,0,0,0,0,0,0,0
45633,475,3,57,57,0,2,0,0
0,0,0,0,0,0,0,0,0
263474,2346,7,538,536,2,0,1,0
0,0,0,0,0,0,0,0,0
1867,36,2,0,0,0,2,0,0
1867,36,2,0,0,0,2,0,0
74264,892,3,80,76,4,5,1,0
0,0,0,0,0,0,0,0,0
0,0,0,0,0,0,0,0,0
613298,2104,1,88,35,53,3,1,1
490624,1755,0,81,35,46,2,1,1
0,0,0,0,0,0,0,0,0
0,0,0,0,0,0,0,0,0
3771,75,0,10,10,0,0,0,0
74264,892,3,80,76,4,5,1,0
0,0,0,0,0,0,0,0,0
0,0,0,0,0,0,0,0,0
49047,804,5,100,98,2,1,0,0
0,0,0,0,0,0,0,0,0
95705,127,0,11,4,7,0,1,0
8911,34,0,2,2,0,0,0,0
15231,35,0,2,2,0,0,0,0
8911,34,0,2,2,0,0,0,0
25955,28,0,1,0,1,0,0,0
25955,28,0,1,0,1,0,0,0
25955,28,0,1,0,1,0,0,0
25955,28,0,1,0,1,0,0,0
0,0,0,0,0,0,0,0,0
0,0,0,0,0,0,0,0,0
60455,379,1,6,4,2,0,0,0
0,0,0,0,0,0,0,0,0
8911,34,0,2,2,0,0,0,0
0,0,0,0,0,0,0,0,0
0,0,0,0,0,0,0,0,0
0,0,0,0,0,0,0,0,0
0,0,0,0,0,0,0,0,0
0,0,0,0,0,0,0,0,0
278534,1109,15,66,64,2,2,1,0
677336,556,0,4,0,4,2,1,1
672728,555,0,4,0,4,2,1,1
0,0,0,0,0,0,0,0,0
0,0,0,0,0,0,0,0,0
66523,56,0,2,2,0,0,1,0
0,0,0,0,0,0,0,0,0
7722,52,2,0,0,0,0,0,0
7722,52,2,0,0,0,0,0,0
0,0,0,0,0,0,0,0,0
0,0,0,0,0,0,0,0,0
0,0,0,0,0,0,0,0,0
0,0,0,0,0,0,0,0,0
0,0,0,0,0,0,0,0,0
0,0,0,0,0,0,0,0,0
0,0,0,0,0,0,0,0,0
0,0,0,0,0,0,0,0,0
3385,41,0,6,0,6,0,0,0
0,0,0,0,0,0,0,0,0
45352,338,3,8,6,2,1,0,0
136596,44,4,1,1,0,2,0,0
4125,11,0,0,0,0,0,0,0
8911,34,0,2,2,0,0,0,0
0,0,0,0,0,0,0,0,0
0,0,0,0,0,0,0,0,0
10765,87,1,10,6,4,3,1,0
5088,89,3,20,16,4,1,1,0
148367,424,2,21,17,4,0,1,0
0,0,0,0,0,0,0,0,0
81363,191,3,12,7,5,5,1,0
0,0,0,0,0,0,0,0,0
0,0,0,0,0,0,0,0,0
21196,142,2,12,10,2,4,1,0
4394,25,0,1,0,1,0,0,0
4394,25,0,1,0,1,0,0,0
0,0,0,0,0,0,0,0,0
0,0,0,0,0,0,0,0,0
0,0,0,0,0,0,0,0,0
49361,583,6,80,69,11,0,1,0
0,0,0,0,0,0,0,0,0
0,0,0,0,0,0,0,0,0
8347,45,0,1,1,0,15,0,0
7556,98,1,4,4,0,0,1,0
0,0,0,0,0,0,0,0,0
0,0,0,0,0,0,0,0,0
0,0,0,0,0,0,0,0,0
0,0,0,0,0,0,0,0,0
0,0,0,0,0,0,0,0,0
0,0,0,0,0,0,0,0,0
0,0,0,0,0,0,0,0,0
0,0,0,0,0,0,0,0,0
0,0,0,0,0,0,0,0,0
671030,555,0,4,4,0,2,1,1
0,0,0,0,0,0,0,0,0
675891,555,0,4,0,4,2,1,1
249850,1530,1,290,243,47,1,1,0
249862,1530,1,290,243,47,1,1,0
0,0,0,0,0,0,0,0,0
0,0,0,0,0,0,0,0,0
0,0,0,0,0,0,0,0,0
207588,1068,1,259,221,38,3,0,0
207588,1068,1,259,225,34,3,0,0
0,0,0,0,0,0,0,0,0
249862,1530,1,290,243,47,1,1,0
249851,1530,1,290,243,47,1,1,0
0,0,0,0,0,0,0,0,0
0,0,0,0,0,0,0,0,0
2678,43,3,1,0,1,0,0,0
2678,43,3,1,0,1,0,0,0
0,0,0,0,0,0,0,0,0
2678,43,3,1,0,1,0,0,0
0,0,0,0,0,0,0,0,0
2678,43,3,1,0,1,0,0,0
0,0,0,0,0,0,0,0,0
2678,43,3,1,0,1,0,0,0
2678,43,3,1,0,1,0,0,0
2678,43,3,1,0,1,0,0,0
10970,75,0,0,0,0,0,0,0
108959,84,0,4,3,1,0,1,0
15297,50,2,0,0,0,2,0,0
7217,35,2,0,0,0,0,0,0
0,0,0,0,0,0,0,0,0
34415,50,2,0,0,0,2,0,0
0,0,0,0,0,0,0,0,0
0,0,0,0,0,0,0,0,0
7722,52,2,0,0,0,0,0,0
7722,52,2,0,0,0,0,0,0
7722,52,2,0,0,0,0,0,0
7722,52,2,0,0,0,0,0,0
7722,52,2,0,0,0,0,0,0
7722,52,2,0,0,0,0,0,0
7722,52,2,0,0,0,0,0,0
7722,52,2,0,0,0,0,0,0
7722,52,2,0,0,0,0,0,0
7722,52,2,0,0,0,0,0,0
0,0,0,0,0,0,0,0,0
0,0,0,0,0,0,0,0,0
0,0,0,0,0,0,0,0,0
0,0,0,0,0,0,0,0,0
0,0,0,0,0,0,0,0,0
0,0,0,0,0,0,0,0,0
0,0,0,0,0,0,0,0,0
7195,35,2,0,0,0,0,0,0
0,0,0,0,0,0,0,0,0
0,0,0,0,0,0,0,0,0
0,0,0,0,0,0,0,0,0
36627,51,3,0,0,0,2,0,0
74554,289,1,0,0,0,7,0,0
0,0,0,0,0,0,0,0,0
0,0,0,0,0,0,0,0,0
0,0,0,0,0,0,0,0,0
0,0,0,0,0,0,0,0,0
0,0,0,0,0,0,0,0,0
0,0,0,0,0,0,0,0,0
117601,696,8,32,11,21,1,0,0
3022466,267,4,6,6,0,1,1,0
0,0,0,0,0,0,0,0,0
0,0,0,0,0,0,0,0,0
139329,220,3,3,2,1,9,0,0
0,0,0,0,0,0,0,0,0
0,0,0,0,0,0,0,0,0
0,0,0,0,0,0,0,0,0
0,0,0,0,0,0,0,0,0
0,0,0,0,0,0,0,0,0
0,0,0,0,0,0,0,0,0
0,0,0,0,0,0,0,0,0
0,0,0,0,0,0,0,0,0
97305,556,6,75,69,6,11,0,0
128209,366,5,2,0,2,5,0,0
48635,210,2,0,0,0,3,0,0
129864,228,0,16,14,2,1,1,0
45336,180,2,1,0,1,1,0,0
0,0,0,0,0,0,0,0,0
28679,42,3,0,0,0,2,0,0
211760,46,5,0,0,0,0,0,0
208086,1073,1,259,221,38,3,0,0
0,0,0,0,0,0,0,0,0
88805,982,2,194,193,1,2,1,0
0,0,0,0,0,0,0,0,0
58857,900,4,163,1,162,3,1,0
0,0,0,0,0,0,0,0,0
0,0,0,0,0,0,0,0,0
79179,896,3,65,10,55,2,1,0
674706,556,0,4,4,0,2,1,1
0,0,0,0,0,0,0,0,0
124445,491,5,10,8,2,4,1,0
254169,1082,1,259,224,35,3,0,0
254169,1082,1,259,220,39,3,0,0
254169,1082,1,259,221,38,3,0,0
254169,1082,1,259,220,39,3,0,0
0,0,0,0,0,0,0,0,0
675096,556,0,4,4,0,2,1,1
0,0,0,0,0,0,0,0,0
0,0,0,0,0,0,0,0,0
0,0,0,0,0,0,0,0,0
0,0,0,0,0,0,0,0,0
10453,75,0,0,0,0,0,0,0
0,0,0,0,0,0,0,0,0
0,0,0,0,0,0,0,0,0
0,0,0,0,0,0,0,0,0
0,0,0,0,0,0,0,0,0
0,0,0,0,0,0,0,0,0
0,0,0,0,0,0,0,0,0
247164,306,7,14,6,8,1,0,0
0,0,0,0,0,0,0,0,0
46920,191,2,2,2,0,2,0,0
502083,82,3,0,0,0,1,0,0
0,0,0,0,0,0,0,0,0
0,0,0,0,0,0,0,0,0
0,0,0,0,0,0,0,0,0
0,0,0,0,0,0,0,0,0
47413,203,2,2,2,0,1,0,0
1420540,35,4,0,0,0,0,1,0
0,0,0,0,0,0,0,0,0
0,0,0,0,0,0,0,0,0
0,0,0,0,0,0,0,0,0
0,0,0,0,0,0,0,0,0
0,0,0,0,0,0,0,0,0
0,0,0,0,0,0,0,0,0
0,0,0,0,0,0,0,0,0
0,0,0,0,0,0,0,0,0
7183,103,1,5,0,5,3,1,0
443190,891,0,25,23,2,2,1,0
23799,35,0,2,1,1,0,1,0
0,0,0,0,0,0,0,0,0
677284,556,0,4,4,0,2,1,1
2081,18,0,0,0,0,0,1,0
0,0,0,0,0,0,0,0,0
0,0,0,0,0,0,0,0,0
0,0,0,0,0,0,0,0,0
6666,117,1,3,1,2,0,1,0
0,0,0,0,0,0,0,0,0
0,0,0,0,0,0,0,0,0
0,0,0,0,0,0,0,0,0
0,0,0,0,0,0,0,0,0
0,0,0,0,0,0,0,0,0
42907,475,3,7,7,0,0,0,0
22894,37,0,2,1,1,0,1,0
0,0,0,0,0,0,0,0,0
0,0,0,0,0,0,0,0,0
0,0,0,0,0,0,0,0,0
0,0,0,0,0,0,0,0,0
0,0,0,0,0,0,0,0,0
0,0,0,0,0,0,0,0,0
0,0,0,0,0,0,0,0,0
0,0,0,0,0,0,0,0,0
0,0,0,0,0,0,0,0,0
0,0,0,0,0,0,0,0,0
0,0,0,0,0,0,0,0,0
0,0,0,0,0,0,0,0,0
173132,1472,6,164,154,10,1,0,0
0,0,0,0,0,0,0,0,0
0,0,0,0,0,0,0,0,0
0,0,0,0,0,0,0,0,0
0,0,0,0,0,0,0,0,0
671132,555,0,4,4,0,2,1,1
12377,100,4,6,6,0,0,0,0
0,0,0,0,0,0,0,0,0
18189,220,2,10,10,0,0,1,0
0,0,0,0,0,0,0,0,0
0,0,0,0,0,0,0,0,0
87544,2049,2,605,605,0,0,1,0
0,0,0,0,0,0,0,0,0
0,0,0,0,0,0,0,0,0
18242,136,1,22,17,5,3,1,0
1781,23,0,0,0,0,0,0,0
38862,145,3,7,6,1,0,0,0
0,0,0,0,0,0,0,0,0
667318,62,4,3,3,0,2,1,0
0,0,0,0,0,0,0,0,0
95765,50,4,2,2,0,0,1,0
9715,213,0,52,51,1,0,1,0
38003,242,2,0,0,0,4,0,0
37272,165,3,8,4,4,10,1,0
673312,555,0,4,4,0,2,1,1
87126,497,2,21,21,0,1,0,0
54951,59,1,1,1,0,7,0,0
0,0,0,0,0,0,0,0,0
0,0,0,0,0,0,0,0,0
0,0,0,0,0,0,0,0,0
0,0,0,0,0,0,0,0,0
430162,1452,12,34,17,17,35,1,0
0,0,0,0,0,0,0,0,0
221898,727,4,148,143,5,20,1,0
0,0,0,0,0,0,0,0,0
81211,193,3,13,8,5,5,1,0
0,0,0,0,0,0,0,0,0
0,0,0,0,0,0,0,0,0
0,0,0,0,0,0,0,0,0
0,0,0,0,0,0,0,0,0
0,0,0,0,0,0,0,0,0
0,0,0,0,0,0,0,0,0
7489,49,0,3,0,3,1,0,1
0,0,0,0,0,0,0,0,0
0,0,0,0,0,0,0,0,0
0,0,0,0,0,0,0,0,0
0,0,0,0,0,0,0,0,0
0,0,0,0,0,0,0,0,0
0,0,0,0,0,0,0,0,0
0,0,0,0,0,0,0,0,0
0,0,0,0,0,0,0,0,0
81211,193,3,13,8,5,5,1,0
674701,555,0,4,4,0,2,1,1
677522,555,0,4,4,0,2,1,1
0,0,0,0,0,0,0,0,0
0,0,0,0,0,0,0,0,0
0,0,0,0,0,0,0,0,0
0,0,0,0,0,0,0,0,0
0,0,0,0,0,0,0,0,0
0,0,0,0,0,0,0,0,0
0,0,0,0,0,0,0,0,0
0,0,0,0,0,0,0,0,0
151080,404,6,26,24,2,0,1,0
48240,220,2,1,1,0,1,0,0
0,0,0,0,0,0,0,0,0
0,0,0,0,0,0,0,0,0
0,0,0,0,0,0,0,0,0
0,0,0,0,0,0,0,0,0
0,0,0,0,0,0,0,0,0
0,0,0,0,0,0,0,0,0
1154803,102,3,6,4,2,0,1,0
52768,92,3,8,6,2,0,0,0
33319,156,3,8,4,4,10,1,0
698109,551,0,5,0,5,2,1,1
676785,556,0,4,0,4,2,1,1
126538,797,10,82,71,11,1,1,0
8583,63,1,2,2,0,0,0,1
0,0,0,0,0,0,0,0,0
40039,256,9,20,18,2,11,1,0
232705,343,0,17,4,13,0,1,0
230642,344,0,17,4,13,0,1,0
0,0,0,0,0,0,0,0,0
169705,1293,10,72,64,8,2,1,0
176524,1475,9,222,221,1,3,1,0
0,0,0,0,0,0,0,0,0
0,0,0,0,0,0,0,0,0
0,0,0,0,0,0,0,0,0
0,0,0,0,0,0,0,0,0
612775,2112,1,92,39,53,3,1,1
66466,247,0,46,24,22,0,1,1
66487,247,0,46,24,22,0,1,1
66491,247,0,46,24,22,0,1,1
66492,247,0,46,24,22,0,1,1
66492,247,0,46,24,22,0,1,1
66494,247,0,46,24,22,0,1,1
0,0,0,0,0,0,0,0,0
245377,1708,16,301,271,30,4,0,0
0,0,0,0,0,0,0,0,0
0,0,0,0,0,0,0,0,0
0,0,0,0,0,0,0,0,0
0,0,0,0,0,0,0,0,0
0,0,0,0,0,0,0,0,0
8645,25,0,0,0,0,2,0,0
35774,159,3,8,4,4,11,1,0
305860,1040,0,88,48,40,1,0,0
305860,1040,0,88,79,9,1,0,0
13408,173,5,24,0,24,0,1,0
123979,266,6,55,55,0,3,1,0
703693,1030,3,59,34,25,50,1,0
0,0,0,0,0,0,0,0,0
50863,180,1,7,4,3,0,0,0
681964,556,0,4,0,4,2,1,1
3519,36,2,0,0,0,0,0,0
3445,10,0,1,0,1,0,1,0
13377,50,2,0,0,0,2,0,0
0,0,0,0,0,0,0,0,0
0,0,0,0,0,0,0,0,0
0,0,0,0,0,0,0,0,0
0,0,0,0,0,0,0,0,0
0,0,0,0,0,0,0,0,0
0,0,0,0,0,0,0,0,0
22934,63,0,3,0,3,3,1,0
23505,313,0,54,48,6,0,1,0
0,0,0,0,0,0,0,0,0
0,0,0,0,0,0,0,0,0
66605,56,0,0,0,0,0,1,0
66666,56,0,0,0,0,0,1,0
0,0,0,0,0,0,0,0,0
0,0,0,0,0,0,0,0,0
0,0,0,0,0,0,0,0,0
0,0,0,0,0,0,0,0,0
0,0,0,0,0,0,0,0,0
0,0,0,0,0,0,0,0,0
2630,40,1,2,1,1,0,0,0
675458,555,0,4,4,0,2,1,1
1318,30,2,0,0,0,0,0,0
1452,32,2,0,0,0,0,0,0
2663,34,2,0,0,0,0,0,0
0,0,0,0,0,0,0,0,0
0,0,0,0,0,0,0,0,0
0,0,0,0,0,0,0,0,0
0,0,0,0,0,0,0,0,0
0,0,0,0,0,0,0,0,0
70068,112,2,5,3,2,0,1,0
57393,572,5,23,15,8,0,1,0
0,0,0,0,0,0,0,0,0
23232,525,4,63,63,0,0,1,0
0,0,0,0,0,0,0,0,0
0,0,0,0,0,0,0,0,0
97923,41,2,0,0,0,1,0,0
0,0,0,0,0,0,0,0,0
521069,1936,0,88,35,53,3,1,1
493789,1845,0,74,30,44,2,1,1
55757,481,2,105,21,84,6,1,0
0,0,0,0,0,0,0,0,0
88805,982,2,194,193,1,2,1,0
44197,294,7,21,14,7,3,0,0
82242,270,3,27,22,5,1,1,0
15005,54,1,1,1,0,0,0,0
65479,245,0,46,24,22,0,1,1
65488,245,0,46,24,22,0,1,1
46572,376,5,81,29,52,1,1,0
0,0,0,0,0,0,0,0,0
50057,136,0,7,1,6,0,0,0
0,0,0,0,0,0,0,0,0
5550,50,0,1,0,1,0,0,0
0,0,0,0,0,0,0,0,0
0,0,0,0,0,0,0,0,0
0,0,0,0,0,0,0,0,0
2790,26,2,0,0,0,0,0,0
0,0,0,0,0,0,0,0,0
152967,290,4,10,9,1,1,1,0
152973,290,4,10,9,1,1,1,0
70283,835,7,186,183,3,5,0,0
5797,86,1,0,0,0,0,0,0
7109,55,0,2,2,0,0,0,0
7078,55,0,2,2,0,0,0,0
9378,49,5,0,0,0,3,1,0
0,0,0,0,0,0,0,0,0
0,0,0,0,0,0,0,0,0
10519,19,1,2,0,2,0,0,0
10519,19,1,2,0,2,0,0,0
0,0,0,0,0,0,0,0,0
31119,98,0,3,0,3,0,0,0
115072,780,16,30,4,26,3,1,0
316401,2302,10,308,287,21,10,0,0
673849,555,0,4,4,0,2,1,1
0,0,0,0,0,0,0,0,0
122640,145,2,2,0,2,8,0,0
0,0,0,0,0,0,0,0,0
1108737,7426,18,1926,1922,4,8,1,0
98774,903,11,129,126,3,11,1,0
0,0,0,0,0,0,0,0,0
0,0,0,0,0,0,0,0,0
12160,50,3,0,0,0,2,0,0
396051,4307,5,327,183,144,0,1,0
31660,86,2,0,0,0,1,0,0
4404,73,0,2,1,1,0,0,0
4404,73,0,2,1,1,0,0,0
4404,73,0,2,1,1,0,0,0
4404,73,0,2,1,1,0,0,0
4410,73,0,2,1,1,0,0,0
4410,73,0,2,1,1,0,0,0
4410,73,0,2,1,1,0,0,0
4410,73,0,2,1,1,0,0,0
4410,73,0,2,1,1,0,0,0
4410,73,0,2,1,1,0,0,0
4410,73,0,2,1,1,0,0,0
4410,73,0,2,1,1,0,0,0
4404,73,0,2,1,1,0,0,0
4404,73,0,2,1,1,0,0,0
0,0,0,0,0,0,0,0,0
4404,73,0,2,1,1,0,0,0
4404,73,0,2,1,1,0,0,0
4404,73,0,2,1,1,0,0,0
8911,34,0,2,2,0,0,0,0
0,0,0,0,0,0,0,0,0
0,0,0,0,0,0,0,0,0
682716,556,0,4,0,4,2,1,1
87400,602,9,29,17,12,1,0,0
55208,288,1,5,5,0,0,0,0
0,0,0,0,0,0,0,0,0
0,0,0,0,0,0,0,0,0
0,0,0,0,0,0,0,0,0
0,0,0,0,0,0,0,0,0
0,0,0,0,0,0,0,0,0
149263,2013,4,593,592,1,69,1,0
0,0,0,0,0,0,0,0,0
0,0,0,0,0,0,0,0,0
106474,432,3,138,6,132,4,0,1
0,0,0,0,0,0,0,0,0
10449,29,0,0,0,0,0,0,0
0,0,0,0,0,0,0,0,0
0,0,0,0,0,0,0,0,0
0,0,0,0,0,0,0,0,0
0,0,0,0,0,0,0,0,0
0,0,0,0,0,0,0,0,0
0,0,0,0,0,0,0,0,0
0,0,0,0,0,0,0,0,0
0,0,0,0,0,0,0,0,0
0,0,0,0,0,0,0,0,0
0,0,0,0,0,0,0,0,0
0,0,0,0,0,0,0,0,0
0,0,0,0,0,0,0,0,0
0,0,0,0,0,0,0,0,0
0,0,0,0,0,0,0,0,0
0,0,0,0,0,0,0,0,0
0,0,0,0,0,0,0,0,0
0,0,0,0,0,0,0,0,0
14888,43,4,0,0,0,0,0,0
73631,1126,8,40,34,6,20,1,0
0,0,0,0,0,0,0,0,0
5969,53,1,0,0,0,0,0,0
0,0,0,0,0,0,0,0,0
0,0,0,0,0,0,0,0,0
1537,16,0,0,0,0,0,0,0
86353,182,8,21,14,7,6,1,0
0,0,0,0,0,0,0,0,0
0,0,0,0,0,0,0,0,0
0,0,0,0,0,0,0,0,0
0,0,0,0,0,0,0,0,0
0,0,0,0,0,0,0,0,0
0,0,0,0,0,0,0,0,0
0,0,0,0,0,0,0,0,0
0,0,0,0,0,0,0,0,0
0,0,0,0,0,0,0,0,0
0,0,0,0,0,0,0,0,0
0,0,0,0,0,0,0,0,0
0,0,0,0,0,0,0,0,0
0,0,0,0,0,0,0,0,0
0,0,0,0,0,0,0,0,0
0,0,0,0,0,0,0,0,0
0,0,0,0,0,0,0,0,0
4411,57,2,3,3,0,0,0,0
0,0,0,0,0,0,0,0,0
60843,69,1,7,5,2,0,0,0
9376,49,5,0,0,0,3,1,0
0,0,0,0,0,0,0,0,0
0,0,0,0,0,0,0,0,0
0,0,0,0,0,0,0,0,0
0,0,0,0,0,0,0,0,0
0,0,0,0,0,0,0,0,0
0,0,0,0,0,0,0,0,0
207588,1068,1,259,221,38,3,0,0
673457,555,0,4,4,0,2,1,1
0,0,0,0,0,0,0,0,0
0,0,0,0,0,0,0,0,0
0,0,0,0,0,0,0,0,0
0,0,0,0,0,0,0,0,0
3189,48,0,1,1,0,0,0,0
3197,48,0,1,1,0,0,0,0
0,0,0,0,0,0,0,0,0
0,0,0,0,0,0,0,0,0
6135,76,2,5,5,0,0,1,0
0,0,0,0,0,0,0,0,0
0,0,0,0,0,0,0,0,0
0,0,0,0,0,0,0,0,0
0,0,0,0,0,0,0,0,0
59857,414,3,137,6,131,5,0,1
0,0,0,0,0,0,0,0,0
0,0,0,0,0,0,0,0,0
0,0,0,0,0,0,0,0,0
15957,224,5,35,34,1,0,1,0
0,0,0,0,0,0,0,0,0
0,0,0,0,0,0,0,0,0
114454,455,5,54,34,20,6,0,0
1131,20,1,0,0,0,0,0,0
0,0,0,0,0,0,0,0,0
0,0,0,0,0,0,0,0,0
0,0,0,0,0,0,0,0,0
0,0,0,0,0,0,0,0,0
0,0,0,0,0,0,0,0,0
0,0,0,0,0,0,0,0,0
0,0,0,0,0,0,0,0,0
0,0,0,0,0,0,0,0,0
0,0,0,0,0,0,0,0,0
168447,726,0,68,4,64,0,1,1
92288,70,1,9,9,0,6,0,0
0,0,0,0,0,0,0,0,0
0,0,0,0,0,0,0,0,0
0,0,0,0,0,0,0,0,0
0,0,0,0,0,0,0,0,0
468882,1751,0,73,28,45,2,1,1
472553,1744,0,72,30,42,2,1,1
0,0,0,0,0,0,0,0,0
0,0,0,0,0,0,0,0,0
0,0,0,0,0,0,0,0,0
137014,69,3,2,1,1,2,1,0
161342,218,4,26,18,8,2,1,0
0,0,0,0,0,0,0,0,0
0,0,0,0,0,0,0,0,0
207588,1068,1,259,220,39,3,0,0
207588,1068,1,259,220,39,3,0,0
0,0,0,0,0,0,0,0,0
0,0,0,0,0,0,0,0,0
305860,1040,0,88,48,40,1,0,0
0,0,0,0,0,0,0,0,0
494382,1768,0,16,8,8,12,0,0
0,0,0,0,0,0,0,0,0
0,0,0,0,0,0,0,0,0
0,0,0,0,0,0,0,0,0
0,0,0,0,0,0,0,0,0
0,0,0,0,0,0,0,0,0
0,0,0,0,0,0,0,0,0
305860,1040,0,88,48,40,1,0,0
305860,1040,0,88,79,9,1,0,0
0,0,0,0,0,0,0,0,0
0,0,0,0,0,0,0,0,0
0,0,0,0,0,0,0,0,0
3777,44,0,2,0,2,1,0,0
12002,47,3,5,5,0,1,0,0
0,0,0,0,0,0,0,0,0
0,0,0,0,0,0,0,0,0
0,0,0,0,0,0,0,0,0
0,0,0,0,0,0,0,0,0
0,0,0,0,0,0,0,0,0
0,0,0,0,0,0,0,0,0
0,0,0,0,0,0,0,0,0
35909,49,1,1,0,1,0,1,0
35909,49,1,1,0,1,0,1,0
0,0,0,0,0,0,0,0,0
86666,661,3,130,125,5,5,1,0
50044,69,5,2,2,0,0,0,0
50085,69,5,2,1,1,0,0,0
685968,1109,2,265,258,7,14,1,0
0,0,0,0,0,0,0,0,0
0,0,0,0,0,0,0,0,0
0,0,0,0,0,0,0,0,0
0,0,0,0,0,0,0,0,0
0,0,0,0,0,0,0,0,0
0,0,0,0,0,0,0,0,0
0,0,0,0,0,0,0,0,0
0,0,0,0,0,0,0,0,0
0,0,0,0,0,0,0,0,0
0,0,0,0,0,0,0,0,0
1349654,3271,9,32,17,15,5,1,0
0,0,0,0,0,0,0,0,0
145646,246,8,7,4,3,2,1,0
37092,51,5,1,1,0,1,1,0
0,0,0,0,0,0,0,0,0
0,0,0,0,0,0,0,0,0
0,0,0,0,0,0,0,0,0
0,0,0,0,0,0,0,0,0
0,0,0,0,0,0,0,0,0
0,0,0,0,0,0,0,0,0
0,0,0,0,0,0,0,0,0
0,0,0,0,0,0,0,0,0
0,0,0,0,0,0,0,0,0
0,0,0,0,0,0,0,0,0
0,0,0,0,0,0,0,0,0
0,0,0,0,0,0,0,0,0
0,0,0,0,0,0,0,0,0
0,0,0,0,0,0,0,0,0
52253,269,1,5,5,0,0,0,0
0,0,0,0,0,0,0,0,0
0,0,0,0,0,0,0,0,0
0,0,0,0,0,0,0,0,0
0,0,0,0,0,0,0,0,0
0,0,0,0,0,0,0,0,0
16148,89,3,7,3,4,0,1,0
0,0,0,0,0,0,0,0,0
0,0,0,0,0,0,0,0,0
0,0,0,0,0,0,0,0,0
0,0,0,0,0,0,0,0,0
0,0,0,0,0,0,0,0,0
0,0,0,0,0,0,0,0,0
0,0,0,0,0,0,0,0,0
0,0,0,0,0,0,0,0,0
0,0,0,0,0,0,0,0,0
0,0,0,0,0,0,0,0,0
17447,59,1,14,11,3,0,0,0
17431,59,1,14,11,3,0,0,0
0,0,0,0,0,0,0,0,0
0,0,0,0,0,0,0,0,0
0,0,0,0,0,0,0,0,0
0,0,0,0,0,0,0,0,0
0,0,0,0,0,0,0,0,0
0,0,0,0,0,0,0,0,0
0,0,0,0,0,0,0,0,0
0,0,0,0,0,0,0,0,0
0,0,0,0,0,0,0,0,0
0,0,0,0,0,0,0,0,0
46506,191,2,2,1,1,1,0,0
0,0,0,0,0,0,0,0,0
0,0,0,0,0,0,0,0,0
87712,159,5,2,1,1,11,1,0
42402,82,5,0,0,0,0,0,0
0,0,0,0,0,0,0,0,0
0,0,0,0,0,0,0,0,0
0,0,0,0,0,0,0,0,0
0,0,0,0,0,0,0,0,0
0,0,0,0,0,0,0,0,0
0,0,0,0,0,0,0,0,0
0,0,0,0,0,0,0,0,0
124955,905,8,85,80,5,4,1,0
0,0,0,0,0,0,0,0,0
0,0,0,0,0,0,0,0,0
9569,102,1,2,0,2,0,0,0
704087,552,0,5,0,5,2,1,1
676104,555,0,4,0,4,2,1,1
0,0,0,0,0,0,0,0,0
0,0,0,0,0,0,0,0,0
122045,76,2,1,1,0,0,1,0
0,0,0,0,0,0,0,0,0
1192700,227,3,50,50,0,1,1,0
0,0,0,0,0,0,0,0,0
0,0,0,0,0,0,0,0,0
0,0,0,0,0,0,0,0,0
0,0,0,0,0,0,0,0,0
0,0,0,0,0,0,0,0,0
0,0,0,0,0,0,0,0,0
0,0,0,0,0,0,0,0,0
0,0,0,0,0,0,0,0,0
0,0,0,0,0,0,0,0,0
1819261,53,2,1,1,0,0,1,0
0,0,0,0,0,0,0,0,0
0,0,0,0,0,0,0,0,0
12516,59,0,0,0,0,0,0,0
0,0,0,0,0,0,0,0,0
0,0,0,0,0,0,0,0,0
0,0,0,0,0,0,0,0,0
0,0,0,0,0,0,0,0,0
0,0,0,0,0,0,0,0,0
341777,180,6,5,0,5,0,1,0
436885,52,2,1,1,0,0,1,0
0,0,0,0,0,0,0,0,0
0,0,0,0,0,0,0,0,0
0,0,0,0,0,0,0,0,0
0,0,0,0,0,0,0,0,0
48243,211,2,2,1,1,1,0,0
27845,155,5,5,2,3,1,0,0
675087,556,0,4,4,0,2,1,1
0,0,0,0,0,0,0,0,0
0,0,0,0,0,0,0,0,0
79761,69,2,5,4,1,2,1,0
225415,1076,8,123,120,3,4,1,0
29792,175,5,7,1,6,1,0,0
0,0,0,0,0,0,0,0,0
0,0,0,0,0,0,0,0,0
0,0,0,0,0,0,0,0,0
0,0,0,0,0,0,0,0,0
0,0,0,0,0,0,0,0,0
0,0,0,0,0,0,0,0,0
3292,37,0,1,1,0,0,0,0
3292,37,0,1,1,0,0,0,0
0,0,0,0,0,0,0,0,0
0,0,0,0,0,0,0,0,0
0,0,0,0,0,0,0,0,0
0,0,0,0,0,0,0,0,0
0,0,0,0,0,0,0,0,0
0,0,0,0,0,0,0,0,0
0,0,0,0,0,0,0,0,0
0,0,0,0,0,0,0,0,0
0,0,0,0,0,0,0,0,0
0,0,0,0,0,0,0,0,0
0,0,0,0,0,0,0,0,0
0,0,0,0,0,0,0,0,0
0,0,0,0,0,0,0,0,0
0,0,0,0,0,0,0,0,0
0,0,0,0,0,0,0,0,0
0,0,0,0,0,0,0,0,0
0,0,0,0,0,0,0,0,0
0,0,0,0,0,0,0,0,0
0,0,0,0,0,0,0,0,0
0,0,0,0,0,0,0,0,0
0,0,0,0,0,0,0,0,0
0,0,0,0,0,0,0,0,0
0,0,0,0,0,0,0,0,0
26216,35,4,0,0,0,3,0,0
26111,35,4,0,0,0,3,0,0
88792,60,0,5,5,0,0,1,0
1156394,360,1,19,14,5,0,1,0
0,0,0,0,0,0,0,0,0
118438,90,2,3,2,1,3,1,0
65394,245,0,46,24,22,0,1,1
65395,245,0,46,24,22,0,1,1
0,0,0,0,0,0,0,0,0
0,0,0,0,0,0,0,0,0
0,0,0,0,0,0,0,0,0
0,0,0,0,0,0,0,0,0
0,0,0,0,0,0,0,0,0
0,0,0,0,0,0,0,0,0
0,0,0,0,0,0,0,0,0
0,0,0,0,0,0,0,0,0
0,0,0,0,0,0,0,0,0
0,0,0,0,0,0,0,0,0
0,0,0,0,0,0,0,0,0
0,0,0,0,0,0,0,0,0
0,0,0,0,0,0,0,0,0
0,0,0,0,0,0,0,0,0
0,0,0,0,0,0,0,0,0
0,0,0,0,0,0,0,0,0
0,0,0,0,0,0,0,0,0
0,0,0,0,0,0,0,0,0
0,0,0,0,0,0,0,0,0
0,0,0,0,0,0,0,0,0
0,0,0,0,0,0,0,0,0
0,0,0,0,0,0,0,0,0
0,0,0,0,0,0,0,0,0
0,0,0,0,0,0,0,0,0
0,0,0,0,0,0,0,0,0
0,0,0,0,0,0,0,0,0
0,0,0,0,0,0,0,0,0
0,0,0,0,0,0,0,0,0
0,0,0,0,0,0,0,0,0
0,0,0,0,0,0,0,0,0
55757,481,2,105,21,84,6,1,0
0,0,0,0,0,0,0,0,0
0,0,0,0,0,0,0,0,0
0,0,0,0,0,0,0,0,0
0,0,0,0,0,0,0,0,0
0,0,0,0,0,0,0,0,0
13130,29,1,0,0,0,3,0,0
0,0,0,0,0,0,0,0,0
0,0,0,0,0,0,0,0,0
0,0,0,0,0,0,0,0,0
0,0,0,0,0,0,0,0,0
0,0,0,0,0,0,0,0,0
0,0,0,0,0,0,0,0,0
196082,2336,4,427,6,421,4,1,0
0,0,0,0,0,0,0,0,0
0,0,0,0,0,0,0,0,0
0,0,0,0,0,0,0,0,0
0,0,0,0,0,0,0,0,0
0,0,0,0,0,0,0,0,0
0,0,0,0,0,0,0,0,0
0,0,0,0,0,0,0,0,0
0,0,0,0,0,0,0,0,0
8339,123,1,3,1,2,0,1,0
8339,123,1,3,1,2,0,1,0
5871,43,3,4,4,0,0,0,0
0,0,0,0,0,0,0,0,0
0,0,0,0,0,0,0,0,0
0,0,0,0,0,0,0,0,0
0,0,0,0,0,0,0,0,0
0,0,0,0,0,0,0,0,0
0,0,0,0,0,0,0,0,0
0,0,0,0,0,0,0,0,0
0,0,0,0,0,0,0,0,0
0,0,0,0,0,0,0,0,0
0,0,0,0,0,0,0,0,0
778,15,0,2,0,2,0,0,0
0,0,0,0,0,0,0,0,0
35714,171,6,4,1,3,1,0,0
0,0,0,0,0,0,0,0,0
0,0,0,0,0,0,0,0,0
0,0,0,0,0,0,0,0,0
0,0,0,0,0,0,0,0,0
0,0,0,0,0,0,0,0,0
0,0,0,0,0,0,0,0,0
0,0,0,0,0,0,0,0,0
0,0,0,0,0,0,0,0,0
0,0,0,0,0,0,0,0,0
0,0,0,0,0,0,0,0,0
0,0,0,0,0,0,0,0,0
3385,41,0,6,0,6,0,0,0
0,0,0,0,0,0,0,0,0
0,0,0,0,0,0,0,0,0
0,0,0,0,0,0,0,0,0
5612,39,1,0,0,0,1,0,0
5612,39,1,0,0,0,1,0,0
0,0,0,0,0,0,0,0,0
0,0,0,0,0,0,0,0,0
0,0,0,0,0,0,0,0,0
0,0,0,0,0,0,0,0,0
0,0,0,0,0,0,0,0,0
0,0,0,0,0,0,0,0,0
24239,426,3,87,85,2,1,1,0
0,0,0,0,0,0,0,0,0
0,0,0,0,0,0,0,0,0
45504,440,2,19,8,11,0,1,0
0,0,0,0,0,0,0,0,0
0,0,0,0,0,0,0,0,0
0,0,0,0,0,0,0,0,0
42402,82,5,0,0,0,0,0,0
0,0,0,0,0,0,0,0,0
0,0,0,0,0,0,0,0,0
0,0,0,0,0,0,0,0,0
675641,556,0,4,4,0,2,1,1
0,0,0,0,0,0,0,0,0
128293,365,5,1,1,0,5,0,0
0,0,0,0,0,0,0,0,0
3385,41,0,6,0,6,0,0,0
0,0,0,0,0,0,0,0,0
0,0,0,0,0,0,0,0,0
0,0,0,0,0,0,0,0,0
0,0,0,0,0,0,0,0,0
0,0,0,0,0,0,0,0,0
0,0,0,0,0,0,0,0,0
0,0,0,0,0,0,0,0,0
562057,434,5,21,20,1,0,1,0
0,0,0,0,0,0,0,0,0
0,0,0,0,0,0,0,0,0
43213,468,2,66,3,63,2,0,0
0,0,0,0,0,0,0,0,0
0,0,0,0,0,0,0,0,0
0,0,0,0,0,0,0,0,0
0,0,0,0,0,0,0,0,0
0,0,0,0,0,0,0,0,0
57095,299,1,6,4,2,0,0,0
0,0,0,0,0,0,0,0,0
0,0,0,0,0,0,0,0,0
250306,179,4,26,18,8,2,1,0
0,0,0,0,0,0,0,0,0
0,0,0,0,0,0,0,0,0
0,0,0,0,0,0,0,0,0
0,0,0,0,0,0,0,0,0
0,0,0,0,0,0,0,0,0
0,0,0,0,0,0,0,0,0
0,0,0,0,0,0,0,0,0
0,0,0,0,0,0,0,0,0
0,0,0,0,0,0,0,0,0
0,0,0,0,0,0,0,0,0
36493,81,1,1,1,0,0,0,0
39069,380,3,33,18,15,7,1,0
39069,380,3,33,24,9,7,1,0
0,0,0,0,0,0,0,0,0
0,0,0,0,0,0,0,0,0
475763,1819,0,76,28,48,2,1,1
500576,1853,0,86,35,51,2,1,1
0,0,0,0,0,0,0,0,0
0,0,0,0,0,0,0,0,0
0,0,0,0,0,0,0,0,0
0,0,0,0,0,0,0,0,0
0,0,0,0,0,0,0,0,0
0,0,0,0,0,0,0,0,0
0,0,0,0,0,0,0,0,0
10340,69,0,1,1,0,0,0,0
10340,69,0,1,1,0,0,0,0
0,0,0,0,0,0,0,0,0
22601,34,0,1,1,0,0,1,0
0,0,0,0,0,0,0,0,0
0,0,0,0,0,0,0,0,0
0,0,0,0,0,0,0,0,0
0,0,0,0,0,0,0,0,0
0,0,0,0,0,0,0,0,0
0,0,0,0,0,0,0,0,0
0,0,0,0,0,0,0,0,0
0,0,0,0,0,0,0,0,0
0,0,0,0,0,0,0,0,0
0,0,0,0,0,0,0,0,0
0,0,0,0,0,0,0,0,0
0,0,0,0,0,0,0,0,0
0,0,0,0,0,0,0,0,0
0,0,0,0,0,0,0,0,0
0,0,0,0,0,0,0,0,0
0,0,0,0,0,0,0,0,0
0,0,0,0,0,0,0,0,0
2318,49,0,1,1,0,0,0,0
2318,49,0,1,1,0,0,0,0
39072,380,3,33,18,15,7,1,0
39069,380,3,33,24,9,7,1,0
0,0,0,0,0,0,0,0,0
0,0,0,0,0,0,0,0,0
0,0,0,0,0,0,0,0,0
0,0,0,0,0,0,0,0,0
0,0,0,0,0,0,0,0,0
0,0,0,0,0,0,0,0,0
0,0,0,0,0,0,0,0,0
0,0,0,0,0,0,0,0,0
0,0,0,0,0,0,0,0,0
0,0,0,0,0,0,0,0,0
139952,306,3,11,3,8,2,0,0
0,0,0,0,0,0,0,0,0
0,0,0,0,0,0,0,0,0
139952,306,3,11,3,8,2,0,0
139952,306,3,11,3,8,2,0,0
0,0,0,0,0,0,0,0,0
0,0,0,0,0,0,0,0,0
0,0,0,0,0,0,0,0,0
0,0,0,0,0,0,0,0,0
0,0,0,0,0,0,0,0,0
0,0,0,0,0,0,0,0,0
1017951,864,0,244,239,5,0,1,0
0,0,0,0,0,0,0,0,0
0,0,0,0,0,0,0,0,0
0,0,0,0,0,0,0,0,0
199815,55,6,1,1,0,1,0,0
785035,729,1,14,14,0,0,1,0
0,0,0,0,0,0,0,0,0
0,0,0,0,0,0,0,0,0
0,0,0,0,0,0,0,0,0
250306,179,4,26,18,8,2,1,0
656814,1119,5,298,296,2,11,1,0
0,0,0,0,0,0,0,0,0
0,0,0,0,0,0,0,0,0
0,0,0,0,0,0,0,0,0
0,0,0,0,0,0,0,0,0
0,0,0,0,0,0,0,0,0
0,0,0,0,0,0,0,0,0
16152,35,0,5,1,4,0,0,0
0,0,0,0,0,0,0,0,0
0,0,0,0,0,0,0,0,0
0,0,0,0,0,0,0,0,0
0,0,0,0,0,0,0,0,0
0,0,0,0,0,0,0,0,0
0,0,0,0,0,0,0,0,0
0,0,0,0,0,0,0,0,0
0,0,0,0,0,0,0,0,0
0,0,0,0,0,0,0,0,0
0,0,0,0,0,0,0,0,0
0,0,0,0,0,0,0,0,0
0,0,0,0,0,0,0,0,0
0,0,0,0,0,0,0,0,0
0,0,0,0,0,0,0,0,0
0,0,0,0,0,0,0,0,0
0,0,0,0,0,0,0,0,0
0,0,0,0,0,0,0,0,0
0,0,0,0,0,0,0,0,0
0,0,0,0,0,0,0,0,0
0,0,0,0,0,0,0,0,0
72632,139,2,2,2,0,4,0,0
0,0,0,0,0,0,0,0,0
0,0,0,0,0,0,0,0,0
0,0,0,0,0,0,0,0,0
13378,26,0,1,0,1,0,0,0
13378,26,0,1,0,1,0,0,0
0,0,0,0,0,0,0,0,0
92467,1041,2,60,33,27,2,1,0
28595,45,0,4,1,3,0,0,0
0,0,0,0,0,0,0,0,0
0,0,0,0,0,0,0,0,0
0,0,0,0,0,0,0,0,0
9641,62,0,0,0,0,0,0,0
0,0,0,0,0,0,0,0,0
0,0,0,0,0,0,0,0,0
105675,733,12,31,27,4,3,1,0
0,0,0,0,0,0,0,0,0
408926,98,7,0,0,0,3,0,0
0,0,0,0,0,0,0,0,0
0,0,0,0,0,0,0,0,0
0,0,0,0,0,0,0,0,0
41928,277,5,22,19,3,9,0,0
41886,277,5,22,19,3,9,0,0
0,0,0,0,0,0,0,0,0
0,0,0,0,0,0,0,0,0
0,0,0,0,0,0,0,0,0
13134,150,1,4,0,4,0,1,0
54272,486,5,21,13,8,0,1,0
0,0,0,0,0,0,0,0,0
0,0,0,0,0,0,0,0,0
0,0,0,0,0,0,0,0,0
0,0,0,0,0,0,0,0,0
53257,274,1,25,5,20,18,1,0
0,0,0,0,0,0,0,0,0
0,0,0,0,0,0,0,0,0
1555,27,1,7,2,5,0,1,0
394797,3102,9,684,679,5,4,1,0
88477,474,10,77,54,23,0,0,0
56223,604,6,130,129,1,4,1,0
0,0,0,0,0,0,0,0,0
27327,146,6,6,3,3,1,0,0
5333,55,1,0,0,0,1,0,0
5333,55,1,0,0,0,1,0,0
0,0,0,0,0,0,0,0,0
0,0,0,0,0,0,0,0,0
0,0,0,0,0,0,0,0,0
0,0,0,0,0,0,0,0,0
0,0,0,0,0,0,0,0,0
0,0,0,0,0,0,0,0,0
0,0,0,0,0,0,0,0,0
0,0,0,0,0,0,0,0,0
0,0,0,0,0,0,0,0,0
0,0,0,0,0,0,0,0,0
0,0,0,0,0,0,0,0,0
0,0,0,0,0,0,0,0,0
0,0,0,0,0,0,0,0,0
120629,925,10,88,71,17,3,1,0
0,0,0,0,0,0,0,0,0
0,0,0,0,0,0,0,0,0
0,0,0,0,0,0,0,0,0
0,0,0,0,0,0,0,0,0
0,0,0,0,0,0,0,0,0
0,0,0,0,0,0,0,0,0
0,0,0,0,0,0,0,0,0
35387,301,8,26,23,3,9,1,0
0,0,0,0,0,0,0,0,0
0,0,0,0,0,0,0,0,0
0,0,0,0,0,0,0,0,0
0,0,0,0,0,0,0,0,0
28452,152,5,11,7,4,0,1,0
0,0,0,0,0,0,0,0,0
28723,108,3,4,4,0,1,0,0
6334,74,0,4,1,3,0,0,0
0,0,0,0,0,0,0,0,0
0,0,0,0,0,0,0,0,0
0,0,0,0,0,0,0,0,0
0,0,0,0,0,0,0,0,0
0,0,0,0,0,0,0,0,0
0,0,0,0,0,0,0,0,0
0,0,0,0,0,0,0,0,0
0,0,0,0,0,0,0,0,0
2318,49,0,1,1,0,0,0,0
2318,49,0,1,1,0,0,0,0
0,0,0,0,0,0,0,0,0
0,0,0,0,0,0,0,0,0
0,0,0,0,0,0,0,0,0
0,0,0,0,0,0,0,0,0
229529,1263,11,171,157,14,4,0,0
0,0,0,0,0,0,0,0,0
68557,428,11,54,51,3,5,0,0
55750,459,1,15,14,1,2,1,0
423324,6426,5,1058,12,1046,5,1,0
675192,556,0,4,4,0,2,1,1
66067,245,0,46,24,22,0,1,1
66065,245,0,46,24,22,0,1,1
0,0,0,0,0,0,0,0,0
0,0,0,0,0,0,0,0,0
0,0,0,0,0,0,0,0,0
0,0,0,0,0,0,0,0,0
0,0,0,0,0,0,0,0,0
0,0,0,0,0,0,0,0,0
0,0,0,0,0,0,0,0,0
0,0,0,0,0,0,0,0,0
0,0,0,0,0,0,0,0,0
81598,191,3,12,7,5,5,1,0
0,0,0,0,0,0,0,0,0
0,0,0,0,0,0,0,0,0
0,0,0,0,0,0,0,0,0
0,0,0,0,0,0,0,0,0
0,0,0,0,0,0,0,0,0
0,0,0,0,0,0,0,0,0
2752355,34,4,0,0,0,0,1,0
0,0,0,0,0,0,0,0,0
0,0,0,0,0,0,0,0,0
0,0,0,0,0,0,0,0,0
0,0,0,0,0,0,0,0,0
0,0,0,0,0,0,0,0,0
0,0,0,0,0,0,0,0,0
0,0,0,0,0,0,0,0,0
0,0,0,0,0,0,0,0,0
0,0,0,0,0,0,0,0,0
0,0,0,0,0,0,0,0,0
0,0,0,0,0,0,0,0,0
0,0,0,0,0,0,0,0,0
0,0,0,0,0,0,0,0,0
0,0,0,0,0,0,0,0,0
19129,299,3,47,47,0,2,1,0
48216,579,10,80,78,2,0,1,0
56527,695,1,98,70,28,11,0,0
6696,46,4,1,1,0,2,1,0
441806,261,9,6,1,5,8,1,0
0,0,0,0,0,0,0,0,0
25261,307,6,38,5,33,7,1,0
0,0,0,0,0,0,0,0,0
197067,1573,18,292,287,5,21,1,0
0,0,0,0,0,0,0,0,0
0,0,0,0,0,0,0,0,0
0,0,0,0,0,0,0,0,0
0,0,0,0,0,0,0,0,0
0,0,0,0,0,0,0,0,0
16100,35,0,5,1,4,0,0,0
0,0,0,0,0,0,0,0,0
0,0,0,0,0,0,0,0,0
15927,167,0,14,0,14,2,1,0
0,0,0,0,0,0,0,0,0
83187,646,11,67,5,62,1,1,0
0,0,0,0,0,0,0,0,0
66540,345,1,5,5,0,0,0,0
13110,108,1,0,0,0,0,0,0
0,0,0,0,0,0,0,0,0
0,0,0,0,0,0,0,0,0
0,0,0,0,0,0,0,0,0
0,0,0,0,0,0,0,0,0
0,0,0,0,0,0,0,0,0
0,0,0,0,0,0,0,0,0
0,0,0,0,0,0,0,0,0
366472,69,3,0,0,0,0,0,0
366408,69,3,0,0,0,0,0,0
0,0,0,0,0,0,0,0,0
840,26,0,0,0,0,0,0,0
135060,880,7,160,154,6,14,1,0
171771,172,0,6,6,0,1,1,1
673159,555,0,4,0,4,2,1,1
4134,52,0,1,0,1,1,0,0
59869,414,3,137,6,131,5,0,1
0,0,0,0,0,0,0,0,0
34456,245,8,24,13,11,0,1,0
56527,695,1,98,70,28,11,0,0
56490,695,1,98,70,28,11,0,0
47665,231,8,5,4,1,0,0,0
135286,919,6,35,35,0,2,1,0
0,0,0,0,0,0,0,0,0
0,0,0,0,0,0,0,0,0
52744,510,0,41,34,7,0,1,0
0,0,0,0,0,0,0,0,0
0,0,0,0,0,0,0,0,0
0,0,0,0,0,0,0,0,0
0,0,0,0,0,0,0,0,0
0,0,0,0,0,0,0,0,0
0,0,0,0,0,0,0,0,0
0,0,0,0,0,0,0,0,0
0,0,0,0,0,0,0,0,0
0,0,0,0,0,0,0,0,0
0,0,0,0,0,0,0,0,0
0,0,0,0,0,0,0,0,0
0,0,0,0,0,0,0,0,0
501747,1859,0,83,36,47,2,1,1
518051,1941,0,83,35,48,3,1,1
496481,1844,0,84,35,49,2,1,1
499653,1859,0,83,35,48,2,1,1
0,0,0,0,0,0,0,0,0
0,0,0,0,0,0,0,0,0
0,0,0,0,0,0,0,0,0
52738,510,0,41,34,7,0,1,0
447429,214,2,50,50,0,1,1,0
0,0,0,0,0,0,0,0,0
0,0,0,0,0,0,0,0,0
0,0,0,0,0,0,0,0,0
0,0,0,0,0,0,0,0,0
13110,108,1,0,0,0,0,0,0
0,0,0,0,0,0,0,0,0
13110,108,1,0,0,0,0,0,0
13110,108,1,0,0,0,0,0,0
0,0,0,0,0,0,0,0,0
13110,108,1,0,0,0,0,0,0
0,0,0,0,0,0,0,0,0
0,0,0,0,0,0,0,0,0
48403,705,4,163,26,137,3,1,0
0,0,0,0,0,0,0,0,0
0,0,0,0,0,0,0,0,0
0,0,0,0,0,0,0,0,0
23010,37,0,2,1,1,0,1,0
0,0,0,0,0,0,0,0,0
0,0,0,0,0,0,0,0,0
0,0,0,0,0,0,0,0,0
0,0,0,0,0,0,0,0,0
0,0,0,0,0,0,0,0,0
5702,53,0,2,0,2,0,0,0
199048,62,6,1,1,0,2,0,0
0,0,0,0,0,0,0,0,0
0,0,0,0,0,0,0,0,0
0,0,0,0,0,0,0,0,0
0,0,0,0,0,0,0,0,0
0,0,0,0,0,0,0,0,0
0,0,0,0,0,0,0,0,0
0,0,0,0,0,0,0,0,0
0,0,0,0,0,0,0,0,0
173334,198,3,18,8,10,0,1,0
35843,169,3,3,0,3,3,1,0
57737,170,3,5,3,2,3,1,0
41173,184,2,6,2,4,0,1,0
0,0,0,0,0,0,0,0,0
0,0,0,0,0,0,0,0,0
0,0,0,0,0,0,0,0,0
0,0,0,0,0,0,0,0,0
122339,519,2,44,42,2,8,1,0
0,0,0,0,0,0,0,0,0
11877,156,5,22,21,1,0,1,0
0,0,0,0,0,0,0,0,0
0,0,0,0,0,0,0,0,0
61088,184,3,1,1,0,0,0,0
0,0,0,0,0,0,0,0,0
0,0,0,0,0,0,0,0,0
47656,286,6,30,29,1,9,1,0
46901,134,10,4,4,0,0,1,0
168832,491,4,2,1,1,9,0,0
686232,1109,2,265,258,7,14,1,0
142540,1214,9,292,289,3,1,0,0
0,0,0,0,0,0,0,0,0
13792,116,1,0,0,0,0,0,0
0,0,0,0,0,0,0,0,0
0,0,0,0,0,0,0,0,0
35677,264,4,23,22,1,0,0,0
680071,556,0,4,4,0,2,1,1
0,0,0,0,0,0,0,0,0
0,0,0,0,0,0,0,0,0
0,0,0,0,0,0,0,0,0
0,0,0,0,0,0,0,0,0
0,0,0,0,0,0,0,0,0
0,0,0,0,0,0,0,0,0
3987,184,0,27,27,0,0,0,0
144946,257,0,47,5,42,1,1,1
0,0,0,0,0,0,0,0,0
0,0,0,0,0,0,0,0,0
686232,1109,2,265,258,7,14,1,0
0,0,0,0,0,0,0,0,0
0,0,0,0,0,0,0,0,0
0,0,0,0,0,0,0,0,0
1834,25,0,1,0,1,0,0,0
1834,25,0,1,0,1,0,0,0
165563,477,4,2,1,1,7,0,0
165563,477,4,2,1,1,7,0,0
169525,501,4,6,3,3,8,1,0
169525,501,4,6,3,3,8,1,0
173359,527,4,5,4,1,9,1,0
165606,478,4,2,1,1,7,0,0
165606,478,4,2,1,1,7,0,0
47446,207,2,1,0,1,1,0,0
6124,190,0,0,0,0,0,0,0
0,0,0,0,0,0,0,0,0
416029,217,6,3,1,2,0,1,0
0,0,0,0,0,0,0,0,0
44925,278,11,22,17,5,4,0,0
0,0,0,0,0,0,0,0,0
0,0,0,0,0,0,0,0,0
0,0,0,0,0,0,0,0,0
676123,556,0,4,4,0,2,1,1
4981541,66,4,0,0,0,0,1,0
16793,92,0,16,3,13,0,1,0
0,0,0,0,0,0,0,0,0
0,0,0,0,0,0,0,0,0
0,0,0,0,0,0,0,0,0
0,0,0,0,0,0,0,0,0
0,0,0,0,0,0,0,0,0
0,0,0,0,0,0,0,0,0
0,0,0,0,0,0,0,0,0
6124,190,0,0,0,0,0,0,0
0,0,0,0,0,0,0,0,0
390542,5641,8,1013,885,128,14,1,0
92430,1041,2,60,33,27,2,1,0
0,0,0,0,0,0,0,0,0
263638,512,4,49,46,3,7,1,0
38586,343,5,23,14,9,0,1,0
19164,172,7,48,46,2,6,1,0
677143,556,0,4,4,0,2,1,1
0,0,0,0,0,0,0,0,0
0,0,0,0,0,0,0,0,0
0,0,0,0,0,0,0,0,0
0,0,0,0,0,0,0,0,0
0,0,0,0,0,0,0,0,0
0,0,0,0,0,0,0,0,0
5461,60,2,1,1,0,0,0,0
0,0,0,0,0,0,0,0,0
0,0,0,0,0,0,0,0,0
0,0,0,0,0,0,0,0,0
0,0,0,0,0,0,0,0,0
0,0,0,0,0,0,0,0,0
1790,23,0,0,0,0,0,0,0
1790,23,0,0,0,0,0,0,0
361136,1416,9,49,28,21,0,0,0
0,0,0,0,0,0,0,0,0
0,0,0,0,0,0,0,0,0
33871,147,5,0,0,0,0,0,0
0,0,0,0,0,0,0,0,0
154233,199,5,9,4,5,0,0,0
0,0,0,0,0,0,0,0,0
0,0,0,0,0,0,0,0,0
0,0,0,0,0,0,0,0,0
0,0,0,0,0,0,0,0,0
0,0,0,0,0,0,0,0,0
63720,600,5,22,19,3,4,0,0
89058,734,5,22,19,3,4,0,0
48353,216,2,2,2,0,1,1,0
0,0,0,0,0,0,0,0,0
0,0,0,0,0,0,0,0,0
33871,147,5,0,0,0,0,0,0
2830,21,2,0,0,0,0,0,0
0,0,0,0,0,0,0,0,0
0,0,0,0,0,0,0,0,0
2621,38,0,1,1,0,0,0,0
2621,38,0,1,1,0,0,0,0
10672,153,3,18,18,0,3,1,0
10672,153,3,18,18,0,3,1,0
131377,45,2,1,1,0,0,0,0
0,0,0,0,0,0,0,0,0
105516,807,15,35,23,12,3,1,0
2145,35,0,1,0,1,0,1,0
2145,35,0,1,0,1,0,1,0
149250,561,7,58,46,12,0,0,0
0,0,0,0,0,0,0,0,0
0,0,0,0,0,0,0,0,0
16152,35,0,5,1,4,0,0,0
9651,61,2,0,0,0,0,0,0
680208,556,0,4,0,4,2,1,1
0,0,0,0,0,0,0,0,0
0,0,0,0,0,0,0,0,0
0,0,0,0,0,0,0,0,0
0,0,0,0,0,0,0,0,0
0,0,0,0,0,0,0,0,0
0,0,0,0,0,0,0,0,0
0,0,0,0,0,0,0,0,0
0,0,0,0,0,0,0,0,0
0,0,0,0,0,0,0,0,0
0,0,0,0,0,0,0,0,0
0,0,0,0,0,0,0,0,0
0,0,0,0,0,0,0,0,0
81541,191,3,12,7,5,5,1,0
0,0,0,0,0,0,0,0,0
0,0,0,0,0,0,0,0,0
0,0,0,0,0,0,0,0,0
0,0,0,0,0,0,0,0,0
2830,21,2,0,0,0,0,0,0
135938,218,4,26,18,8,2,1,0
0,0,0,0,0,0,0,0,0
0,0,0,0,0,0,0,0,0
0,0,0,0,0,0,0,0,0
0,0,0,0,0,0,0,0,0
0,0,0,0,0,0,0,0,0
0,0,0,0,0,0,0,0,0
0,0,0,0,0,0,0,0,0
0,0,0,0,0,0,0,0,0
0,0,0,0,0,0,0,0,0
0,0,0,0,0,0,0,0,0
0,0,0,0,0,0,0,0,0
0,0,0,0,0,0,0,0,0
0,0,0,0,0,0,0,0,0
0,0,0,0,0,0,0,0,0
0,0,0,0,0,0,0,0,0
0,0,0,0,0,0,0,0,0
16152,35,0,5,1,4,0,0,0
490654,189,5,45,32,13,0,1,0
0,0,0,0,0,0,0,0,0
0,0,0,0,0,0,0,0,0
0,0,0,0,0,0,0,0,0
0,0,0,0,0,0,0,0,0
0,0,0,0,0,0,0,0,0
0,0,0,0,0,0,0,0,0
0,0,0,0,0,0,0,0,0
0,0,0,0,0,0,0,0,0
0,0,0,0,0,0,0,0,0
0,0,0,0,0,0,0,0,0
191924,705,9,135,116,19,1,1,0
56655,144,1,11,5,6,6,0,0
0,0,0,0,0,0,0,0,0
0,0,0,0,0,0,0,0,0
225804,119,0,15,6,9,0,1,0
53277,465,8,102,93,9,0,1,0
0,0,0,0,0,0,0,0,0
0,0,0,0,0,0,0,0,0
498304,1822,0,84,35,49,2,1,1
487168,1762,0,83,35,48,2,1,1
15535,31,0,2,1,1,0,1,0
15617,31,0,2,1,1,0,1,0
0,0,0,0,0,0,0,0,0
0,0,0,0,0,0,0,0,0
0,0,0,0,0,0,0,0,0
0,0,0,0,0,0,0,0,0
0,0,0,0,0,0,0,0,0
29819,476,6,44,43,1,2,1,0
0,0,0,0,0,0,0,0,0
0,0,0,0,0,0,0,0,0
0,0,0,0,0,0,0,0,0
0,0,0,0,0,0,0,0,0
0,0,0,0,0,0,0,0,0
0,0,0,0,0,0,0,0,0
0,0,0,0,0,0,0,0,0
0,0,0,0,0,0,0,0,0
0,0,0,0,0,0,0,0,0
0,0,0,0,0,0,0,0,0
0,0,0,0,0,0,0,0,0
0,0,0,0,0,0,0,0,0
0,0,0,0,0,0,0,0,0
0,0,0,0,0,0,0,0,0
0,0,0,0,0,0,0,0,0
0,0,0,0,0,0,0,0,0
0,0,0,0,0,0,0,0,0
0,0,0,0,0,0,0,0,0
0,0,0,0,0,0,0,0,0
0,0,0,0,0,0,0,0,0
0,0,0,0,0,0,0,0,0
0,0,0,0,0,0,0,0,0
239921,102,4,5,5,0,3,1,0
309700,179,4,26,18,8,2,1,0
0,0,0,0,0,0,0,0,0
0,0,0,0,0,0,0,0,0
5534,41,2,0,0,0,1,0,0
0,0,0,0,0,0,0,0,0
0,0,0,0,0,0,0,0,0
509695,997,2,138,86,52,0,0,0
501198,840,2,136,84,52,1,0,0
211,8,0,1,1,0,0,0,0
0,0,0,0,0,0,0,0,0
0,0,0,0,0,0,0,0,0
128991,200,2,1,0,1,12,0,0
9548,59,2,0,0,0,0,0,0
53692,93,3,8,6,2,0,0,0
0,0,0,0,0,0,0,0,0
42909,368,14,45,42,3,0,0,0
22261,33,0,1,1,0,0,1,0
0,0,0,0,0,0,0,0,0
13589,73,6,3,3,0,0,0,0
64956,481,7,52,26,26,5,1,0
64455,481,7,52,26,26,5,1,0
0,0,0,0,0,0,0,0,0
0,0,0,0,0,0,0,0,0
225804,119,0,15,6,9,0,1,0
0,0,0,0,0,0,0,0,0
0,0,0,0,0,0,0,0,0
0,0,0,0,0,0,0,0,0
0,0,0,0,0,0,0,0,0
0,0,0,0,0,0,0,0,0
0,0,0,0,0,0,0,0,0
0,0,0,0,0,0,0,0,0
0,0,0,0,0,0,0,0,0
0,0,0,0,0,0,0,0,0
0,0,0,0,0,0,0,0,0
0,0,0,0,0,0,0,0,0
0,0,0,0,0,0,0,0,0
0,0,0,0,0,0,0,0,0
0,0,0,0,0,0,0,0,0
0,0,0,0,0,0,0,0,0
0,0,0,0,0,0,0,0,0
0,0,0,0,0,0,0,0,0
4818,63,3,7,3,4,0,1,0
0,0,0,0,0,0,0,0,0
0,0,0,0,0,0,0,0,0
0,0,0,0,0,0,0,0,0
0,0,0,0,0,0,0,0,0
0,0,0,0,0,0,0,0,0
0,0,0,0,0,0,0,0,0
3970,67,3,0,0,0,0,0,0
3970,67,3,0,0,0,0,0,0
13657,117,2,16,16,0,4,0,0
13657,117,2,16,16,0,4,0,0
0,0,0,0,0,0,0,0,0
117844,433,7,39,35,4,0,1,0
0,0,0,0,0,0,0,0,0
0,0,0,0,0,0,0,0,0
2145,35,0,1,0,1,0,1,0
2145,35,0,1,0,1,0,1,0
0,0,0,0,0,0,0,0,0
0,0,0,0,0,0,0,0,0
0,0,0,0,0,0,0,0,0
13657,117,2,16,16,0,4,0,0
0,0,0,0,0,0,0,0,0
46689,194,2,2,1,1,1,0,0
0,0,0,0,0,0,0,0,0
0,0,0,0,0,0,0,0,0
0,0,0,0,0,0,0,0,0
464,6,0,0,0,0,0,0,0
0,0,0,0,0,0,0,0,0
0,0,0,0,0,0,0,0,0
0,0,0,0,0,0,0,0,0
0,0,0,0,0,0,0,0,0
856849,937,0,39,16,23,4,1,0
943523,942,0,39,16,23,4,1,0
111618,98,4,6,2,4,0,0,0
111618,98,4,6,2,4,0,0,0
0,0,0,0,0,0,0,0,0
12968,91,3,3,2,1,0,0,0
0,0,0,0,0,0,0,0,0
0,0,0,0,0,0,0,0,0
677246,556,0,4,4,0,2,1,1
36964,162,3,8,4,4,10,1,0
0,0,0,0,0,0,0,0,0
0,0,0,0,0,0,0,0,0
0,0,0,0,0,0,0,0,0
0,0,0,0,0,0,0,0,0
0,0,0,0,0,0,0,0,0
0,0,0,0,0,0,0,0,0
81581,193,3,13,8,5,5,1,0
15069,142,0,56,51,5,0,0,0
186865,378,3,25,7,18,14,1,0
0,0,0,0,0,0,0,0,0
0,0,0,0,0,0,0,0,0
0,0,0,0,0,0,0,0,0
0,0,0,0,0,0,0,0,0
92467,1041,2,60,33,27,2,1,0
35074,248,5,47,4,43,5,1,0
0,0,0,0,0,0,0,0,0
50571,586,6,204,201,3,2,0,0
0,0,0,0,0,0,0,0,0
0,0,0,0,0,0,0,0,0
0,0,0,0,0,0,0,0,0
13687,38,2,0,0,0,2,0,0
0,0,0,0,0,0,0,0,0
2145,35,0,1,0,1,0,1,0
2145,35,0,1,0,1,0,1,0
2204,34,0,1,0,1,0,1,0
2204,34,0,1,0,1,0,1,0
0,0,0,0,0,0,0,0,0
0,0,0,0,0,0,0,0,0
36975,293,11,24,21,3,2,1,0
0,0,0,0,0,0,0,0,0
0,0,0,0,0,0,0,0,0
0,0,0,0,0,0,0,0,0
1825,23,0,0,0,0,0,0,0
0,0,0,0,0,0,0,0,0
187017,378,3,25,7,18,13,1,0
152735,754,10,31,27,4,0,1,0
0,0,0,0,0,0,0,0,0
0,0,0,0,0,0,0,0,0
0,0,0,0,0,0,0,0,0
0,0,0,0,0,0,0,0,0
72394,467,14,41,35,6,0,1,0
0,0,0,0,0,0,0,0,0
28637,45,0,4,1,3,0,0,0
0,0,0,0,0,0,0,0,0
33718,326,7,37,35,2,6,1,0
0,0,0,0,0,0,0,0,0
0,0,0,0,0,0,0,0,0
0,0,0,0,0,0,0,0,0
0,0,0,0,0,0,0,0,0
0,0,0,0,0,0,0,0,0
117561,696,8,32,10,22,1,0,0
3385,41,0,6,0,6,0,0,0
0,0,0,0,0,0,0,0,0
0,0,0,0,0,0,0,0,0
13379,145,1,10,5,5,0,0,0
0,0,0,0,0,0,0,0,0
0,0,0,0,0,0,0,0,0
0,0,0,0,0,0,0,0,0
0,0,0,0,0,0,0,0,0
0,0,0,0,0,0,0,0,0
0,0,0,0,0,0,0,0,0
0,0,0,0,0,0,0,0,0
0,0,0,0,0,0,0,0,0
0,0,0,0,0,0,0,0,0
0,0,0,0,0,0,0,0,0
0,0,0,0,0,0,0,0,0
33844,46,2,0,0,0,2,0,0
0,0,0,0,0,0,0,0,0
675567,556,0,4,4,0,2,1,1
0,0,0,0,0,0,0,0,0
0,0,0,0,0,0,0,0,0
26221,236,1,31,31,0,0,1,0
0,0,0,0,0,0,0,0,0
0,0,0,0,0,0,0,0,0
0,0,0,0,0,0,0,0,0
191976,375,3,24,7,17,15,1,0
0,0,0,0,0,0,0,0,0
0,0,0,0,0,0,0,0,0
675594,556,0,4,4,0,2,1,1
0,0,0,0,0,0,0,0,0
0,0,0,0,0,0,0,0,0
96429,417,8,98,33,65,12,1,0
0,0,0,0,0,0,0,0,0
0,0,0,0,0,0,0,0,0
0,0,0,0,0,0,0,0,0
0,0,0,0,0,0,0,0,0
152420,598,6,62,45,17,5,1,0
0,0,0,0,0,0,0,0,0
136463,390,6,29,1,28,22,1,0
0,0,0,0,0,0,0,0,0
0,0,0,0,0,0,0,0,0
0,0,0,0,0,0,0,0,0
764800,2124,0,29,17,12,10,0,0
16152,35,0,5,1,4,0,0,0
0,0,0,0,0,0,0,0,0
0,0,0,0,0,0,0,0,0
0,0,0,0,0,0,0,0,0
843187,505,7,26,17,9,4,1,0
119270,538,17,19,19,0,2,1,0
0,0,0,0,0,0,0,0,0
0,0,0,0,0,0,0,0,0
92467,1041,2,60,33,27,2,1,0
0,0,0,0,0,0,0,0,0
0,0,0,0,0,0,0,0,0
0,0,0,0,0,0,0,0,0
0,0,0,0,0,0,0,0,0
0,0,0,0,0,0,0,0,0
0,0,0,0,0,0,0,0,0
0,0,0,0,0,0,0,0,0
0,0,0,0,0,0,0,0,0
0,0,0,0,0,0,0,0,0
0,0,0,0,0,0,0,0,0
0,0,0,0,0,0,0,0,0
4640,61,0,1,1,0,0,0,0
4640,61,0,1,1,0,0,0,0
0,0,0,0,0,0,0,0,0
0,0,0,0,0,0,0,0,0
0,0,0,0,0,0,0,0,0
165705,478,4,2,1,1,7,0,0
171099,509,4,6,3,3,9,0,0
171099,509,4,6,3,3,9,0,0
0,0,0,0,0,0,0,0,0
173439,527,4,5,4,1,9,1,0
166731,485,4,4,3,1,8,0,0
166672,485,4,4,3,1,8,0,0
165400,478,4,2,1,1,7,0,0
166683,485,4,4,3,1,8,0,0
92430,1041,2,60,37,23,2,1,0
0,0,0,0,0,0,0,0,0
0,0,0,0,0,0,0,0,0
0,0,0,0,0,0,0,0,0
0,0,0,0,0,0,0,0,0
0,0,0,0,0,0,0,0,0
0,0,0,0,0,0,0,0,0
0,0,0,0,0,0,0,0,0
0,0,0,0,0,0,0,0,0
0,0,0,0,0,0,0,0,0
0,0,0,0,0,0,0,0,0
0,0,0,0,0,0,0,0,0
0,0,0,0,0,0,0,0,0
199521,1897,10,290,210,80,12,1,0
675751,556,0,4,4,0,2,1,1
0,0,0,0,0,0,0,0,0
0,0,0,0,0,0,0,0,0
0,0,0,0,0,0,0,0,0
0,0,0,0,0,0,0,0,0
0,0,0,0,0,0,0,0,0
0,0,0,0,0,0,0,0,0
0,0,0,0,0,0,0,0,0
0,0,0,0,0,0,0,0,0
78686,191,3,12,7,5,5,1,0
0,0,0,0,0,0,0,0,0
0,0,0,0,0,0,0,0,0
13491,114,1,0,0,0,0,0,0
0,0,0,0,0,0,0,0,0
0,0,0,0,0,0,0,0,0
310975,1862,13,48,42,6,2,1,0
0,0,0,0,0,0,0,0,0
0,0,0,0,0,0,0,0,0
0,0,0,0,0,0,0,0,0
0,0,0,0,0,0,0,0,0
0,0,0,0,0,0,0,0,0
0,0,0,0,0,0,0,0,0
0,0,0,0,0,0,0,0,0
0,0,0,0,0,0,0,0,0
0,0,0,0,0,0,0,0,0
0,0,0,0,0,0,0,0,0
0,0,0,0,0,0,0,0,0
861906,186,1,4,0,4,1,0,0
0,0,0,0,0,0,0,0,0
0,0,0,0,0,0,0,0,0
179638,1689,1,181,180,1,1,1,0
0,0,0,0,0,0,0,0,0
0,0,0,0,0,0,0,0,0
0,0,0,0,0,0,0,0,0
18961,14,0,1,1,0,0,0,0
0,0,0,0,0,0,0,0,0
0,0,0,0,0,0,0,0,0
3385,41,0,6,0,6,0,0,0
0,0,0,0,0,0,0,0,0
0,0,0,0,0,0,0,0,0
0,0,0,0,0,0,0,0,0
0,0,0,0,0,0,0,0,0
0,0,0,0,0,0,0,0,0
0,0,0,0,0,0,0,0,0
0,0,0,0,0,0,0,0,0
0,0,0,0,0,0,0,0,0
680973,556,0,4,0,4,2,1,1
16152,35,0,5,1,4,0,0,0
311501,891,3,103,81,22,5,1,0
3385,41,0,6,0,6,0,0,0
3385,41,0,6,0,6,0,0,0
0,0,0,0,0,0,0,0,0
0,0,0,0,0,0,0,0,0
0,0,0,0,0,0,0,0,0
0,0,0,0,0,0,0,0,0
37196,312,1,11,11,0,0,1,0
41907,384,1,11,11,0,0,1,0
0,0,0,0,0,0,0,0,0
0,0,0,0,0,0,0,0,0
0,0,0,0,0,0,0,0,0
0,0,0,0,0,0,0,0,0
0,0,0,0,0,0,0,0,0
0,0,0,0,0,0,0,0,0
0,0,0,0,0,0,0,0,0
0,0,0,0,0,0,0,0,0
0,0,0,0,0,0,0,0,0
0,0,0,0,0,0,0,0,0
0,0,0,0,0,0,0,0,0
0,0,0,0,0,0,0,0,0
0,0,0,0,0,0,0,0,0
0,0,0,0,0,0,0,0,0
0,0,0,0,0,0,0,0,0
0,0,0,0,0,0,0,0,0
0,0,0,0,0,0,0,0,0
27166,36,0,3,1,2,0,0,0
322368,1150,12,55,13,42,0,0,0
0,0,0,0,0,0,0,0,0
0,0,0,0,0,0,0,0,0
0,0,0,0,0,0,0,0,0
248967,2124,12,422,419,3,1,1,0
23381,408,4,66,64,2,5,1,0
52221,566,8,74,62,12,4,1,0
0,0,0,0,0,0,0,0,0
6330,64,2,6,4,2,0,1,0
0,0,0,0,0,0,0,0,0
0,0,0,0,0,0,0,0,0
0,0,0,0,0,0,0,0,0
0,0,0,0,0,0,0,0,0
0,0,0,0,0,0,0,0,0
0,0,0,0,0,0,0,0,0
0,0,0,0,0,0,0,0,0
0,0,0,0,0,0,0,0,0
0,0,0,0,0,0,0,0,0
0,0,0,0,0,0,0,0,0
0,0,0,0,0,0,0,0,0
0,0,0,0,0,0,0,0,0
0,0,0,0,0,0,0,0,0
0,0,0,0,0,0,0,0,0
0,0,0,0,0,0,0,0,0
0,0,0,0,0,0,0,0,0
0,0,0,0,0,0,0,0,0
0,0,0,0,0,0,0,0,0
0,0,0,0,0,0,0,0,0
0,0,0,0,0,0,0,0,0
0,0,0,0,0,0,0,0,0
0,0,0,0,0,0,0,0,0
0,0,0,0,0,0,0,0,0
0,0,0,0,0,0,0,0,0
0,0,0,0,0,0,0,0,0
0,0,0,0,0,0,0,0,0
0,0,0,0,0,0,0,0,0
0,0,0,0,0,0,0,0,0
0,0,0,0,0,0,0,0,0
0,0,0,0,0,0,0,0,0
0,0,0,0,0,0,0,0,0
0,0,0,0,0,0,0,0,0
0,0,0,0,0,0,0,0,0
0,0,0,0,0,0,0,0,0
0,0,0,0,0,0,0,0,0
0,0,0,0,0,0,0,0,0
0,0,0,0,0,0,0,0,0
0,0,0,0,0,0,0,0,0
0,0,0,0,0,0,0,0,0
0,0,0,0,0,0,0,0,0
0,0,0,0,0,0,0,0,0
0,0,0,0,0,0,0,0,0
0,0,0,0,0,0,0,0,0
0,0,0,0,0,0,0,0,0
0,0,0,0,0,0,0,0,0
0,0,0,0,0,0,0,0,0
127360,297,7,44,39,5,0,1,0
404701,9938,3,1053,632,421,0,1,0
39610,72,1,1,1,0,0,0,0
0,0,0,0,0,0,0,0,0
0,0,0,0,0,0,0,0,0
0,0,0,0,0,0,0,0,0
0,0,0,0,0,0,0,0,0
115553,572,7,47,45,2,1,1,0
675834,556,0,4,4,0,2,1,1
0,0,0,0,0,0,0,0,0
3385,41,0,6,0,6,0,0,0
5247,45,0,2,1,1,1,0,0
0,0,0,0,0,0,0,0,0
0,0,0,0,0,0,0,0,0
0,0,0,0,0,0,0,0,0
0,0,0,0,0,0,0,0,0
0,0,0,0,0,0,0,0,0
0,0,0,0,0,0,0,0,0
0,0,0,0,0,0,0,0,0
0,0,0,0,0,0,0,0,0
105435,1042,1,180,40,140,3,1,0
0,0,0,0,0,0,0,0,0
0,0,0,0,0,0,0,0,0
3385,41,0,6,0,6,0,0,0
0,0,0,0,0,0,0,0,0
0,0,0,0,0,0,0,0,0
0,0,0,0,0,0,0,0,0
0,0,0,0,0,0,0,0,0
0,0,0,0,0,0,0,0,0
0,0,0,0,0,0,0,0,0
0,0,0,0,0,0,0,0,0
0,0,0,0,0,0,0,0,0
0,0,0,0,0,0,0,0,0
0,0,0,0,0,0,0,0,0
0,0,0,0,0,0,0,0,0
0,0,0,0,0,0,0,0,0
0,0,0,0,0,0,0,0,0
0,0,0,0,0,0,0,0,0
0,0,0,0,0,0,0,0,0
0,0,0,0,0,0,0,0,0
0,0,0,0,0,0,0,0,0
0,0,0,0,0,0,0,0,0
0,0,0,0,0,0,0,0,0
0,0,0,0,0,0,0,0,0
0,0,0,0,0,0,0,0,0
0,0,0,0,0,0,0,0,0
0,0,0,0,0,0,0,0,0
0,0,0,0,0,0,0,0,0
0,0,0,0,0,0,0,0,0
0,0,0,0,0,0,0,0,0
0,0,0,0,0,0,0,0,0
0,0,0,0,0,0,0,0,0
0,0,0,0,0,0,0,0,0
0,0,0,0,0,0,0,0,0
0,0,0,0,0,0,0,0,0
0,0,0,0,0,0,0,0,0
0,0,0,0,0,0,0,0,0
0,0,0,0,0,0,0,0,0
0,0,0,0,0,0,0,0,0
0,0,0,0,0,0,0,0,0
0,0,0,0,0,0,0,0,0
0,0,0,0,0,0,0,0,0
0,0,0,0,0,0,0,0,0
0,0,0,0,0,0,0,0,0
0,0,0,0,0,0,0,0,0
0,0,0,0,0,0,0,0,0
0,0,0,0,0,0,0,0,0
0,0,0,0,0,0,0,0,0
0,0,0,0,0,0,0,0,0
0,0,0,0,0,0,0,0,0
0,0,0,0,0,0,0,0,0
0,0,0,0,0,0,0,0,0
0,0,0,0,0,0,0,0,0
0,0,0,0,0,0,0,0,0
127359,297,7,44,39,5,0,1,0
0,0,0,0,0,0,0,0,0
0,0,0,0,0,0,0,0,0
58684,379,4,55,10,45,0,1,0
675805,556,0,4,4,0,2,1,1
408168,1054,5,50,46,4,0,0,0
0,0,0,0,0,0,0,0,0
0,0,0,0,0,0,0,0,0
0,0,0,0,0,0,0,0,0
0,0,0,0,0,0,0,0,0
12855,142,0,56,51,5,0,0,0
6330,64,2,6,4,2,0,1,0
0,0,0,0,0,0,0,0,0
0,0,0,0,0,0,0,0,0
144164,428,8,30,1,29,35,1,0
0,0,0,0,0,0,0,0,0
0,0,0,0,0,0,0,0,0
0,0,0,0,0,0,0,0,0
0,0,0,0,0,0,0,0,0
0,0,0,0,0,0,0,0,0
192174,378,3,25,7,18,14,1,0
0,0,0,0,0,0,0,0,0
675519,556,0,4,4,0,2,1,1
18029,57,1,3,3,0,0,1,0
3385,41,0,6,0,6,0,0,0
3385,41,0,6,0,6,0,0,0
3385,41,0,6,0,6,0,0,0
363417,39,4,0,0,0,2,1,0
0,0,0,0,0,0,0,0,0
0,0,0,0,0,0,0,0,0
0,0,0,0,0,0,0,0,0
2024795,362,0,22,1,21,3,1,0
0,0,0,0,0,0,0,0,0
16112,42,3,0,0,0,2,0,0
16112,42,3,0,0,0,2,0,0
0,0,0,0,0,0,0,0,0
0,0,0,0,0,0,0,0,0
0,0,0,0,0,0,0,0,0
0,0,0,0,0,0,0,0,0
0,0,0,0,0,0,0,0,0
0,0,0,0,0,0,0,0,0
0,0,0,0,0,0,0,0,0
0,0,0,0,0,0,0,0,0
0,0,0,0,0,0,0,0,0
0,0,0,0,0,0,0,0,0
0,0,0,0,0,0,0,0,0
0,0,0,0,0,0,0,0,0
16112,42,3,0,0,0,2,0,0
16112,42,3,0,0,0,2,0,0
0,0,0,0,0,0,0,0,0
0,0,0,0,0,0,0,0,0
0,0,0,0,0,0,0,0,0
0,0,0,0,0,0,0,0,0
0,0,0,0,0,0,0,0,0
431,6,0,0,0,0,0,0,0
0,0,0,0,0,0,0,0,0
0,0,0,0,0,0,0,0,0
0,0,0,0,0,0,0,0,0
192679,382,3,25,7,18,14,1,0
34824,529,7,156,110,46,0,0,0
0,0,0,0,0,0,0,0,0
194379,500,0,75,49,26,4,1,0
0,0,0,0,0,0,0,0,0
10180,81,4,1,0,1,1,0,0
0,0,0,0,0,0,0,0,0
10169,81,4,1,0,1,1,0,0
0,0,0,0,0,0,0,0,0
35585,159,3,8,4,4,11,1,0
0,0,0,0,0,0,0,0,0
0,0,0,0,0,0,0,0,0
36663,311,9,17,16,1,1,1,0
231416,1894,4,134,132,2,9,1,0
366830,2867,11,104,104,0,3,1,0
675639,556,0,4,4,0,2,1,1
105357,720,15,49,29,20,0,1,0
0,0,0,0,0,0,0,0,0
3385,41,0,6,0,6,0,0,0
0,0,0,0,0,0,0,0,0
0,0,0,0,0,0,0,0,0
0,0,0,0,0,0,0,0,0
0,0,0,0,0,0,0,0,0
0,0,0,0,0,0,0,0,0
7009,113,1,5,0,5,2,1,0
0,0,0,0,0,0,0,0,0
0,0,0,0,0,0,0,0,0
0,0,0,0,0,0,0,0,0
0,0,0,0,0,0,0,0,0
0,0,0,0,0,0,0,0,0
0,0,0,0,0,0,0,0,0
0,0,0,0,0,0,0,0,0
0,0,0,0,0,0,0,0,0
16112,42,3,0,0,0,2,0,0
16112,42,3,0,0,0,2,0,0
16112,42,3,0,0,0,2,0,0
16112,42,3,0,0,0,2,0,0
2486,42,3,0,0,0,0,0,0
2486,42,3,0,0,0,0,0,0
0,0,0,0,0,0,0,0,0
0,0,0,0,0,0,0,0,0
0,0,0,0,0,0,0,0,0
6147,49,2,1,0,1,0,1,0
0,0,0,0,0,0,0,0,0
3385,41,0,6,0,6,0,0,0
3385,41,0,6,0,6,0,0,0
176411,709,8,44,20,24,22,1,0
0,0,0,0,0,0,0,0,0
0,0,0,0,0,0,0,0,0
0,0,0,0,0,0,0,0,0
0,0,0,0,0,0,0,0,0
0,0,0,0,0,0,0,0,0
0,0,0,0,0,0,0,0,0
3385,41,0,6,0,6,0,0,0
21953,33,0,1,1,0,0,1,0
0,0,0,0,0,0,0,0,0
0,0,0,0,0,0,0,0,0
0,0,0,0,0,0,0,0,0
23209,48,0,7,2,5,0,0,0
0,0,0,0,0,0,0,0,0
0,0,0,0,0,0,0,0,0
0,0,0,0,0,0,0,0,0
521445,1865,0,88,36,52,3,1,1
555909,1806,0,82,36,46,2,1,1
6137,44,1,2,1,1,0,0,0
6137,44,1,2,1,1,0,0,0
0,0,0,0,0,0,0,0,0
0,0,0,0,0,0,0,0,0
0,0,0,0,0,0,0,0,0
0,0,0,0,0,0,0,0,0
0,0,0,0,0,0,0,0,0
0,0,0,0,0,0,0,0,0
0,0,0,0,0,0,0,0,0
0,0,0,0,0,0,0,0,0
0,0,0,0,0,0,0,0,0
0,0,0,0,0,0,0,0,0
0,0,0,0,0,0,0,0,0
0,0,0,0,0,0,0,0,0
0,0,0,0,0,0,0,0,0
0,0,0,0,0,0,0,0,0
0,0,0,0,0,0,0,0,0
0,0,0,0,0,0,0,0,0
0,0,0,0,0,0,0,0,0
22600,33,0,1,1,0,0,1,0
22555,33,0,1,1,0,0,1,0
702844,552,0,5,5,0,2,1,1
145579,69,0,9,4,5,6,0,0
0,0,0,0,0,0,0,0,0
57535,178,3,18,11,7,0,1,0
8224,123,7,11,11,0,0,1,0
3641,19,1,0,0,0,0,0,0
0,0,0,0,0,0,0,0,0
0,0,0,0,0,0,0,0,0
0,0,0,0,0,0,0,0,0
0,0,0,0,0,0,0,0,0
0,0,0,0,0,0,0,0,0
46696,671,4,163,26,137,3,1,0
0,0,0,0,0,0,0,0,0
0,0,0,0,0,0,0,0,0
0,0,0,0,0,0,0,0,0
0,0,0,0,0,0,0,0,0
0,0,0,0,0,0,0,0,0
0,0,0,0,0,0,0,0,0
0,0,0,0,0,0,0,0,0
0,0,0,0,0,0,0,0,0
0,0,0,0,0,0,0,0,0
3385,41,0,6,0,6,0,0,0
0,0,0,0,0,0,0,0,0
0,0,0,0,0,0,0,0,0
0,0,0,0,0,0,0,0,0
0,0,0,0,0,0,0,0,0
16152,35,0,5,1,4,0,0,0
0,0,0,0,0,0,0,0,0
0,0,0,0,0,0,0,0,0
0,0,0,0,0,0,0,0,0
0,0,0,0,0,0,0,0,0
0,0,0,0,0,0,0,0,0
0,0,0,0,0,0,0,0,0
0,0,0,0,0,0,0,0,0
0,0,0,0,0,0,0,0,0
0,0,0,0,0,0,0,0,0
0,0,0,0,0,0,0,0,0
0,0,0,0,0,0,0,0,0
0,0,0,0,0,0,0,0,0
0,0,0,0,0,0,0,0,0
0,0,0,0,0,0,0,0,0
0,0,0,0,0,0,0,0,0
0,0,0,0,0,0,0,0,0
0,0,0,0,0,0,0,0,0
15314,203,3,5,5,0,2,0,0
70059,452,2,15,10,5,2,0,0
12157,85,4,1,1,0,6,0,0
53756,438,3,10,7,3,6,1,0
0,0,0,0,0,0,0,0,0
0,0,0,0,0,0,0,0,0
0,0,0,0,0,0,0,0,0
271757,93,2,1,0,1,0,0,0
271757,93,2,1,0,1,0,0,0
85364,948,5,119,113,6,0,0,0
145965,483,3,18,10,8,20,1,0
0,0,0,0,0,0,0,0,0
0,0,0,0,0,0,0,0,0
0,0,0,0,0,0,0,0,0
0,0,0,0,0,0,0,0,0
0,0,0,0,0,0,0,0,0
0,0,0,0,0,0,0,0,0
0,0,0,0,0,0,0,0,0
0,0,0,0,0,0,0,0,0
0,0,0,0,0,0,0,0,0
0,0,0,0,0,0,0,0,0
0,0,0,0,0,0,0,0,0
0,0,0,0,0,0,0,0,0
0,0,0,0,0,0,0,0,0
0,0,0,0,0,0,0,0,0
7926,54,0,1,0,1,0,0,0
0,0,0,0,0,0,0,0,0
0,0,0,0,0,0,0,0,0
0,0,0,0,0,0,0,0,0
0,0,0,0,0,0,0,0,0
191796,378,3,25,7,18,14,1,0
0,0,0,0,0,0,0,0,0
53273,102,5,6,5,1,0,0,0
23819,35,0,2,1,1,0,1,0
0,0,0,0,0,0,0,0,0
0,0,0,0,0,0,0,0,0
0,0,0,0,0,0,0,0,0
0,0,0,0,0,0,0,0,0
0,0,0,0,0,0,0,0,0
0,0,0,0,0,0,0,0,0
0,0,0,0,0,0,0,0,0
0,0,0,0,0,0,0,0,0
0,0,0,0,0,0,0,0,0
2062,33,0,1,0,1,0,0,0
2062,33,0,1,0,1,0,0,0
26868,34,0,2,1,1,0,0,0
0,0,0,0,0,0,0,0,0
16152,35,0,5,1,4,0,0,0
0,0,0,0,0,0,0,0,0
0,0,0,0,0,0,0,0,0
37366,249,8,10,10,0,1,1,0
89114,67,0,9,9,0,5,0,0
176115,327,4,4,2,2,3,0,0
0,0,0,0,0,0,0,0,0
0,0,0,0,0,0,0,0,0
0,0,0,0,0,0,0,0,0
9528,68,2,4,4,0,0,0,0
0,0,0,0,0,0,0,0,0
0,0,0,0,0,0,0,0,0
0,0,0,0,0,0,0,0,0
195760,433,6,52,52,0,1,1,0
191908,378,3,25,7,18,14,1,0
0,0,0,0,0,0,0,0,0
5641,70,7,0,0,0,0,0,0
0,0,0,0,0,0,0,0,0
676201,556,0,4,4,0,2,1,1
9346,68,2,4,4,0,0,0,0
0,0,0,0,0,0,0,0,0
92149,813,14,181,177,4,1,1,0
0,0,0,0,0,0,0,0,0
0,0,0,0,0,0,0,0,0
98940,66,4,0,0,0,2,1,0
0,0,0,0,0,0,0,0,0
0,0,0,0,0,0,0,0,0
0,0,0,0,0,0,0,0,0
0,0,0,0,0,0,0,0,0
0,0,0,0,0,0,0,0,0
0,0,0,0,0,0,0,0,0
31868,392,3,93,91,2,0,1,0
0,0,0,0,0,0,0,0,0
0,0,0,0,0,0,0,0,0
0,0,0,0,0,0,0,0,0
0,0,0,0,0,0,0,0,0
0,0,0,0,0,0,0,0,0
0,0,0,0,0,0,0,0,0
0,0,0,0,0,0,0,0,0
16112,42,3,0,0,0,2,0,0
16112,42,3,0,0,0,2,0,0
16112,42,3,0,0,0,2,0,0
16112,42,3,0,0,0,2,0,0
16112,42,3,0,0,0,2,0,0
16112,42,3,0,0,0,2,0,0
0,0,0,0,0,0,0,0,0
0,0,0,0,0,0,0,0,0
0,0,0,0,0,0,0,0,0
0,0,0,0,0,0,0,0,0
0,0,0,0,0,0,0,0,0
0,0,0,0,0,0,0,0,0
0,0,0,0,0,0,0,0,0
0,0,0,0,0,0,0,0,0
0,0,0,0,0,0,0,0,0
0,0,0,0,0,0,0,0,0
0,0,0,0,0,0,0,0,0
0,0,0,0,0,0,0,0,0
0,0,0,0,0,0,0,0,0
0,0,0,0,0,0,0,0,0
0,0,0,0,0,0,0,0,0
0,0,0,0,0,0,0,0,0
0,0,0,0,0,0,0,0,0
0,0,0,0,0,0,0,0,0
0,0,0,0,0,0,0,0,0
0,0,0,0,0,0,0,0,0
0,0,0,0,0,0,0,0,0
735999,2109,3,127,55,72,1,0,0
16693,92,0,16,3,13,0,1,0
59696,188,2,13,0,13,0,1,0
0,0,0,0,0,0,0,0,0
0,0,0,0,0,0,0,0,0
34456,529,7,156,110,46,0,0,0
16152,35,0,5,1,4,0,0,0
16152,35,0,5,1,4,0,0,0
177848,584,4,12,8,4,3,1,0
34272,529,7,156,110,46,0,0,0
54399,166,7,1,0,1,0,0,0
0,0,0,0,0,0,0,0,0
37665,348,3,39,15,24,0,1,0
0,0,0,0,0,0,0,0,0
0,0,0,0,0,0,0,0,0
0,0,0,0,0,0,0,0,0
0,0,0,0,0,0,0,0,0
0,0,0,0,0,0,0,0,0
0,0,0,0,0,0,0,0,0
2752359,34,4,0,0,0,0,1,0
0,0,0,0,0,0,0,0,0
938021,361,0,22,1,21,3,1,0
0,0,0,0,0,0,0,0,0
66838,615,12,122,24,98,2,1,0
16112,42,3,0,0,0,2,0,0
16112,42,3,0,0,0,2,0,0
16112,42,3,0,0,0,2,0,0
16112,42,3,0,0,0,2,0,0
0,0,0,0,0,0,0,0,0
0,0,0,0,0,0,0,0,0
0,0,0,0,0,0,0,0,0
0,0,0,0,0,0,0,0,0
0,0,0,0,0,0,0,0,0
0,0,0,0,0,0,0,0,0
0,0,0,0,0,0,0,0,0
0,0,0,0,0,0,0,0,0
0,0,0,0,0,0,0,0,0
0,0,0,0,0,0,0,0,0
63819,479,0,21,15,6,0,1,0
66838,615,12,122,24,98,2,1,0
40054,259,4,39,15,24,9,1,0
0,0,0,0,0,0,0,0,0
10156,81,4,1,0,1,1,0,0
59765,188,2,13,0,13,0,1,0
0,0,0,0,0,0,0,0,0
0,0,0,0,0,0,0,0,0
92467,1041,2,60,33,27,2,1,0
0,0,0,0,0,0,0,0,0
675630,556,0,4,4,0,2,1,1
0,0,0,0,0,0,0,0,0
0,0,0,0,0,0,0,0,0
0,0,0,0,0,0,0,0,0
5735,91,0,7,6,1,0,0,0
0,0,0,0,0,0,0,0,0
0,0,0,0,0,0,0,0,0
0,0,0,0,0,0,0,0,0
675504,556,0,4,4,0,2,1,1
0,0,0,0,0,0,0,0,0
0,0,0,0,0,0,0,0,0
0,0,0,0,0,0,0,0,0
0,0,0,0,0,0,0,0,0
0,0,0,0,0,0,0,0,0
0,0,0,0,0,0,0,0,0
0,0,0,0,0,0,0,0,0
0,0,0,0,0,0,0,0,0
0,0,0,0,0,0,0,0,0
0,0,0,0,0,0,0,0,0
16112,42,3,0,0,0,2,0,0
16112,42,3,0,0,0,2,0,0
0,0,0,0,0,0,0,0,0
0,0,0,0,0,0,0,0,0
0,0,0,0,0,0,0,0,0
16152,35,0,5,1,4,0,0,0
35085,482,6,84,78,6,0,1,0
0,0,0,0,0,0,0,0,0
0,0,0,0,0,0,0,0,0
164281,1500,4,158,121,37,0,1,0
84593,362,9,25,19,6,1,0,0
193671,382,3,25,7,18,14,1,0
89839,893,4,76,25,51,4,1,0
0,0,0,0,0,0,0,0,0
0,0,0,0,0,0,0,0,0
0,0,0,0,0,0,0,0,0
280312,492,4,49,46,3,2,1,0
0,0,0,0,0,0,0,0,0
1177531,1270,1,44,33,11,7,1,0
0,0,0,0,0,0,0,0,0
263103,100,4,5,5,0,3,1,0
313977,187,4,26,18,8,2,1,0
313901,187,4,26,18,8,2,1,0
0,0,0,0,0,0,0,0,0
0,0,0,0,0,0,0,0,0
0,0,0,0,0,0,0,0,0
0,0,0,0,0,0,0,0,0
702706,552,0,5,5,0,2,1,1
0,0,0,0,0,0,0,0,0
0,0,0,0,0,0,0,0,0
0,0,0,0,0,0,0,0,0
0,0,0,0,0,0,0,0,0
0,0,0,0,0,0,0,0,0
0,0,0,0,0,0,0,0,0
0,0,0,0,0,0,0,0,0
0,0,0,0,0,0,0,0,0
0,0,0,0,0,0,0,0,0
0,0,0,0,0,0,0,0,0
0,0,0,0,0,0,0,0,0
0,0,0,0,0,0,0,0,0
0,0,0,0,0,0,0,0,0
0,0,0,0,0,0,0,0,0
0,0,0,0,0,0,0,0,0
0,0,0,0,0,0,0,0,0
0,0,0,0,0,0,0,0,0
67175,16,0,1,0,1,0,0,0
67175,16,0,1,0,1,0,0,0
0,0,0,0,0,0,0,0,0
0,0,0,0,0,0,0,0,0
7825,33,0,2,2,0,0,1,0
0,0,0,0,0,0,0,0,0
0,0,0,0,0,0,0,0,0
0,0,0,0,0,0,0,0,0
80191,692,10,158,148,10,0,1,0
0,0,0,0,0,0,0,0,0
0,0,0,0,0,0,0,0,0
0,0,0,0,0,0,0,0,0
0,0,0,0,0,0,0,0,0
3728,24,2,0,0,0,0,0,0
0,0,0,0,0,0,0,0,0
3385,41,0,6,0,6,0,0,0
0,0,0,0,0,0,0,0,0
3385,41,0,6,0,6,0,0,0
0,0,0,0,0,0,0,0,0
314001,187,4,26,18,8,2,1,0
639083,107,4,4,4,0,4,1,0
0,0,0,0,0,0,0,0,0
0,0,0,0,0,0,0,0,0
0,0,0,0,0,0,0,0,0
0,0,0,0,0,0,0,0,0
0,0,0,0,0,0,0,0,0
0,0,0,0,0,0,0,0,0
0,0,0,0,0,0,0,0,0
0,0,0,0,0,0,0,0,0
106342,611,10,36,27,9,4,0,0
0,0,0,0,0,0,0,0,0
0,0,0,0,0,0,0,0,0
57420,405,5,48,43,5,0,1,0
0,0,0,0,0,0,0,0,0
2003,32,5,1,1,0,0,0,0
2003,32,5,1,1,0,0,0,0
2003,32,5,1,1,0,0,0,0
0,0,0,0,0,0,0,0,0
0,0,0,0,0,0,0,0,0
0,0,0,0,0,0,0,0,0
0,0,0,0,0,0,0,0,0
0,0,0,0,0,0,0,0,0
0,0,0,0,0,0,0,0,0
0,0,0,0,0,0,0,0,0
0,0,0,0,0,0,0,0,0
0,0,0,0,0,0,0,0,0
0,0,0,0,0,0,0,0,0
0,0,0,0,0,0,0,0,0
0,0,0,0,0,0,0,0,0
0,0,0,0,0,0,0,0,0
0,0,0,0,0,0,0,0,0
0,0,0,0,0,0,0,0,0
450210,1400,1,98,74,24,18,1,0
0,0,0,0,0,0,0,0,0
4511,71,4,6,1,5,1,1,0
0,0,0,0,0,0,0,0,0
0,0,0,0,0,0,0,0,0
0,0,0,0,0,0,0,0,0
0,0,0,0,0,0,0,0,0
0,0,0,0,0,0,0,0,0
0,0,0,0,0,0,0,0,0
0,0,0,0,0,0,0,0,0
0,0,0,0,0,0,0,0,0
0,0,0,0,0,0,0,0,0
0,0,0,0,0,0,0,0,0
0,0,0,0,0,0,0,0,0
0,0,0,0,0,0,0,0,0
0,0,0,0,0,0,0,0,0
0,0,0,0,0,0,0,0,0
0,0,0,0,0,0,0,0,0
190328,376,3,25,7,18,15,1,0
0,0,0,0,0,0,0,0,0
0,0,0,0,0,0,0,0,0
0,0,0,0,0,0,0,0,0
0,0,0,0,0,0,0,0,0
4653,41,0,18,16,2,0,0,0
0,0,0,0,0,0,0,0,0
0,0,0,0,0,0,0,0,0
0,0,0,0,0,0,0,0,0
0,0,0,0,0,0,0,0,0
0,0,0,0,0,0,0,0,0
709673,3055,4,78,51,27,38,0,0
0,0,0,0,0,0,0,0,0
0,0,0,0,0,0,0,0,0
0,0,0,0,0,0,0,0,0
0,0,0,0,0,0,0,0,0
92998,545,7,82,79,3,2,1,0
0,0,0,0,0,0,0,0,0
0,0,0,0,0,0,0,0,0
0,0,0,0,0,0,0,0,0
0,0,0,0,0,0,0,0,0
0,0,0,0,0,0,0,0,0
0,0,0,0,0,0,0,0,0
37019,163,3,8,4,4,11,1,0
35701,159,3,8,4,4,11,1,0
204396,1027,5,166,117,49,5,1,0
0,0,0,0,0,0,0,0,0
0,0,0,0,0,0,0,0,0
0,0,0,0,0,0,0,0,0
0,0,0,0,0,0,0,0,0
783056,55,0,10,10,0,0,0,0
783056,55,0,10,10,0,0,0,0
0,0,0,0,0,0,0,0,0
0,0,0,0,0,0,0,0,0
0,0,0,0,0,0,0,0,0
0,0,0,0,0,0,0,0,0
0,0,0,0,0,0,0,0,0
0,0,0,0,0,0,0,0,0
131522,314,5,25,25,0,3,0,0
0,0,0,0,0,0,0,0,0
188430,1116,7,58,38,20,2,1,0
0,0,0,0,0,0,0,0,0
146713,840,11,49,38,11,2,0,0
0,0,0,0,0,0,0,0,0
119657,1750,4,352,348,4,2,1,0
0,0,0,0,0,0,0,0,0
79192,409,9,40,36,4,0,1,0
0,0,0,0,0,0,0,0,0
0,0,0,0,0,0,0,0,0
0,0,0,0,0,0,0,0,0
92562,84,0,15,15,0,6,0,0
0,0,0,0,0,0,0,0,0
0,0,0,0,0,0,0,0,0
0,0,0,0,0,0,0,0,0
0,0,0,0,0,0,0,0,0
0,0,0,0,0,0,0,0,0
0,0,0,0,0,0,0,0,0
0,0,0,0,0,0,0,0,0
189427,348,3,24,7,17,11,1,0
0,0,0,0,0,0,0,0,0
0,0,0,0,0,0,0,0,0
28845,44,0,4,3,1,0,0,0
0,0,0,0,0,0,0,0,0
0,0,0,0,0,0,0,0,0
0,0,0,0,0,0,0,0,0
0,0,0,0,0,0,0,0,0
38759,49,2,3,3,0,0,0,0
0,0,0,0,0,0,0,0,0
0,0,0,0,0,0,0,0,0
0,0,0,0,0,0,0,0,0
0,0,0,0,0,0,0,0,0
1405,21,2,3,3,0,0,1,0
0,0,0,0,0,0,0,0,0
4750,31,0,2,2,0,0,1,0
22744,38,0,2,2,0,0,1,0
0,0,0,0,0,0,0,0,0
3385,41,0,6,0,6,0,0,0
0,0,0,0,0,0,0,0,0
0,0,0,0,0,0,0,0,0
0,0,0,0,0,0,0,0,0
0,0,0,0,0,0,0,0,0
836,21,0,8,8,0,0,0,0
11642,50,0,5,1,4,0,0,0
136433,327,8,29,24,5,20,1,0
7704,101,3,14,1,13,2,0,0
7704,101,3,14,11,3,2,0,0
7704,101,3,14,11,3,2,0,0
0,0,0,0,0,0,0,0,0
0,0,0,0,0,0,0,0,0
0,0,0,0,0,0,0,0,0
0,0,0,0,0,0,0,0,0
65855,247,0,46,24,22,0,1,1
0,0,0,0,0,0,0,0,0
0,0,0,0,0,0,0,0,0
0,0,0,0,0,0,0,0,0
0,0,0,0,0,0,0,0,0
0,0,0,0,0,0,0,0,0
0,0,0,0,0,0,0,0,0
0,0,0,0,0,0,0,0,0
0,0,0,0,0,0,0,0,0
0,0,0,0,0,0,0,0,0
0,0,0,0,0,0,0,0,0
0,0,0,0,0,0,0,0,0
0,0,0,0,0,0,0,0,0
0,0,0,0,0,0,0,0,0
0,0,0,0,0,0,0,0,0
0,0,0,0,0,0,0,0,0
0,0,0,0,0,0,0,0,0
192260,378,3,25,7,18,13,1,0
0,0,0,0,0,0,0,0,0
703332,552,0,5,5,0,2,1,1
0,0,0,0,0,0,0,0,0
0,0,0,0,0,0,0,0,0
0,0,0,0,0,0,0,0,0
0,0,0,0,0,0,0,0,0
0,0,0,0,0,0,0,0,0
9995,65,0,3,3,0,0,0,0
0,0,0,0,0,0,0,0,0
3235,19,1,0,0,0,0,0,0
86475,520,10,35,31,4,6,1,0
35521,159,3,8,4,4,11,1,0
35795,160,3,8,4,4,10,1,0
8364,50,1,1,1,0,0,0,0
318335,2433,10,344,338,6,5,1,0
0,0,0,0,0,0,0,0,0
0,0,0,0,0,0,0,0,0
0,0,0,0,0,0,0,0,0
0,0,0,0,0,0,0,0,0
0,0,0,0,0,0,0,0,0
0,0,0,0,0,0,0,0,0
0,0,0,0,0,0,0,0,0
0,0,0,0,0,0,0,0,0
0,0,0,0,0,0,0,0,0
0,0,0,0,0,0,0,0,0
74750,651,4,32,21,11,2,1,0
42176,78,4,0,0,0,0,0,0
22562,39,0,3,1,2,0,1,0
3385,41,0,6,0,6,0,0,0
3385,41,0,6,0,6,0,0,0
0,0,0,0,0,0,0,0,0
0,0,0,0,0,0,0,0,0
0,0,0,0,0,0,0,0,0
0,0,0,0,0,0,0,0,0
36148,212,2,51,50,1,1,1,0
27925,35,1,0,0,0,1,0,0
0,0,0,0,0,0,0,0,0
0,0,0,0,0,0,0,0,0
0,0,0,0,0,0,0,0,0
0,0,0,0,0,0,0,0,0
141079,419,8,30,1,29,35,1,0
0,0,0,0,0,0,0,0,0
0,0,0,0,0,0,0,0,0
0,0,0,0,0,0,0,0,0
0,0,0,0,0,0,0,0,0
0,0,0,0,0,0,0,0,0
0,0,0,0,0,0,0,0,0
0,0,0,0,0,0,0,0,0
0,0,0,0,0,0,0,0,0
0,0,0,0,0,0,0,0,0
0,0,0,0,0,0,0,0,0
0,0,0,0,0,0,0,0,0
0,0,0,0,0,0,0,0,0
0,0,0,0,0,0,0,0,0
0,0,0,0,0,0,0,0,0
0,0,0,0,0,0,0,0,0
359215,2126,8,77,72,5,11,1,0
16927,237,5,47,39,8,2,1,0
0,0,0,0,0,0,0,0,0
0,0,0,0,0,0,0,0,0
0,0,0,0,0,0,0,0,0
0,0,0,0,0,0,0,0,0
0,0,0,0,0,0,0,0,0
5910,32,1,2,1,1,0,0,0
0,0,0,0,0,0,0,0,0
0,0,0,0,0,0,0,0,0
0,0,0,0,0,0,0,0,0
22003,33,0,1,1,0,0,1,0
11615,66,4,8,0,8,0,1,0
0,0,0,0,0,0,0,0,0
362391,2222,13,63,39,24,25,1,0
0,0,0,0,0,0,0,0,0
3385,41,0,6,0,6,0,0,0
3385,41,0,6,0,6,0,0,0
0,0,0,0,0,0,0,0,0
313912,187,4,26,18,8,2,1,0
0,0,0,0,0,0,0,0,0
0,0,0,0,0,0,0,0,0
0,0,0,0,0,0,0,0,0
0,0,0,0,0,0,0,0,0
0,0,0,0,0,0,0,0,0
0,0,0,0,0,0,0,0,0
7638,33,0,2,2,0,0,1,0
267447,1528,14,87,83,4,4,1,0
0,0,0,0,0,0,0,0,0
0,0,0,0,0,0,0,0,0
65721,247,0,46,24,22,0,1,1
65709,247,0,46,24,22,0,1,1
0,0,0,0,0,0,0,0,0
0,0,0,0,0,0,0,0,0
0,0,0,0,0,0,0,0,0
0,0,0,0,0,0,0,0,0
0,0,0,0,0,0,0,0,0
0,0,0,0,0,0,0,0,0
0,0,0,0,0,0,0,0,0
0,0,0,0,0,0,0,0,0
0,0,0,0,0,0,0,0,0
0,0,0,0,0,0,0,0,0
267447,1528,14,87,83,4,4,1,0
3141,39,2,1,0,1,0,0,0
0,0,0,0,0,0,0,0,0
0,0,0,0,0,0,0,0,0
0,0,0,0,0,0,0,0,0
0,0,0,0,0,0,0,0,0
0,0,0,0,0,0,0,0,0
0,0,0,0,0,0,0,0,0
0,0,0,0,0,0,0,0,0
0,0,0,0,0,0,0,0,0
0,0,0,0,0,0,0,0,0
0,0,0,0,0,0,0,0,0
0,0,0,0,0,0,0,0,0
0,0,0,0,0,0,0,0,0
0,0,0,0,0,0,0,0,0
0,0,0,0,0,0,0,0,0
93521,84,0,15,15,0,6,0,0
0,0,0,0,0,0,0,0,0
0,0,0,0,0,0,0,0,0
0,0,0,0,0,0,0,0,0
0,0,0,0,0,0,0,0,0
0,0,0,0,0,0,0,0,0
0,0,0,0,0,0,0,0,0
0,0,0,0,0,0,0,0,0
0,0,0,0,0,0,0,0,0
0,0,0,0,0,0,0,0,0
0,0,0,0,0,0,0,0,0
0,0,0,0,0,0,0,0,0
0,0,0,0,0,0,0,0,0
0,0,0,0,0,0,0,0,0
0,0,0,0,0,0,0,0,0
0,0,0,0,0,0,0,0,0
5885,63,4,8,8,0,2,0,0
0,0,0,0,0,0,0,0,0
0,0,0,0,0,0,0,0,0
0,0,0,0,0,0,0,0,0
0,0,0,0,0,0,0,0,0
0,0,0,0,0,0,0,0,0
4194,94,2,3,0,3,0,0,0
0,0,0,0,0,0,0,0,0
0,0,0,0,0,0,0,0,0
0,0,0,0,0,0,0,0,0
0,0,0,0,0,0,0,0,0
0,0,0,0,0,0,0,0,0
0,0,0,0,0,0,0,0,0
183688,180,4,26,18,8,2,1,0
0,0,0,0,0,0,0,0,0
0,0,0,0,0,0,0,0,0
24370,398,1,54,49,5,2,1,0
0,0,0,0,0,0,0,0,0
0,0,0,0,0,0,0,0,0
984,20,0,0,0,0,0,0,0
7803,33,0,2,2,0,0,1,0
0,0,0,0,0,0,0,0,0
0,0,0,0,0,0,0,0,0
0,0,0,0,0,0,0,0,0
0,0,0,0,0,0,0,0,0
0,0,0,0,0,0,0,0,0
0,0,0,0,0,0,0,0,0
0,0,0,0,0,0,0,0,0
0,0,0,0,0,0,0,0,0
0,0,0,0,0,0,0,0,0
0,0,0,0,0,0,0,0,0
0,0,0,0,0,0,0,0,0
7570,120,0,4,1,3,0,0,0
7570,120,0,4,1,3,0,0,0
0,0,0,0,0,0,0,0,0
0,0,0,0,0,0,0,0,0
0,0,0,0,0,0,0,0,0
0,0,0,0,0,0,0,0,0
0,0,0,0,0,0,0,0,0
0,0,0,0,0,0,0,0,0
0,0,0,0,0,0,0,0,0
0,0,0,0,0,0,0,0,0
0,0,0,0,0,0,0,0,0
0,0,0,0,0,0,0,0,0
0,0,0,0,0,0,0,0,0
0,0,0,0,0,0,0,0,0
0,0,0,0,0,0,0,0,0
0,0,0,0,0,0,0,0,0
0,0,0,0,0,0,0,0,0
0,0,0,0,0,0,0,0,0
0,0,0,0,0,0,0,0,0
0,0,0,0,0,0,0,0,0
0,0,0,0,0,0,0,0,0
0,0,0,0,0,0,0,0,0
0,0,0,0,0,0,0,0,0
136262,323,8,27,24,3,20,1,0
0,0,0,0,0,0,0,0,0
267949,185,4,26,18,8,2,1,0
0,0,0,0,0,0,0,0,0
0,0,0,0,0,0,0,0,0
0,0,0,0,0,0,0,0,0
0,0,0,0,0,0,0,0,0
65648,247,0,46,24,22,0,1,1
65649,247,0,46,24,22,0,1,1
65648,247,0,46,24,22,0,1,1
65646,247,0,46,24,22,0,1,1
0,0,0,0,0,0,0,0,0
0,0,0,0,0,0,0,0,0
0,0,0,0,0,0,0,0,0
0,0,0,0,0,0,0,0,0
0,0,0,0,0,0,0,0,0
0,0,0,0,0,0,0,0,0
0,0,0,0,0,0,0,0,0
220023,523,7,56,51,5,0,1,0
141565,425,8,30,24,6,35,1,0
24180,287,9,8,5,3,0,0,0
0,0,0,0,0,0,0,0,0
0,0,0,0,0,0,0,0,0
0,0,0,0,0,0,0,0,0
0,0,0,0,0,0,0,0,0
0,0,0,0,0,0,0,0,0
0,0,0,0,0,0,0,0,0
0,0,0,0,0,0,0,0,0
0,0,0,0,0,0,0,0,0
0,0,0,0,0,0,0,0,0
9240,125,1,5,5,0,0,0,0
0,0,0,0,0,0,0,0,0
0,0,0,0,0,0,0,0,0
0,0,0,0,0,0,0,0,0
483655,1706,1,192,32,160,12,1,0
0,0,0,0,0,0,0,0,0
0,0,0,0,0,0,0,0,0
0,0,0,0,0,0,0,0,0
0,0,0,0,0,0,0,0,0
274956,3103,8,310,289,21,13,0,0
190599,378,3,25,7,18,15,1,0
0,0,0,0,0,0,0,0,0
11666,50,0,5,0,5,0,0,0
0,0,0,0,0,0,0,0,0
0,0,0,0,0,0,0,0,0
24372,164,2,12,1,11,5,1,0
0,0,0,0,0,0,0,0,0
0,0,0,0,0,0,0,0,0
179426,1689,1,181,180,1,1,1,0
179850,1689,1,181,180,1,1,1,0
0,0,0,0,0,0,0,0,0
0,0,0,0,0,0,0,0,0
17393,245,0,5,5,0,6,1,0
0,0,0,0,0,0,0,0,0
0,0,0,0,0,0,0,0,0
0,0,0,0,0,0,0,0,0
0,0,0,0,0,0,0,0,0
0,0,0,0,0,0,0,0,0
0,0,0,0,0,0,0,0,0
0,0,0,0,0,0,0,0,0
0,0,0,0,0,0,0,0,0
0,0,0,0,0,0,0,0,0
0,0,0,0,0,0,0,0,0
0,0,0,0,0,0,0,0,0
0,0,0,0,0,0,0,0,0
0,0,0,0,0,0,0,0,0
0,0,0,0,0,0,0,0,0
0,0,0,0,0,0,0,0,0
0,0,0,0,0,0,0,0,0
0,0,0,0,0,0,0,0,0
0,0,0,0,0,0,0,0,0
0,0,0,0,0,0,0,0,0
26914,37,0,1,0,1,0,0,0
26914,37,0,1,0,1,0,0,0
0,0,0,0,0,0,0,0,0
0,0,0,0,0,0,0,0,0
0,0,0,0,0,0,0,0,0
0,0,0,0,0,0,0,0,0
0,0,0,0,0,0,0,0,0
0,0,0,0,0,0,0,0,0
0,0,0,0,0,0,0,0,0
0,0,0,0,0,0,0,0,0
0,0,0,0,0,0,0,0,0
0,0,0,0,0,0,0,0,0
16312,89,0,15,1,14,0,1,0
0,0,0,0,0,0,0,0,0
0,0,0,0,0,0,0,0,0
21867,33,0,1,1,0,0,1,0
21851,33,0,1,1,0,0,1,0
0,0,0,0,0,0,0,0,0
191613,378,3,25,7,18,14,1,0
0,0,0,0,0,0,0,0,0
681033,556,0,4,0,4,2,1,1
703627,552,0,5,5,0,2,1,1
704030,552,0,5,5,0,2,1,1
676639,556,0,4,4,0,2,1,1
0,0,0,0,0,0,0,0,0
0,0,0,0,0,0,0,0,0
748247,523,7,15,1,14,0,1,0
748247,523,7,15,15,0,0,1,0
0,0,0,0,0,0,0,0,0
0,0,0,0,0,0,0,0,0
0,0,0,0,0,0,0,0,0
680560,556,0,4,0,4,2,1,1
0,0,0,0,0,0,0,0,0
22561,39,0,3,1,2,0,1,0
0,0,0,0,0,0,0,0,0
0,0,0,0,0,0,0,0,0
0,0,0,0,0,0,0,0,0
0,0,0,0,0,0,0,0,0
0,0,0,0,0,0,0,0,0
0,0,0,0,0,0,0,0,0
0,0,0,0,0,0,0,0,0
0,0,0,0,0,0,0,0,0
16042,91,4,9,6,3,2,0,0
47498,143,1,3,0,3,1,0,0
0,0,0,0,0,0,0,0,0
0,0,0,0,0,0,0,0,0
0,0,0,0,0,0,0,0,0
82131,193,3,13,8,5,5,1,0
82131,193,3,13,8,5,5,1,0
584,10,0,0,0,0,0,0,0
584,10,0,0,0,0,0,0,0
0,0,0,0,0,0,0,0,0
3385,41,0,6,0,6,0,0,0
676132,556,0,4,4,0,2,1,1
347079,64,1,5,5,0,0,1,0
0,0,0,0,0,0,0,0,0
251213,438,2,48,0,48,0,1,0
0,0,0,0,0,0,0,0,0
8911,34,0,2,2,0,0,0,0
13994,196,6,19,18,1,0,1,0
0,0,0,0,0,0,0,0,0
0,0,0,0,0,0,0,0,0
13690,38,2,0,0,0,2,0,0
0,0,0,0,0,0,0,0,0
0,0,0,0,0,0,0,0,0
0,0,0,0,0,0,0,0,0
65648,247,0,46,24,22,0,1,1
65647,247,0,46,24,22,0,1,1
0,0,0,0,0,0,0,0,0
65649,247,0,46,24,22,0,1,1
0,0,0,0,0,0,0,0,0
617495,2098,1,95,40,55,3,1,1
621280,2097,1,95,40,55,3,1,1
0,0,0,0,0,0,0,0,0
0,0,0,0,0,0,0,0,0
22323,321,6,67,59,8,2,1,0
0,0,0,0,0,0,0,0,0
0,0,0,0,0,0,0,0,0
676672,556,0,4,4,0,2,1,1
0,0,0,0,0,0,0,0,0
0,0,0,0,0,0,0,0,0
0,0,0,0,0,0,0,0,0
705217,552,0,5,5,0,2,1,1
0,0,0,0,0,0,0,0,0
0,0,0,0,0,0,0,0,0
0,0,0,0,0,0,0,0,0
0,0,0,0,0,0,0,0,0
191345,378,3,25,7,18,14,1,0
0,0,0,0,0,0,0,0,0
212343,812,17,45,33,12,8,1,0
0,0,0,0,0,0,0,0,0
113002,695,14,43,40,3,1,0,0
0,0,0,0,0,0,0,0,0
0,0,0,0,0,0,0,0,0
0,0,0,0,0,0,0,0,0
0,0,0,0,0,0,0,0,0
0,0,0,0,0,0,0,0,0
0,0,0,0,0,0,0,0,0
0,0,0,0,0,0,0,0,0
0,0,0,0,0,0,0,0,0
0,0,0,0,0,0,0,0,0
5209,47,4,0,0,0,2,1,0
0,0,0,0,0,0,0,0,0
0,0,0,0,0,0,0,0,0
327879,32,0,0,0,0,0,0,0
3479,48,0,1,1,0,0,0,0
3479,48,0,1,1,0,0,0,0
11486,127,1,16,12,4,1,1,0
11486,127,1,16,12,4,1,1,0
0,0,0,0,0,0,0,0,0
0,0,0,0,0,0,0,0,0
0,0,0,0,0,0,0,0,0
0,0,0,0,0,0,0,0,0
0,0,0,0,0,0,0,0,0
0,0,0,0,0,0,0,0,0
65646,247,0,46,24,22,0,1,1
0,0,0,0,0,0,0,0,0
0,0,0,0,0,0,0,0,0
0,0,0,0,0,0,0,0,0
0,0,0,0,0,0,0,0,0
0,0,0,0,0,0,0,0,0
0,0,0,0,0,0,0,0,0
0,0,0,0,0,0,0,0,0
0,0,0,0,0,0,0,0,0
0,0,0,0,0,0,0,0,0
0,0,0,0,0,0,0,0,0
0,0,0,0,0,0,0,0,0
0,0,0,0,0,0,0,0,0
0,0,0,0,0,0,0,0,0
0,0,0,0,0,0,0,0,0
0,0,0,0,0,0,0,0,0
0,0,0,0,0,0,0,0,0
0,0,0,0,0,0,0,0,0
0,0,0,0,0,0,0,0,0
0,0,0,0,0,0,0,0,0
0,0,0,0,0,0,0,0,0
0,0,0,0,0,0,0,0,0
7513,49,0,3,3,0,1,0,1
212060,899,2,48,7,41,6,1,0
463252,1168,8,106,81,25,14,1,0
0,0,0,0,0,0,0,0,0
0,0,0,0,0,0,0,0,0
0,0,0,0,0,0,0,0,0
191403,378,3,25,7,18,14,1,0
1415295,3498,9,561,533,28,1,1,0
0,0,0,0,0,0,0,0,0
33987,236,10,7,7,0,0,1,0
0,0,0,0,0,0,0,0,0
707425,1122,6,59,55,4,16,1,0
707424,1122,6,59,48,11,16,1,0
0,0,0,0,0,0,0,0,0
136879,569,11,51,49,2,3,1,0
6376,65,7,3,2,1,0,0,0
6376,65,7,3,2,1,0,0,0
0,0,0,0,0,0,0,0,0
3385,41,0,6,0,6,0,0,0
15334,142,0,56,51,5,0,0,0
1813246,81,4,6,6,0,5,0,0
162240,218,4,26,18,8,2,1,0
0,0,0,0,0,0,0,0,0
88501,57,4,5,5,0,2,0,0
0,0,0,0,0,0,0,0,0
0,0,0,0,0,0,0,0,0
168911,457,10,8,8,0,3,1,0
34075,51,3,0,0,0,2,0,0
8242,146,0,15,15,0,5,1,0
1242267,126,2,17,17,0,2,0,0
130277,368,8,31,31,0,1,1,0
0,0,0,0,0,0,0,0,0
143102,853,10,65,56,9,7,1,0
0,0,0,0,0,0,0,0,0
180492,949,11,39,34,5,3,1,0
0,0,0,0,0,0,0,0,0
260969,1728,5,108,101,7,0,1,0
0,0,0,0,0,0,0,0,0
65648,247,0,46,24,22,0,1,1
65650,247,0,46,24,22,0,1,1
66851,253,0,46,24,22,0,1,1
137671,178,0,6,3,3,0,1,0
137671,178,0,6,3,3,0,1,0
14207,83,2,0,0,0,0,0,0
14207,83,2,0,0,0,0,0,0
0,0,0,0,0,0,0,0,0
0,0,0,0,0,0,0,0,0
0,0,0,0,0,0,0,0,0
0,0,0,0,0,0,0,0,0
317508,1723,12,127,69,58,0,1,0
0,0,0,0,0,0,0,0,0
0,0,0,0,0,0,0,0,0
71175,192,0,32,16,16,0,0,0
0,0,0,0,0,0,0,0,0
0,0,0,0,0,0,0,0,0
0,0,0,0,0,0,0,0,0
0,0,0,0,0,0,0,0,0
107408,674,3,140,130,10,8,0,0
35782,159,3,8,4,4,11,1,0
33697,155,3,8,4,4,11,1,0
33660,661,10,120,112,8,0,1,0
33660,661,10,120,112,8,0,1,0
33660,661,10,120,112,8,0,1,0
167484,931,11,118,100,18,3,0,0
0,0,0,0,0,0,0,0,0
0,0,0,0,0,0,0,0,0
6748,91,3,0,0,0,0,0,0
6748,91,3,0,0,0,0,0,0
182775,44,4,0,0,0,2,1,0
0,0,0,0,0,0,0,0,0
0,0,0,0,0,0,0,0,0
0,0,0,0,0,0,0,0,0
0,0,0,0,0,0,0,0,0
0,0,0,0,0,0,0,0,0
1905500,251,4,4,4,0,0,1,0
0,0,0,0,0,0,0,0,0
0,0,0,0,0,0,0,0,0
0,0,0,0,0,0,0,0,0
65648,247,0,46,24,22,0,1,1
0,0,0,0,0,0,0,0,0
0,0,0,0,0,0,0,0,0
0,0,0,0,0,0,0,0,0
0,0,0,0,0,0,0,0,0
0,0,0,0,0,0,0,0,0
0,0,0,0,0,0,0,0,0
8410,74,6,3,2,1,0,0,0
0,0,0,0,0,0,0,0,0
0,0,0,0,0,0,0,0,0
675461,556,0,4,4,0,2,1,1
0,0,0,0,0,0,0,0,0
0,0,0,0,0,0,0,0,0
0,0,0,0,0,0,0,0,0
0,0,0,0,0,0,0,0,0
0,0,0,0,0,0,0,0,0
0,0,0,0,0,0,0,0,0
589310,227,5,29,23,6,0,1,0
0,0,0,0,0,0,0,0,0
0,0,0,0,0,0,0,0,0
0,0,0,0,0,0,0,0,0
0,0,0,0,0,0,0,0,0
0,0,0,0,0,0,0,0,0
0,0,0,0,0,0,0,0,0
0,0,0,0,0,0,0,0,0
0,0,0,0,0,0,0,0,0
0,0,0,0,0,0,0,0,0
0,0,0,0,0,0,0,0,0
0,0,0,0,0,0,0,0,0
0,0,0,0,0,0,0,0,0
0,0,0,0,0,0,0,0,0
0,0,0,0,0,0,0,0,0
0,0,0,0,0,0,0,0,0
0,0,0,0,0,0,0,0,0
0,0,0,0,0,0,0,0,0
0,0,0,0,0,0,0,0,0
0,0,0,0,0,0,0,0,0
3436,54,0,0,0,0,0,1,0
26892,36,0,3,1,2,0,0,0
8224,123,7,11,11,0,0,1,0
11666,50,0,5,0,5,0,0,0
0,0,0,0,0,0,0,0,0
0,0,0,0,0,0,0,0,0
129014,978,7,131,126,5,14,0,0
0,0,0,0,0,0,0,0,0
89866,402,6,70,66,4,36,1,0
