page_len,page_tag_num,page_tech_num,page_domain_type_num,page_like_req_domain_num,page_unlike_req_domain_num,page_hidden_tag_num,page_have_copyright,page_have_redirect
207800,273,0,17,14,3,0,1,0
0,0,0,0,0,0,0,0,0
63294,238,0,46,41,5,0,1,1
109026,391,0,46,40,6,1,1,1
569785,391,2,62,58,4,27,1,1
26940,243,1,13,7,6,9,1,0
487646,1721,1,211,58,153,11,1,0
36169,355,0,7,5,2,6,0,0
768922,2969,1,346,312,34,10,1,0
84479,991,0,328,325,3,0,0,0
0,0,0,0,0,0,0,0,0
211618,277,0,18,10,8,0,1,0
189684,193,3,29,28,1,2,1,0
182553,171,3,9,9,0,2,1,0
409558,857,4,115,12,103,9,1,0
307122,705,4,115,84,31,8,1,0
453566,2159,2,456,148,308,3,1,0
163636,332,1,73,24,49,0,1,0
0,0,0,0,0,0,0,0,0
489090,4014,2,1280,985,295,24,1,0
291458,2308,1,246,38,208,4,1,0
36280,346,3,13,3,10,1,1,0
208502,277,0,18,9,9,0,1,0
0,0,0,0,0,0,0,0,0
0,0,0,0,0,0,0,0,0
184748,488,0,74,48,26,4,1,0
2144762,4787,0,289,23,266,7,0,0
313958,369,0,44,30,14,11,1,1
647331,3052,2,554,338,216,9,0,1
459926,389,0,17,13,4,1,1,0
461802,386,0,20,16,4,1,1,0
446679,1564,2,343,285,58,6,1,0
0,0,0,0,0,0,0,0,0
216898,277,0,18,9,9,0,1,0
715695,2199,1,304,286,18,10,1,0
445937,1399,2,117,42,75,6,1,0
244027,414,1,17,1,16,3,1,0
289705,789,2,214,164,50,0,1,0
214931,234,0,48,32,16,2,1,0
0,0,0,0,0,0,0,0,0
210280,277,0,18,9,9,0,1,0
0,0,0,0,0,0,0,0,0
208491,278,0,18,9,9,0,1,0
849529,4206,1,369,326,43,94,1,0
27986,167,2,8,8,0,0,0,0
210324,277,0,18,11,7,0,1,0
3124,27,0,13,2,11,0,1,0
390429,601,1,20,18,2,0,0,0
301089,1594,1,267,13,254,2,0,0
208552,277,0,18,9,9,0,1,0
0,0,0,0,0,0,0,0,0
0,0,0,0,0,0,0,0,0
307712,824,4,120,94,26,11,1,0
309208,1990,5,220,197,23,6,0,0
207936,277,0,18,9,9,0,1,0
207590,277,0,18,9,9,0,1,0
165774,291,2,16,16,0,0,0,0
702796,540,0,4,0,4,2,1,1
0,0,0,0,0,0,0,0,0
0,0,0,0,0,0,0,0,0
479579,2406,4,89,68,21,4,0,0
148127,556,6,45,20,25,0,1,0
262811,2253,3,70,67,3,5,1,0
27061,131,3,11,10,1,3,0,0
871537,3903,5,374,354,20,9,1,0
0,0,0,0,0,0,0,0,0
1648643,1679,2,267,251,16,0,1,0
0,0,0,0,0,0,0,0,0
169885,972,2,118,91,27,0,1,0
57638,400,3,46,44,2,2,0,0
281864,1371,1,281,252,29,0,1,0
208483,277,0,18,12,6,0,1,0
1370424,5465,2,455,413,42,0,1,0
113572,104,0,7,6,1,0,1,0
30587,349,3,82,56,26,1,1,0
67121,388,3,35,29,6,3,1,0
207899,273,0,17,9,8,0,1,0
0,0,0,0,0,0,0,0,0
440806,1344,1,210,181,29,5,1,0
208465,277,0,18,13,5,0,1,0
208442,277,0,18,11,7,0,1,0
422162,1120,1,145,110,35,3,1,0
301327,963,0,175,9,166,29,1,0
0,0,0,0,0,0,0,0,0
476310,4736,3,963,910,53,81,1,0
0,0,0,0,0,0,0,0,0
574364,4406,8,746,526,220,8,1,0
210430,277,0,18,10,8,0,1,0
218140,292,3,88,88,0,3,0,0
222190,1638,0,113,101,12,1,1,0
52757,320,0,9,9,0,2,0,0
49254,1261,0,359,357,2,8,1,0
81810,77,0,11,11,0,1,1,0
5636,26,0,2,1,1,0,1,0
334156,1290,4,133,22,111,0,1,0
0,0,0,0,0,0,0,0,0
159826,1253,4,96,90,6,10,1,0
40136,163,4,14,13,1,7,1,0
799380,3042,1,368,331,37,11,1,0
594995,1776,4,295,75,220,5,1,0
360091,2829,0,386,377,9,10,1,0
89334,680,0,147,144,3,4,1,0
165774,291,2,16,16,0,0,0,0
701438,540,0,4,0,4,2,1,1
677836,2585,1,327,292,35,10,1,0
112692,533,7,88,83,5,13,1,0
41327,124,5,16,16,0,3,1,0
3189823,2865,8,435,178,257,38,1,0
0,0,0,0,0,0,0,0,0
362078,5880,4,1388,148,1240,25,0,0
19070,54,1,1,1,0,1,0,0
26942,39,0,2,1,1,0,0,0
53946,832,3,178,135,43,2,1,0
208435,277,0,18,9,9,0,1,0
208477,277,0,18,12,6,0,1,0
289222,860,0,163,156,7,2,0,0
9360,154,0,14,13,1,5,1,0
1157201,1557,3,135,130,5,0,0,0
405289,486,4,40,33,7,7,0,0
91112,439,2,54,33,21,2,1,0
329624,2737,5,674,659,15,1,1,0
0,0,0,0,0,0,0,0,0
0,0,0,0,0,0,0,0,0
160340,2783,3,546,355,191,2,0,0
0,0,0,0,0,0,0,0,0
0,0,0,0,0,0,0,0,0
227275,1177,0,73,50,23,0,1,1
1361197,5261,1,830,768,62,5,1,0
0,0,0,0,0,0,0,0,0
0,0,0,0,0,0,0,0,0
422121,1114,1,346,342,4,0,1,0
77386,264,0,38,35,3,0,1,0
0,0,0,0,0,0,0,0,0
13181,145,0,37,33,4,0,1,0
0,0,0,0,0,0,0,0,0
0,0,0,0,0,0,0,0,0
208535,277,0,18,15,3,0,1,0
731476,3040,6,286,282,4,14,1,0
325240,130,2,7,6,1,0,1,0
231122,1581,8,305,228,77,10,1,0
208075,277,0,18,12,6,0,1,0
210473,277,0,18,15,3,0,1,0
695738,2115,14,127,8,119,1,1,0
32705,123,3,4,2,2,1,0,0
690858,2801,1,208,195,13,8,1,0
1081326,924,7,125,93,32,36,1,0
3195873,10576,1,1228,1194,34,10,1,0
0,0,0,0,0,0,0,0,0
0,0,0,0,0,0,0,0,0
881262,2277,2,417,362,55,11,1,0
266619,213,0,21,9,12,5,1,0
208352,277,0,18,10,8,0,1,0
210253,277,0,18,12,6,0,1,0
204852,1427,3,404,377,27,4,1,0
0,0,0,0,0,0,0,0,0
0,0,0,0,0,0,0,0,0
207847,273,0,17,11,6,0,1,0
0,0,0,0,0,0,0,0,0
210036,277,0,18,9,9,0,1,0
0,0,0,0,0,0,0,0,0
410323,3592,1,325,325,0,3,1,0
0,0,0,0,0,0,0,0,0
189919,202,2,17,17,0,1,1,0
208259,277,0,18,9,9,0,1,0
27354,110,4,2,2,0,6,0,0
15788,176,2,17,16,1,0,1,0
18056,57,1,1,0,1,0,0,0
230853,1580,8,306,254,52,10,1,0
0,0,0,0,0,0,0,0,0
1025349,3659,9,377,324,53,41,1,0
0,0,0,0,0,0,0,0,0
306297,381,1,95,39,56,0,1,0
215539,234,0,50,33,17,2,1,0
1556531,2836,11,322,307,15,27,1,1
7235,67,1,8,6,2,2,0,0
0,0,0,0,0,0,0,0,0
1802689,8692,7,1203,1175,28,34,1,0
512480,1024,1,150,28,122,3,1,0
107004,1269,1,224,213,11,7,1,0
0,0,0,0,0,0,0,0,0
237906,2655,9,402,380,22,18,1,0
255675,1282,6,325,303,22,20,1,0
306998,772,9,114,94,20,18,1,0
0,0,0,0,0,0,0,0,0
114747,740,2,111,67,44,2,1,0
10779,99,2,17,14,3,3,1,0
1190839,3090,7,591,381,210,11,1,0
214239,747,1,64,62,2,1,1,0
174339,306,1,110,87,23,2,1,0
168746,171,0,73,52,21,0,1,0
1168090,4445,9,590,362,228,68,1,1
218218,699,3,131,125,6,2,1,0
40375,153,4,13,1,12,1,1,0
413995,2414,2,185,169,16,1,1,0
209075,273,0,17,4,13,0,1,0
1611028,3222,5,179,179,0,1,1,0
1718700,3296,5,182,181,1,4,1,0
0,0,0,0,0,0,0,0,0
315909,2225,9,387,342,45,102,1,0
414297,3082,3,562,550,12,1,1,0
251047,362,3,88,77,11,1,1,0
158863,204,1,24,18,6,2,1,0
62318,472,1,43,34,9,1,1,0
222630,1237,1,194,189,5,3,1,0
721121,3632,1,255,255,0,84,1,0
0,0,0,0,0,0,0,0,0
209196,277,0,18,9,9,0,1,0
1014153,2176,5,230,217,13,17,1,0
0,0,0,0,0,0,0,0,0
208881,277,0,18,10,8,0,1,0
0,0,0,0,0,0,0,0,0
1170536,1710,5,279,221,58,21,1,0
184091,1941,4,299,207,92,9,1,0
208231,277,0,18,12,6,0,1,0
0,0,0,0,0,0,0,0,0
304099,2278,5,453,369,84,22,1,0
864267,4342,2,315,303,12,1,1,0
60407,217,2,20,18,2,3,1,0
379011,1315,6,182,158,24,28,1,0
98465,320,2,18,15,3,3,1,0
0,0,0,0,0,0,0,0,0
0,0,0,0,0,0,0,0,0
393635,803,1,73,57,16,0,1,0
6885,75,1,9,9,0,0,0,0
83588,1004,3,347,293,54,0,1,0
14361,99,2,3,3,0,0,0,0
544946,1762,1,300,264,36,11,1,0
2313319,3948,6,507,504,3,12,1,0
48748,146,5,4,4,0,1,0,0
813929,4722,7,452,449,3,6,0,0
103718,280,7,11,11,0,6,0,0
130319,564,12,102,86,16,9,0,0
306520,531,2,39,38,1,4,0,0
66594,758,8,37,37,0,13,1,0
39819,362,7,49,45,4,3,1,0
0,0,0,0,0,0,0,0,0
368821,2157,1,335,152,183,18,0,0
672050,4320,11,721,671,50,35,1,0
0,0,0,0,0,0,0,0,0
394305,2090,4,428,418,10,8,1,0
198382,899,3,158,149,9,5,1,0
210424,277,0,18,12,6,0,1,0
845757,2887,1,431,390,41,11,1,0
413195,1257,1,371,346,25,13,0,0
414633,2615,5,341,315,26,1,1,0
339067,4000,3,1062,1049,13,63,1,0
0,0,0,0,0,0,0,0,0
759544,2865,5,300,271,29,6,1,0
414708,1337,6,136,128,8,5,1,0
414374,1174,5,14,12,2,18,1,0
1062621,1534,7,294,265,29,19,1,0
1277855,1394,5,159,150,9,6,1,0
334222,1759,1,120,111,9,3,1,0
0,0,0,0,0,0,0,0,0
1462078,3440,2,24,14,10,136,1,0
216046,950,2,149,126,23,1,1,0
1319134,3501,2,597,267,330,2,1,0
0,0,0,0,0,0,0,0,0
208484,277,0,18,15,3,0,1,0
462697,4091,2,633,368,265,3,1,0
1301,15,0,2,0,2,0,0,0
29255,302,2,43,42,1,2,1,0
196807,1124,1,100,61,39,0,0,0
443274,2214,1,659,635,24,3,1,0
158822,1428,11,421,410,11,16,1,0
0,0,0,0,0,0,0,0,0
919266,6083,4,100,88,12,14,1,0
0,0,0,0,0,0,0,0,0
208561,277,0,18,15,3,0,1,0
0,0,0,0,0,0,0,0,0
702756,2170,5,225,220,5,61,0,0
401688,762,3,51,47,4,4,0,0
112540,38,0,1,1,0,2,0,0
350501,1776,8,166,82,84,9,1,0
1174372,10162,9,2170,2158,12,11,1,0
59530,174,9,6,4,2,1,0,0
306431,2251,2,325,312,13,3,1,0
210395,277,0,18,9,9,0,1,0
349060,2386,4,249,224,25,58,1,0
42388,436,3,80,50,30,60,1,0
11077,90,3,22,19,3,0,1,0
22880,192,3,23,17,6,1,1,0
677668,1945,3,179,111,68,3,1,0
0,0,0,0,0,0,0,0,0
0,0,0,0,0,0,0,0,0
382751,3832,0,611,521,90,3,0,0
14001,154,1,17,8,9,1,0,0
14128,262,2,37,18,19,9,1,0
208480,277,0,18,9,9,0,1,0
0,0,0,0,0,0,0,0,0
0,0,0,0,0,0,0,0,0
48677,310,2,44,22,22,2,1,0
29115,171,1,16,8,8,2,1,0
656204,2094,3,123,114,9,1,1,0
0,0,0,0,0,0,0,0,0
0,0,0,0,0,0,0,0,0
447252,2901,6,667,527,140,29,1,0
0,0,0,0,0,0,0,0,0
540103,2699,2,395,378,17,35,1,0
187960,2177,1,91,75,16,61,1,0
154824,610,3,33,27,6,1,1,0
0,0,0,0,0,0,0,0,0
400661,1316,3,232,222,10,1,0,0
593019,1481,5,239,225,14,3,0,0
472934,1803,7,363,356,7,3,1,0
16691,128,6,11,11,0,4,0,0
0,0,0,0,0,0,0,0,0
210408,277,0,18,12,6,0,1,0
1367793,3585,11,192,140,52,9,1,0
61181,253,9,7,0,7,12,0,0
56869,639,2,160,142,18,0,1,0
701811,2879,6,220,214,6,30,1,1
0,0,0,0,0,0,0,0,0
364243,1399,4,146,62,84,2,0,0
212323,225,0,46,31,15,2,1,0
0,0,0,0,0,0,0,0,0
287691,1998,5,669,650,19,12,1,0
250953,1714,5,597,572,25,12,1,0
6224,80,1,9,6,3,2,0,0
0,0,0,0,0,0,0,0,0
0,0,0,0,0,0,0,0,0
837044,1889,5,196,182,14,7,1,0
0,0,0,0,0,0,0,0,0
723644,746,4,75,63,12,6,1,0
108381,247,3,36,30,6,2,1,0
127242,964,6,227,201,26,6,1,0
364259,471,5,41,10,31,16,1,0
0,0,0,0,0,0,0,0,0
474574,1778,1,392,143,249,11,1,0
387764,3180,4,235,228,7,8,1,0
229103,334,4,46,39,7,8,1,0
210399,277,0,18,10,8,0,1,0
1067245,2376,3,215,212,3,0,1,0
0,0,0,0,0,0,0,0,0
0,0,0,0,0,0,0,0,0
5023,63,1,12,9,3,0,0,0
209956,294,0,16,10,6,1,1,0
0,0,0,0,0,0,0,0,0
393864,3212,6,226,222,4,107,1,0
133422,292,5,14,12,2,2,0,0
443203,2027,6,457,439,18,21,1,0
0,0,0,0,0,0,0,0,0
0,0,0,0,0,0,0,0,0
0,0,0,0,0,0,0,0,0
0,0,0,0,0,0,0,0,0
0,0,0,0,0,0,0,0,0
4166857,12074,13,1531,1523,8,29,1,0
67536,807,6,120,21,99,26,1,0
0,0,0,0,0,0,0,0,0
1077229,7470,2,1726,1342,384,181,1,0
19939,169,2,24,23,1,4,1,0
0,0,0,0,0,0,0,0,0
208501,277,0,18,14,4,0,1,0
0,0,0,0,0,0,0,0,0
1225881,5112,2,1012,954,58,7,1,0
424425,610,0,35,33,2,0,1,0
495311,1154,1,99,59,40,0,1,0
18821,102,0,24,16,8,0,0,0
1117546,4427,1,553,279,274,2,1,0
5902,61,0,3,2,1,0,1,0
136390,629,7,101,91,10,5,1,0
0,0,0,0,0,0,0,0,0
6195,54,1,0,0,0,0,0,1
104951,1295,2,419,409,10,17,1,0
9673,156,0,15,1,14,1,1,0
5843,124,1,10,10,0,1,1,0
208449,277,0,18,9,9,0,1,0
0,0,0,0,0,0,0,0,0
133440,1596,2,580,566,14,50,1,0
933091,5012,5,376,365,11,236,1,0
781949,3313,9,697,376,321,24,1,0
54256,599,6,137,131,6,9,1,0
154068,135,0,8,6,2,0,1,0
137880,670,5,75,58,17,0,0,0
375450,3934,7,246,246,0,11,0,0
624590,1318,10,234,161,73,23,0,0
212508,972,2,54,48,6,7,1,0
210453,277,0,18,9,9,0,1,0
712836,2327,2,498,10,488,15,1,0
208406,277,0,18,9,9,0,1,0
287363,1181,2,284,284,0,10,1,0
64170,379,3,33,24,9,14,1,0
9685,156,0,15,1,14,1,1,0
5843,124,1,10,10,0,1,1,0
586145,2245,5,367,340,27,27,1,0
192725,1352,3,320,260,60,2,1,0
208512,277,0,18,10,8,0,1,0
0,0,0,0,0,0,0,0,0
32042,343,0,105,101,4,0,0,0
59443,561,3,55,53,2,6,1,0
1080800,4489,8,683,676,7,27,1,0
142723,2574,2,505,502,3,1,1,0
668503,2892,6,365,286,79,17,1,0
596722,1921,1,396,218,178,24,1,0
79947,117,2,11,6,5,2,0,0
472090,1295,4,249,230,19,25,1,0
123709,817,11,128,101,27,2,0,0
204843,278,0,18,9,9,0,1,0
166658,774,2,247,230,17,8,1,0
62473,365,0,115,114,1,0,1,0
0,0,0,0,0,0,0,0,0
216005,1861,5,211,208,3,9,1,0
520445,2198,4,308,59,249,5,1,0
115720,1138,6,303,299,4,9,1,0
0,0,0,0,0,0,0,0,0
534972,2640,8,361,339,22,24,1,0
399250,309,7,2,2,0,12,1,0
44192,696,2,162,150,12,1,1,0
123272,1144,3,124,28,96,8,0,0
25329,238,3,23,18,5,5,0,0
125717,2185,3,689,655,34,12,1,0
83802,106,1,16,12,4,0,1,0
0,0,0,0,0,0,0,0,0
0,0,0,0,0,0,0,0,0
0,0,0,0,0,0,0,0,0
208499,277,0,18,13,5,0,1,0
457719,1927,10,447,350,97,14,1,0
525603,2598,6,225,172,53,9,1,0
199972,1065,2,178,145,33,17,1,0
113945,840,4,87,53,34,0,1,0
78304,1030,3,6,0,6,2,0,0
63354,238,0,46,25,21,0,1,1
109079,391,0,46,40,6,1,1,1
455273,2124,7,526,452,74,7,1,0
455314,2124,7,526,452,74,7,1,0
73665,792,2,160,145,15,8,1,0
624556,965,5,103,43,60,18,1,0
994194,1008,4,89,76,13,11,1,0
210383,277,0,18,9,9,0,1,0
0,0,0,0,0,0,0,0,0
0,0,0,0,0,0,0,0,0
635203,1994,2,160,152,8,7,1,1
268120,135,1,8,5,3,5,1,1
99854,1270,5,260,244,16,31,1,0
0,0,0,0,0,0,0,0,0
361894,1508,9,275,246,29,101,1,0
208402,277,0,18,10,8,0,1,0
195479,1510,9,316,193,123,9,1,0
64690,186,10,6,3,3,2,0,0
246032,1244,3,228,220,8,12,0,0
1027767,3618,6,668,633,35,21,1,0
0,0,0,0,0,0,0,0,0
515823,2595,9,461,417,44,19,1,0
209266,129,0,5,1,4,0,1,0
480553,2062,7,191,173,18,22,1,0
201137,522,7,18,12,6,11,1,0
781498,3826,7,243,214,29,224,1,0
3335729,35048,8,3587,2528,1059,51,1,0
47106,132,8,3,0,3,0,1,0
165403,1497,9,220,74,146,22,1,0
341465,2776,4,714,704,10,34,1,0
126396,462,4,69,60,9,9,1,0
0,0,0,0,0,0,0,0,0
0,0,0,0,0,0,0,0,0
0,0,0,0,0,0,0,0,0
0,0,0,0,0,0,0,0,0
22659,41,0,2,1,1,0,1,0
658867,3206,7,388,264,124,21,0,0
106795,1943,2,86,0,86,24,1,0
208992,277,0,18,10,8,0,1,0
209222,276,0,17,9,8,0,1,0
271630,269,2,6,6,0,2,1,1
261765,178,2,0,0,0,2,1,1
289811,1820,6,429,394,35,15,1,0
0,0,0,0,0,0,0,0,0
0,0,0,0,0,0,0,0,0
0,0,0,0,0,0,0,0,0
1203155,7154,3,327,319,8,4,1,0
808519,3778,3,75,65,10,3,1,0
106309,1342,1,429,227,202,2,0,0
0,0,0,0,0,0,0,0,0
23888,289,3,61,52,9,1,1,0
708944,4202,3,359,336,23,55,1,0
205242,890,2,3,3,0,8,0,0
358257,1499,4,107,81,26,5,1,0
29816,149,2,5,5,0,2,0,0
231478,895,3,148,138,10,45,1,0
244255,945,3,115,105,10,42,1,0
813440,5460,3,393,350,43,286,0,0
45378,117,2,7,7,0,0,0,0
297940,1336,5,201,183,18,4,1,1
162635,285,3,10,9,1,1,0,1
419765,3060,6,444,432,12,55,1,0
186763,193,6,2,2,0,3,0,0
0,0,0,0,0,0,0,0,0
21215,100,3,9,7,2,2,0,0
0,0,0,0,0,0,0,0,0
0,0,0,0,0,0,0,0,0
855492,1821,8,179,163,16,16,1,0
0,0,0,0,0,0,0,0,0
6547,117,0,28,27,1,0,0,0
400362,1044,3,206,190,16,9,1,0
242199,1623,4,326,129,197,6,1,0
4398995,4113,8,723,666,57,49,1,0
2545960,582,3,41,23,18,49,1,0
275521,1055,6,216,201,15,7,1,0
0,0,0,0,0,0,0,0,0
97214,466,2,71,64,7,3,1,0
477149,1564,8,546,524,22,22,1,0
331984,2723,5,436,396,40,46,0,0
93744,275,0,47,24,23,0,1,1
1108032,1619,4,125,72,53,58,1,0
112621,522,4,105,74,31,7,1,0
143693,428,3,134,97,37,4,1,0
168709,170,0,73,52,21,0,1,0
9689,156,0,15,7,8,1,1,0
5843,124,1,10,10,0,1,1,0
322145,1966,6,283,258,25,3,1,0
312821,1985,8,239,208,31,4,1,0
0,0,0,0,0,0,0,0,0
16174,64,1,5,1,4,0,0,0
792396,5682,1,1275,1001,274,15,1,0
163499,332,1,73,24,49,0,1,0
1134978,4681,17,345,289,56,1,1,0
310365,1677,1,323,318,5,4,1,0
163499,332,1,73,24,49,0,1,0
139802,2929,1,1040,1040,0,73,1,0
18107,306,1,40,39,1,9,0,0
1694964,2505,8,260,226,34,20,1,0
0,0,0,0,0,0,0,0,0
459832,2531,2,753,134,619,6,1,1
139830,221,2,25,19,6,6,1,0
0,0,0,0,0,0,0,0,0
1554601,1231,4,205,198,7,4,1,0
466581,98,0,5,5,0,0,1,0
116492,581,2,82,75,7,25,1,0
338777,2929,10,812,803,9,10,1,0
652139,3464,4,271,260,11,5,1,0
1343595,1337,7,59,53,6,24,1,0
323805,1386,5,78,77,1,1,0,0
117584,215,2,13,12,1,1,0,0
1787465,5697,6,385,378,7,2,1,0
0,0,0,0,0,0,0,0,0
51031,453,3,112,85,27,4,1,0
126128,1036,4,140,123,17,3,1,0
45329,202,2,7,6,1,2,0,0
678185,3408,8,162,102,60,14,1,0
269599,570,5,22,21,1,9,0,0
850331,2903,2,403,385,18,15,1,0
477078,2494,9,572,456,116,2,1,0
203299,321,6,33,30,3,4,1,0
1406155,8198,2,682,612,70,251,0,0
1757937,4599,8,632,527,105,6,0,0
208510,277,0,18,9,9,0,1,0
375058,1350,1,252,210,42,10,1,0
35369,341,0,6,4,2,0,0,0
0,0,0,0,0,0,0,0,0
0,0,0,0,0,0,0,0,0
699786,771,8,93,81,12,12,1,0
178272,848,4,116,74,42,3,1,0
10862,99,2,17,14,3,3,1,0
339196,1585,9,269,255,14,53,1,0
700902,5370,9,271,259,12,53,1,0
0,0,0,0,0,0,0,0,0
433994,1608,12,345,296,49,20,1,0
210112,277,0,18,9,9,0,1,0
210347,277,0,18,9,9,0,1,0
809914,2093,2,407,332,75,11,1,0
267368,220,0,25,8,17,5,1,0
0,0,0,0,0,0,0,0,0
912803,3326,2,248,227,21,149,0,0
48080,202,5,11,11,0,4,0,0
193331,1656,6,185,8,177,3,1,0
669294,3558,7,206,187,19,5,1,0
209087,1174,2,96,79,17,1,0,0
226642,1570,5,405,377,28,14,1,0
470083,3280,5,418,418,0,19,1,0
29347,442,3,52,44,8,1,1,0
4557,45,1,6,6,0,0,0,0
82994,500,0,65,58,7,0,1,0
84148,384,0,33,30,3,0,1,0
396275,1399,4,178,151,27,13,1,0
188544,2614,6,358,292,66,17,1,0
840931,2305,4,382,379,3,19,1,0
1245637,1637,7,371,358,13,12,1,0
8430286,1431,7,263,250,13,9,1,0
500765,4329,8,1244,1238,6,23,1,0
1563570,1356,3,165,140,25,16,1,0
15362,145,0,35,31,4,2,1,0
282326,796,7,43,42,1,9,1,0
111064,226,3,18,18,0,6,1,0
71931,707,4,124,117,7,13,1,0
0,0,0,0,0,0,0,0,0
0,0,0,0,0,0,0,0,0
482225,294,0,18,9,9,1,1,0
211304,2340,8,432,423,9,12,1,0
329775,1496,6,187,180,7,5,1,0
126929,396,10,60,60,0,3,0,0
0,0,0,0,0,0,0,0,0
0,0,0,0,0,0,0,0,0
708732,1703,3,100,96,4,1,0,0
22918,40,0,1,1,0,0,1,0
267969,2745,3,1046,939,107,13,0,0
0,0,0,0,0,0,0,0,0
391107,1705,8,216,194,22,20,1,0
79871,107,0,15,12,3,2,1,0
212642,886,4,73,49,24,1,1,0
844649,2698,9,497,479,18,11,1,0
190371,1197,6,244,224,20,12,1,0
243696,1658,6,378,366,12,23,1,0
89955,731,1,313,312,1,0,0,0
796577,2731,3,615,564,51,6,1,0
465430,154,5,9,6,3,6,1,0
305735,1896,5,288,248,40,5,0,0
8971,100,0,6,6,0,0,0,0
789128,3357,3,473,464,9,12,1,0
144876,275,1,17,15,2,0,0,0
146128,302,5,13,12,1,3,1,0
499972,3025,5,518,355,163,22,1,0
21961,158,1,6,4,2,1,0,0
2068905,3711,7,542,418,124,25,1,0
450142,3405,6,736,718,18,3,1,0
767,5,0,0,0,0,0,0,0
253826,1367,6,137,115,22,16,1,0
126162,1117,5,229,216,13,12,1,1
696436,4950,7,846,777,69,4,0,0
296556,905,5,70,28,42,13,1,0
112990,466,5,32,29,3,0,1,0
213078,2008,4,237,228,9,29,1,0
36684,429,0,106,26,80,5,1,0
72541,739,2,85,83,2,4,1,0
258012,1805,8,304,273,31,6,1,1
73671,389,0,43,39,4,0,1,1
406145,3303,2,214,208,6,1,0,0
693913,1057,5,116,109,7,25,1,0
672963,3971,11,250,220,30,56,1,0
0,0,0,0,0,0,0,0,0
230376,1346,6,169,109,60,6,1,0
347826,330,3,31,23,8,0,1,0
0,0,0,0,0,0,0,0,0
482410,294,0,18,9,9,1,1,0
0,0,0,0,0,0,0,0,0
808472,4279,6,653,594,59,27,1,0
301390,1169,3,406,171,235,8,1,0
29775,173,4,28,28,0,2,1,0
890379,2676,7,510,497,13,6,1,0
803346,1758,9,374,358,16,23,1,0
0,0,0,0,0,0,0,0,0
232885,769,3,59,50,9,15,1,0
171950,467,6,40,29,11,5,1,0
434285,2142,4,94,72,22,28,0,0
445793,1080,8,115,98,17,9,1,0
449961,2414,8,537,405,132,28,1,1
603491,3391,14,597,589,8,50,1,0
136632,386,3,92,85,7,3,1,0
1168291,2480,4,402,367,35,12,1,0
221737,198,0,17,8,9,5,1,0
484082,2204,5,151,122,29,7,1,0
0,0,0,0,0,0,0,0,0
1137021,3451,6,376,354,22,118,1,0
169745,660,5,118,92,26,5,1,0
195640,787,6,74,64,10,7,1,0
0,0,0,0,0,0,0,0,0
513764,2744,16,357,337,20,24,1,0
47399,310,5,84,80,4,4,1,0
0,0,0,0,0,0,0,0,0
403838,1876,5,321,317,4,21,1,0
40291,540,1,61,40,21,10,1,0
167548,1253,1,168,143,25,1,1,0
0,0,0,0,0,0,0,0,0
1296296,1832,3,88,81,7,5,1,0
382009,83,0,4,4,0,0,1,0
275397,2667,10,143,121,22,13,1,0
138206,165,1,10,4,6,7,1,0
74820,268,9,42,42,0,1,1,0
112513,1034,3,82,73,9,6,1,1
112317,809,4,217,199,18,5,1,1
0,0,0,0,0,0,0,0,0
0,0,0,0,0,0,0,0,0
523976,2431,5,199,191,8,91,1,0
1831978,15448,6,592,583,9,4,1,0
530470,1554,7,59,55,4,10,1,0
66825,1114,3,332,328,4,12,1,0
72807,252,2,4,4,0,4,0,0
260632,784,9,79,78,1,64,1,0
0,0,0,0,0,0,0,0,0
810043,2386,1,377,322,55,4,1,0
532270,1816,5,318,299,19,14,1,0
594506,1196,7,288,275,13,17,1,0
186063,888,0,205,205,0,0,0,0
0,0,0,0,0,0,0,0,0
0,0,0,0,0,0,0,0,0
0,0,0,0,0,0,0,0,0
707447,3234,2,453,358,95,3,1,0
152511,799,5,50,33,17,1,1,0
1464379,7649,6,1640,1480,160,16,1,0
114771,1368,2,232,202,30,3,1,0
184673,679,2,94,72,22,14,1,0
19383,134,4,54,39,15,1,1,0
6701,55,4,4,4,0,0,0,0
0,0,0,0,0,0,0,0,0
490365,1026,6,136,118,18,7,1,0
297778,878,10,144,24,120,21,1,0
0,0,0,0,0,0,0,0,0
116708,563,6,35,20,15,3,1,0
976703,3567,17,697,612,85,66,1,1
98332,409,12,4,4,0,9,0,0
157956,2478,6,762,756,6,37,1,0
67044,1382,6,387,381,6,17,1,0
1038946,2127,10,289,269,20,40,1,0
454455,1906,5,253,246,7,1,1,0
20507,272,5,33,30,3,2,1,0
0,0,0,0,0,0,0,0,0
0,0,0,0,0,0,0,0,0
0,0,0,0,0,0,0,0,0
85241,71,0,10,10,0,6,0,0
5224,66,6,5,0,5,0,0,0
647686,884,7,73,58,15,2,0,0
16085,89,1,8,5,3,1,0,0
31930,277,8,36,27,9,4,1,0
61153,207,9,37,31,6,5,1,0
70962,536,4,46,13,33,0,0,0
70962,536,4,46,45,1,0,0,0
0,0,0,0,0,0,0,0,0
35841,601,4,225,111,114,11,0,0
0,0,0,0,0,0,0,0,0
554170,2514,4,306,300,6,9,1,0
17677,322,0,74,66,8,0,0,0
23731,113,3,6,2,4,4,0,0
0,0,0,0,0,0,0,0,0
169902,624,2,92,71,21,9,1,0
501896,3286,1,406,378,28,0,1,0
613412,4829,2,1743,1685,58,4,1,0
35154,96,0,3,1,2,2,0,0
202600,1236,6,335,286,49,3,1,0
0,0,0,0,0,0,0,0,0
166616,193,1,22,19,3,0,0,0
554363,3108,7,312,247,65,22,0,0
713671,2066,2,211,204,7,7,1,1
261551,135,1,8,6,2,5,1,1
237564,1730,8,376,202,174,53,1,0
47066,119,6,2,2,0,3,0,0
0,0,0,0,0,0,0,0,0
555657,1673,2,337,321,16,0,1,0
238775,2319,2,521,504,17,3,1,0
0,0,0,0,0,0,0,0,0
1022622,3752,6,246,227,19,9,0,0
29446,123,2,2,2,0,8,0,0
0,0,0,0,0,0,0,0,0
376115,2012,5,223,210,13,16,0,0
32743,142,0,4,2,2,0,0,0
0,0,0,0,0,0,0,0,0
0,0,0,0,0,0,0,0,0
230317,2380,5,331,276,55,14,1,0
58678,822,2,160,152,8,4,1,0
24568,325,1,108,100,8,0,1,0
45435,473,4,101,90,11,15,1,0
3523,47,1,6,6,0,0,0,0
657984,3173,4,644,597,47,21,0,0
260848,1118,3,201,183,18,13,0,0
66232,659,5,44,42,2,26,1,0
325353,2457,5,352,332,20,27,1,0
0,0,0,0,0,0,0,0,0
287152,2887,4,594,592,2,3,1,0
79866,970,5,191,157,34,1,1,0
8541,87,4,2,2,0,0,1,0
1128301,2019,7,682,677,5,16,1,0
629450,1215,6,612,611,1,15,1,0
197223,2409,5,180,98,82,5,1,0
287838,787,2,214,164,50,0,1,0
214859,234,0,48,32,16,2,1,0
0,0,0,0,0,0,0,0,0
621011,2245,5,202,162,40,8,1,0
0,0,0,0,0,0,0,0,0
0,0,0,0,0,0,0,0,0
0,0,0,0,0,0,0,0,0
26346,368,2,20,17,3,33,1,0
152710,1605,3,300,296,4,25,1,0
482339,294,0,18,10,8,1,1,0
1477768,5765,4,1351,1313,38,77,1,0
198567,436,2,103,99,4,0,1,1
0,0,0,0,0,0,0,0,0
1401054,2479,4,306,298,8,14,1,0
245650,2493,5,185,177,8,8,0,0
869168,2750,5,426,417,9,11,1,0
397763,1724,7,288,277,11,29,1,0
118102,96,6,5,5,0,1,1,0
152582,2697,1,431,384,47,4,1,0
46520,478,2,8,7,1,8,1,0
18067,303,2,62,60,2,0,0,0
169989,1833,5,331,312,19,50,0,0
0,0,0,0,0,0,0,0,0
73943,1304,2,417,272,145,11,0,0
1505753,2336,4,350,187,163,12,1,0
940199,546,4,69,54,15,1,1,0
640821,3331,5,474,440,34,10,1,0
822972,2848,3,347,15,332,2,1,0
624289,714,3,44,38,6,5,1,0
785529,2306,6,60,54,6,2,1,0
701515,2452,3,44,39,5,2,1,0
465502,1238,7,187,183,4,8,1,0
71601,598,3,160,124,36,1,1,0
1769682,3531,7,263,255,8,29,1,0
366176,430,6,4,4,0,13,1,0
209323,910,8,104,77,27,5,0,0
644220,2548,8,266,235,31,15,0,0
198770,1331,10,297,287,10,11,1,0
0,0,0,0,0,0,0,0,0
0,0,0,0,0,0,0,0,0
0,0,0,0,0,0,0,0,0
0,0,0,0,0,0,0,0,0
0,0,0,0,0,0,0,0,0
239109,1943,2,305,296,9,3,1,0
95586,1000,3,209,183,26,11,1,0
250821,2664,11,424,26,398,25,1,0
240102,1450,3,249,198,51,0,1,0
180715,653,5,92,40,52,0,1,0
353800,2921,11,684,593,91,49,0,0
0,0,0,0,0,0,0,0,0
7433,129,2,4,4,0,3,1,0
820887,1239,9,139,122,17,21,1,0
603278,770,5,133,86,47,2,1,0
12480,108,4,5,3,2,4,1,0
521645,2460,11,236,206,30,33,1,0
24651,303,4,3,2,1,3,1,0
148972,2252,3,650,610,40,3,1,0
15605,252,1,86,86,0,1,0,0
0,0,0,0,0,0,0,0,0
207057,1381,5,159,151,8,1,1,0
96219,450,10,57,54,3,4,1,0
0,0,0,0,0,0,0,0,0
152151,379,2,28,13,15,0,1,0
169272,572,6,53,47,6,2,1,0
50905,392,7,91,43,48,10,1,0
27310,185,7,24,22,2,11,1,0
0,0,0,0,0,0,0,0,0
168468,690,1,225,195,30,0,1,0
0,0,0,0,0,0,0,0,0
779519,5706,9,892,779,113,30,1,0
24219,332,1,57,53,4,0,0,0
34680,94,3,6,6,0,2,1,0
129083,1326,3,266,262,4,2,1,0
54735,675,4,174,126,48,7,1,0
529358,4126,1,703,541,162,24,1,0
0,0,0,0,0,0,0,0,0
45267,282,5,32,32,0,2,1,0
62279,263,6,18,17,1,2,1,0
217769,290,0,15,9,6,1,1,0
0,0,0,0,0,0,0,0,0
643494,2922,2,202,189,13,0,1,0
0,0,0,0,0,0,0,0,0
482937,294,0,18,9,9,1,1,0
0,0,0,0,0,0,0,0,0
1733463,1097,10,202,188,14,29,1,0
0,0,0,0,0,0,0,0,0
192546,651,7,4,4,0,7,0,0
231882,835,5,182,158,24,20,1,0
0,0,0,0,0,0,0,0,0
0,0,0,0,0,0,0,0,0
1130507,3333,4,287,261,26,53,1,0
212153,372,1,46,38,8,0,0,0
464196,1759,5,92,10,82,6,1,0
481820,294,0,18,9,9,1,1,0
160807,330,2,45,43,2,4,0,0
483883,294,0,18,9,9,1,1,0
61687,356,5,74,72,2,5,1,0
467991,2310,5,356,324,32,5,1,0
0,0,0,0,0,0,0,0,0
573858,4794,3,660,440,220,52,1,0
2419629,21065,6,225,213,12,8,1,0
135969,268,2,15,10,5,3,0,0
617051,2862,9,467,458,9,14,1,0
80130,647,8,111,107,4,5,1,0
47684,240,6,45,44,1,8,1,0
0,0,0,0,0,0,0,0,0
0,0,0,0,0,0,0,0,0
184244,707,7,79,72,7,6,1,0
0,0,0,0,0,0,0,0,0
0,0,0,0,0,0,0,0,0
322830,5789,1,1844,1807,37,13,1,0
483960,294,0,18,11,7,1,1,0
847290,1002,9,83,73,10,8,1,0
0,0,0,0,0,0,0,0,0
156,5,0,0,0,0,0,0,0
194748,775,4,56,52,4,15,1,0
174203,339,2,33,27,6,10,1,0
54190,415,11,42,8,34,0,1,0
46336,544,3,125,111,14,3,1,0
383927,1567,4,226,225,1,1,1,0
445908,1533,6,196,176,20,23,1,0
538193,2588,6,225,213,12,8,1,0
1328926,10883,11,579,565,14,50,1,0
205137,2823,2,1385,1373,12,5,1,0
2601683,30614,8,2813,1926,887,9,0,0
47106,132,8,3,0,3,0,1,0
152616,2298,0,683,673,10,6,1,0
26076,342,0,5,5,0,0,0,0
189236,1259,7,184,170,14,8,1,0
79628,537,0,19,12,7,17,0,0
0,0,0,0,0,0,0,0,0
0,0,0,0,0,0,0,0,0
448415,1438,7,136,120,16,19,1,0
33421,509,7,51,50,1,4,1,0
212527,692,1,122,104,18,1,1,0
65196,92,0,10,5,5,1,0,0
0,0,0,0,0,0,0,0,0
760425,556,3,62,45,17,4,1,0
0,0,0,0,0,0,0,0,0
1294809,4380,11,417,353,64,34,1,0
218882,916,3,291,280,11,9,1,0
125426,162,0,12,5,7,0,1,0
0,0,0,0,0,0,0,0,0
0,0,0,0,0,0,0,0,0
196803,913,4,39,26,13,9,1,0
243343,1596,11,287,270,17,4,1,0
0,0,0,0,0,0,0,0,0
127660,27,0,0,0,0,0,0,0
435208,1824,2,220,210,10,116,1,0
467416,1635,0,580,562,18,4,1,0
68870,168,4,8,6,2,6,0,0
1605176,3411,12,533,457,76,41,1,0
0,0,0,0,0,0,0,0,0
141794,543,10,96,89,7,2,1,0
172098,709,11,71,35,36,3,1,0
139549,458,10,66,30,36,5,1,0
295226,1476,1,341,281,60,0,1,0
175583,831,10,167,42,125,20,1,0
323044,652,2,130,128,2,2,0,0
119813,1315,4,255,241,14,5,1,0
198726,1628,6,292,247,45,1,1,0
143927,465,13,6,6,0,8,1,0
1579728,3392,5,418,398,20,6,1,0
0,0,0,0,0,0,0,0,0
0,0,0,0,0,0,0,0,0
11357,185,1,13,13,0,0,1,0
3301,50,2,4,4,0,0,1,0
174509,820,2,61,0,61,0,1,0
502364,2010,6,266,236,30,94,1,0
481294,294,0,18,10,8,1,1,0
117586,1723,4,433,433,0,3,1,0
2750769,1013,8,128,119,9,18,1,0
35390,344,0,6,4,2,0,0,0
696907,4482,2,655,630,25,6,1,0
95394,999,4,201,84,117,9,1,0
395990,1718,14,55,39,16,15,1,0
0,0,0,0,0,0,0,0,0
46696,365,4,69,56,13,2,0,0
171827,635,4,84,82,2,13,0,0
908809,3581,10,621,37,584,26,1,1
2939997,2391,7,199,177,22,17,1,0
805351,3142,1,113,75,38,1,1,0
1235347,3782,7,553,439,114,14,1,0
483872,294,0,18,9,9,1,1,0
1144,13,0,0,0,0,0,0,0
138159,334,2,31,24,7,0,1,0
140175,369,2,31,24,7,0,1,0
492669,8371,2,2245,2109,136,36,0,1
46376,548,2,62,49,13,6,1,0
0,0,0,0,0,0,0,0,0
395546,1941,12,104,11,93,18,1,0
32705,123,3,4,2,2,1,0,0
93020,1067,5,211,203,8,18,0,0
269713,69,0,16,12,4,0,1,0
309196,1990,5,220,8,212,6,0,0
0,0,0,0,0,0,0,0,0
395060,1215,9,198,151,47,19,1,0
0,0,0,0,0,0,0,0,0
174237,578,3,47,36,11,9,1,0
1197126,1981,5,312,242,70,15,1,0
2984873,3728,5,593,553,40,17,1,0
36349,183,0,9,2,7,0,1,1
26884,39,0,2,1,1,0,0,0
0,0,0,0,0,0,0,0,0
49496,180,0,31,14,17,4,1,0
124583,475,1,23,1,22,13,1,0
0,0,0,0,0,0,0,0,0
0,0,0,0,0,0,0,0,0
1546912,5910,9,1244,1228,16,207,1,0
211604,277,0,18,9,9,0,1,0
1035185,2384,9,290,285,5,38,1,0
0,0,0,0,0,0,0,0,0
0,0,0,0,0,0,0,0,0
145133,1004,4,208,142,66,4,1,0
49429,334,3,38,22,16,2,0,0
0,0,0,0,0,0,0,0,0
446366,2966,10,619,578,41,39,0,0
345579,1779,11,426,398,28,26,1,0
0,0,0,0,0,0,0,0,0
299273,1592,1,229,223,6,1,0,0
2089487,18859,15,419,391,28,16,1,0
59809,517,6,59,52,7,0,1,0
114822,316,7,43,43,0,4,1,0
0,0,0,0,0,0,0,0,0
468397,1493,2,349,266,83,11,1,0
339329,317,0,13,3,10,2,1,0
0,0,0,0,0,0,0,0,0
0,0,0,0,0,0,0,0,0
555983,2469,6,391,379,12,8,1,0
8239,87,3,4,2,2,0,0,0
82362,1557,9,430,317,113,3,1,0
8814,130,2,16,12,4,1,1,0
215399,382,1,49,28,21,0,0,0
227137,1149,3,103,100,3,1,1,0
218662,862,1,72,50,22,8,1,1
208767,277,0,18,10,8,0,1,0
0,0,0,0,0,0,0,0,0
504200,1082,18,82,61,21,22,1,0
0,0,0,0,0,0,0,0,0
0,0,0,0,0,0,0,0,0
0,0,0,0,0,0,0,0,0
0,0,0,0,0,0,0,0,0
0,0,0,0,0,0,0,0,0
0,0,0,0,0,0,0,0,0
0,0,0,0,0,0,0,0,0
0,0,0,0,0,0,0,0,0
0,0,0,0,0,0,0,0,0
232857,823,2,281,201,80,1,1,0
0,0,0,0,0,0,0,0,0
0,0,0,0,0,0,0,0,0
0,0,0,0,0,0,0,0,0
0,0,0,0,0,0,0,0,0
0,0,0,0,0,0,0,0,0
0,0,0,0,0,0,0,0,0
29270,414,5,101,80,21,0,0,0
0,0,0,0,0,0,0,0,0
0,0,0,0,0,0,0,0,0
0,0,0,0,0,0,0,0,0
0,0,0,0,0,0,0,0,0
0,0,0,0,0,0,0,0,0
0,0,0,0,0,0,0,0,0
550568,3397,4,53,49,4,1,0,0
709031,1514,4,101,97,4,3,1,0
0,0,0,0,0,0,0,0,0
0,0,0,0,0,0,0,0,0
208677,277,0,18,9,9,0,1,0
0,0,0,0,0,0,0,0,0
1448887,10906,3,616,581,35,346,0,0
279089,1626,7,149,139,10,20,1,0
78727,452,5,88,80,8,12,1,0
112619,1412,3,230,215,15,6,1,0
208593,277,0,18,12,6,0,1,0
4791,38,2,0,0,0,0,0,0
0,0,0,0,0,0,0,0,0
375332,1448,13,254,200,54,20,1,0
935100,572,5,42,37,5,14,1,0
193328,1040,3,277,235,42,4,0,0
306368,382,1,95,42,53,0,1,0
215515,235,0,50,33,17,2,1,0
0,0,0,0,0,0,0,0,0
60756,636,0,189,186,3,0,0,0
854581,2777,9,312,302,10,27,1,0
1197174,3567,6,249,172,77,4,1,0
6190,72,2,3,3,0,2,1,0
0,0,0,0,0,0,0,0,0
0,0,0,0,0,0,0,0,0
85550,429,2,31,31,0,1,0,0
436259,2244,7,219,200,19,3,1,0
265623,661,8,35,16,19,4,0,0
0,0,0,0,0,0,0,0,0
0,0,0,0,0,0,0,0,0
284523,4411,4,1239,1155,84,16,1,0
0,0,0,0,0,0,0,0,0
146959,2931,2,1072,1061,11,1,1,0
25130,352,3,83,79,4,0,0,0
0,0,0,0,0,0,0,0,0
610042,922,10,90,90,0,37,0,0
285149,1220,4,239,223,16,5,1,0
467433,2164,7,594,529,65,4,1,0
460942,2124,7,527,452,75,4,1,0
470353,986,5,57,48,9,35,1,0
788617,1261,4,192,102,90,16,1,0
574171,3731,4,525,517,8,7,1,0
361565,1202,4,431,423,8,5,1,0
0,0,0,0,0,0,0,0,0
208675,277,0,18,15,3,0,1,0
0,0,0,0,0,0,0,0,0
452263,1784,2,93,60,33,1,0,0
472716,3499,4,426,338,88,2,1,0
290034,1085,4,224,187,37,2,1,0
0,0,0,0,0,0,0,0,0
803636,5768,3,788,781,7,14,0,0
599898,2675,11,310,230,80,17,1,0
294858,944,4,114,66,48,5,1,0
0,0,0,0,0,0,0,0,0
0,0,0,0,0,0,0,0,0
935472,5792,8,838,774,64,17,1,0
674797,2069,2,190,184,6,7,1,1
263827,137,1,8,5,3,5,1,1
0,0,0,0,0,0,0,0,0
121650,311,2,24,21,3,0,1,0
120944,275,4,24,20,4,0,1,0
712695,2906,10,347,319,28,178,1,0
54121,185,5,6,3,3,5,1,0
109353,1848,3,499,494,5,59,0,0
77360,1243,3,265,260,5,12,0,0
196707,685,3,76,72,4,4,1,0
93873,421,4,59,56,3,4,1,0
244376,1439,8,274,260,14,11,1,0
0,0,0,0,0,0,0,0,0
730146,4155,7,215,132,83,49,1,0
788426,3213,7,190,178,12,24,1,0
248087,936,7,69,54,15,30,1,0
372697,1712,7,471,442,29,11,1,0
240759,1571,3,277,268,9,11,1,0
1185033,5402,4,639,540,99,22,1,0
422665,978,5,185,166,19,24,0,0
271125,1657,5,205,185,20,5,0,0
151909,2100,7,639,637,2,6,1,0
4320,49,3,12,8,4,0,0,0
1024236,3421,6,262,230,32,9,1,0
0,0,0,0,0,0,0,0,0
543820,2528,6,310,186,124,18,0,0
0,0,0,0,0,0,0,0,0
354995,2575,7,530,401,129,25,1,1
564184,5829,7,1864,1104,760,14,1,0
0,0,0,0,0,0,0,0,0
0,0,0,0,0,0,0,0,0
0,0,0,0,0,0,0,0,0
234414,3001,3,498,495,3,3,1,0
371532,850,3,250,242,8,15,1,0
163586,380,10,60,53,7,4,1,0
252172,3639,5,702,671,31,4,0,0
14478,171,3,30,28,2,2,0,0
979584,4357,4,814,663,151,16,1,0
1082977,4676,5,952,267,685,23,1,0
576754,1351,5,193,173,20,7,1,0
49359,482,3,90,78,12,1,1,0
619636,1244,11,91,75,16,22,1,0
943270,3687,5,683,667,16,13,1,0
662374,2321,9,429,392,37,37,1,0
2547224,586,3,41,25,16,49,1,0
234942,2419,5,274,260,14,6,1,0
0,0,0,0,0,0,0,0,0
390342,1479,8,124,107,17,16,1,0
638011,281,16,14,5,9,11,1,0
676960,5606,3,1481,1409,72,3,1,0
529071,1530,5,330,280,50,8,1,0
362109,1953,6,311,225,86,50,1,0
821535,2431,16,256,182,74,32,1,0
0,0,0,0,0,0,0,0,0
41186,118,4,23,23,0,0,1,0
307042,665,6,142,136,6,8,1,0
450143,2883,3,203,183,20,12,1,0
210673,277,0,18,9,9,0,1,0
262542,2390,4,459,439,20,9,0,0
709555,1903,1,386,302,84,1,1,0
27150,39,0,2,1,1,0,0,0
0,0,0,0,0,0,0,0,0
347417,2731,3,260,237,23,110,1,0
246869,1460,3,279,227,52,11,1,0
8820,130,2,16,12,4,1,1,0
107275,1091,7,103,96,7,6,1,0
261894,1784,3,610,306,304,24,0,0
309085,4628,4,325,236,89,4,1,0
0,0,0,0,0,0,0,0,0
139963,1677,1,527,501,26,0,1,0
1764959,15500,8,344,325,19,17,1,0
56207,182,6,11,9,2,4,0,0
0,0,0,0,0,0,0,0,0
0,0,0,0,0,0,0,0,0
0,0,0,0,0,0,0,0,0
507348,3039,2,490,103,387,11,1,0
147684,110,1,13,12,1,5,1,0
0,0,0,0,0,0,0,0,0
249963,2672,2,1247,1061,186,7,0,0
6559994,33354,6,113,105,8,4258,0,1
192103,1762,11,353,338,15,29,1,0
27879,291,4,65,64,1,10,1,0
16935,228,5,60,57,3,8,1,0
0,0,0,0,0,0,0,0,0
929012,1597,6,145,131,14,32,1,0
0,0,0,0,0,0,0,0,0
15134,68,1,5,1,4,0,0,0
231267,2216,4,631,604,27,1,1,0
27330,39,0,2,1,1,0,0,0
1509852,1335,0,159,117,42,12,1,0
930072,549,0,58,50,8,9,1,0
204729,1503,3,471,101,370,17,0,0
0,0,0,0,0,0,0,0,0
550484,1346,7,258,240,18,8,1,0
7565,79,3,4,2,2,0,0,0
417269,1560,3,204,145,59,5,1,0
214825,333,4,18,5,13,8,1,0
359379,1406,6,151,121,30,23,1,0
765922,3142,5,156,28,128,1,1,0
85436,776,7,67,64,3,9,1,0
39686,244,6,13,12,1,4,1,0
0,0,0,0,0,0,0,0,0
0,0,0,0,0,0,0,0,0
0,0,0,0,0,0,0,0,0
135617,1291,3,267,190,77,7,1,0
67597,291,2,43,33,10,3,1,0
67536,807,6,120,21,99,26,1,0
0,0,0,0,0,0,0,0,0
1056967,2404,6,317,295,22,1,1,0
0,0,0,0,0,0,0,0,0
136088,2012,1,722,680,42,0,1,0
136081,2012,1,722,678,44,0,1,0
172243,902,1,204,176,28,0,1,0
99608,420,2,78,46,32,0,1,0
0,0,0,0,0,0,0,0,0
235207,658,2,100,82,18,6,1,0
461769,1461,1,124,121,3,2,1,1
247522,144,1,8,5,3,6,1,1
0,0,0,0,0,0,0,0,0
0,0,0,0,0,0,0,0,0
208150,1168,7,156,127,29,27,1,0
0,0,0,0,0,0,0,0,0
978034,4892,8,304,223,81,13,1,0
215977,1183,5,217,197,20,4,1,0
39769,515,1,31,28,3,5,0,0
247889,2257,5,395,388,7,18,1,0
227198,1336,9,420,395,25,6,1,0
38658,459,3,184,175,9,9,0,0
16979,196,3,51,51,0,9,0,0
1505400,2213,5,322,316,6,9,1,0
20152,395,3,4,2,2,2,1,0
750288,1505,2,196,190,6,6,1,0
38510,359,3,70,63,7,4,1,0
688438,953,2,189,22,167,11,1,0
0,0,0,0,0,0,0,0,0
0,0,0,0,0,0,0,0,0
0,0,0,0,0,0,0,0,0
36063,155,5,14,11,3,9,1,0
0,0,0,0,0,0,0,0,0
75305,575,8,119,119,0,21,1,0
114777,981,5,182,7,175,11,1,0
8865,78,4,2,2,0,1,0,0
59123,378,7,49,33,16,6,1,0
21076,37,0,1,1,0,0,1,0
205979,1575,10,259,243,16,29,1,0
0,0,0,0,0,0,0,0,0
0,0,0,0,0,0,0,0,0
176968,2381,12,537,527,10,12,1,0
0,0,0,0,0,0,0,0,0
106642,1317,3,444,439,5,4,1,0
0,0,0,0,0,0,0,0,0
74499,333,1,55,47,8,2,0,0
0,0,0,0,0,0,0,0,0
0,0,0,0,0,0,0,0,0
262731,1225,3,170,147,23,12,0,0
311937,1933,5,278,260,18,28,1,0
76951,298,4,9,9,0,9,1,0
0,0,0,0,0,0,0,0,0
0,0,0,0,0,0,0,0,0
0,0,0,0,0,0,0,0,0
0,0,0,0,0,0,0,0,0
0,0,0,0,0,0,0,0,0
165650,698,2,124,99,25,4,1,0
0,0,0,0,0,0,0,0,0
433107,2307,0,422,376,46,1,1,0
337965,1650,4,149,128,21,8,1,0
223899,1056,7,53,53,0,19,1,0
201700,989,8,104,92,12,2,1,0
0,0,0,0,0,0,0,0,0
574955,5155,6,628,604,24,115,1,0
475598,4646,12,586,580,6,4,0,0
2758785,9080,8,610,582,28,9,1,0
43799,520,5,29,27,2,16,1,0
639453,6236,8,1704,1662,42,43,1,0
384021,4411,4,1515,1475,40,18,1,0
678334,1712,2,383,359,24,1,1,0
68154,760,1,60,49,11,0,0,0
4245,48,3,1,1,0,4,0,0
129636,992,7,83,74,9,19,0,0
112096,947,3,72,69,3,4,0,0
372953,1138,4,90,64,26,1,1,0
944398,4996,7,365,297,68,32,1,0
76066,367,1,6,4,2,22,0,0
0,0,0,0,0,0,0,0,0
74842,1227,3,194,191,3,3,1,0
13022,179,2,55,54,1,0,1,0
1130572,1519,6,140,87,53,27,1,0
636684,2025,4,277,268,9,10,1,0
184669,1285,12,314,294,20,36,1,1
0,0,0,0,0,0,0,0,0
117812,1705,5,426,416,10,1,0,0
13236,170,5,21,21,0,1,0,0
584210,933,5,103,50,53,20,1,0
71700,560,8,48,38,10,4,1,0
0,0,0,0,0,0,0,0,0
0,0,0,0,0,0,0,0,0
162355,560,0,117,115,2,1,1,0
264383,2440,5,626,587,39,14,1,0
24218,460,4,108,102,6,8,1,0
18050,310,4,93,87,6,8,1,0
236881,1298,2,406,398,8,0,1,0
43331,306,2,75,68,7,0,1,0
626186,2955,7,787,722,65,17,1,0
16603,142,2,4,4,0,0,0,0
136179,1208,9,291,286,5,8,1,0
0,0,0,0,0,0,0,0,0
0,0,0,0,0,0,0,0,0
62792,1068,3,402,368,34,2,1,0
1556,11,0,1,1,0,0,0,0
0,0,0,0,0,0,0,0,0
259240,1594,3,441,416,25,155,1,0
0,0,0,0,0,0,0,0,0
0,0,0,0,0,0,0,0,0
57021,344,1,210,200,10,0,1,0
24387,155,1,24,20,4,1,1,0
488230,1312,4,202,9,193,20,1,0
250498,1377,9,168,115,53,12,1,0
143340,515,10,86,77,9,3,1,0
225387,2353,4,280,270,10,0,0,0
111090,1104,3,82,73,9,4,1,0
0,0,0,0,0,0,0,0,0
1242587,3005,11,310,207,103,9,1,0
91636,1669,1,524,433,91,0,1,0
0,0,0,0,0,0,0,0,0
27948,45,0,4,1,3,0,0,0
0,0,0,0,0,0,0,0,0
0,0,0,0,0,0,0,0,0
146313,1047,4,228,160,68,4,1,0
51434,376,3,54,36,18,2,0,0
1603309,7579,6,257,233,24,36,1,0
0,0,0,0,0,0,0,0,0
630841,2578,9,531,272,259,38,1,0
382999,2815,7,728,658,70,16,1,0
14340,112,5,15,13,2,2,1,0
0,0,0,0,0,0,0,0,0
3011746,3028,5,311,289,22,15,1,0
0,0,0,0,0,0,0,0,0
564351,2171,11,439,420,19,25,1,0
729407,3673,6,613,544,69,4,0,1
17461,131,2,11,10,1,5,0,0
1132447,2013,7,682,681,1,12,1,0
629685,1209,6,612,611,1,11,1,0
0,0,0,0,0,0,0,0,0
0,0,0,0,0,0,0,0,0
0,0,0,0,0,0,0,0,0
374799,2269,2,355,344,11,2,1,0
0,0,0,0,0,0,0,0,0
91411,428,8,38,29,9,0,1,0
62549,225,9,23,19,4,2,1,0
9683,156,0,15,1,14,1,1,0
5843,124,1,10,10,0,1,1,0
1000553,7508,4,507,499,8,7,1,0
123567,703,10,111,95,16,1,1,0
37919,352,0,8,3,5,0,1,1
0,0,0,0,0,0,0,0,0
180943,804,4,75,64,11,8,1,0
78193,554,2,5,2,3,2,0,0
630801,2745,10,409,378,31,23,1,0
0,0,0,0,0,0,0,0,0
0,0,0,0,0,0,0,0,0
1768541,3279,6,337,325,12,37,1,0
0,0,0,0,0,0,0,0,0
3200601,1061,5,101,90,11,5,1,0
660362,4673,6,766,675,91,26,1,0
163839,2111,1,304,300,4,20,0,0
27205,39,0,2,1,1,0,0,0
479090,2897,5,686,492,194,6,1,0
0,0,0,0,0,0,0,0,0
0,0,0,0,0,0,0,0,0
0,0,0,0,0,0,0,0,0
725619,2465,10,168,152,16,15,1,0
598435,2394,5,218,206,12,7,0,0
309521,1349,17,217,207,10,16,1,0
402976,2845,3,464,456,8,2,1,0
425905,1210,4,240,240,0,10,1,0
9679,156,0,15,1,14,1,1,0
5843,124,1,10,10,0,1,1,0
105716,740,9,131,127,4,4,1,0
587363,2785,8,299,173,126,21,0,0
143246,2431,11,800,777,23,20,1,0
387716,2777,5,776,745,31,3,0,0
2815,12,1,0,0,0,2,0,0
922385,4113,14,708,687,21,79,1,0
820326,3186,12,615,594,21,34,1,0
543861,1820,6,122,118,4,5,1,0
414114,1177,5,15,13,2,18,1,0
38845,680,6,136,109,27,1,0,0
1126894,3510,5,609,586,23,23,1,0
727583,2538,5,535,519,16,33,1,0
368337,3612,3,403,370,33,36,1,0
174112,1384,5,169,136,33,19,1,0
18067,303,2,62,60,2,0,0,0
229302,3515,2,804,499,305,8,1,0
78295,768,9,85,40,45,31,1,0
25145,226,7,27,26,1,12,1,0
121616,1050,4,219,196,23,20,1,0
250699,2833,2,418,408,10,2,1,0
69634,1170,5,332,332,0,0,1,0
7517,150,2,23,23,0,2,1,0
530004,4749,9,574,495,79,79,1,0
241380,1306,3,293,288,5,0,1,0
147987,750,5,171,166,5,0,1,0
344016,940,3,145,123,22,2,1,0
0,0,0,0,0,0,0,0,0
0,0,0,0,0,0,0,0,0
0,0,0,0,0,0,0,0,0
0,0,0,0,0,0,0,0,0
0,0,0,0,0,0,0,0,0
230355,1188,6,117,98,19,2,1,0
0,0,0,0,0,0,0,0,0
182445,1485,7,388,368,20,8,1,0
0,0,0,0,0,0,0,0,0
520177,2258,6,297,173,124,20,0,0
0,0,0,0,0,0,0,0,0
730512,2249,3,111,80,31,47,1,0
458304,384,4,43,21,22,5,1,0
425049,4181,10,311,291,20,32,1,0
23767,80,9,3,3,0,0,0,0
0,0,0,0,0,0,0,0,0
5023,63,1,12,9,3,0,0,0
662693,5627,3,1075,1015,60,26,0,0
364066,2488,5,502,477,25,35,0,0
186477,3094,3,1007,993,14,106,1,0
244076,1076,7,107,99,8,13,1,0
48024,216,6,43,32,11,5,1,0
288427,1760,3,165,146,19,16,1,0
899408,5811,8,637,327,310,7,0,0
285479,706,2,62,17,45,2,0,0
353219,3517,6,641,561,80,24,1,0
511049,1523,4,204,194,10,8,1,0
1168557,2524,2,391,310,81,11,1,0
221546,197,0,16,7,9,5,1,0
122972,630,6,83,81,2,11,0,0
0,0,0,0,0,0,0,0,0
327860,1184,13,252,237,15,28,1,0
0,0,0,0,0,0,0,0,0
35330,479,3,77,68,9,1,1,0
1056708,2050,10,282,277,5,35,1,0
1527659,1751,13,144,123,21,100,1,0
86246,268,1,18,13,5,7,1,0
0,0,0,0,0,0,0,0,0
671226,610,4,83,74,9,2,1,0
185367,1751,8,382,372,10,10,1,0
714319,2384,7,264,236,28,48,1,0
242431,283,2,7,7,0,3,1,0
102014,1695,3,354,352,2,6,1,0
42393,669,3,224,222,2,6,1,0
783707,4118,0,470,9,461,53,1,0
9542,80,0,7,6,1,0,1,0
0,0,0,0,0,0,0,0,0
288193,2163,1,277,229,48,1,1,0
20567,128,1,18,8,10,1,1,0
747154,1913,2,364,288,76,11,1,0
268297,220,0,22,7,15,5,1,0
0,0,0,0,0,0,0,0,0
1503345,6078,12,240,18,222,4,1,0
118674,599,11,115,63,52,4,1,0
1880367,14786,1,3680,3657,23,62,1,0
308417,178,4,21,13,8,0,0,0
460728,1200,0,154,128,26,0,1,0
44121,349,0,48,21,27,0,1,0
0,0,0,0,0,0,0,0,0
134582,1859,2,249,246,3,5,0,0
285735,1939,8,399,375,24,10,1,0
385997,1846,6,142,126,16,38,0,0
1640569,4088,5,655,647,8,34,1,0
30852,407,3,71,66,5,4,0,0
10823,161,4,26,23,3,2,0,0
1142021,10351,12,606,597,9,5,1,0
86207,582,2,27,22,5,3,0,0
262699,1743,7,302,275,27,50,1,0
45889,493,3,170,131,39,13,1,0
7243,170,2,43,43,0,1,0,0
8014,180,2,44,37,7,1,0,0
441529,4676,4,912,736,176,16,0,0
633199,4443,0,322,292,30,36,0,0
118337,543,3,35,23,12,6,1,0
2277000,3233,2,107,79,28,30,1,0
478885,1648,3,187,75,112,3,1,0
85492,1707,1,658,618,40,0,1,0
0,0,0,0,0,0,0,0,0
45845,567,2,73,45,28,1,1,0
1746519,3226,6,509,364,145,15,1,0
22948,67,3,1,0,1,2,0,0
0,0,0,0,0,0,0,0,0
550290,3075,3,120,98,22,5,1,0
0,0,0,0,0,0,0,0,0
0,0,0,0,0,0,0,0,0
100434,363,0,16,15,1,0,1,0
0,0,0,0,0,0,0,0,0
186640,611,2,93,31,62,1,1,0
197677,896,4,88,74,14,2,1,0
98876,208,2,18,18,0,1,1,0
0,0,0,0,0,0,0,0,0
0,0,0,0,0,0,0,0,0
88776,263,6,31,25,6,3,1,0
79673,212,6,34,31,3,3,1,0
0,0,0,0,0,0,0,0,0
198457,1664,0,266,217,49,5,1,0
206322,1923,10,260,246,14,5,1,0
299101,3357,9,820,635,185,81,1,0
129688,389,3,28,21,7,24,1,0
0,0,0,0,0,0,0,0,0
193145,2121,6,826,821,5,0,1,0
1049904,4200,3,80,64,16,12,1,0
769218,3314,2,39,36,3,1,1,0
499284,2604,5,504,476,28,13,1,0
1288459,10238,4,1076,1066,10,6,1,0
21414,174,6,20,18,2,9,1,0
1017549,1183,4,87,69,18,13,1,0
555925,967,5,63,43,20,16,1,0
147453,1888,2,213,189,24,4,1,0
7085,104,2,7,6,1,1,1,0
355114,907,4,165,140,25,13,1,0
2572661,1000,1,180,173,7,2,1,0
46197,654,3,172,85,87,7,1,0
0,0,0,0,0,0,0,0,0
77303,558,7,91,90,1,2,1,0
0,0,0,0,0,0,0,0,0
0,0,0,0,0,0,0,0,0
234812,2629,3,377,360,17,0,0,0
295201,790,3,104,93,11,18,1,0
62544,879,5,206,194,12,6,1,0
35800,333,3,11,0,11,0,1,0
129076,2233,1,703,674,29,0,1,0
0,0,0,0,0,0,0,0,0
210625,277,0,18,11,7,0,1,0
387313,1071,5,175,165,10,7,1,0
0,0,0,0,0,0,0,0,0
186280,756,7,62,43,19,35,1,0
454246,1682,3,147,44,103,21,1,0
282738,543,1,8,2,6,4,0,0
746255,3596,11,803,749,54,13,1,0
0,0,0,0,0,0,0,0,0
3633942,1249,6,80,59,21,16,1,0
109123,248,3,36,30,6,2,1,0
686850,4012,8,180,165,15,18,1,0
1025826,5151,9,1062,1042,20,86,1,0
0,0,0,0,0,0,0,0,0
0,0,0,0,0,0,0,0,0
262822,3319,2,217,203,14,4,1,0
59902,678,2,113,99,14,4,1,0
460728,2302,7,341,315,26,151,1,0
12301,193,3,23,20,3,0,0,0
0,0,0,0,0,0,0,0,0
167757,1077,4,226,207,19,13,1,0
19460,252,4,19,18,1,0,1,0
0,0,0,0,0,0,0,0,0
406266,1482,5,188,180,8,3,1,0
70668,115,3,11,10,1,2,1,0
674886,4357,13,489,447,42,8,0,0
0,0,0,0,0,0,0,0,0
966403,2238,3,177,154,23,8,1,0
434884,3191,12,691,628,63,17,1,0
209973,273,0,17,4,13,0,1,0
186649,851,14,75,61,14,8,0,0
379955,5632,2,480,455,25,34,1,0
23293,414,3,12,8,4,5,1,0
694072,9568,7,666,645,21,23,1,0
113297,285,5,11,7,4,17,1,0
2044878,8592,8,1235,1214,21,46,1,0
186038,612,5,13,7,6,14,1,0
162487,986,2,354,337,17,1,1,0
56609,592,8,71,29,42,0,1,0
589021,4430,7,21,20,1,8,1,0
182364,2564,3,355,326,29,10,1,0
37189,275,4,21,19,2,0,1,0
290442,1833,3,239,233,6,2,0,0
0,0,0,0,0,0,0,0,0
976944,5353,7,599,513,86,13,1,0
0,0,0,0,0,0,0,0,0
0,0,0,0,0,0,0,0,0
160808,1443,0,207,195,12,3,1,0
0,0,0,0,0,0,0,0,0
0,0,0,0,0,0,0,0,0
0,0,0,0,0,0,0,0,0
175637,1388,7,317,292,25,13,1,0
20069,73,1,1,1,0,0,0,0
539067,3566,5,1004,982,22,2,1,0
285761,2683,7,866,854,12,4,1,0
635931,372,9,41,39,2,5,1,0
456313,231,10,3,3,0,4,1,0
2040509,5536,5,248,194,54,6,1,0
317216,2893,11,285,249,36,15,1,0
103744,567,8,98,92,6,7,1,0
102525,566,8,98,92,6,7,1,0
1542257,1981,8,207,192,15,2,1,0
0,0,0,0,0,0,0,0,0
197817,1820,6,443,428,15,11,1,0
345546,3105,2,254,231,23,0,1,0
15560,89,1,4,1,3,0,0,0
0,0,0,0,0,0,0,0,0
0,0,0,0,0,0,0,0,0
212229,294,0,16,9,7,1,1,0
393075,3940,1,618,612,6,13,1,0
930411,1707,10,234,226,8,32,1,0
536274,1730,5,336,327,9,8,1,0
534354,1953,7,328,318,10,12,1,0
86498,1906,4,351,277,74,0,1,0
267922,1088,1,167,153,14,6,1,0
611265,873,0,138,130,8,0,1,0
0,0,0,0,0,0,0,0,0
331286,2035,5,188,181,7,2,0,0
310681,268,0,15,11,4,2,1,0
147993,304,5,75,72,3,10,1,0
144607,177,7,17,14,3,3,1,0
1676641,16294,5,163,137,26,12,0,0
13119,152,0,3,2,1,15,1,0
1834467,15558,5,503,492,11,13,1,0
882680,4163,4,156,118,38,36,1,0
0,0,0,0,0,0,0,0,0
0,0,0,0,0,0,0,0,0
507333,4518,8,724,705,19,44,1,0
0,0,0,0,0,0,0,0,0
0,0,0,0,0,0,0,0,0
887985,3850,2,123,119,4,115,1,0
184887,219,3,7,5,2,8,1,0
2097832,11140,4,506,493,13,23,1,0
0,0,0,0,0,0,0,0,0
278682,1475,7,203,198,5,24,1,0
285727,1835,8,87,73,14,21,0,0
16051,111,2,12,0,12,0,0,0
370511,2535,7,423,405,18,19,1,0
71429,1151,1,388,382,6,4,1,0
26613,325,1,75,69,6,0,1,0
0,0,0,0,0,0,0,0,0
0,0,0,0,0,0,0,0,0
227247,1173,3,279,232,47,8,1,0
1272516,4986,1,523,504,19,4,0,0
1272670,4986,1,523,504,19,4,0,0
634506,975,5,103,78,25,20,1,0
141571,1323,3,292,273,19,13,0,0
1457421,1188,3,166,154,12,3,1,0
387145,90,0,5,3,2,0,1,0
0,0,0,0,0,0,0,0,0
272830,2318,6,373,373,0,6,1,0
0,0,0,0,0,0,0,0,0
0,0,0,0,0,0,0,0,0
0,0,0,0,0,0,0,0,0
81378,1263,3,220,197,23,26,1,0
839368,4468,6,1104,1094,10,23,1,0
130552,617,5,94,85,9,15,1,0
158269,817,6,147,108,39,2,1,0
474023,1385,6,224,194,30,5,1,0
36281,354,2,16,10,6,2,1,0
121968,1582,7,220,215,5,2,1,0
20804,119,4,27,24,3,0,1,0
863973,4019,6,190,166,24,8,1,0
596499,2396,6,42,37,5,8,1,0
250169,1454,2,114,103,11,5,1,0
0,0,0,0,0,0,0,0,0
295508,1932,3,214,205,9,7,1,0
0,0,0,0,0,0,0,0,0
0,0,0,0,0,0,0,0,0
614035,2297,8,83,76,7,6,1,0
510348,3755,7,939,796,143,17,1,0
206068,4107,1,670,668,2,3,0,0
7244,28,0,0,0,0,0,0,0
305925,891,10,107,87,20,13,1,0
0,0,0,0,0,0,0,0,0
359648,2135,1,415,414,1,20,1,0
0,0,0,0,0,0,0,0,0
328201,3186,1,730,703,27,35,1,0
0,0,0,0,0,0,0,0,0
0,0,0,0,0,0,0,0,0
541778,2630,12,707,687,20,20,1,0
111238,307,9,13,6,7,17,0,0
190811,752,4,211,211,0,1,1,0
194136,517,4,30,29,1,2,1,0
682968,821,6,116,97,19,4,1,0
0,0,0,0,0,0,0,0,0
0,0,0,0,0,0,0,0,0
442912,1178,1,187,115,72,2,1,0
520604,2625,5,316,262,54,4,1,0
2154623,5661,8,981,621,360,24,1,0
13969,51,0,0,0,0,2,0,0
169634,829,4,144,135,9,15,0,0
263783,3551,1,988,864,124,128,1,0
0,0,0,0,0,0,0,0,0
0,0,0,0,0,0,0,0,0
0,0,0,0,0,0,0,0,0
0,0,0,0,0,0,0,0,0
777335,2356,4,184,171,13,44,0,0
355634,1713,9,541,531,10,7,1,0
11408,61,2,1,0,1,1,0,0
339076,2969,5,419,402,17,30,1,0
1952579,4004,7,510,300,210,24,1,0
621567,1165,5,183,169,14,2,1,0
235832,1641,7,248,238,10,10,0,0
1033252,1677,8,328,302,26,87,1,0
119325,389,3,33,24,9,3,0,0
64255,863,2,312,306,6,17,1,0
26639,439,2,134,121,13,1,1,0
602540,1392,6,306,296,10,7,1,0
0,0,0,0,0,0,0,0,0
402549,3844,9,651,345,306,140,1,0
0,0,0,0,0,0,0,0,0
298322,1292,1,154,142,12,9,1,0
7362,46,3,0,0,0,0,1,0
292627,1962,6,290,271,19,45,1,0
6830,54,0,5,3,2,0,1,0
472238,4199,8,884,774,110,60,1,0
0,0,0,0,0,0,0,0,0
443272,3017,9,409,394,15,10,1,1
219361,1086,2,82,77,5,5,1,0
0,0,0,0,0,0,0,0,0
0,0,0,0,0,0,0,0,0
664567,1671,2,193,147,46,14,1,0
230619,332,0,14,3,11,0,1,0
12260,150,2,25,11,14,1,0,0
11285,125,2,18,15,3,1,0,0
1053881,7121,4,947,900,47,8,0,0
107254,865,4,172,138,34,8,0,0
0,0,0,0,0,0,0,0,0
0,0,0,0,0,0,0,0,0
1221144,2101,8,159,144,15,37,1,0
1601037,2568,9,216,138,78,52,1,0
43576,294,6,34,32,2,3,1,0
11978,147,5,27,25,2,0,1,0
190371,1024,5,210,166,44,5,1,0
93636,352,4,37,31,6,2,0,0
0,0,0,0,0,0,0,0,0
855087,4855,3,1008,952,56,10,1,0
479185,1892,8,180,142,38,8,1,0
520967,1383,5,42,35,7,2,0,0
1319230,3553,11,192,42,150,9,1,0
277594,259,7,5,1,4,12,0,0
61841,718,10,141,84,57,9,1,0
33740,37,2,1,0,1,0,1,0
223544,1865,11,318,297,21,66,1,0
137023,428,4,61,26,35,4,1,0
0,0,0,0,0,0,0,0,0
263275,1462,3,289,256,33,26,1,0
0,0,0,0,0,0,0,0,0
151991,1200,2,261,237,24,1,1,0
229695,1090,3,6,5,1,1,0,0
0,0,0,0,0,0,0,0,0
470605,508,6,97,95,2,6,1,0
1728934,3114,2,156,113,43,357,1,0
289781,783,2,82,67,15,30,1,0
181657,371,1,58,47,11,1,1,0
318865,6003,4,1621,1594,27,96,1,0
0,0,0,0,0,0,0,0,0
0,0,0,0,0,0,0,0,0
0,0,0,0,0,0,0,0,0
56802,640,10,148,106,42,1,1,0
152802,2654,2,664,495,169,11,1,0
156705,1241,5,170,145,25,16,0,0
13406,152,0,3,2,1,15,1,0
793169,3666,3,32,12,20,2,1,0
650846,2676,5,681,679,2,12,1,0
667781,2834,7,511,493,18,12,1,0
46712,438,2,12,11,1,2,0,0
120397,1445,3,411,331,80,7,1,0
796795,1976,5,210,139,71,5,1,0
0,0,0,0,0,0,0,0,0
70023,351,8,57,23,34,1,0,0
32712,146,4,10,10,0,5,1,0
422602,2989,13,503,485,18,16,1,0
118891,350,12,8,8,0,13,0,0
295063,1913,5,148,133,15,9,1,0
284967,814,6,154,142,12,2,1,0
93276,184,4,22,12,10,1,1,0
27674,42,0,2,1,1,0,0,0
475315,3141,2,236,223,13,4,1,0
385841,3185,2,409,149,260,5,1,0
223991,1832,1,295,70,225,3,1,0
25507,233,2,65,57,8,0,1,0
32396,202,1,39,39,0,1,1,0
949198,979,2,118,104,14,3,1,0
214703,1525,11,400,400,0,0,1,0
0,0,0,0,0,0,0,0,0
33183,175,2,15,14,1,1,1,0
348654,2043,6,366,282,84,67,1,0
1819255,2139,14,156,147,9,35,1,0
191446,1000,3,187,180,7,11,1,0
110668,2067,2,894,193,701,5,1,0
34670,154,4,40,32,8,0,1,0
23642,191,1,12,1,11,0,1,0
190060,2786,5,664,628,36,5,1,0
231113,1268,3,186,154,32,2,0,0
104607,1222,7,319,316,3,8,1,0
486198,2828,6,464,349,115,46,1,0
451252,6580,6,2568,2129,439,129,1,0
10485,150,3,22,19,3,6,1,0
0,0,0,0,0,0,0,0,0
213295,3164,9,491,481,10,30,1,0
585793,226,9,24,16,8,29,1,0
482523,1436,2,214,178,36,0,1,0
231635,356,0,15,9,6,1,1,0
243677,870,6,149,145,4,8,1,0
561216,1788,4,33,31,2,6,0,0
1385928,1621,5,272,265,7,149,1,0
163256,1570,4,152,24,128,19,1,0
46018,201,2,7,6,1,2,0,0
263860,608,1,58,51,7,0,0,0
47857,239,7,39,34,5,2,1,0
1745240,3588,4,529,524,5,8,1,0
478592,933,5,173,168,5,6,1,0
0,0,0,0,0,0,0,0,0
492453,1374,10,251,45,206,23,1,0
264043,1988,4,200,187,13,7,1,0
366468,3894,6,415,407,8,19,1,0
219951,1887,6,301,286,15,34,1,0
7591,85,2,4,4,0,0,0,0
44756,558,2,159,78,81,12,1,0
0,0,0,0,0,0,0,0,0
157786,1607,9,285,248,37,1,0,0
24755,336,7,3,1,2,1,0,0
435885,3581,6,727,701,26,1,1,0
226031,795,6,176,174,2,1,1,0
6374803,1449,4,119,58,61,56,1,0
48646,291,10,31,19,12,1,1,0
0,0,0,0,0,0,0,0,0
739694,3334,4,817,252,565,6,1,1
140677,216,2,24,20,4,5,1,0
190286,469,1,42,38,4,6,1,0
0,0,0,0,0,0,0,0,0
544514,2370,6,254,190,64,17,0,0
119580,465,3,57,43,14,5,1,0
403783,1244,4,194,174,20,38,1,0
1734,29,0,6,0,6,0,0,0
716191,6768,3,594,585,9,0,1,0
232050,358,0,15,8,7,1,1,0
165713,1337,3,343,273,70,0,1,0
18438,172,4,19,11,8,2,1,0
472714,1411,7,336,284,52,9,1,1
368625,716,6,219,183,36,4,1,0
0,0,0,0,0,0,0,0,0
0,0,0,0,0,0,0,0,0
0,0,0,0,0,0,0,0,0
0,0,0,0,0,0,0,0,0
478440,1214,1,119,81,38,4,0,0
67368,242,3,17,9,8,0,1,0
412932,2787,10,212,169,43,64,1,0
321342,1260,7,217,208,9,12,1,0
91402,561,4,147,140,7,1,1,0
1033921,3785,2,327,277,50,1,1,0
289887,1309,3,111,91,20,4,1,0
25690,207,5,12,7,5,2,1,0
0,0,0,0,0,0,0,0,0
484416,3439,9,672,639,33,71,0,0
584595,10791,6,4421,4415,6,7,1,0
110921,1257,6,359,359,0,2,1,0
1034473,2236,10,308,291,17,48,1,0
224162,1635,8,192,158,34,10,1,0
640471,2301,2,334,331,3,1,0,0
254542,3065,3,841,592,249,25,1,0
0,0,0,0,0,0,0,0,0
0,0,0,0,0,0,0,0,0
0,0,0,0,0,0,0,0,0
128871,915,5,335,300,35,9,1,0
74730,775,2,103,95,8,5,0,0
116231,1128,2,299,257,42,2,1,0
0,0,0,0,0,0,0,0,0
735344,4590,9,1232,1223,9,20,1,0
459908,2069,6,102,94,8,13,1,0
418373,921,2,141,110,31,2,1,0
468073,2073,4,14,10,4,54,1,0
272985,2643,7,563,507,56,7,1,0
65258,511,10,85,75,10,8,1,0
42290,367,5,48,43,5,5,1,0
47061,129,2,5,5,0,9,1,0
199250,750,15,61,1,60,1,1,0
114217,894,4,116,114,2,0,0,0
1053329,1531,7,140,122,18,28,1,0
230533,965,11,113,111,2,19,0,0
191394,2038,7,419,343,76,12,1,0
8209,95,1,8,8,0,1,1,0
72301,719,0,222,212,10,7,1,0
0,0,0,0,0,0,0,0,0
397880,1289,9,198,175,23,18,1,0
31223,771,1,211,211,0,2,1,0
356765,1913,8,438,396,42,19,1,0
147984,503,8,107,95,12,12,1,0
0,0,0,0,0,0,0,0,0
440716,5876,3,1329,1111,218,14,1,0
95742,856,3,148,140,8,36,1,0
438939,3883,3,994,923,71,1,1,1
0,0,0,0,0,0,0,0,0
0,0,0,0,0,0,0,0,0
465886,1617,11,110,93,17,21,1,0
41070,269,4,9,2,7,3,1,0
145345,353,5,57,39,18,3,1,0
49056,402,9,103,87,16,0,1,0
389688,1488,5,186,154,32,18,1,0
547637,2633,7,319,203,116,20,0,0
837044,1870,2,182,168,14,13,1,0
75753,507,5,80,47,33,4,0,0
0,0,0,0,0,0,0,0,0
210555,1697,8,196,184,12,43,1,0
91458,738,8,84,84,0,12,1,0
495025,2457,6,389,314,75,6,1,0
7303,96,1,16,16,0,1,1,0
221508,1276,9,181,177,4,14,1,0
0,0,0,0,0,0,0,0,0
0,0,0,0,0,0,0,0,0
0,0,0,0,0,0,0,0,0
77047,1279,6,93,72,21,0,0,0
725761,4219,7,465,449,16,4,1,0
91093,257,0,48,24,24,0,1,1
0,0,0,0,0,0,0,0,0
1920216,3842,8,532,476,56,30,1,0
570036,946,4,2,0,2,9,1,0
228950,332,0,14,3,11,0,1,0
42830,427,10,68,58,10,5,0,0
218757,3235,5,857,846,11,19,1,0
264128,1182,3,283,256,27,1,1,0
116489,1028,10,130,78,52,1,1,0
0,0,0,0,0,0,0,0,0
0,0,0,0,0,0,0,0,0
169453,494,7,74,61,13,1,1,0
0,0,0,0,0,0,0,0,0
369766,3033,4,535,477,58,5,1,0
29319,180,2,43,15,28,1,1,0
603147,2392,18,339,315,24,46,1,0
82002,210,5,13,11,2,8,1,0
441612,3140,2,343,330,13,3,1,0
40060,396,6,84,44,40,10,1,0
733911,4265,4,803,485,318,53,1,0
0,0,0,0,0,0,0,0,0
0,0,0,0,0,0,0,0,0
15423,43,0,1,0,1,2,0,1
150617,1029,5,138,116,22,6,1,0
482848,4674,3,450,438,12,1,0,0
10126,101,4,3,3,0,0,0,0
0,0,0,0,0,0,0,0,0
279006,1876,13,389,367,22,18,0,0
97739,676,3,94,88,6,0,1,0
35019,286,4,46,40,6,6,1,0
0,0,0,0,0,0,0,0,0
0,0,0,0,0,0,0,0,0
0,0,0,0,0,0,0,0,0
57280,606,4,93,79,14,16,1,0
8795,135,2,23,22,1,0,1,0
35752,444,2,133,110,23,3,1,0
13356,194,2,29,24,5,10,0,0
0,0,0,0,0,0,0,0,0
0,0,0,0,0,0,0,0,0
253800,1080,1,258,236,22,3,0,0
810581,1331,1,211,177,34,1,0,0
259515,983,1,72,61,11,13,1,0
605751,1600,4,142,134,8,1,1,0
276014,302,3,2,2,0,0,1,0
117048,993,2,268,132,136,2,1,0
0,0,0,0,0,0,0,0,0
91449,676,4,198,180,18,3,1,0
390225,3704,5,821,420,401,40,1,0
177430,1578,1,518,505,13,2,1,0
0,0,0,0,0,0,0,0,0
557877,2407,12,532,511,21,13,1,1
22060,198,5,4,2,2,3,1,0
715872,1045,3,117,108,9,0,1,0
203460,708,2,127,114,13,13,1,0
0,0,0,0,0,0,0,0,0
7065,79,0,2,2,0,0,0,0
305610,1966,7,420,395,25,19,1,0
307271,1526,7,103,87,16,5,1,0
1635381,1408,3,176,17,159,5,1,0
379532,93,0,3,3,0,0,1,0
1637553,5442,8,372,177,195,21,1,0
247035,1692,6,403,356,47,15,1,0
0,0,0,0,0,0,0,0,0
258544,809,6,92,84,8,2,1,0
751838,374,5,29,22,7,5,1,0
1701360,6240,4,520,482,38,2,1,0
0,0,0,0,0,0,0,0,0
755215,2552,2,330,314,16,5,1,0
220459,2830,5,930,916,14,11,1,0
11622,111,1,30,30,0,0,1,0
489699,1082,8,126,102,24,7,1,0
15242,101,2,7,7,0,0,0,0
23420,110,0,8,1,7,2,1,0
343652,1627,2,145,137,8,6,1,0
76574,603,8,139,90,49,5,0,0
649938,788,7,124,116,8,3,1,0
415283,130,3,2,2,0,0,0,0
112088,472,4,91,79,12,19,1,0
111790,427,4,64,55,9,25,1,0
109233,1566,3,380,340,40,12,0,0
14655,193,3,10,7,3,6,1,0
9146,127,3,11,8,3,3,1,0
0,0,0,0,0,0,0,0,0
0,0,0,0,0,0,0,0,0
0,0,0,0,0,0,0,0,0
284200,1421,14,242,205,37,26,1,0
0,0,0,0,0,0,0,0,0
82397,940,2,190,187,3,2,0,0
24178,464,2,104,104,0,2,0,0
3190940,5031,14,906,883,23,43,1,0
217572,417,11,6,5,1,20,1,0
128621,1011,8,226,206,20,12,0,0
48158,117,5,12,12,0,0,1,0
29325,242,4,22,20,2,2,1,0
6112,80,6,5,5,0,1,0,0
785984,1762,6,65,29,36,1,1,0
0,0,0,0,0,0,0,0,0
115280,1262,8,311,304,7,12,1,0
380855,2367,8,456,447,9,10,1,0
163759,1351,7,248,239,9,5,1,0
0,0,0,0,0,0,0,0,0
489799,3153,4,250,203,47,8,1,0
604116,2836,4,218,91,127,14,1,0
228603,1878,8,282,158,124,9,1,0
770,16,0,2,2,0,0,0,0
0,0,0,0,0,0,0,0,0
910774,1931,10,182,151,31,24,1,0
0,0,0,0,0,0,0,0,0
546934,1961,13,314,278,36,28,1,0
0,0,0,0,0,0,0,0,0
124056,796,4,120,112,8,5,1,0
122658,1248,7,381,336,45,21,0,0
148276,1346,10,168,154,14,34,1,0
713375,1521,5,90,53,37,2,1,0
217780,1316,2,140,126,14,4,1,0
29804,148,2,5,5,0,0,1,0
562453,2287,12,557,433,124,23,0,0
0,0,0,0,0,0,0,0,0
452109,1467,7,71,66,5,0,1,0
102351,1098,2,163,162,1,7,1,0
63630,944,1,263,259,4,16,1,0
1466614,1206,2,138,126,12,2,1,0
382493,121,0,5,5,0,0,1,0
0,0,0,0,0,0,0,0,0
222924,954,4,117,111,6,11,1,0
0,0,0,0,0,0,0,0,0
643122,2701,10,447,268,179,67,1,0
1895089,339,6,45,39,6,0,1,0
0,0,0,0,0,0,0,0,0
59635,595,8,94,49,45,1,1,0
28305,169,2,21,17,4,3,1,0
0,0,0,0,0,0,0,0,0
310012,1211,5,64,63,1,17,1,0
0,0,0,0,0,0,0,0,0
334057,1644,7,233,217,16,15,1,0
524041,1027,7,124,110,14,22,1,0
427418,2075,5,302,270,32,4,1,0
0,0,0,0,0,0,0,0,0
246196,1545,4,165,130,35,15,1,0
0,0,0,0,0,0,0,0,0
264587,2995,2,136,129,7,21,0,0
541156,2703,2,531,440,91,3,1,0
163874,331,1,74,25,49,0,1,0
235573,358,0,15,12,3,1,1,0
620852,2236,4,114,104,10,24,1,0
32769,662,4,235,227,8,2,1,0
392879,1269,7,34,24,10,9,1,0
265297,1855,8,146,144,2,62,0,0
354677,3639,5,681,614,67,75,1,0
120516,569,3,99,91,8,22,1,0
208470,879,5,83,69,14,17,1,0
0,0,0,0,0,0,0,0,0
0,0,0,0,0,0,0,0,0
0,0,0,0,0,0,0,0,0
1336166,8426,3,665,460,205,13,1,0
0,0,0,0,0,0,0,0,0
6214,58,0,4,1,3,0,1,0
0,0,0,0,0,0,0,0,0
236675,3456,2,738,734,4,10,1,0
0,0,0,0,0,0,0,0,0
0,0,0,0,0,0,0,0,0
733117,1191,5,123,103,20,5,1,0
246290,824,5,110,87,23,4,1,0
956618,4758,2,442,350,92,190,1,0
9574,103,2,9,9,0,1,0,0
0,0,0,0,0,0,0,0,0
397129,3153,4,405,394,11,5,1,0
939424,5756,7,546,392,154,108,0,0
77681,824,3,105,105,0,0,1,0
0,0,0,0,0,0,0,0,0
286668,2187,9,200,180,20,7,1,0
0,0,0,0,0,0,0,0,0
1428010,8794,10,1161,992,169,158,1,0
25849,151,2,13,1,12,2,1,0
3019395,1586,1,507,491,16,0,1,0
0,0,0,0,0,0,0,0,0
28816,45,0,4,1,3,0,0,0
15226,327,4,67,27,40,1,1,0
79851,958,2,332,332,0,1,1,0
719686,1518,4,124,99,25,1,0,0
491248,3562,17,594,441,153,319,1,0
292138,3142,7,757,680,77,9,1,0
0,0,0,0,0,0,0,0,0
1489930,1247,3,142,128,14,2,1,0
383390,120,0,4,4,0,0,1,0
0,0,0,0,0,0,0,0,0
500395,2360,4,457,437,20,15,1,0
47963,258,1,97,94,3,2,0,0
0,0,0,0,0,0,0,0,0
70072,567,1,26,14,12,21,1,0
383188,2676,11,562,546,16,29,1,1
0,0,0,0,0,0,0,0,0
0,0,0,0,0,0,0,0,0
0,0,0,0,0,0,0,0,0
1259,23,0,1,1,0,0,0,0
270601,2216,7,413,412,1,0,0,0
94318,283,8,37,36,1,2,0,0
0,0,0,0,0,0,0,0,0
249184,1840,7,484,442,42,12,1,0
457932,3882,6,431,409,22,324,1,0
407780,644,8,78,69,9,1,1,0
0,0,0,0,0,0,0,0,0
1467810,2336,6,116,110,6,14,1,0
0,0,0,0,0,0,0,0,0
1369675,2689,6,381,175,206,26,1,0
83100,1356,1,376,361,15,0,0,0
148557,1675,3,272,259,13,13,1,0
30204,215,2,19,17,2,2,1,0
78895,1169,3,231,177,54,6,1,0
0,0,0,0,0,0,0,0,0
307744,2222,4,443,204,239,4,1,0
61297,144,1,27,18,9,2,1,0
703971,3650,5,955,945,10,1,1,0
545257,1975,2,181,161,20,5,0,0
0,0,0,0,0,0,0,0,0
4171065,218,2,31,27,4,0,1,0
9987,122,3,10,10,0,1,1,0
693105,3243,3,724,518,206,28,1,0
22755,320,2,60,30,30,1,1,0
197368,2944,3,841,835,6,64,1,0
0,0,0,0,0,0,0,0,0
56429,383,2,45,36,9,4,1,0
43905,143,3,6,6,0,0,0,0
430375,6975,5,968,965,3,27,1,1
52287,323,5,8,7,1,0,0,0
187304,1227,5,211,130,81,3,1,0
256256,581,0,109,101,8,0,1,0
745043,1166,3,157,132,25,9,1,0
160459,1919,9,254,157,97,7,1,0
61128,315,8,10,2,8,13,0,0
97477,1103,4,260,251,9,12,0,0
669683,6645,3,468,455,13,17,1,1
146856,930,4,195,159,36,15,1,0
108834,570,4,149,141,8,14,1,0
288250,974,5,115,104,11,27,1,0
660407,3497,7,612,502,110,46,0,0
410244,3780,5,674,502,172,4,1,1
0,0,0,0,0,0,0,0,0
60148,858,8,136,132,4,1,0,0
12216,155,4,11,11,0,2,1,0
0,0,0,0,0,0,0,0,0
0,0,0,0,0,0,0,0,0
0,0,0,0,0,0,0,0,0
0,0,0,0,0,0,0,0,0
0,0,0,0,0,0,0,0,0
0,0,0,0,0,0,0,0,0
0,0,0,0,0,0,0,0,0
21259,36,0,2,1,1,0,1,0
0,0,0,0,0,0,0,0,0
0,0,0,0,0,0,0,0,0
237343,1674,8,575,568,7,0,0,0
143538,2388,4,300,296,4,6,1,0
39982,509,3,164,162,2,4,1,0
0,0,0,0,0,0,0,0,0
0,0,0,0,0,0,0,0,0
0,0,0,0,0,0,0,0,0
394343,1412,4,138,131,7,17,1,0
0,0,0,0,0,0,0,0,0
23411,338,1,57,49,8,1,1,0
218694,1373,4,181,163,18,2,1,0
0,0,0,0,0,0,0,0,0
666233,2073,6,377,358,19,6,1,0
0,0,0,0,0,0,0,0,0
49111,510,4,67,52,15,2,1,0
0,0,0,0,0,0,0,0,0
0,0,0,0,0,0,0,0,0
0,0,0,0,0,0,0,0,0
0,0,0,0,0,0,0,0,0
0,0,0,0,0,0,0,0,0
0,0,0,0,0,0,0,0,0
529818,1122,6,119,112,7,9,1,0
182001,435,2,24,0,24,15,0,0
0,0,0,0,0,0,0,0,0
0,0,0,0,0,0,0,0,0
0,0,0,0,0,0,0,0,0
0,0,0,0,0,0,0,0,0
0,0,0,0,0,0,0,0,0
0,0,0,0,0,0,0,0,0
0,0,0,0,0,0,0,0,0
0,0,0,0,0,0,0,0,0
832613,3099,11,488,416,72,0,1,0
0,0,0,0,0,0,0,0,0
0,0,0,0,0,0,0,0,0
98941,1363,6,146,126,20,8,1,0
0,0,0,0,0,0,0,0,0
0,0,0,0,0,0,0,0,0
0,0,0,0,0,0,0,0,0
59400,321,2,41,4,37,1,0,0
58196,317,1,41,30,11,1,0,0
0,0,0,0,0,0,0,0,0
0,0,0,0,0,0,0,0,0
0,0,0,0,0,0,0,0,0
0,0,0,0,0,0,0,0,0
0,0,0,0,0,0,0,0,0
0,0,0,0,0,0,0,0,0
0,0,0,0,0,0,0,0,0
983892,1259,4,186,172,14,0,1,0
0,0,0,0,0,0,0,0,0
0,0,0,0,0,0,0,0,0
0,0,0,0,0,0,0,0,0
0,0,0,0,0,0,0,0,0
0,0,0,0,0,0,0,0,0
0,0,0,0,0,0,0,0,0
0,0,0,0,0,0,0,0,0
0,0,0,0,0,0,0,0,0
0,0,0,0,0,0,0,0,0
41173,196,4,6,3,3,7,1,0
0,0,0,0,0,0,0,0,0
1157849,4521,1,571,193,378,2,1,0
7162,134,0,49,29,20,1,0,0
405248,6209,2,3406,3379,27,1,1,0
0,0,0,0,0,0,0,0,0
0,0,0,0,0,0,0,0,0
0,0,0,0,0,0,0,0,0
87276,535,0,92,88,4,1,1,0
251205,1750,7,266,237,29,25,1,0
103615,507,9,77,71,6,30,1,0
249334,912,0,136,20,116,17,1,0
111132,581,4,63,54,9,7,0,0
0,0,0,0,0,0,0,0,0
0,0,0,0,0,0,0,0,0
0,0,0,0,0,0,0,0,0
673712,3340,11,204,188,16,21,1,0
316610,1029,9,157,137,20,19,1,0
370946,4982,1,1490,1441,49,1,0,0
76016,163,1,14,4,10,1,1,0
539807,1497,6,294,241,53,14,0,0
133224,207,3,12,8,4,10,1,0
646333,2737,6,355,355,0,0,1,0
31217,130,7,13,10,3,3,0,0
590514,3961,8,407,387,20,22,1,0
166128,1089,5,200,186,14,85,0,1
240865,1141,7,169,142,27,11,1,0
7989,84,5,13,6,7,6,1,0
0,0,0,0,0,0,0,0,0
405,6,0,0,0,0,0,0,0
152591,1642,5,236,211,25,11,1,0
175965,1637,7,373,362,11,11,0,0
176146,1637,7,373,361,12,12,0,0
0,0,0,0,0,0,0,0,0
0,0,0,0,0,0,0,0,0
517208,2194,2,193,92,101,6,1,0
0,0,0,0,0,0,0,0,0
0,0,0,0,0,0,0,0,0
988758,3795,14,235,220,15,162,1,0
273794,1462,6,304,290,14,21,1,0
90290,923,3,237,229,8,4,1,0
0,0,0,0,0,0,0,0,0
250784,799,3,153,143,10,2,1,0
46899,163,3,20,12,8,1,1,0
302026,743,3,96,87,9,10,1,0
44435,477,2,161,143,18,22,1,0
6781,83,1,7,7,0,2,1,0
933487,3256,18,512,446,66,32,1,0
53248,819,2,11,2,9,1,0,0
298292,889,10,112,101,11,17,1,0
401315,2335,8,487,433,54,41,1,0
0,0,0,0,0,0,0,0,0
99361,871,10,85,77,8,5,0,0
163729,771,1,64,53,11,0,1,0
272001,1343,2,192,185,7,7,1,0
260475,400,5,41,33,8,7,1,0
651029,3439,12,436,429,7,7,1,1
550700,1800,1,210,40,170,15,1,0
36491,355,0,7,5,2,6,0,0
231700,762,3,123,105,18,38,1,0
44401,638,3,238,232,6,3,0,0
36713,616,3,23,22,1,1,1,0
433065,2558,1,187,180,7,2,1,0
50220,1116,1,318,301,17,0,0,0
232632,338,0,17,11,6,0,1,0
870170,1990,11,312,297,15,13,1,0
363650,2431,6,201,162,39,10,1,0
0,0,0,0,0,0,0,0,0
188882,828,4,68,55,13,5,1,0
671105,540,0,4,0,4,2,1,1
1102109,801,2,54,44,10,7,1,0
390004,1019,4,187,160,27,14,1,0
0,0,0,0,0,0,0,0,0
567730,4224,6,439,416,23,5,1,0
477046,1248,8,121,107,14,7,1,0
14667,101,2,7,7,0,0,0,0
69553,516,8,23,19,4,8,0,0
22543,167,12,3,2,1,3,1,0
0,0,0,0,0,0,0,0,0
158550,2084,1,263,222,41,1,1,0
529847,1714,6,88,86,2,4,1,0
426153,1192,6,15,13,2,19,1,0
332619,1364,5,162,126,36,8,1,0
0,0,0,0,0,0,0,0,0
0,0,0,0,0,0,0,0,0
218335,678,1,52,31,21,1,1,0
569684,4194,4,600,598,2,16,0,0
146522,1152,1,152,145,7,10,0,0
56671,745,4,227,200,27,6,1,0
43180,511,6,168,157,11,3,1,0
2063844,7516,2,560,461,99,2,0,0
0,0,0,0,0,0,0,0,0
2020635,3179,4,409,395,14,249,1,0
0,0,0,0,0,0,0,0,0
0,0,0,0,0,0,0,0,0
0,0,0,0,0,0,0,0,0
379551,1569,10,310,265,45,4,1,0
273177,1107,9,137,137,0,7,1,0
0,0,0,0,0,0,0,0,0
1318378,3707,6,444,396,48,7,1,0
113853,296,2,56,44,12,0,1,0
15250,221,0,81,81,0,1,1,0
0,0,0,0,0,0,0,0,0
2366082,310,0,14,10,4,0,1,0
47202,411,1,46,29,17,0,1,0
76109,1736,1,588,587,1,0,1,0
0,0,0,0,0,0,0,0,0
0,0,0,0,0,0,0,0,0
99680,1081,6,233,188,45,5,0,0
817082,1661,6,121,94,27,20,1,0
0,0,0,0,0,0,0,0,0
0,0,0,0,0,0,0,0,0
0,0,0,0,0,0,0,0,0
0,0,0,0,0,0,0,0,0
588423,3954,5,579,542,37,11,0,0
314498,1154,7,240,231,9,10,0,0
845448,8054,6,1106,992,114,38,1,0
201821,825,8,96,84,12,16,1,0
60416,124,7,3,3,0,4,0,0
359427,3274,6,886,886,0,0,0,0
47720,412,2,124,119,5,4,1,0
35939,155,2,31,28,3,5,1,0
684799,5569,1,275,256,19,10,1,0
665215,1979,4,252,218,34,3,1,0
0,0,0,0,0,0,0,0,0
292881,1223,2,144,126,18,1,1,0
0,0,0,0,0,0,0,0,0
0,0,0,0,0,0,0,0,0
219458,1605,12,314,231,83,28,1,0
279502,1322,8,110,65,45,16,0,0
55080,830,1,218,215,3,0,0,0
0,0,0,0,0,0,0,0,0
797754,4539,7,1436,1420,16,69,1,0
507002,2590,6,1213,1197,16,65,1,0
1383193,1227,8,162,142,20,11,1,0
1324136,793,5,121,106,15,4,1,0
636126,4280,10,1145,919,226,5,1,0
311460,2285,2,344,317,27,3,1,0
0,0,0,0,0,0,0,0,0
1367110,4742,4,633,459,174,4,1,0
0,0,0,0,0,0,0,0,0
42616,587,2,89,56,33,26,1,0
220166,1343,7,206,195,11,28,1,0
39034,131,5,6,6,0,2,1,0
86822,208,6,30,23,7,2,1,0
230874,1277,9,269,232,37,2,1,0
0,0,0,0,0,0,0,0,0
860314,2915,8,362,254,108,14,1,0
670225,1727,3,135,69,66,3,1,0
1195890,2936,8,293,265,28,17,1,0
586771,2672,10,310,154,156,16,1,0
298590,943,4,114,67,47,5,1,0
0,0,0,0,0,0,0,0,0
1802517,3095,6,382,348,34,14,1,0
36897,160,2,1,1,0,3,0,0
0,0,0,0,0,0,0,0,0
821575,2232,5,317,304,13,10,1,0
1043696,2028,11,307,264,43,39,1,0
57366,728,3,92,79,13,8,1,0
0,0,0,0,0,0,0,0,0
947732,3315,5,571,361,210,220,1,0
174326,859,1,187,171,16,7,1,0
0,0,0,0,0,0,0,0,0
1888253,6515,12,1125,1021,104,227,1,0
58093,127,1,2,2,0,0,0,1
0,0,0,0,0,0,0,0,0
171064,482,6,55,27,28,4,1,0
0,0,0,0,0,0,0,0,0
0,0,0,0,0,0,0,0,0
31618,213,3,31,26,5,1,0,0
903174,4358,10,814,775,39,170,1,0
55889,529,1,103,93,10,5,1,0
0,0,0,0,0,0,0,0,0
313506,1507,6,132,107,25,8,1,0
0,0,0,0,0,0,0,0,0
0,0,0,0,0,0,0,0,0
0,0,0,0,0,0,0,0,0
793197,5924,4,573,573,0,37,1,0
6308,54,5,5,5,0,2,0,0
465938,6464,1,1794,1747,47,0,0,0
137643,1171,0,158,147,11,6,1,0
0,0,0,0,0,0,0,0,0
229031,336,0,16,5,11,0,1,0
0,0,0,0,0,0,0,0,0
499060,1987,12,311,14,297,34,1,0
229558,338,0,17,11,6,0,1,0
0,0,0,0,0,0,0,0,0
0,0,0,0,0,0,0,0,0
497770,2851,9,360,353,7,51,1,0
137374,903,4,54,40,14,2,1,0
12707,113,5,18,16,2,1,1,0
14310,127,5,20,18,2,1,1,0
471843,2187,7,172,163,9,8,1,0
569542,1522,16,264,245,19,28,1,0
0,0,0,0,0,0,0,0,0
8916,155,1,62,40,22,1,1,0
564081,4407,5,1670,1661,9,2,0,0
0,0,0,0,0,0,0,0,0
0,0,0,0,0,0,0,0,0
2818014,7695,4,499,451,48,0,1,0
219965,1013,2,89,70,19,6,1,0
0,0,0,0,0,0,0,0,0
0,0,0,0,0,0,0,0,0
0,0,0,0,0,0,0,0,0
272324,1402,13,282,268,14,8,1,0
12001,79,6,5,5,0,0,0,0
855231,3429,3,630,588,42,5,1,0
194613,873,0,34,14,20,0,1,0
526441,3958,5,207,178,29,4,0,0
293635,1255,9,192,102,90,5,1,0
194359,189,1,21,18,3,0,0,0
0,0,0,0,0,0,0,0,0
348963,3199,3,527,379,148,0,1,0
95490,1725,5,204,180,24,12,1,0
20425,122,4,12,9,3,9,1,0
770164,5997,4,974,969,5,4,1,0
3211052,1187,6,187,179,8,5,1,0
502772,139,2,10,10,0,0,1,0
0,0,0,0,0,0,0,0,0
578618,3655,3,474,437,37,5,1,0
101189,782,12,45,33,12,25,1,0
198203,1270,9,280,233,47,8,1,0
39513,187,7,2,2,0,5,0,0
248242,1233,14,238,217,21,13,1,0
395779,4175,9,691,624,67,7,1,0
92152,259,1,48,24,24,0,1,1
291318,959,1,101,91,10,17,1,0
0,0,0,0,0,0,0,0,0
18453,247,4,22,20,2,0,0,0
9104,109,5,1,1,0,2,0,0
46246,548,3,62,49,13,0,0,0
0,0,0,0,0,0,0,0,0
281358,1550,3,116,108,8,3,1,0
164341,654,3,5,5,0,1,1,0
1318628,1369,1,105,41,64,12,1,0
0,0,0,0,0,0,0,0,0
638737,2886,1,268,226,42,48,1,0
566737,4259,8,223,210,13,21,1,0
476713,1425,7,175,170,5,70,1,0
251163,1405,2,290,274,16,0,1,0
594754,3792,4,549,548,1,6,1,0
487147,1100,8,122,105,17,7,1,0
15178,101,2,7,7,0,0,0,0
27867,151,4,21,9,12,1,0,0
22568,125,5,15,9,6,3,0,0
0,0,0,0,0,0,0,0,0
0,0,0,0,0,0,0,0,0
39603,441,5,63,57,6,9,1,0
16726,154,4,25,23,2,8,1,0
806895,1672,6,136,95,41,19,1,0
306095,4044,3,1371,1369,2,5,0,0
275176,3335,0,1197,874,323,1,1,0
9548,101,2,16,16,0,0,1,0
101003,1336,1,58,57,1,0,1,0
104588,1371,1,70,70,0,0,1,0
265893,982,1,161,138,23,24,1,0
0,0,0,0,0,0,0,0,0
177502,884,4,56,45,11,7,1,0
172394,1053,6,6,6,0,11,1,0
468278,3343,9,157,142,15,12,0,0
236544,1482,4,189,185,4,0,0,0
0,0,0,0,0,0,0,0,0
1420961,3173,4,193,163,30,3,1,0
76653,335,1,12,10,2,9,1,0
171294,893,7,130,109,21,10,1,0
0,0,0,0,0,0,0,0,0
339821,1948,14,156,141,15,16,1,0
409754,1389,8,226,206,20,34,1,0
233075,336,0,16,3,13,0,1,0
685302,2584,7,296,265,31,10,1,0
257486,1594,8,98,90,8,41,1,0
86222,112,5,4,4,0,6,0,0
4284917,9871,9,1530,1434,96,33,1,0
540262,1718,8,272,272,0,11,1,0
0,0,0,0,0,0,0,0,0
172347,2252,5,218,51,167,17,1,0
60809,701,5,169,149,20,5,1,0
431682,2652,8,431,412,19,21,1,0
64485,557,2,34,31,3,45,1,0
24180,184,3,10,10,0,6,1,0
106119,1199,4,195,76,119,4,1,0
228524,784,4,103,93,10,0,1,0
928241,3054,8,3,3,0,2,0,0
202333,1489,8,218,199,19,7,0,0
127147,1268,4,404,354,50,26,0,0
7703,133,1,5,5,0,0,0,0
762175,3683,10,373,67,306,12,1,0
857982,3810,2,165,144,21,3,1,0
1528822,1192,5,94,94,0,4,1,0
140882,224,6,4,4,0,4,1,0
355477,2513,12,308,293,15,27,1,1
0,0,0,0,0,0,0,0,0
486222,3180,5,314,296,18,4,1,0
246326,1441,6,258,148,110,29,1,0
569007,2755,7,343,266,77,21,0,0
172313,1649,7,325,320,5,24,1,0
11489,98,3,2,2,0,1,0,0
480510,2222,8,344,325,19,21,1,0
58463,175,6,4,4,0,12,0,0
197020,2110,6,414,401,13,15,1,0
37935,454,3,79,73,6,2,1,0
21944,113,4,12,11,1,3,1,0
0,0,0,0,0,0,0,0,0
0,0,0,0,0,0,0,0,0
120360,1508,5,231,229,2,2,1,0
19763,112,4,27,24,3,0,1,0
0,0,0,0,0,0,0,0,0
0,0,0,0,0,0,0,0,0
185263,1188,5,249,243,6,7,1,0
87396,617,15,151,124,27,6,1,0
140597,1046,2,98,77,21,12,0,0
135111,372,2,19,19,0,27,0,0
318698,632,6,3,0,3,1,1,0
0,0,0,0,0,0,0,0,0
147392,1058,2,290,290,0,0,1,0
952454,1867,2,315,288,27,1,1,0
402571,1016,5,180,161,19,8,1,0
173026,1938,3,388,365,23,16,1,0
0,0,0,0,0,0,0,0,0
286484,1943,6,388,383,5,11,1,0
257831,1610,6,368,358,10,11,1,0
267098,1637,1,169,159,10,8,1,0
267098,1637,1,169,159,10,8,1,0
0,0,0,0,0,0,0,0,0
0,0,0,0,0,0,0,0,0
47896,460,3,166,150,16,6,1,0
11554,133,3,22,20,2,0,1,0
332080,1667,7,259,225,34,8,1,0
31211,186,2,12,7,5,2,0,0
108284,1251,1,263,249,14,1,1,0
67282,470,4,114,101,13,1,1,0
0,0,0,0,0,0,0,0,0
557643,2439,12,411,402,9,18,0,0
0,0,0,0,0,0,0,0,0
12047,335,1,124,118,6,0,0,0
0,0,0,0,0,0,0,0,0
0,0,0,0,0,0,0,0,0
2206614,186,2,16,15,1,3,1,0
967375,3948,3,517,493,24,5,1,0
0,0,0,0,0,0,0,0,0
342042,1233,14,40,24,16,16,1,0
0,0,0,0,0,0,0,0,0
250485,1035,2,158,148,10,5,0,0
489073,2376,1,428,379,49,1,1,0
271836,2197,0,388,377,11,25,1,0
76221,358,1,50,39,11,23,1,0
203013,2082,5,600,573,27,4,1,0
4607,57,1,10,5,5,0,1,0
203571,710,2,127,105,22,13,1,0
198687,2243,2,510,488,22,15,1,1
2999599,10739,0,617,598,19,22,0,0
0,0,0,0,0,0,0,0,0
3695477,6613,11,240,222,18,31,1,0
406676,2904,9,550,532,18,22,1,0
0,0,0,0,0,0,0,0,0
232651,338,0,17,8,9,0,1,0
261831,919,7,95,54,41,2,1,0
220990,2086,4,370,363,7,4,1,0
220092,2077,4,427,421,6,5,1,0
0,0,0,0,0,0,0,0,0
480784,2259,6,198,174,24,14,1,0
567400,2723,8,262,209,53,17,1,0
35713,341,3,14,3,11,1,1,0
495019,2222,6,260,233,27,24,1,0
293098,1578,9,261,227,34,18,1,0
250082,1055,9,178,155,23,5,1,0
27616,42,0,2,1,1,0,0,0
1456256,9558,3,1170,1143,27,12,1,0
1146769,7678,3,864,837,27,5,1,0
0,0,0,0,0,0,0,0,0
0,0,0,0,0,0,0,0,0
442570,5023,5,1111,1104,7,5,1,0
1299345,3392,9,147,136,11,21,1,0
43383,122,1,3,0,3,2,1,0
0,0,0,0,0,0,0,0,0
478142,3170,7,393,339,54,11,1,0
147090,383,6,13,3,10,9,0,0
156896,905,5,125,123,2,17,1,0
85141,293,0,58,57,1,0,1,0
0,0,0,0,0,0,0,0,0
118755,638,12,75,70,5,26,1,0
0,0,0,0,0,0,0,0,0
130804,987,10,94,83,11,17,1,0
958531,4315,6,282,270,12,16,1,0
190840,989,10,293,276,17,18,1,0
572631,1462,8,240,224,16,9,1,1
10652,98,3,15,4,11,0,0,0
292450,1753,5,284,254,30,7,0,0
9283,101,0,6,6,0,0,0,0
0,0,0,0,0,0,0,0,0
365180,2434,5,374,351,23,13,1,0
189378,1027,4,220,207,13,5,1,0
664485,6259,3,521,436,85,17,1,1
236409,52,0,0,0,0,1,1,0
75471,1737,1,659,654,5,0,1,0
47211,227,3,20,15,5,4,1,0
64791,99,4,18,17,1,3,1,0
65637,110,4,16,15,1,3,1,0
0,0,0,0,0,0,0,0,0
0,0,0,0,0,0,0,0,0
729426,3381,2,131,87,44,5,1,0
0,0,0,0,0,0,0,0,0
0,0,0,0,0,0,0,0,0
1118902,2198,6,187,134,53,50,1,0
0,0,0,0,0,0,0,0,0
726312,5576,5,1284,1270,14,6,0,0
0,0,0,0,0,0,0,0,0
0,0,0,0,0,0,0,0,0
147762,1117,3,204,194,10,5,1,0
94872,812,2,110,92,18,3,1,0
220704,301,5,33,21,12,1,1,0
352704,3036,3,280,273,7,4,1,0
198291,1005,3,38,31,7,4,1,0
578236,2095,11,446,427,19,105,1,0
16558,159,1,38,25,13,0,0,0
9960,110,1,18,14,4,0,0,0
755734,3747,6,895,882,13,4,1,0
451591,1669,2,215,208,7,1,0,0
107694,1437,1,341,339,2,7,1,0
0,0,0,0,0,0,0,0,0
655525,6058,13,1224,1123,101,63,0,1
228528,338,0,17,11,6,0,1,0
477222,1020,12,95,78,17,44,1,0
1364295,1741,8,189,151,38,43,1,0
20511,36,0,2,1,1,0,1,0
0,0,0,0,0,0,0,0,0
415906,2231,7,485,432,53,5,1,0
0,0,0,0,0,0,0,0,0
641773,1236,6,114,97,17,30,1,0
501146,2292,2,152,149,3,4,1,0
189140,406,2,62,59,3,4,1,0
72126,502,4,81,68,13,4,1,0
396129,1495,5,328,320,8,2,1,0
290409,1195,6,155,146,9,2,1,0
0,0,0,0,0,0,0,0,0
367354,1019,6,126,94,32,19,1,0
385490,5150,9,532,474,58,14,1,0
98177,435,8,63,51,12,1,1,0
34099,540,6,39,34,5,2,1,0
608540,2733,1,155,133,22,16,1,0
39365,110,4,6,3,3,0,0,0
95858,791,7,142,118,24,17,1,0
19039,235,5,48,24,24,5,1,0
298337,1086,4,120,110,10,1,1,0
16079,162,1,14,10,4,4,1,0
499126,1860,6,406,383,23,12,1,0
0,0,0,0,0,0,0,0,0
192511,1405,7,304,293,11,4,1,0
0,0,0,0,0,0,0,0,0
0,0,0,0,0,0,0,0,0
329082,2258,7,403,393,10,15,0,0
159359,588,4,80,6,74,16,1,0
32803,199,2,21,11,10,7,1,0
0,0,0,0,0,0,0,0,0
77534,559,4,84,58,26,0,1,0
0,0,0,0,0,0,0,0,0
169217,1616,4,264,226,38,0,0,0
643945,346,7,3,3,0,4,1,0
48237,505,4,126,122,4,3,1,0
0,0,0,0,0,0,0,0,0
269184,1751,4,481,468,13,2,0,1
321721,3855,2,898,897,1,1,1,0
480071,4584,5,1299,584,715,17,0,0
0,0,0,0,0,0,0,0,0
14406,16,1,0,0,0,0,0,0
0,0,0,0,0,0,0,0,0
0,0,0,0,0,0,0,0,0
233325,338,0,17,9,8,0,1,0
305336,1008,7,203,190,13,26,1,0
496797,2619,4,555,535,20,25,1,0
0,0,0,0,0,0,0,0,0
0,0,0,0,0,0,0,0,0
81375,1178,4,305,302,3,1,1,0
457628,2161,16,206,182,24,15,1,0
725645,2686,2,439,439,0,1,1,0
176194,1688,6,405,397,8,15,1,0
141599,183,6,25,22,3,5,1,0
0,0,0,0,0,0,0,0,0
482767,1613,10,239,208,31,31,1,0
404643,2495,15,387,358,29,27,1,0
1215863,3510,6,374,319,55,61,1,0
187648,1479,6,281,277,4,10,1,0
895228,3736,5,292,256,36,7,1,0
505409,966,5,68,52,16,8,1,0
333599,706,7,43,29,14,13,1,0
214913,1317,4,183,160,23,3,1,0
179232,2629,3,409,406,3,9,0,0
41574,306,3,31,30,1,3,0,0
53280,457,5,21,13,8,0,1,0
265789,1831,4,302,277,25,11,1,0
172103,528,4,33,32,1,5,1,0
823,19,0,2,0,2,0,0,0
986916,11368,6,1452,1239,213,30,1,0
356107,1364,0,135,115,20,0,1,0
861646,3187,10,244,218,26,7,1,0
271950,332,9,12,9,3,6,0,0
186927,1726,2,404,404,0,2,0,0
196032,1814,10,294,259,35,20,1,0
237026,957,4,86,77,9,0,1,0
271418,1924,10,330,72,258,23,0,0
228772,336,0,17,11,6,0,1,0
451708,4242,6,1419,1409,10,20,1,0
34654,269,2,56,56,0,8,1,0
0,0,0,0,0,0,0,0,0
1213622,5410,4,1192,1137,55,24,1,0
0,0,0,0,0,0,0,0,0
52813,420,7,78,69,9,4,1,0
2316791,1335,8,184,138,46,28,1,0
116255,103,0,15,8,7,0,1,0
130039,923,8,234,223,11,11,1,1
161790,912,10,182,166,16,31,1,0
263920,3575,1,996,871,125,129,1,0
0,0,0,0,0,0,0,0,0
0,0,0,0,0,0,0,0,0
221568,1247,5,191,15,176,22,1,0
12120,85,2,5,5,0,6,1,0
427291,3320,10,266,247,19,27,1,0
213144,1173,3,414,407,7,11,1,0
0,0,0,0,0,0,0,0,0
234705,2869,10,404,385,19,2,1,0
686113,519,0,3,0,3,2,1,1
191348,386,1,60,57,3,1,1,0
178076,265,0,40,38,2,1,1,0
6760,48,4,4,1,3,2,1,0
6046344,2726,0,0,0,0,1,1,0
232843,2385,2,318,317,1,0,1,0
0,0,0,0,0,0,0,0,0
0,0,0,0,0,0,0,0,0
350027,1259,12,331,326,5,0,1,0
0,0,0,0,0,0,0,0,0
210134,384,3,52,45,7,6,1,0
259853,2460,6,132,125,7,3,1,0
89824,539,6,75,66,9,3,1,0
0,0,0,0,0,0,0,0,0
271380,2000,8,359,336,23,4,1,0
121783,1084,8,208,188,20,0,1,0
69094,818,2,31,25,6,3,1,0
558346,3784,6,597,586,11,10,1,0
0,0,0,0,0,0,0,0,0
348348,952,14,37,19,18,57,1,0
4967,88,0,28,24,4,0,1,0
110728,615,14,91,24,67,7,1,0
95725,460,14,91,80,11,7,1,0
307013,1211,8,228,217,11,22,1,0
126211,1080,6,159,141,18,10,1,0
38786,207,6,19,13,6,2,1,0
973765,3598,7,821,783,38,28,1,0
86248,770,7,131,124,7,19,1,0
230262,334,0,16,3,13,0,1,0
529606,2346,8,273,192,81,20,0,0
276080,3211,9,813,741,72,28,1,0
0,0,0,0,0,0,0,0,0
278370,1473,11,287,287,0,23,1,0
47440,484,5,77,56,21,3,1,0
39014,452,6,89,82,7,15,1,0
267940,464,11,24,20,4,33,0,0
631895,2421,5,594,586,8,6,1,0
870877,1654,1,207,178,29,36,1,0
0,0,0,0,0,0,0,0,0
0,0,0,0,0,0,0,0,0
67185,434,6,67,64,3,7,1,0
366550,2803,5,382,363,19,5,1,0
0,0,0,0,0,0,0,0,0
33508,675,2,198,198,0,3,0,0
0,0,0,0,0,0,0,0,0
0,0,0,0,0,0,0,0,0
725651,3270,6,318,289,29,90,1,0
0,0,0,0,0,0,0,0,0
0,0,0,0,0,0,0,0,0
80193,358,7,42,26,16,9,1,0
76058,347,7,26,12,14,11,1,0
0,0,0,0,0,0,0,0,0
165160,1939,4,513,509,4,14,1,0
0,0,0,0,0,0,0,0,0
636455,2636,4,391,378,13,9,1,0
0,0,0,0,0,0,0,0,0
0,0,0,0,0,0,0,0,0
1017221,2464,4,291,262,29,2,1,0
247858,1315,4,155,136,19,5,0,0
0,0,0,0,0,0,0,0,0
0,0,0,0,0,0,0,0,0
0,0,0,0,0,0,0,0,0
160906,1830,4,453,412,41,17,1,0
7703,133,1,5,5,0,0,0,0
578304,2421,12,392,315,77,26,1,0
0,0,0,0,0,0,0,0,0
0,0,0,0,0,0,0,0,0
0,0,0,0,0,0,0,0,0
5287,75,6,7,4,3,0,0,0
47495,366,3,68,51,17,0,1,0
113878,1204,7,290,273,17,17,1,0
20718,132,4,18,18,0,1,1,0
547277,1130,9,268,255,13,32,1,0
754389,1583,8,231,215,16,17,1,0
143237,902,3,250,139,111,1,1,0
65146,199,2,22,13,9,12,1,0
505267,2864,4,531,391,140,81,1,0
21508,143,3,10,10,0,0,1,0
0,0,0,0,0,0,0,0,0
0,0,0,0,0,0,0,0,0
0,0,0,0,0,0,0,0,0
125153,581,6,89,61,28,17,1,0
11420,81,7,6,6,0,0,1,0
0,0,0,0,0,0,0,0,0
0,0,0,0,0,0,0,0,0
55562,923,3,89,87,2,6,0,0
7170650,41284,12,3874,2340,1534,69,1,0
47106,132,8,3,0,3,0,1,0
35061,428,5,75,74,1,0,0,0
199997,888,9,120,91,29,6,1,0
242172,2508,7,8,5,3,13,1,0
131312,1858,2,236,222,14,31,1,0
0,0,0,0,0,0,0,0,0
0,0,0,0,0,0,0,0,0
91607,500,4,81,43,38,4,1,0
0,0,0,0,0,0,0,0,0
230168,338,0,17,11,6,0,1,0
125830,900,7,37,27,10,2,1,0
225333,2168,3,83,33,50,62,1,0
161970,2067,2,561,247,314,4,1,0
0,0,0,0,0,0,0,0,0
0,0,0,0,0,0,0,0,0
706955,3506,5,407,397,10,16,1,0
292361,126,4,2,2,0,2,1,0
0,0,0,0,0,0,0,0,0
228275,1232,7,110,101,9,12,1,0
865057,428,2,57,44,13,0,1,0
590891,2048,7,340,285,55,26,1,0
243030,743,9,131,83,48,8,1,0
819813,6499,6,1177,1039,138,5,1,0
9480,111,1,5,2,3,0,0,0
557036,1338,9,149,136,13,24,1,0
14735,101,2,7,7,0,0,0,0
0,0,0,0,0,0,0,0,0
0,0,0,0,0,0,0,0,0
0,0,0,0,0,0,0,0,0
151240,1309,3,391,370,21,6,0,0
53203,318,8,40,33,7,11,1,0
98951,1450,5,414,413,1,1,0,0
159889,934,6,124,108,16,2,1,0
718911,1980,12,315,253,62,21,1,0
54913,380,10,57,12,45,3,1,0
0,0,0,0,0,0,0,0,0
0,0,0,0,0,0,0,0,0
66317,602,3,114,88,26,13,1,0
6453,109,3,21,16,5,2,1,0
299127,1030,5,121,38,83,1,1,0
229526,338,0,17,9,8,0,1,0
1096207,2112,4,461,405,56,17,1,0
62840,430,3,22,12,10,23,1,0
0,0,0,0,0,0,0,0,0
0,0,0,0,0,0,0,0,0
583755,2228,6,114,102,12,32,1,0
86007,634,5,115,78,37,1,1,0
0,0,0,0,0,0,0,0,0
21333,238,2,30,15,15,0,1,0
0,0,0,0,0,0,0,0,0
1586178,5900,1,307,289,18,101,1,0
0,0,0,0,0,0,0,0,0
259404,1280,4,165,133,32,2,1,0
0,0,0,0,0,0,0,0,0
0,0,0,0,0,0,0,0,0
0,0,0,0,0,0,0,0,0
252391,3318,2,563,521,42,7,1,0
164829,1482,7,284,211,73,10,1,0
14354,152,1,19,16,3,2,1,0
8854,101,1,20,16,4,1,1,0
0,0,0,0,0,0,0,0,0
158483,1365,7,88,76,12,98,1,0
0,0,0,0,0,0,0,0,0
101160,850,4,176,127,49,2,1,0
857630,5516,3,285,275,10,4,1,0
534384,2809,2,179,130,49,2,1,0
154116,352,3,47,37,10,4,1,0
0,0,0,0,0,0,0,0,0
795328,2031,4,80,71,9,17,1,0
799754,1898,8,154,149,5,21,1,0
799754,1898,8,154,149,5,21,1,0
451968,981,11,127,119,8,19,1,0
4455616,1112,3,208,193,15,4,1,0
0,0,0,0,0,0,0,0,0
833170,2347,11,268,260,8,14,1,0
55058,363,16,35,28,7,16,1,0
0,0,0,0,0,0,0,0,0
0,0,0,0,0,0,0,0,0
0,0,0,0,0,0,0,0,0
0,0,0,0,0,0,0,0,0
0,0,0,0,0,0,0,0,0
441984,2282,6,476,11,465,9,1,0
46774,438,2,12,11,1,2,0,0
266716,3696,1,1030,905,125,129,1,0
648097,2453,14,472,467,5,22,1,0
1675,20,0,1,1,0,0,0,0
322558,3162,5,131,111,20,42,0,0
51735,196,4,13,10,3,3,0,0
522141,3185,3,332,317,15,0,1,0
229299,338,0,17,9,8,0,1,0
149658,616,0,67,65,2,0,1,0
83634,72,1,1,1,0,2,1,0
31695,276,3,19,16,3,3,1,0
0,0,0,0,0,0,0,0,0
0,0,0,0,0,0,0,0,0
42389,710,2,82,74,8,3,1,0
8873,107,1,8,8,0,6,0,0
298325,2485,5,472,412,60,7,1,0
384323,671,3,88,70,18,3,1,0
48707,126,1,12,2,10,0,0,0
0,0,0,0,0,0,0,0,0
70457,339,2,105,100,5,6,1,0
666118,4931,5,1042,945,97,6,0,0
109893,1204,0,167,167,0,1,0,0
722252,1958,7,273,226,47,23,1,0
243644,473,7,6,0,6,5,0,0
0,0,0,0,0,0,0,0,0
108392,726,5,120,114,6,8,1,0
358465,1944,8,165,114,51,38,1,0
142606,2856,3,720,714,6,24,1,0
173704,2214,4,270,259,11,8,1,0
0,0,0,0,0,0,0,0,0
116477,307,2,23,18,5,0,1,0
387449,1700,5,284,247,37,10,0,0
8953,100,0,6,6,0,0,0,0
0,0,0,0,0,0,0,0,0
0,0,0,0,0,0,0,0,0
0,0,0,0,0,0,0,0,0
198253,1007,5,192,187,5,1,1,0
267735,2165,9,583,573,10,34,1,0
27939,237,2,24,23,1,14,1,0
1290619,3681,2,429,426,3,4,1,0
0,0,0,0,0,0,0,0,0
40221,285,5,18,11,7,2,1,0
273695,1799,4,339,331,8,15,1,0
0,0,0,0,0,0,0,0,0
178376,1473,8,357,355,2,10,1,0
0,0,0,0,0,0,0,0,0
3485244,2029,0,83,80,3,0,1,0
68303,319,1,16,12,4,2,1,0
728597,3044,6,463,300,163,15,1,0
7816,126,1,9,1,8,0,0,0
7655,47,0,11,1,10,0,0,0
0,0,0,0,0,0,0,0,0
135636,3049,1,523,523,0,0,0,0
0,0,0,0,0,0,0,0,0
0,0,0,0,0,0,0,0,0
0,0,0,0,0,0,0,0,0
175150,1115,11,313,309,4,15,1,0
488946,1071,8,149,140,9,23,1,0
361040,2489,7,174,167,7,4,1,0
109270,239,7,14,13,1,3,0,0
785446,1784,13,186,175,11,25,1,0
164202,736,8,47,24,23,10,0,0
0,0,0,0,0,0,0,0,0
422709,1398,6,179,160,19,0,1,0
501669,1454,6,153,137,16,0,1,0
187568,1181,3,104,20,84,6,1,0
77226,514,8,42,42,0,1,1,0
0,0,0,0,0,0,0,0,0
0,0,0,0,0,0,0,0,0
499472,2522,2,339,315,24,12,1,0
111722,563,3,60,48,12,4,1,0
0,0,0,0,0,0,0,0,0
52390,325,1,70,57,13,1,1,0
598887,3734,3,890,763,127,35,0,0
133331,1424,6,218,194,24,11,1,0
9814,43,1,2,0,2,0,1,0
0,0,0,0,0,0,0,0,0
140518,1147,14,115,107,8,16,1,0
415144,1323,5,254,229,25,33,1,0
234340,449,9,32,28,4,5,1,0
9776,54,0,1,1,0,0,0,0
0,0,0,0,0,0,0,0,0
0,0,0,0,0,0,0,0,0
66888,331,11,55,54,1,23,0,0
64612,228,10,9,7,2,17,0,0
1711030,1867,5,267,251,16,8,1,0
0,0,0,0,0,0,0,0,0
0,0,0,0,0,0,0,0,0
226847,1236,11,166,58,108,3,1,0
0,0,0,0,0,0,0,0,0
0,0,0,0,0,0,0,0,0
387104,1194,2,168,140,28,1,0,0
0,0,0,0,0,0,0,0,0
440810,1736,1,217,207,10,15,0,0
0,0,0,0,0,0,0,0,0
407989,716,0,78,50,28,2,1,0
750222,3788,4,1035,661,374,5,1,0
248841,84,3,7,5,2,4,1,0
231724,340,0,17,12,5,0,1,0
110379,2120,3,722,671,51,0,1,0
1905036,2969,8,401,363,38,25,1,0
65934,87,4,13,11,2,0,0,0
739952,4042,6,782,694,88,22,1,0
241807,732,4,17,11,6,5,1,0
158732,2114,2,194,184,10,8,1,0
0,0,0,0,0,0,0,0,0
193679,1520,6,235,219,16,33,1,0
58542,198,1,19,1,18,4,1,0
0,0,0,0,0,0,0,0,0
1013329,3427,6,414,396,18,123,1,0
0,0,0,0,0,0,0,0,0
105098,668,4,181,180,1,5,1,0
26449,349,3,21,19,2,2,1,0
10839,133,4,21,20,1,2,1,0
0,0,0,0,0,0,0,0,0
607242,5584,3,2316,2305,11,12,1,0
312235,1595,5,278,266,12,3,0,0
0,0,0,0,0,0,0,0,0
0,0,0,0,0,0,0,0,0
452922,1554,4,111,109,2,8,1,0
0,0,0,0,0,0,0,0,0
550111,2462,11,287,279,8,60,1,1
0,0,0,0,0,0,0,0,0
0,0,0,0,0,0,0,0,0
0,0,0,0,0,0,0,0,0
402436,1256,11,37,13,24,10,1,0
0,0,0,0,0,0,0,0,0
0,0,0,0,0,0,0,0,0
630074,657,7,130,72,58,14,1,0
308807,1084,6,218,185,33,0,1,0
160889,565,2,64,20,44,12,1,0
38220,149,2,5,3,2,2,0,0
961174,1796,2,325,297,28,1,1,0
552922,1583,5,340,298,42,8,1,0
153839,618,2,117,99,18,3,0,0
74408,458,7,41,35,6,20,1,0
173326,1540,6,367,341,26,11,1,0
112711,927,1,0,0,0,1,1,0
482653,3060,2,333,327,6,82,1,0
161079,1264,8,281,228,53,5,0,0
256564,1359,7,195,178,17,1,1,0
30655,85,3,8,4,4,1,1,0
90600,565,5,114,103,11,14,1,0
0,0,0,0,0,0,0,0,0
36640,307,2,49,32,17,1,1,0
50636,218,0,76,73,3,0,0,0
47818,587,3,168,156,12,0,1,0
37616,406,4,74,55,19,1,1,0
0,0,0,0,0,0,0,0,0
227004,3898,2,1425,1411,14,85,1,0
0,0,0,0,0,0,0,0,0
58642,347,4,35,35,0,3,0,0
23250,103,5,6,6,0,3,0,0
18153,259,6,31,29,2,0,1,0
23292,173,9,25,23,2,0,1,0
0,0,0,0,0,0,0,0,0
0,0,0,0,0,0,0,0,0
14733,94,3,5,2,3,0,0,0
281295,1242,15,252,105,147,15,1,0
0,0,0,0,0,0,0,0,0
469632,1770,5,165,155,10,21,1,0
230519,473,5,9,7,2,10,0,0
0,0,0,0,0,0,0,0,0
22059,254,3,30,7,23,3,1,0
703284,2621,7,414,349,65,52,1,0
0,0,0,0,0,0,0,0,0
41299,844,1,234,234,0,0,0,0
14321,307,1,13,13,0,0,0,0
148575,968,4,341,101,240,2,1,0
60746,733,5,249,64,185,1,1,0
453584,2106,7,569,469,100,4,1,0
465882,2192,7,524,449,75,4,1,0
0,0,0,0,0,0,0,0,0
0,0,0,0,0,0,0,0,0
0,0,0,0,0,0,0,0,0
0,0,0,0,0,0,0,0,0
224114,259,3,25,19,6,1,1,0
0,0,0,0,0,0,0,0,0
486432,1456,2,201,181,20,0,0,0
538401,2161,12,459,362,97,17,1,1
308254,1252,11,219,200,19,31,1,0
0,0,0,0,0,0,0,0,0
0,0,0,0,0,0,0,0,0
27904,42,0,2,1,1,0,0,0
0,0,0,0,0,0,0,0,0
234251,1421,2,202,176,26,3,0,0
175088,2288,7,341,329,12,115,1,0
421012,2438,6,292,254,38,52,1,1
61906,1144,5,61,57,4,37,0,0
20686,36,0,2,1,1,0,1,0
147023,620,6,126,120,6,5,1,0
197573,1931,5,360,319,41,18,1,0
66608,623,5,187,183,4,9,1,0
651233,2252,10,186,170,16,8,1,0
882209,2707,0,262,238,24,14,1,0
138137,802,3,2,1,1,1,0,0
0,0,0,0,0,0,0,0,0
0,0,0,0,0,0,0,0,0
8861,144,6,12,12,0,0,1,0
67938,679,0,159,157,2,4,1,0
2658035,8800,2,156,146,10,269,1,0
287019,186,2,12,11,1,11,1,0
296,13,0,1,1,0,0,0,0
346622,1854,12,200,178,22,27,1,0
0,0,0,0,0,0,0,0,0
0,0,0,0,0,0,0,0,0
42560,503,3,85,76,9,1,1,0
19311,221,3,35,33,2,3,1,0
0,0,0,0,0,0,0,0,0
0,0,0,0,0,0,0,0,0
381658,3278,6,369,358,11,12,1,0
380593,3270,6,366,352,14,11,1,0
0,0,0,0,0,0,0,0,0
251914,517,1,35,27,8,7,0,0
346761,298,1,11,6,5,0,0,0
161949,743,9,133,121,12,6,1,0
593984,5410,9,533,215,318,10,1,0
316754,2659,5,226,100,126,2,1,0
196338,1728,7,373,370,3,0,1,0
117193,326,7,51,48,3,1,1,0
37103,102,7,1,1,0,0,0,0
0,0,0,0,0,0,0,0,0
0,0,0,0,0,0,0,0,0
424891,829,5,200,157,43,3,0,0
19627,32,0,1,1,0,0,1,0
0,0,0,0,0,0,0,0,0
0,0,0,0,0,0,0,0,0
80487,316,6,61,45,16,0,1,0
534986,8293,3,1339,1338,1,6,1,0
536005,8294,3,1339,1338,1,6,1,0
0,0,0,0,0,0,0,0,0
1282279,3938,3,405,387,18,334,1,0
366024,1725,9,129,127,2,15,1,0
58503,430,10,80,53,27,1,1,0
0,0,0,0,0,0,0,0,0
459540,2206,5,308,232,76,44,1,0
21668,118,4,6,6,0,0,0,0
0,0,0,0,0,0,0,0,0
62317,396,1,110,5,105,5,1,0
62041,157,3,15,6,9,7,1,0
258344,538,1,38,30,8,3,0,0
1472810,63,1,4,4,0,1,0,0
428777,2340,7,189,118,71,11,1,0
210856,734,7,18,12,6,10,1,0
109233,638,7,109,93,16,7,1,0
1285331,1388,18,69,47,22,4,1,0
0,0,0,0,0,0,0,0,0
749652,6746,7,482,473,9,3,1,1
413810,1630,11,178,121,57,17,1,0
820121,2618,6,431,412,19,5,1,0
644257,2696,5,1259,1236,23,8,1,0
426463,4527,6,1178,1170,8,11,1,0
694607,209,3,28,26,2,2,0,0
82594,861,7,127,114,13,12,0,0
2495656,1908,5,326,314,12,6,1,0
1127712,1502,5,275,263,12,9,1,0
268415,2823,8,478,468,10,14,0,0
375399,2642,8,359,330,29,33,1,0
1132182,3495,6,312,301,11,12,1,0
978877,3369,7,285,270,15,4,1,0
331840,1498,3,268,225,43,4,1,0
109346,1187,9,330,322,8,6,1,0
332454,2584,10,233,209,24,4,0,0
402374,967,2,70,57,13,4,1,0
70621,245,7,26,25,1,2,1,0
0,0,0,0,0,0,0,0,0
0,0,0,0,0,0,0,0,0
0,0,0,0,0,0,0,0,0
231211,338,0,17,10,7,0,1,0
270013,1944,7,497,481,16,13,1,0
637520,1131,4,101,98,3,2,1,0
4790,47,1,4,4,0,0,0,0
206329,1570,9,119,90,29,1,1,0
86824,562,10,78,78,0,6,0,0
0,0,0,0,0,0,0,0,0
149200,1513,7,335,326,9,51,1,0
0,0,0,0,0,0,0,0,0
13195,117,6,3,3,0,7,1,0
28259,238,7,52,39,13,3,1,0
487931,689,5,9,5,4,5,1,0
157199,1282,3,309,309,0,50,0,0
55002,851,4,244,243,1,3,1,0
808150,3114,2,474,469,5,7,1,0
124978,154,0,8,8,0,0,1,0
132739,645,7,71,68,3,16,0,0
580240,5722,9,350,332,18,16,1,0
98333,1388,10,137,124,13,11,1,0
257221,811,4,78,76,2,10,0,0
378321,2267,8,230,217,13,4,1,0
93312,259,0,48,24,24,0,1,1
978756,1808,2,324,295,29,1,1,0
554395,1586,5,338,291,47,8,1,0
0,0,0,0,0,0,0,0,0
968011,2061,11,184,172,12,33,1,0
132881,877,9,229,195,34,3,0,0
59474,739,8,181,179,2,1,1,0
58369,855,2,321,217,104,0,1,0
15213,87,2,12,11,1,0,1,0
0,0,0,0,0,0,0,0,0
92647,1114,4,160,158,2,21,1,0
55988,580,3,34,34,0,2,1,0
419108,1079,8,111,96,15,7,1,0
14593,101,2,7,7,0,0,0,0
0,0,0,0,0,0,0,0,0
0,0,0,0,0,0,0,0,0
0,0,0,0,0,0,0,0,0
0,0,0,0,0,0,0,0,0
975712,2002,9,316,248,68,7,1,0
860263,1799,9,343,316,27,7,1,0
0,0,0,0,0,0,0,0,0
176199,1243,3,88,77,11,0,1,0
35192,98,5,6,6,0,0,0,0
106832,978,8,175,162,13,9,1,0
0,0,0,0,0,0,0,0,0
0,0,0,0,0,0,0,0,0
2364208,20192,5,3022,2042,980,51,1,0
686283,522,0,5,1,4,2,1,1
737678,2628,10,521,211,310,24,1,0
418370,660,7,58,53,5,5,1,0
0,0,0,0,0,0,0,0,0
265063,2426,6,574,564,10,9,0,0
505663,2849,1,190,163,27,0,1,0
362445,4321,5,1071,1049,22,7,1,0
0,0,0,0,0,0,0,0,0
137850,877,3,159,144,15,10,1,0
25273,122,3,0,0,0,1,1,0
254218,1443,2,162,152,10,1,1,0
47374,159,4,4,4,0,3,0,0
0,0,0,0,0,0,0,0,0
0,0,0,0,0,0,0,0,0
0,0,0,0,0,0,0,0,0
0,0,0,0,0,0,0,0,0
0,0,0,0,0,0,0,0,0
209902,839,12,136,120,16,43,1,0
452831,2110,0,284,266,18,0,0,0
0,0,0,0,0,0,0,0,0
590155,4835,4,425,410,15,15,0,0
231267,915,4,113,102,11,7,0,0
0,0,0,0,0,0,0,0,0
31564,463,4,158,118,40,0,1,0
20422,223,3,33,15,18,3,1,0
385317,1140,9,180,162,18,17,1,0
148814,301,6,3,2,1,7,0,0
155682,908,5,183,73,110,0,1,0
157058,1770,9,410,354,56,20,1,0
210107,775,9,135,123,12,6,1,0
0,0,0,0,0,0,0,0,0
0,0,0,0,0,0,0,0,0
231331,338,0,17,9,8,0,1,0
240815,1738,6,350,308,42,5,1,0
16701,161,5,29,20,9,4,1,0
0,0,0,0,0,0,0,0,0
361811,2261,6,298,257,41,1,1,1
1236298,3081,6,398,392,6,12,1,0
11691,78,1,2,2,0,0,0,0
501930,1929,6,216,116,100,3,1,0
236860,1186,4,162,150,12,7,1,0
12685,100,4,18,13,5,0,1,0
311653,1467,9,279,270,9,14,1,0
0,0,0,0,0,0,0,0,0
1616456,1689,8,427,387,40,18,1,0
356813,1643,5,96,55,41,11,1,0
734533,1386,13,330,316,14,16,1,0
0,0,0,0,0,0,0,0,0
158674,1527,7,318,296,22,12,1,0
0,0,0,0,0,0,0,0,0
279585,1616,4,210,131,79,4,1,0
0,0,0,0,0,0,0,0,0
229051,338,0,17,9,8,0,1,0
434585,3268,4,521,443,78,2,1,0
0,0,0,0,0,0,0,0,0
96628,1173,10,239,214,25,6,1,0
6920,130,2,20,16,4,0,1,0
0,0,0,0,0,0,0,0,0
541530,1750,4,61,60,1,21,1,0
409796,1032,5,52,49,3,21,1,0
0,0,0,0,0,0,0,0,0
0,0,0,0,0,0,0,0,0
329638,3688,5,596,544,52,14,1,0
1112218,9198,17,487,478,9,21,1,0
0,0,0,0,0,0,0,0,0
1106,14,0,0,0,0,0,1,0
0,0,0,0,0,0,0,0,0
0,0,0,0,0,0,0,0,0
233328,2333,5,312,68,244,13,1,0
0,0,0,0,0,0,0,0,0
214810,1974,6,377,303,74,5,1,0
200837,1189,5,218,205,13,0,1,0
0,0,0,0,0,0,0,0,0
0,0,0,0,0,0,0,0,0
107983,447,10,44,40,4,9,1,0
0,0,0,0,0,0,0,0,0
5509,65,2,6,6,0,1,0,0
424168,2054,4,480,419,61,2,1,1
0,0,0,0,0,0,0,0,0
0,0,0,0,0,0,0,0,0
0,0,0,0,0,0,0,0,0
877922,3776,2,231,215,16,5,1,1
0,0,0,0,0,0,0,0,0
73414673,1445,10,58,47,11,6,1,0
592992,1781,7,143,129,14,32,1,0
212877,897,7,113,109,4,33,1,0
288116,2195,2,368,336,32,3,1,0
58361,393,4,42,36,6,3,1,0
77743,90,5,4,4,0,1,0,0
216300,1686,9,238,232,6,29,1,0
366640,965,6,121,61,60,8,1,0
338898,385,5,90,76,14,3,1,0
0,0,0,0,0,0,0,0,0
40079,396,6,84,44,40,10,1,0
0,0,0,0,0,0,0,0,0
0,0,0,0,0,0,0,0,0
259082,915,7,94,84,10,2,1,0
0,0,0,0,0,0,0,0,0
411584,1777,2,490,466,24,5,1,0
664663,2450,2,491,424,67,2,1,0
816587,2373,6,351,304,47,22,1,0
260604,698,7,6,5,1,5,0,0
545061,1752,1,213,32,181,11,1,0
36150,355,0,7,5,2,6,0,0
0,0,0,0,0,0,0,0,0
115224,1227,4,311,299,12,1,0,0
560566,4723,3,561,548,13,21,1,0
0,0,0,0,0,0,0,0,0
0,0,0,0,0,0,0,0,0
0,0,0,0,0,0,0,0,0
0,0,0,0,0,0,0,0,0
147233,355,6,12,11,1,5,0,0
938,9,0,0,0,0,0,0,0
0,0,0,0,0,0,0,0,0
463901,1347,5,191,162,29,1,1,0
0,0,0,0,0,0,0,0,0
195126,3358,1,623,548,75,12,1,0
155687,1783,9,336,234,102,14,1,0
0,0,0,0,0,0,0,0,0
521837,8016,4,303,219,84,41,1,0
85974,416,4,66,52,14,6,1,0
234270,1714,5,167,136,31,13,0,0
0,0,0,0,0,0,0,0,0
339908,1009,12,190,183,7,5,1,0
0,0,0,0,0,0,0,0,0
87813,575,2,34,31,3,41,1,0
127577,1798,4,157,152,5,8,0,0
0,0,0,0,0,0,0,0,0
338614,773,5,47,36,11,6,1,0
323342,349,5,4,1,3,4,0,0
85661,1078,4,251,152,99,2,1,0
144755,1354,1,489,472,17,7,1,0
3978,42,1,2,2,0,2,1,0
0,0,0,0,0,0,0,0,0
621548,2842,6,496,481,15,3,1,0
1235502,7825,6,1545,1500,45,112,1,0
108365,812,6,171,158,13,31,1,0
226019,2366,4,218,208,10,8,0,0
13587,309,2,72,71,1,1,0,0
79278,1012,2,167,129,38,6,1,0
84877,662,3,83,79,4,1,1,0
129553,1143,9,187,177,10,15,0,0
4973,44,4,3,3,0,0,1,0
36706,520,6,127,94,33,1,1,0
50125,442,1,12,10,2,0,1,0
29801,520,2,93,90,3,4,1,0
54012,719,4,87,84,3,1,1,0
190453,826,5,109,103,6,12,1,0
720449,8505,7,1602,689,913,4,1,0
0,0,0,0,0,0,0,0,0
1020386,2061,5,308,307,1,9,1,0
1214630,1933,14,167,153,14,34,1,0
1115814,1893,14,152,106,46,36,1,0
340545,1618,6,96,87,9,45,1,0
0,0,0,0,0,0,0,0,0
0,0,0,0,0,0,0,0,0
480326,3845,3,761,740,21,25,1,0
228389,2752,9,854,851,3,11,1,0
50625,263,11,22,22,0,14,1,0
0,0,0,0,0,0,0,0,0
76881,1125,5,162,147,15,1,0,0
11696,106,3,13,13,0,1,0,0
83751,1043,2,262,254,8,7,1,0
989377,2699,8,576,551,25,83,1,0
0,0,0,0,0,0,0,0,0
572846,914,3,74,58,16,0,1,0
976870,5897,1,312,308,4,3,1,0
122899,305,1,3,2,1,3,0,0
2715,74,0,11,0,11,0,1,0
958552,2248,7,281,266,15,12,1,0
65894,215,2,14,7,7,1,1,0
141462,1413,10,274,265,9,46,1,0
28076,371,3,94,85,9,2,1,0
412913,2286,6,420,409,11,0,1,0
901263,2718,9,228,207,21,12,1,0
0,0,0,0,0,0,0,0,0
0,0,0,0,0,0,0,0,0
0,0,0,0,0,0,0,0,0
166969,2286,1,375,374,1,0,1,0
0,0,0,0,0,0,0,0,0
0,0,0,0,0,0,0,0,0
1021899,3878,8,364,301,63,9,0,0
0,0,0,0,0,0,0,0,0
19692,34,0,1,1,0,0,1,0
0,0,0,0,0,0,0,0,0
154573,1008,17,119,109,10,6,1,0
155157,1511,2,376,369,7,8,0,0
74633,818,2,57,32,25,0,1,0
0,0,0,0,0,0,0,0,0
20711,36,0,2,1,1,0,1,0
196396,952,8,138,131,7,21,1,0
114404,348,7,55,48,7,1,1,0
0,0,0,0,0,0,0,0,0
284719,787,10,53,50,3,20,1,0
23619,439,2,88,87,1,0,0,0
290499,3156,7,1387,1386,1,6,1,0
149579,331,8,36,35,1,9,0,0
0,0,0,0,0,0,0,0,0
237014,898,6,120,109,11,14,1,0
102065,238,5,9,8,1,9,0,0
604181,3924,9,274,114,160,16,1,0
67180,799,5,181,159,22,16,1,0
5806,94,3,17,15,2,1,1,0
300087,1232,3,105,82,23,1,1,0
0,0,0,0,0,0,0,0,0
208653,1592,3,137,113,24,24,1,0
127861,516,3,4,4,0,4,1,0
81678,539,1,41,26,15,0,0,0
131152,460,6,17,14,3,0,0,0
0,0,0,0,0,0,0,0,0
29151,152,3,3,3,0,3,0,0
125043,1595,5,388,367,21,8,0,0
729009,6433,12,1303,1191,112,55,1,0
0,0,0,0,0,0,0,0,0
929858,1545,5,307,242,65,29,1,0
0,0,0,0,0,0,0,0,0
255191,1921,3,273,272,1,21,1,0
720881,2001,2,300,143,157,37,0,0
704458,3471,3,560,533,27,5,1,0
41375,287,2,41,24,17,9,0,0
136864,1063,0,110,104,6,0,1,0
258897,1833,4,213,213,0,8,0,0
0,0,0,0,0,0,0,0,0
0,0,0,0,0,0,0,0,0
319100,5171,4,1285,966,319,24,0,0
19070,54,1,1,1,0,1,0,0
75894,595,5,97,82,15,7,1,0
21046,214,3,26,24,2,3,1,0
269838,729,3,127,118,9,10,1,0
353716,8568,1,2912,2898,14,1,1,0
224694,934,7,123,77,46,5,1,0
8872,123,2,30,1,29,0,1,0
164575,962,7,144,129,15,10,1,0
31942,170,1,54,53,1,0,1,0
76954,281,2,43,43,0,0,1,0
454322,1014,3,112,100,12,10,1,0
114742,255,1,28,21,7,4,1,0
115362,1542,4,299,170,129,0,0,0
941895,2947,3,340,192,148,31,1,0
345730,891,8,102,17,85,13,1,0
183325,1246,2,208,189,19,3,1,0
0,0,0,0,0,0,0,0,0
330616,1740,1,60,53,7,21,1,0
46110,175,3,9,6,3,1,0,0
587070,2086,6,234,98,136,2,1,0
21109,59,1,0,0,0,1,0,0
0,0,0,0,0,0,0,0,0
89318,301,4,37,24,13,1,0,0
35230,128,3,5,4,1,2,0,0
58317,418,0,108,97,11,0,1,0
4506,42,2,3,3,0,0,0,0
0,0,0,0,0,0,0,0,0
115842,1312,2,253,203,50,6,1,0
202856,309,7,41,34,7,3,1,0
103407,181,7,18,18,0,5,0,0
1152905,1693,5,233,164,69,6,1,0
0,0,0,0,0,0,0,0,0
0,0,0,0,0,0,0,0,0
244327,2341,2,321,273,48,11,1,0
566934,2373,14,395,357,38,41,1,0
0,0,0,0,0,0,0,0,0
356964,2620,8,382,367,15,86,1,0
331794,1324,3,132,124,8,1,0,0
484086,3485,11,990,288,702,75,1,0
11522,118,9,6,6,0,2,1,0
127145,1200,2,395,317,78,10,1,0
0,0,0,0,0,0,0,0,0
264379,1846,5,215,199,16,20,1,0
0,0,0,0,0,0,0,0,0
443308,1618,6,228,193,35,52,1,0
93445,774,11,114,4,110,2,1,0
0,0,0,0,0,0,0,0,0
0,0,0,0,0,0,0,0,0
789563,3452,3,232,223,9,9,1,0
383165,1516,5,250,163,87,27,1,0
16511,86,4,6,6,0,0,0,0
0,0,0,0,0,0,0,0,0
344290,880,4,243,238,5,6,1,0
619597,3629,7,908,879,29,10,1,0
148197,1189,7,339,331,8,5,1,0
50331,277,7,24,19,5,6,1,0
96732,683,1,37,12,25,4,0,0
590356,2086,14,384,375,9,16,1,0
288865,411,11,46,38,8,13,1,0
251363,1686,6,333,328,5,8,1,0
578619,232,3,9,0,9,2,1,0
78735,848,7,70,66,4,7,1,0
0,0,0,0,0,0,0,0,0
0,0,0,0,0,0,0,0,0
796001,5605,4,939,360,579,3,0,0
277621,1811,7,427,414,13,3,1,0
2870,41,2,7,6,1,0,1,0
0,0,0,0,0,0,0,0,0
52226,400,0,93,90,3,0,0,0
27294,421,1,84,78,6,0,1,0
444603,1434,5,174,130,44,4,1,0
471912,1581,7,190,71,119,11,1,0
0,0,0,0,0,0,0,0,0
104303,503,4,85,67,18,1,0,0
33235,246,2,73,73,0,0,1,0
0,0,0,0,0,0,0,0,0
0,0,0,0,0,0,0,0,0
227403,1226,4,211,197,14,9,0,0
8903,100,0,6,6,0,0,0,0
0,0,0,0,0,0,0,0,0
93431,2657,3,1485,782,703,0,1,0
14315,65,2,13,8,5,0,1,0
121887,1197,2,188,181,7,14,1,0
975891,4725,7,921,877,44,46,1,0
0,0,0,0,0,0,0,0,0
193488,2660,4,629,619,10,43,1,0
0,0,0,0,0,0,0,0,0
529878,2547,8,612,482,130,28,1,1
292475,918,2,151,130,21,1,1,0
188381,452,2,58,44,14,0,1,0
55915,346,1,24,15,9,5,1,1
0,0,0,0,0,0,0,0,0
83508,1332,7,337,304,33,14,0,0
610667,1549,8,181,167,14,7,1,0
15241,101,2,7,7,0,0,0,0
628409,3803,3,946,923,23,14,1,0
228483,334,0,16,3,13,0,1,0
0,0,0,0,0,0,0,0,0
0,0,0,0,0,0,0,0,0
226305,1798,4,339,336,3,9,0,1
162933,804,7,141,135,6,21,1,0
0,0,0,0,0,0,0,0,0
42640,338,12,44,37,7,5,1,0
89537,259,0,48,24,24,0,1,1
3215207,3410,5,230,205,25,10,1,0
537192,2048,5,144,132,12,0,1,0
116252,1045,5,194,191,3,10,1,0
468444,2226,6,206,178,28,9,1,0
473951,2262,6,206,174,32,9,1,0
218546,2915,6,554,544,10,4,1,0
48853,581,7,114,107,7,2,1,0
0,0,0,0,0,0,0,0,0
0,0,0,0,0,0,0,0,0
261208,3523,2,853,813,40,2,1,0
348776,1498,12,274,233,41,12,1,0
270639,863,10,219,185,34,7,1,0
75554,1245,2,362,357,5,0,1,0
0,0,0,0,0,0,0,0,0
168616,171,0,73,52,21,0,1,0
191312,876,8,107,9,98,9,1,0
37246,121,3,6,4,2,2,0,0
963419,4228,4,623,168,455,21,1,1
21496,125,5,9,3,6,1,1,0
136404,1033,7,190,105,85,5,1,0
0,0,0,0,0,0,0,0,0
612499,3079,4,282,250,32,17,1,0
80853,418,8,32,25,7,6,1,0
0,0,0,0,0,0,0,0,0
767523,2505,2,276,260,16,8,1,0
74302,1926,2,567,567,0,1,1,0
148082,1647,8,352,342,10,19,1,1
398549,2369,15,321,292,29,63,1,0
0,0,0,0,0,0,0,0,0
47290,348,4,48,27,21,1,0,0
47505,348,4,48,27,21,1,0,0
0,0,0,0,0,0,0,0,0
0,0,0,0,0,0,0,0,0
0,0,0,0,0,0,0,0,0
198029,942,0,144,129,15,0,1,0
129542,1277,4,226,189,37,3,1,0
81124,552,6,155,130,25,3,1,0
0,0,0,0,0,0,0,0,0
1103216,2090,10,309,293,16,31,1,0
0,0,0,0,0,0,0,0,0
818399,1842,6,274,259,15,25,1,0
665067,1082,8,133,102,31,15,1,0
341903,923,8,73,61,12,18,1,0
106982,320,7,10,6,4,22,0,0
0,0,0,0,0,0,0,0,0
231422,338,0,17,10,7,0,1,0
313107,1566,4,270,191,79,3,1,0
0,0,0,0,0,0,0,0,0
12342,44,0,3,2,1,0,0,0
239179,400,1,56,14,42,0,0,0
767597,2010,3,233,233,0,114,1,0
187442,577,6,141,138,3,2,1,0
0,0,0,0,0,0,0,0,0
20923,38,0,2,2,0,0,1,0
80284,811,3,96,93,3,8,1,0
255080,1712,11,272,246,26,12,1,0
189171,1131,9,208,191,17,6,1,0
187037,909,11,194,190,4,7,1,0
132641,250,6,13,13,0,4,1,0
268280,1232,6,164,162,2,14,0,0
0,0,0,0,0,0,0,0,0
147766,851,3,102,84,18,0,1,0
0,0,0,0,0,0,0,0,0
494898,2283,9,541,533,8,19,1,0
1131081,1395,9,150,143,7,11,1,0
0,0,0,0,0,0,0,0,0
123094,705,7,123,89,34,0,1,0
380681,1662,6,172,159,13,12,1,0
0,0,0,0,0,0,0,0,0
32096,339,3,85,81,4,1,1,0
7580,91,2,10,10,0,1,0,0
206104,1014,6,179,172,7,1,1,0
142046,893,8,194,180,14,14,0,0
0,0,0,0,0,0,0,0,0
422736,3513,6,716,689,27,10,1,0
99356,1510,6,38,28,10,4,1,0
581630,5367,5,834,830,4,76,1,0
201867,944,7,122,121,1,56,1,0
17290,132,5,21,18,3,2,0,0
18648,45,0,1,0,1,2,0,1
35400,295,12,35,35,0,4,1,0
42746,593,10,106,45,61,0,1,0
36687,408,9,97,48,49,0,1,0
50457,535,7,80,53,27,1,1,0
0,0,0,0,0,0,0,0,0
0,0,0,0,0,0,0,0,0
568748,2550,4,466,452,14,2,1,1
497725,1238,4,180,169,11,10,1,0
0,0,0,0,0,0,0,0,0
481135,1972,5,353,322,31,11,1,0
0,0,0,0,0,0,0,0,0
490860,1143,6,197,184,13,1,1,0
299882,367,0,17,13,4,2,1,0
963592,3557,7,585,578,7,45,1,0
264258,1630,4,377,329,48,1,1,0
16059,76,0,2,1,1,0,0,0
109172,1222,4,142,14,128,15,1,0
218574,588,2,158,146,12,1,0,0
56438,749,4,153,140,13,0,0,0
174446,306,1,110,76,34,2,1,0
168777,170,0,73,52,21,0,1,0
64010,973,6,234,227,7,1,1,0
876880,3855,4,475,379,96,5,1,0
0,0,0,0,0,0,0,0,0
9335,168,1,51,51,0,2,1,0
0,0,0,0,0,0,0,0,0
234672,1284,15,143,140,3,97,1,0
91654,1311,8,356,319,37,14,1,0
42237,312,10,58,54,4,7,1,0
72142,476,13,68,59,9,3,1,0
0,0,0,0,0,0,0,0,0
101017,791,5,130,124,6,2,1,0
100800,792,5,126,120,6,2,1,0
1044693,1328,6,126,108,18,31,1,0
0,0,0,0,0,0,0,0,0
121571,175,0,8,8,0,3,1,0
122416,199,0,17,15,2,3,1,0
913275,3017,4,158,131,27,3,1,0
0,0,0,0,0,0,0,0,0
26541,269,0,60,58,2,0,0,0
27062,322,4,58,57,1,0,0,0
18603,254,4,52,52,0,0,0,0
277154,976,5,297,286,11,0,1,0
343294,1274,11,105,96,9,5,1,0
212649,1699,4,305,170,135,16,1,0
1119078,3361,7,439,346,93,59,1,0
0,0,0,0,0,0,0,0,0
566897,1809,1,283,124,159,13,1,0
79255,112,1,10,1,9,2,0,0
506421,3332,3,326,299,27,8,0,0
0,0,0,0,0,0,0,0,0
0,0,0,0,0,0,0,0,0
0,0,0,0,0,0,0,0,0
850843,3080,7,539,517,22,15,1,0
603917,2055,13,386,382,4,3,1,0
363106,759,14,126,116,10,6,1,0
611797,6052,5,888,601,287,2,1,1
2060,38,1,6,0,6,0,1,0
0,0,0,0,0,0,0,0,0
19674,378,0,102,61,41,0,1,0
768340,2108,7,453,431,22,13,1,0
0,0,0,0,0,0,0,0,0
229523,334,0,16,8,8,0,1,0
487171,1725,8,273,211,62,10,1,0
0,0,0,0,0,0,0,0,0
97860,1112,8,251,227,24,7,1,0
51009,552,8,133,116,17,2,1,0
670849,1047,5,112,59,53,32,1,0
225985,2429,7,118,100,18,6,1,0
131358,1449,9,8,8,0,10,0,0
64068,112,0,18,18,0,5,1,0
11268,82,1,6,6,0,1,1,0
189304,1120,2,136,113,23,4,1,0
115670,588,1,82,61,21,4,1,0
0,0,0,0,0,0,0,0,0
862152,1140,4,194,187,7,6,1,0
0,0,0,0,0,0,0,0,0
0,0,0,0,0,0,0,0,0
185364,1732,1,193,189,4,5,1,0
5828,77,3,6,6,0,2,0,0
963041,2427,3,354,321,33,9,1,0
0,0,0,0,0,0,0,0,0
215414,2451,2,638,625,13,10,0,0
141412,903,9,69,35,34,1,0,0
53086,1103,2,275,214,61,1,1,0
34508,401,2,89,51,38,3,1,0
41987,569,6,64,52,12,1,1,0
570240,763,11,161,153,8,15,0,0
292156,1003,13,83,69,14,32,1,0
111338,338,11,10,6,4,24,0,0
167183,726,6,78,32,46,4,1,0
0,0,0,0,0,0,0,0,0
724522,6854,8,519,371,148,614,1,0
745488,5094,9,426,410,16,21,1,0
290723,1684,5,184,174,10,9,1,0
0,0,0,0,0,0,0,0,0
0,0,0,0,0,0,0,0,0
0,0,0,0,0,0,0,0,0
0,0,0,0,0,0,0,0,0
512,14,0,0,0,0,0,0,0
7200,103,3,3,2,1,0,1,0
403730,3055,5,372,246,126,6,1,0
0,0,0,0,0,0,0,0,0
0,0,0,0,0,0,0,0,0
0,0,0,0,0,0,0,0,0
0,0,0,0,0,0,0,0,0
0,0,0,0,0,0,0,0,0
0,0,0,0,0,0,0,0,0
0,0,0,0,0,0,0,0,0
156584,766,0,148,141,7,39,1,0
113575,110,0,8,7,1,0,1,0
0,0,0,0,0,0,0,0,0
1136492,14211,6,3734,3690,44,45,1,0
307287,833,4,120,5,115,11,1,0
80606,1107,4,252,230,22,6,1,0
6783,100,3,8,7,1,0,1,0
0,0,0,0,0,0,0,0,0
0,0,0,0,0,0,0,0,0
59265,696,7,171,118,53,6,1,0
445560,3946,6,1000,943,57,21,1,0
633979,877,8,28,15,13,9,0,0
278426,1374,10,272,261,11,13,1,0
0,0,0,0,0,0,0,0,0
561463,1982,8,199,189,10,54,1,0
286195,858,6,122,113,9,7,1,0
832163,3247,9,437,317,120,62,1,0
33563,485,5,113,44,69,2,1,0
0,0,0,0,0,0,0,0,0
0,0,0,0,0,0,0,0,0
866201,1310,7,96,71,25,29,1,0
0,0,0,0,0,0,0,0,0
362029,3072,3,231,203,28,16,1,0
52148,90,0,6,4,2,0,1,0
2837,38,0,0,0,0,0,0,0
0,0,0,0,0,0,0,0,0
0,0,0,0,0,0,0,0,0
92350,318,5,74,72,2,7,1,0
0,0,0,0,0,0,0,0,0
316281,2111,10,283,224,59,10,1,0
0,0,0,0,0,0,0,0,0
199146,915,11,152,146,6,14,1,0
1148248,2682,9,136,110,26,5,1,0
556727,640,8,87,80,7,3,1,0
950645,3240,6,377,182,195,46,0,0
322876,2369,8,609,580,29,5,1,0
1024065,1962,17,322,308,14,39,1,1
1027547,1972,17,323,309,14,36,1,1
0,0,0,0,0,0,0,0,0
824361,2289,5,324,291,33,18,1,0
250948,545,7,6,5,1,5,0,0
0,0,0,0,0,0,0,0,0
0,0,0,0,0,0,0,0,0
1611085,8276,14,1297,1048,249,8,1,0
141716,870,4,38,32,6,7,0,0
620136,2583,2,227,119,108,6,1,0
0,0,0,0,0,0,0,0,0
0,0,0,0,0,0,0,0,0
0,0,0,0,0,0,0,0,0
424004,5452,4,1355,1324,31,13,1,0
99767,2103,3,718,709,9,2,1,0
421656,1451,13,190,166,24,35,1,0
184658,2047,5,457,318,139,6,1,0
0,0,0,0,0,0,0,0,0
0,0,0,0,0,0,0,0,0
755909,2669,9,239,218,21,42,1,0
184359,1334,6,150,136,14,5,1,0
74448,198,8,11,11,0,4,1,0
0,0,0,0,0,0,0,0,0
0,0,0,0,0,0,0,0,0
0,0,0,0,0,0,0,0,0
248200,3306,2,1500,1494,6,8,0,0
0,0,0,0,0,0,0,0,0
373229,1341,7,136,96,40,6,1,0
191867,449,8,36,25,11,24,1,0
0,0,0,0,0,0,0,0,0
531054,4670,2,337,307,30,2,1,0
61354,438,3,77,75,2,12,1,0
4061,47,1,7,7,0,0,1,0
77995,522,5,78,77,1,7,0,0
0,0,0,0,0,0,0,0,0
994228,2379,6,138,129,9,7,1,0
320443,1189,11,133,120,13,13,1,0
423213,1941,6,202,190,12,9,1,0
579927,1060,6,156,136,20,6,1,0
0,0,0,0,0,0,0,0,0
0,0,0,0,0,0,0,0,0
105155,914,5,55,47,8,1,1,0
0,0,0,0,0,0,0,0,0
756353,1108,10,164,147,17,18,1,0
0,0,0,0,0,0,0,0,0
0,0,0,0,0,0,0,0,0
436283,2709,8,403,287,116,310,1,0
4213890,2815,5,360,254,106,14,1,0
195831,276,4,9,7,2,8,1,0
443203,1959,6,251,190,61,16,1,0
260506,1142,10,244,232,12,25,1,0
176188,823,7,80,58,22,8,1,0
737509,6507,4,1065,1065,0,36,1,0
169771,3008,4,243,241,2,4,1,0
181078,1773,4,461,421,40,1,0,0
0,0,0,0,0,0,0,0,0
102561,512,4,27,24,3,1,1,0
260955,1598,4,238,214,24,7,1,0
20679,35,0,2,1,1,0,1,0
2338018,18623,5,5389,50,5339,6,1,0
617702,8053,5,1186,1169,17,9,1,0
51684,607,4,193,191,2,6,1,0
44362,527,3,161,159,2,4,1,0
0,0,0,0,0,0,0,0,0
4633221,34952,6,3359,1905,1454,35,1,0
47106,132,8,3,0,3,0,1,0
0,0,0,0,0,0,0,0,0
198096,1689,7,217,10,207,1,0,0
108422,176,1,25,16,9,1,1,0
141045,1427,6,269,256,13,12,1,0
0,0,0,0,0,0,0,0,0
415024,905,5,99,88,11,4,1,0
339618,1269,6,115,106,9,4,1,0
293839,2204,3,311,289,22,0,1,0
9896,172,2,20,16,4,0,1,0
492479,3058,1,328,315,13,0,1,0
34218,229,0,4,4,0,0,0,0
403054,2768,5,766,717,49,16,1,0
9485,156,3,31,30,1,5,0,0
0,0,0,0,0,0,0,0,0
551895,1732,6,254,239,15,9,1,0
193744,1461,7,201,103,98,7,1,0
0,0,0,0,0,0,0,0,0
189253,457,3,91,73,18,10,1,0
532691,2522,8,689,423,266,3,1,0
337712,2020,6,350,68,282,4,1,0
218754,527,6,20,9,11,5,0,0
0,0,0,0,0,0,0,0,0
147804,738,6,75,68,7,6,1,0
434413,2066,6,290,282,8,3,1,0
107418,1382,2,191,187,4,2,1,0
278443,1829,5,140,131,9,10,1,0
159650,803,5,68,59,9,2,1,0
0,0,0,0,0,0,0,0,0
101124,506,8,119,114,5,5,1,0
108798,1850,6,330,330,0,20,1,0
433386,1725,11,251,227,24,17,1,0
0,0,0,0,0,0,0,0,0
54767,785,4,314,313,1,2,0,0
9130,142,4,28,28,0,1,0,0
99690,1469,5,175,164,11,78,1,0
24728,158,4,14,8,6,7,1,0
575707,4825,8,601,569,32,44,1,0
479658,1129,8,139,118,21,7,1,0
15124,101,2,7,7,0,0,0,0
307709,3247,5,364,334,30,2,0,0
0,0,0,0,0,0,0,0,0
161298,1130,2,225,185,40,1,1,0
53331,330,2,46,44,2,3,1,0
73424,1301,2,355,325,30,6,1,0
0,0,0,0,0,0,0,0,0
136897,968,7,207,189,18,16,1,0
0,0,0,0,0,0,0,0,0
0,0,0,0,0,0,0,0,0
0,0,0,0,0,0,0,0,0
189163,666,0,16,16,0,3,1,0
308699,1759,0,201,201,0,37,1,0
0,0,0,0,0,0,0,0,0
1196449,1687,4,327,280,47,4,1,0
311495,2258,7,275,248,27,21,1,0
282768,1237,4,79,71,8,1,0,0
0,0,0,0,0,0,0,0,0
357921,2510,2,332,313,19,7,1,0
357921,2510,2,332,312,20,7,1,0
72735,827,5,214,211,3,11,1,0
44331,532,5,137,137,0,10,1,0
0,0,0,0,0,0,0,0,0
105739,483,11,74,73,1,13,1,0
74136,274,11,49,49,0,12,1,0
212922,1440,8,225,213,12,6,1,0
165962,870,8,161,149,12,6,1,0
82461,1203,1,382,333,49,3,1,0
7050,57,0,8,0,8,0,0,0
229937,885,14,123,113,10,18,1,0
60621,867,4,97,52,45,1,1,0
0,0,0,0,0,0,0,0,0
189800,1221,10,207,196,11,21,0,0
530676,1056,8,44,38,6,7,1,0
5817,75,1,2,2,0,0,0,0
211820,1349,9,382,382,0,6,1,0
120487,213,8,30,29,1,2,1,0
92431,1041,2,60,33,27,2,1,0
0,0,0,0,0,0,0,0,0
0,0,0,0,0,0,0,0,0
0,0,0,0,0,0,0,0,0
113723,1684,7,289,258,31,13,1,0
522873,1550,9,270,203,67,39,1,0
213492,535,7,107,102,5,13,1,0
0,0,0,0,0,0,0,0,0
0,0,0,0,0,0,0,0,0
256345,1364,8,166,77,89,2,1,0
276395,494,1,11,4,7,1,1,0
380310,1529,4,507,504,3,1,1,0
117527,1971,5,576,569,7,3,1,0
132448,574,4,73,61,12,2,1,0
0,0,0,0,0,0,0,0,0
1637041,3751,4,385,373,12,36,1,0
40351,279,2,31,14,17,10,0,0
540346,1837,5,207,194,13,11,1,0
769986,4077,13,597,590,7,22,1,1
0,0,0,0,0,0,0,0,0
2230483,5161,2,552,257,295,30,1,0
293158,2098,5,501,457,44,14,0,0
0,0,0,0,0,0,0,0,0
182491,1964,4,301,301,0,0,1,0
0,0,0,0,0,0,0,0,0
276336,3756,5,831,762,69,0,0,0
356906,2973,10,693,677,16,55,0,0
0,0,0,0,0,0,0,0,0
35405,176,7,17,15,2,4,1,0
182559,1287,6,340,292,48,5,1,0
35888,394,4,96,53,43,5,1,0
57133,520,8,126,124,2,4,0,0
296707,1715,8,414,253,161,37,1,0
0,0,0,0,0,0,0,0,0
66365,716,4,196,196,0,0,1,0
561455,4859,8,577,524,53,43,1,0
0,0,0,0,0,0,0,0,0
336699,1915,4,379,349,30,11,1,0
576231,3007,6,263,250,13,9,1,0
0,0,0,0,0,0,0,0,0
0,0,0,0,0,0,0,0,0
157236,478,8,26,20,6,5,1,0
326516,2268,9,251,219,32,23,1,0
516389,2377,8,314,288,26,25,1,0
459480,1563,13,157,132,25,32,1,0
881139,4248,7,743,643,100,67,1,0
435737,1983,3,189,165,24,28,0,0
0,0,0,0,0,0,0,0,0
273826,2100,5,157,129,28,41,1,0
405353,1676,13,234,219,15,43,1,0
91897,183,6,6,3,3,5,1,0
241775,2245,8,575,561,14,13,0,0
0,0,0,0,0,0,0,0,0
1125395,1459,6,129,84,45,32,1,0
0,0,0,0,0,0,0,0,0
1264271,4555,11,687,675,12,234,1,0
839088,3794,11,654,642,12,226,1,0
0,0,0,0,0,0,0,0,0
228422,2237,6,521,507,14,5,1,0
205561,1543,6,414,401,13,5,1,0
314249,2266,2,329,302,27,3,1,0
3732,51,2,6,4,2,0,0,0
1108422,3100,4,283,277,6,17,1,0
195537,575,4,34,25,9,1,1,0
913510,7308,6,841,780,61,40,0,0
90989,339,4,60,55,5,9,0,0
284692,1062,7,204,196,8,5,1,0
0,0,0,0,0,0,0,0,0
0,0,0,0,0,0,0,0,0
383689,1060,3,260,253,7,15,1,0
262221,1272,4,193,179,14,21,1,0
39310,465,0,114,44,70,1,1,0
0,0,0,0,0,0,0,0,0
2978272,213,2,29,25,4,0,1,0
9989,122,3,10,10,0,1,1,0
39017,790,1,45,45,0,6,1,0
0,0,0,0,0,0,0,0,0
143893,1740,4,519,442,77,38,0,0
0,0,0,0,0,0,0,0,0
0,0,0,0,0,0,0,0,0
225356,1514,7,229,221,8,6,1,0
0,0,0,0,0,0,0,0,0
421038,1025,6,83,76,7,0,1,0
0,0,0,0,0,0,0,0,0
0,0,0,0,0,0,0,0,0
0,0,0,0,0,0,0,0,0
0,0,0,0,0,0,0,0,0
62214,426,2,113,109,4,7,0,0
0,0,0,0,0,0,0,0,0
169323,549,7,28,19,9,45,1,0
50893,162,6,15,10,5,7,1,0
791268,3801,3,211,198,13,10,1,0
0,0,0,0,0,0,0,0,0
0,0,0,0,0,0,0,0,0
0,0,0,0,0,0,0,0,0
2438396,2292,6,158,133,25,2,1,0
0,0,0,0,0,0,0,0,0
361247,1889,6,619,572,47,39,1,0
21351,132,3,18,16,2,1,1,0
0,0,0,0,0,0,0,0,0
368728,2621,1,619,365,254,93,1,0
0,0,0,0,0,0,0,0,0
95214,690,4,191,93,98,0,0,0
13607,116,5,5,5,0,0,0,0
177104,1258,2,345,340,5,7,0,0
0,0,0,0,0,0,0,0,0
124392,1101,7,251,98,153,9,1,0
11324,187,1,24,17,7,0,1,0
0,0,0,0,0,0,0,0,0
0,0,0,0,0,0,0,0,0
103239,1008,9,220,206,14,35,1,0
16831,401,0,140,140,0,1,1,0
0,0,0,0,0,0,0,0,0
237633,1485,5,213,207,6,0,1,0
969119,2754,3,292,272,20,7,1,0
77194,359,0,64,59,5,1,1,0
0,0,0,0,0,0,0,0,0
203400,702,8,93,88,5,4,1,0
468556,1109,7,132,119,13,6,1,0
14725,101,2,7,7,0,0,0,0
701334,4677,7,1453,1441,12,301,1,0
0,0,0,0,0,0,0,0,0
7125,77,2,14,14,0,0,0,0
0,0,0,0,0,0,0,0,0
103654,1013,4,188,90,98,9,0,0
0,0,0,0,0,0,0,0,0
0,0,0,0,0,0,0,0,0
283186,2206,5,409,333,76,4,1,0
0,0,0,0,0,0,0,0,0
0,0,0,0,0,0,0,0,0
243372,1713,5,426,415,11,10,1,0
0,0,0,0,0,0,0,0,0
566671,2383,17,346,253,93,25,1,0
71172,1221,2,11,2,9,1,0,0
0,0,0,0,0,0,0,0,0
192561,1079,1,165,162,3,6,1,0
108152,232,1,35,33,2,10,1,0
0,0,0,0,0,0,0,0,0
270920,1650,10,280,250,30,7,1,0
0,0,0,0,0,0,0,0,0
374802,3026,12,704,690,14,48,1,0
161681,1232,12,345,337,8,17,1,0
513392,1905,15,450,449,1,21,1,0
407641,931,14,195,194,1,22,1,0
0,0,0,0,0,0,0,0,0
746723,2373,13,447,425,22,22,0,0
0,0,0,0,0,0,0,0,0
613815,1847,9,257,231,26,11,1,0
255242,1871,0,56,56,0,18,0,0
261778,2555,5,466,315,151,12,0,0
598765,1419,3,159,151,8,7,1,0
326621,2703,5,814,769,45,11,1,0
900955,2942,5,547,450,97,1,1,0
0,0,0,0,0,0,0,0,0
0,0,0,0,0,0,0,0,0
0,0,0,0,0,0,0,0,0
520445,3120,13,347,318,29,5,1,0
216850,891,10,202,157,45,8,1,0
74481,438,9,81,74,7,0,1,0
59909,123,2,4,4,0,0,1,0
1516018,1881,11,204,170,34,32,1,0
305631,1144,2,350,343,7,1,1,0
0,0,0,0,0,0,0,0,0
976582,1888,8,155,135,20,9,1,0
54113,151,5,1,1,0,0,0,0
817849,5039,10,749,719,30,12,1,0
402524,2103,7,523,470,53,27,1,0
65299,484,7,91,79,12,1,1,0
1719537,5404,12,659,524,135,102,1,0
479397,1270,10,271,229,42,26,1,0
448312,3092,8,819,812,7,76,1,0
154895,729,6,72,68,4,2,1,0
43807,931,7,2,2,0,2,0,0
99104,1100,3,87,80,7,109,1,0
64296,267,5,36,36,0,13,1,0
757883,3120,3,396,346,50,3,1,0
697302,3958,10,356,21,335,22,1,0
220589,1114,8,166,158,8,9,1,0
0,0,0,0,0,0,0,0,0
326337,3798,2,547,425,122,1,1,0
144576,1717,3,260,252,8,5,1,0
105461,1433,5,238,230,8,3,1,0
188140,1348,1,156,136,20,16,1,0
5239,119,2,33,33,0,5,1,0
5601,105,2,32,32,0,5,1,0
235544,1196,6,263,2,261,3,1,0
116727,783,7,180,173,7,2,1,0
22296,355,3,99,99,0,0,1,0
80606,1176,2,226,226,0,0,1,0
479221,2618,7,314,282,32,51,1,0
342370,3662,9,1081,412,669,56,1,0
124766,1717,4,198,167,31,3,0,0
60951,980,6,128,120,8,3,1,0
11234,104,3,6,3,3,2,1,1
0,0,0,0,0,0,0,0,0
0,0,0,0,0,0,0,0,0
0,0,0,0,0,0,0,0,0
0,0,0,0,0,0,0,0,0
149801,1633,8,276,275,1,15,1,0
64946,247,9,8,7,1,13,1,0
162698,1084,5,240,220,20,17,1,0
191561,2075,4,289,289,0,9,1,0
2500998,2088,4,308,281,27,6,1,0
0,0,0,0,0,0,0,0,0
0,0,0,0,0,0,0,0,0
363353,2413,11,423,287,136,30,0,0
142740,614,9,111,93,18,16,0,0
287568,1755,4,520,484,36,17,1,0
64822,141,7,11,2,9,5,0,0
333900,3302,10,395,382,13,16,1,0
244438,856,0,4,1,3,2,1,0
141791,1994,3,938,913,25,6,1,0
156254,1413,2,111,104,7,34,1,0
89632,562,2,41,39,2,34,1,0
0,0,0,0,0,0,0,0,0
312796,2061,1,139,95,44,0,1,0
36605,170,2,15,15,0,0,1,0
96594,1259,8,224,221,3,19,1,0
39827,453,5,63,63,0,3,1,0
0,0,0,0,0,0,0,0,0
160128,1139,5,234,225,9,13,1,0
0,0,0,0,0,0,0,0,0
0,0,0,0,0,0,0,0,0
163432,933,2,265,260,5,5,0,0
217245,664,11,108,95,13,23,1,0
920777,4458,8,475,23,452,17,1,0
0,0,0,0,0,0,0,0,0
163420,548,7,106,70,36,5,1,0
0,0,0,0,0,0,0,0,0
831583,1959,16,169,115,54,33,1,0
35975,436,2,11,2,9,1,0,0
0,0,0,0,0,0,0,0,0
0,0,0,0,0,0,0,0,0
0,0,0,0,0,0,0,0,0
0,0,0,0,0,0,0,0,0
812608,4504,7,501,495,6,23,1,1
59079,922,5,227,224,3,8,1,0
41142,663,6,231,228,3,9,1,0
0,0,0,0,0,0,0,0,0
78187,1005,6,197,191,6,3,0,0
281586,1725,3,569,546,23,22,0,0
0,0,0,0,0,0,0,0,0
1007676,3231,4,45,39,6,2,1,0
0,0,0,0,0,0,0,0,0
1990034,2497,3,224,215,9,0,1,0
0,0,0,0,0,0,0,0,0
0,0,0,0,0,0,0,0,0
0,0,0,0,0,0,0,0,0
1235434,1683,5,192,179,13,10,1,0
1074936,3043,6,441,367,74,27,1,0
0,0,0,0,0,0,0,0,0
47379,597,2,65,44,21,3,0,0
612678,2051,6,468,454,14,19,1,0
510930,1605,8,407,393,14,19,1,0
473615,1180,7,131,107,24,6,1,0
14728,101,2,7,7,0,0,0,0
198833,1489,3,386,345,41,0,1,0
1341813,2619,12,169,145,24,14,1,0
19589,378,0,102,57,45,0,1,0
55426,407,5,49,48,1,11,1,0
1893897,12452,2,418,312,106,1,1,0
147314,1010,6,201,190,11,7,1,0
179998,1539,5,444,443,1,8,1,0
124225,800,4,211,210,1,8,1,0
1205660,2186,7,372,346,26,253,1,0
772722,3107,4,499,418,81,5,1,0
564110,2098,4,368,312,56,5,1,0
416153,3428,5,474,402,72,7,1,0
0,0,0,0,0,0,0,0,0
0,0,0,0,0,0,0,0,0
195795,1973,8,470,450,20,19,1,0
0,0,0,0,0,0,0,0,0
397525,4576,6,469,447,22,16,1,0
83022,765,1,149,149,0,0,1,0
0,0,0,0,0,0,0,0,0
141493,1492,2,466,404,62,1,1,0
0,0,0,0,0,0,0,0,0
0,0,0,0,0,0,0,0,0
1114971,2099,10,241,214,27,36,1,0
1452472,2141,9,384,350,34,15,1,0
164003,1469,8,154,153,1,14,0,0
2178159,9474,4,406,405,1,1,1,0
1710787,14237,7,1239,364,875,23,0,0
397954,3967,5,831,784,47,20,0,0
100482,1008,3,188,178,10,6,0,0
171670,1207,5,247,237,10,37,1,0
106631,965,5,190,180,10,38,1,0
42154,431,4,52,29,23,0,1,0
11495,82,3,8,6,2,0,1,0
0,0,0,0,0,0,0,0,0
61831,226,0,47,25,22,0,1,1
109042,395,0,47,39,8,1,1,1
577,7,0,0,0,0,0,0,0
182841,635,3,156,100,56,4,1,0
0,0,0,0,0,0,0,0,0
132825,1139,4,212,179,33,2,1,0
494321,1812,5,503,492,11,24,1,0
64383,671,0,196,187,9,7,1,0
99612,476,3,59,35,24,9,1,0
433885,2315,4,532,330,202,16,1,0
448448,1166,3,132,116,16,11,1,0
118316,316,1,46,33,13,4,1,0
764020,1022,3,77,71,6,0,1,0
0,0,0,0,0,0,0,0,0
0,0,0,0,0,0,0,0,0
139447,1426,8,268,257,11,9,1,0
433611,3480,2,227,161,66,0,1,0
83743,922,6,249,152,97,2,0,0
0,0,0,0,0,0,0,0,0
210113,2361,9,474,471,3,6,1,0
234914,2453,10,477,473,4,7,1,0
259744,781,6,45,37,8,8,1,0
879659,3437,1,378,352,26,10,1,0
0,0,0,0,0,0,0,0,0
0,0,0,0,0,0,0,0,0
885012,4871,5,233,223,10,6,1,0
54300,154,2,5,4,1,3,0,0
0,0,0,0,0,0,0,0,0
25574,426,0,147,147,0,1,1,0
15981,149,0,27,27,0,1,1,0
95105,1416,2,472,461,11,2,1,0
346461,1080,3,49,28,21,17,1,0
428319,2106,4,353,273,80,14,1,0
44135,663,4,147,116,31,4,1,0
230201,943,1,77,71,6,2,0,0
1476329,4706,4,420,399,21,14,0,0
7109,119,1,10,1,9,0,0,0
130771,1713,6,620,617,3,2,1,0
444886,4133,5,1273,253,1020,2,0,0
265770,2122,5,217,93,124,24,1,0
0,0,0,0,0,0,0,0,0
566599,2368,3,332,314,18,8,1,0
639357,1659,2,136,127,9,10,1,1
277417,147,1,8,6,2,6,1,1
0,0,0,0,0,0,0,0,0
204698,389,4,4,0,4,0,1,0
146472,763,2,109,101,8,7,1,0
0,0,0,0,0,0,0,0,0
0,0,0,0,0,0,0,0,0
0,0,0,0,0,0,0,0,0
626010,1622,10,415,409,6,36,1,0
209842,600,8,128,124,4,3,1,0
239006,400,1,56,9,47,0,0,0
339976,2968,8,954,947,7,10,1,0
378662,1491,12,240,205,35,14,1,0
243175,705,12,134,101,33,11,1,0
190434,1064,4,171,143,28,4,1,0
171655,2023,2,449,354,95,69,0,0
0,0,0,0,0,0,0,0,0
0,0,0,0,0,0,0,0,0
167498,341,7,12,8,4,4,0,0
41541,305,5,63,57,6,0,1,0
43722,310,5,67,61,6,0,1,0
149450,178,3,2,0,2,1,0,0
988680,2629,7,543,518,25,17,1,0
0,0,0,0,0,0,0,0,0
62976,363,5,45,33,12,2,1,1
45259,266,2,35,31,4,1,1,1
1326495,7635,8,774,735,39,21,1,0
0,0,0,0,0,0,0,0,0
0,0,0,0,0,0,0,0,0
15332,98,3,4,3,1,4,0,0
762790,8936,10,1566,1496,70,20,1,0
54545,942,2,290,271,19,5,1,0
68888,1065,3,329,226,103,7,0,0
327578,1641,1,159,136,23,9,1,0
93346,1720,3,285,283,2,3,0,0
15933,233,5,53,52,1,0,1,0
0,0,0,0,0,0,0,0,0
55402,636,3,74,62,12,9,1,0
62578,341,8,36,31,5,30,0,0
0,0,0,0,0,0,0,0,0
1592,11,0,1,1,0,0,0,0
116118,1159,1,413,285,128,2,1,0
38157,405,0,58,57,1,0,1,0
0,0,0,0,0,0,0,0,0
4738910,36928,4,3521,2014,1507,34,1,0
47106,132,8,3,0,3,0,1,0
143959,781,8,142,107,35,6,1,0
18085,339,6,77,35,42,0,1,0
0,0,0,0,0,0,0,0,0
381238,4818,4,631,139,492,5,1,0
21901,172,5,14,8,6,0,0,0
430626,1290,13,123,55,68,0,1,0
0,0,0,0,0,0,0,0,0
202259,1222,13,51,7,44,3,1,0
0,0,0,0,0,0,0,0,0
6215478,4024,4,159,143,16,510,1,0
125318,561,6,43,40,3,5,1,0
118241,481,5,31,28,3,0,1,0
304154,1350,8,238,7,231,21,1,0
0,0,0,0,0,0,0,0,0
99394,1236,2,315,297,18,34,0,0
36048,176,1,33,28,5,0,0,0
228714,334,0,16,3,13,0,1,0
8523,89,2,21,14,7,0,1,0
26652,36,0,3,1,2,0,0,0
936742,3372,8,342,331,11,29,1,0
679297,2421,0,166,144,22,1,1,0
414826,1376,4,120,109,11,0,1,0
201599,660,5,85,52,33,13,1,0
11864,89,2,10,7,3,0,1,0
390861,2584,3,459,438,21,3,1,0
386632,1790,12,424,405,19,34,1,0
0,0,0,0,0,0,0,0,0
0,0,0,0,0,0,0,0,0
142098,2358,5,385,381,4,3,1,0
286569,1944,10,414,402,12,17,1,0
286636,1944,10,414,406,8,17,1,0
145078,383,6,37,24,13,9,1,0
7265,59,2,6,3,3,0,1,0
1166638,527,2,13,6,7,4,1,0
0,0,0,0,0,0,0,0,0
61257,1042,1,293,283,10,7,1,0
7450,77,1,13,7,6,1,0,0
0,0,0,0,0,0,0,0,0
0,0,0,0,0,0,0,0,0
212232,936,3,77,67,10,19,1,0
0,0,0,0,0,0,0,0,0
332346,2426,2,630,613,17,0,1,0
0,0,0,0,0,0,0,0,0
146532,1240,7,145,113,32,5,1,0
99977,602,7,21,18,3,5,1,0
120620,911,4,124,113,11,1,1,0
66871,813,2,251,243,8,0,1,0
13618,213,2,43,35,8,0,1,0
347547,2483,8,475,437,38,24,1,0
37763,138,0,8,4,4,1,0,0
0,0,0,0,0,0,0,0,0
683318,2734,4,479,441,38,34,1,0
42543,583,4,138,135,3,1,1,0
457897,1445,3,131,124,7,13,1,0
10836,82,2,3,3,0,0,0,0
0,0,0,0,0,0,0,0,0
0,0,0,0,0,0,0,0,0
0,0,0,0,0,0,0,0,0
333559,2248,4,412,340,72,16,1,0
34756,234,4,18,7,11,0,1,0
762754,959,7,71,61,10,54,1,0
150111,991,2,282,276,6,18,1,0
148756,986,2,282,276,6,18,1,0
27511,42,0,2,1,1,0,0,0
0,0,0,0,0,0,0,0,0
802123,2027,11,347,249,98,13,1,0
0,0,0,0,0,0,0,0,0
329565,734,4,132,116,16,6,1,0
106377,189,2,12,6,6,3,1,0
0,0,0,0,0,0,0,0,0
536940,3694,5,570,553,17,16,1,0
18341,166,1,9,9,0,0,0,0
0,0,0,0,0,0,0,0,0
221411,1310,6,266,226,40,1,1,0
0,0,0,0,0,0,0,0,0
171128,1619,4,92,62,30,2,1,0
0,0,0,0,0,0,0,0,0
0,0,0,0,0,0,0,0,0
121254,398,10,65,65,0,3,1,0
352575,2524,11,325,301,24,44,1,0
103974,1907,0,596,582,14,4,0,0
24894,369,0,154,153,1,1,0,0
357892,3552,3,650,636,14,1,1,0
0,0,0,0,0,0,0,0,0
238306,2627,14,593,587,6,66,1,0
0,0,0,0,0,0,0,0,0
416420,1233,10,116,107,9,14,1,0
125221,1219,3,180,16,164,8,0,0
76569,737,6,119,102,17,1,1,0
0,0,0,0,0,0,0,0,0
445114,4152,8,1155,1140,15,14,1,0
272867,1665,11,273,50,223,2,1,0
44809,88,10,1,0,1,2,1,0
0,0,0,0,0,0,0,0,0
185733,1018,0,157,148,9,5,1,0
271949,1146,2,73,67,6,0,1,0
204807,443,11,51,44,7,16,1,0
61438,172,8,4,4,0,7,0,0
2608420,17756,2,1599,1003,596,18,0,0
14357,93,1,8,8,0,0,0,0
1796657,6819,3,391,383,8,11,0,0
53972,127,2,5,5,0,2,0,0
0,0,0,0,0,0,0,0,0
802846,6361,22,921,889,32,11,1,0
49570,329,4,51,0,51,4,0,0
0,0,0,0,0,0,0,0,0
180588,851,7,170,134,36,9,1,0
11958,76,2,4,4,0,2,1,0
0,0,0,0,0,0,0,0,0
0,0,0,0,0,0,0,0,0
574344,5987,15,1111,1098,13,20,0,0
142714,1539,6,251,227,24,9,1,0
38911,352,3,92,71,21,11,0,0
0,0,0,0,0,0,0,0,0
1243489,14207,5,751,719,32,3,1,0
182918,524,7,47,42,5,4,1,0
500365,1420,0,263,258,5,12,1,0
0,0,0,0,0,0,0,0,0
0,0,0,0,0,0,0,0,0
325893,2054,6,588,423,165,22,1,0
686883,1765,8,320,243,77,20,1,0
849028,4663,13,794,630,164,12,1,1
294798,697,4,115,109,6,0,1,0
0,0,0,0,0,0,0,0,0
349307,1823,6,324,295,29,38,1,0
208338,753,2,218,210,8,3,1,0
0,0,0,0,0,0,0,0,0
347853,3111,8,428,428,0,126,1,0
46890,317,10,40,38,2,3,1,0
400169,281,1,62,55,7,3,1,0
625309,3264,2,383,376,7,0,1,0
11595,89,0,2,2,0,0,0,0
54284,601,4,73,35,38,6,1,0
127375,1982,2,404,402,2,0,1,0
37447,498,4,83,81,2,3,1,0
679040,4060,9,402,378,24,20,0,0
364426,2074,7,130,127,3,13,0,0
0,0,0,0,0,0,0,0,0
52243,559,4,66,63,3,0,0,0
423219,1726,3,212,26,186,9,1,0
31627,111,4,15,15,0,0,0,0
718493,6838,9,1597,1457,140,192,1,0
118230,635,12,78,62,16,29,1,0
161562,2060,4,531,177,354,82,1,0
228676,339,0,17,12,5,0,1,0
77000,690,1,113,104,9,9,1,0
7244,28,0,0,0,0,0,0,0
11478,49,0,1,0,1,0,0,0
0,0,0,0,0,0,0,0,0
4466,64,0,6,6,0,0,0,0
621332,1847,7,165,159,6,5,1,0
540160,1897,7,168,148,20,7,1,0
138904,408,8,54,49,5,1,1,0
498224,748,5,10,8,2,2,1,0
407729,3647,5,261,256,5,5,1,0
65601,375,10,47,45,2,17,1,0
402893,947,7,94,84,10,5,1,0
0,0,0,0,0,0,0,0,0
0,0,0,0,0,0,0,0,0
1342454,3686,12,536,91,445,69,1,0
418548,662,8,58,53,5,5,1,0
349051,1411,4,187,179,8,17,1,0
194914,612,10,76,54,22,11,1,0
126731,228,3,7,3,4,1,0,0
412898,2480,10,444,404,40,19,1,0
0,0,0,0,0,0,0,0,0
0,0,0,0,0,0,0,0,0
0,0,0,0,0,0,0,0,0
117152,321,3,39,37,2,0,0,0
0,0,0,0,0,0,0,0,0
2976134,4694,8,622,606,16,6,1,0
459455,526,9,59,53,6,9,0,0
0,0,0,0,0,0,0,0,0
28360,45,0,4,1,3,0,0,0
804170,3090,2,815,812,3,1,0,0
231030,1154,2,110,92,18,4,0,0
0,0,0,0,0,0,0,0,0
1140445,8141,7,1795,1575,220,18,1,0
848140,8704,5,1287,1261,26,7,1,0
76920,303,3,16,16,0,21,0,0
160872,1996,10,503,487,16,13,1,0
630890,2846,7,310,286,24,10,1,0
0,0,0,0,0,0,0,0,0
13663,37,1,0,0,0,1,0,0
0,0,0,0,0,0,0,0,0
0,0,0,0,0,0,0,0,0
15494,235,0,71,69,2,0,1,0
0,0,0,0,0,0,0,0,0
274157,3065,8,404,383,21,17,1,1
82131,973,5,112,110,2,10,1,1
136244,437,2,106,94,12,5,1,0
28892,145,2,25,21,4,0,0,0
28892,145,2,25,21,4,0,0,0
0,0,0,0,0,0,0,0,0
0,0,0,0,0,0,0,0,0
7370,190,0,20,20,0,0,1,0
151939,1299,3,189,148,41,10,1,0
979,10,1,0,0,0,0,0,0
281141,3570,11,799,788,11,17,1,0
159574,2200,3,967,143,824,0,1,0
7847,71,6,3,2,1,0,0,0
0,0,0,0,0,0,0,0,0
311867,979,13,167,151,16,52,1,0
88896,350,13,35,25,10,15,0,0
111581,936,6,112,94,18,5,1,0
321223,2616,7,677,615,62,5,1,0
195288,1084,17,182,170,12,13,1,0
43262,365,6,37,36,1,1,1,0
0,0,0,0,0,0,0,0,0
273066,1691,10,267,245,22,12,1,0
211971,702,3,101,91,10,2,0,0
96446,339,6,64,56,8,4,0,0
147901,1435,3,427,418,9,1,1,0
0,0,0,0,0,0,0,0,0
0,0,0,0,0,0,0,0,0
23396,172,3,11,11,0,3,1,0
0,0,0,0,0,0,0,0,0
0,0,0,0,0,0,0,0,0
232821,2333,5,316,211,105,13,1,0
194189,1799,11,269,225,44,32,1,0
94815,740,9,151,115,36,23,1,0
42652,694,4,159,128,31,24,1,0
0,0,0,0,0,0,0,0,0
0,0,0,0,0,0,0,0,0
0,0,0,0,0,0,0,0,0
309244,1044,10,139,131,8,17,1,0
0,0,0,0,0,0,0,0,0
542169,1430,2,280,207,73,5,1,0
274838,214,0,21,5,16,5,1,0
1297585,3588,6,379,339,40,31,1,1
1720917,441,6,11,3,8,48,1,0
1759651,544,7,12,6,6,71,1,0
0,0,0,0,0,0,0,0,0
48394,458,5,42,40,2,1,1,0
21070,181,4,26,26,0,0,1,0
144636,2071,5,400,394,6,12,1,0
56107,693,5,149,144,5,15,1,0
640671,10521,13,887,877,10,98,1,1
43290,448,0,38,33,5,1,1,0
1292534,5725,2,577,563,14,1,0,0
102246,997,1,83,73,10,4,1,0
794240,2640,6,494,453,41,2,1,0
11722,180,1,5,1,4,0,1,0
14219,94,2,5,2,3,0,0,0
0,0,0,0,0,0,0,0,0
241462,1933,9,338,314,24,14,1,1
0,0,0,0,0,0,0,0,0
0,0,0,0,0,0,0,0,0
17582,239,4,24,24,0,6,1,0
6553,95,3,11,6,5,0,1,0
575136,1987,7,325,87,238,28,1,0
243887,746,9,131,83,48,10,1,0
0,0,0,0,0,0,0,0,0
97949,1207,4,151,125,26,19,0,0
779692,5221,6,994,977,17,41,1,0
481433,3434,7,711,694,17,21,1,0
601356,1812,7,196,185,11,18,1,0
3155311,4081,1,152,132,20,3,1,0
14268,96,2,6,5,1,1,0,0
0,0,0,0,0,0,0,0,0
0,0,0,0,0,0,0,0,0
0,0,0,0,0,0,0,0,0
1186793,3127,4,343,263,80,5,1,0
0,0,0,0,0,0,0,0,0
119088,670,8,84,82,2,8,1,0
0,0,0,0,0,0,0,0,0
96307,580,5,91,89,2,9,1,0
0,0,0,0,0,0,0,0,0
187761,3056,2,1420,267,1153,13,1,0
45921,513,3,150,105,45,3,1,0
40467,592,3,36,36,0,4,1,0
0,0,0,0,0,0,0,0,0
479719,1089,4,168,157,11,0,1,0
383333,309,3,11,6,5,0,1,0
298316,818,4,154,141,13,2,1,0
92033,180,3,21,10,11,1,1,0
230042,341,0,17,11,6,0,1,0
672111,5727,1,260,240,20,9,1,0
0,0,0,0,0,0,0,0,0
86594,1574,8,46,30,16,3,1,0
156207,1144,5,196,150,46,19,1,0
57073,298,5,44,34,10,15,0,0
0,0,0,0,0,0,0,0,0
0,0,0,0,0,0,0,0,0
1335746,2101,6,199,174,25,32,1,0
142468,985,3,197,102,95,4,0,0
1398185,917,5,97,91,6,0,1,0
1105949,165,7,3,3,0,0,1,0
0,0,0,0,0,0,0,0,0
54012,1115,2,253,239,14,9,0,0
42913,543,5,115,112,3,2,1,0
2051397,3828,5,239,238,1,1,1,0
1970304,3906,5,233,232,1,4,1,0
0,0,0,0,0,0,0,0,0
2170818,5955,7,628,566,62,2,1,0
1043328,3788,5,288,253,35,19,1,0
1165931,2310,5,363,355,8,18,1,0
0,0,0,0,0,0,0,0,0
574683,2673,2,267,243,24,2,1,0
0,0,0,0,0,0,0,0,0
0,0,0,0,0,0,0,0,0
178930,3092,3,828,793,35,27,1,0
7681,52,0,6,1,5,0,0,0
0,0,0,0,0,0,0,0,0
0,0,0,0,0,0,0,0,0
28276,538,2,109,104,5,0,0,0
1038189,1944,10,257,251,6,31,1,0
0,0,0,0,0,0,0,0,0
0,0,0,0,0,0,0,0,0
116544,851,6,183,160,23,8,1,0
240633,1486,9,157,148,9,16,1,0
113820,1373,9,322,37,285,9,1,0
78095,784,9,150,135,15,5,1,0
1267051,2582,15,726,707,19,17,1,0
1105440,1766,15,621,605,16,11,1,0
23215,400,3,116,110,6,0,1,0
126749,228,3,7,3,4,1,0,0
1243643,11820,7,1038,1023,15,7,0,0
0,0,0,0,0,0,0,0,0
99802,639,6,110,78,32,3,1,0
368393,579,0,117,90,27,11,1,0
1130998,1230,1,82,73,9,0,1,0
94480,818,1,71,65,6,0,1,0
43666,328,6,31,23,8,3,1,0
25629,260,6,54,52,2,3,1,0
859033,552,10,58,57,1,3,1,0
33544,166,6,6,6,0,6,0,0
132576,1163,0,265,248,17,3,1,0
39310,485,0,154,143,11,0,1,0
0,0,0,0,0,0,0,0,0
199868,1249,8,210,116,94,10,1,0
67711,273,3,12,10,2,2,1,0
27753,42,0,2,1,1,0,0,0
27680,42,0,2,1,1,0,0,0
538510,4520,9,294,168,126,57,1,0
0,0,0,0,0,0,0,0,0
0,0,0,0,0,0,0,0,0
162757,856,10,109,93,16,4,1,0
104749,319,8,56,47,9,3,1,0
813841,3597,1,545,387,158,4,1,0
0,0,0,0,0,0,0,0,0
738200,1658,4,183,179,4,2,1,0
40421,63,1,0,0,0,0,0,0
246310,1074,6,136,108,28,19,1,0
109539,970,0,350,347,3,1,1,0
96711,570,4,192,153,39,3,0,0
127221,766,0,0,0,0,4,0,0
85774,361,9,32,26,6,14,1,0
267216,740,6,87,67,20,7,1,0
0,0,0,0,0,0,0,0,0
193893,1455,12,231,165,66,3,1,0
59063,969,3,396,353,43,152,0,0
385858,7454,3,1869,1863,6,4,1,0
18530,259,3,35,32,3,3,1,0
175871,1655,6,207,158,49,11,1,0
0,0,0,0,0,0,0,0,0
144320,592,8,30,21,9,12,1,0
0,0,0,0,0,0,0,0,0
2375767,1012,1,74,51,23,3,1,0
0,0,0,0,0,0,0,0,0
61801,317,4,35,33,2,2,1,0
316917,2585,2,353,349,4,55,1,0
196170,1552,4,384,382,2,22,1,0
431721,1562,11,460,446,14,10,0,0
5171407,1722,6,76,73,3,43,0,0
0,0,0,0,0,0,0,0,0
591204,2497,2,223,116,107,6,1,0
0,0,0,0,0,0,0,0,0
0,0,0,0,0,0,0,0,0
114238,1258,2,243,238,5,9,1,0
245599,2265,10,467,352,115,22,1,0
440570,2984,5,703,673,30,0,1,0
680963,818,3,130,126,4,3,1,0
827480,2680,10,535,111,424,24,1,0
418147,657,8,58,53,5,5,1,0
1179158,14453,3,1125,1087,38,15,1,0
193906,1610,3,185,179,6,13,1,0
439777,1044,4,87,67,20,3,1,0
500605,1811,1,154,113,41,0,1,0
218720,1936,10,434,400,34,13,1,0
0,0,0,0,0,0,0,0,0
82455,821,8,166,138,28,2,1,0
177837,1079,14,177,157,20,34,1,0
0,0,0,0,0,0,0,0,0
275855,3718,5,489,393,96,7,1,0
0,0,0,0,0,0,0,0,0
254515,987,5,153,150,3,1,1,0
0,0,0,0,0,0,0,0,0
512826,3063,1,759,674,85,21,1,0
234352,406,0,17,11,6,0,1,0
98831,1451,2,452,448,4,3,1,0
66859,409,3,91,88,3,0,1,0
51862,1246,2,414,409,5,1,1,0
140460,1659,5,217,200,17,2,1,0
534055,1493,5,85,76,9,7,1,0
45,3,0,0,0,0,0,0,0
0,0,0,0,0,0,0,0,0
0,0,0,0,0,0,0,0,0
289207,1398,4,242,238,4,3,1,0
210590,369,7,34,30,4,5,1,0
134373,1436,6,286,271,15,50,1,0
75306,537,1,133,129,4,1,1,0
18891,222,1,42,38,4,1,1,0
490169,3957,10,422,408,14,103,1,0
0,0,0,0,0,0,0,0,0
0,0,0,0,0,0,0,0,0
1084321,3369,9,967,960,7,9,1,0
834996,3004,8,915,908,7,6,1,0
739568,3922,1,176,163,13,2,1,0
0,0,0,0,0,0,0,0,0
55922,845,1,155,66,89,0,0,0
168912,558,5,52,47,5,0,1,0
0,0,0,0,0,0,0,0,0
231720,1504,3,297,283,14,9,1,0
0,0,0,0,0,0,0,0,0
19692,34,0,1,1,0,0,1,0
128132,1486,3,327,319,8,1,1,0
9461,95,2,3,3,0,0,0,0
462522,2367,7,620,553,67,22,1,0
358113,2022,4,256,185,71,17,1,0
123387,730,2,109,76,33,0,1,0
162306,471,12,40,33,7,27,1,0
305881,2428,0,207,172,35,5,1,0
663250,2448,18,326,282,44,31,1,1
399329,905,7,118,92,26,7,1,0
14671,101,2,7,7,0,0,0,0
0,0,0,0,0,0,0,0,0
1307168,3312,12,156,154,2,30,1,0
229194,338,0,17,8,9,0,1,0
222391,1036,4,198,169,29,10,1,0
144493,265,4,27,11,16,5,1,0
128440,1402,3,209,189,20,3,0,0
0,0,0,0,0,0,0,0,0
0,0,0,0,0,0,0,0,0
329593,2003,1,479,469,10,6,1,0
153093,662,1,442,432,10,6,1,0
229108,881,3,75,71,4,6,1,0
312658,861,1,4,1,3,3,0,0
0,0,0,0,0,0,0,0,0
85310,802,5,113,109,4,5,1,0
58355,387,3,32,26,6,0,1,0
0,0,0,0,0,0,0,0,0
124930,1822,2,622,620,2,6,0,0
27554,137,2,20,18,2,6,0,0
0,0,0,0,0,0,0,0,0
0,0,0,0,0,0,0,0,0
0,0,0,0,0,0,0,0,0
1146937,4336,3,1069,1051,18,3,0,0
0,0,0,0,0,0,0,0,0
0,0,0,0,0,0,0,0,0
0,0,0,0,0,0,0,0,0
43939,382,7,55,52,3,0,1,0
38907,561,6,100,86,14,6,0,0
0,0,0,0,0,0,0,0,0
243965,2024,8,286,182,104,6,1,0
392844,2883,3,377,362,15,3,1,0
115695,925,4,79,74,5,5,1,0
1906201,3706,7,511,460,51,25,1,0
569957,946,3,2,0,2,9,1,0
0,0,0,0,0,0,0,0,0
960078,2629,8,329,283,46,66,1,0
1033851,1847,2,344,290,54,1,1,0
548785,1627,5,353,299,54,8,1,0
658096,4171,7,666,655,11,6,0,0
639023,3242,8,833,548,285,26,1,1
139671,1073,12,243,179,64,2,1,0
188426,1962,7,544,533,11,29,1,0
167376,770,6,81,62,19,11,1,0
0,0,0,0,0,0,0,0,0
22798,341,7,51,27,24,2,1,0
78906,296,11,15,15,0,26,1,0
85662,362,12,22,21,1,30,1,0
666966,3799,12,565,521,44,31,1,0
212602,1563,8,224,217,7,84,1,0
216177,2168,3,83,33,50,62,1,0
112371,679,11,56,47,9,14,0,0
197215,989,8,217,187,30,27,1,0
5198541,9901,14,139,127,12,62,1,0
102282,532,3,26,12,14,3,1,0
117326,835,8,211,157,54,19,1,0
71390,627,3,245,209,36,6,1,0
736500,5071,10,776,748,28,7,1,1
27293,731,4,192,190,2,0,1,0
7287,100,5,18,17,1,2,1,0
90777,868,3,216,25,191,0,0,0
0,0,0,0,0,0,0,0,0
0,0,0,0,0,0,0,0,0
518195,7743,2,1059,1053,6,7,1,0
166312,1558,14,286,258,28,10,1,0
302193,1565,2,248,228,20,0,1,0
302193,1565,2,248,227,21,0,1,0
808734,5109,3,205,196,9,3,1,0
0,0,0,0,0,0,0,0,0
609757,1949,6,423,408,15,6,1,0
25723,428,2,52,50,2,6,1,0
90285,683,4,128,82,46,0,1,0
316220,2080,2,150,141,9,34,1,0
0,0,0,0,0,0,0,0,0
0,0,0,0,0,0,0,0,0
1996,60,0,15,5,10,0,0,0
859593,3603,8,269,253,16,17,1,0
0,0,0,0,0,0,0,0,0
649178,1292,7,84,68,16,16,1,0
586528,523,6,49,37,12,16,1,0
0,0,0,0,0,0,0,0,0
907496,5978,4,654,627,27,20,1,0
246526,1332,4,209,206,3,22,1,0
247003,1229,8,114,79,35,7,1,0
0,0,0,0,0,0,0,0,0
122257,2291,2,816,791,25,9,0,0
2621,38,1,4,4,0,0,0,0
496515,1769,3,297,272,25,7,0,0
73752,226,1,25,16,9,2,0,0
0,0,0,0,0,0,0,0,0
579979,4323,2,911,900,11,38,1,0
0,0,0,0,0,0,0,0,0
998010,4969,2,337,272,65,4,1,0
197292,2418,4,369,368,1,11,1,0
898305,5937,8,1862,1852,10,10,1,0
167607,569,5,39,29,10,9,1,0
0,0,0,0,0,0,0,0,0
160625,879,1,181,160,21,2,1,0
1719019,431,6,11,3,8,47,1,0
1759646,544,7,12,6,6,71,1,0
0,0,0,0,0,0,0,0,0
1216924,5521,8,387,288,99,19,1,0
0,0,0,0,0,0,0,0,0
0,0,0,0,0,0,0,0,0
53214,1012,2,238,234,4,8,1,0
314227,817,9,118,108,10,6,1,0
281849,265,7,22,19,3,6,0,0
313585,1140,6,94,78,16,1,1,0
0,0,0,0,0,0,0,0,0
65343,536,5,250,210,40,0,0,0
8061,70,6,3,2,1,0,0,0
421,6,0,0,0,0,0,0,0
966202,712,9,105,95,10,2,1,0
42697,466,8,105,102,3,2,1,0
0,0,0,0,0,0,0,0,0
0,0,0,0,0,0,0,0,0
0,0,0,0,0,0,0,0,0
0,0,0,0,0,0,0,0,0
0,0,0,0,0,0,0,0,0
0,0,0,0,0,0,0,0,0
359992,3653,4,752,702,50,26,1,0
66816,324,4,49,48,1,5,1,0
1424722,8511,2,1046,847,199,12,1,0
1353288,1743,6,196,125,71,36,1,0
258466,1590,6,153,108,45,36,1,0
54911,950,1,179,156,23,0,1,0
0,0,0,0,0,0,0,0,0
97655,441,0,74,54,20,1,1,0
212231,1270,8,352,347,5,3,1,0
0,0,0,0,0,0,0,0,0
283231,2837,7,415,408,7,31,1,0
37993,327,2,52,46,6,5,1,0
0,0,0,0,0,0,0,0,0
1323337,4418,7,940,845,95,22,1,0
0,0,0,0,0,0,0,0,0
362856,677,2,98,98,0,0,1,1
0,0,0,0,0,0,0,0,0
0,0,0,0,0,0,0,0,0
136948,911,14,145,138,7,9,1,0
153006,789,7,68,55,13,5,1,0
111465,2369,1,432,427,5,1,1,0
27812,388,1,20,19,1,1,1,0
62491,491,5,122,105,17,2,1,0
195326,4716,0,401,399,2,0,0,0
147867,1094,5,98,74,24,5,1,0
0,0,0,0,0,0,0,0,0
19876,33,0,1,1,0,0,1,0
80196,512,4,30,30,0,13,1,0
0,0,0,0,0,0,0,0,0
0,0,0,0,0,0,0,0,0
1735005,3669,7,12,9,3,2,0,0
554582,1025,5,168,163,5,7,1,0
229422,338,0,17,11,6,0,1,0
493344,1726,5,268,246,22,20,1,0
858424,2983,8,459,369,90,2,1,0
28751,131,5,8,7,1,1,0,0
199064,1433,4,277,262,15,3,0,0
0,0,0,0,0,0,0,0,0
1192469,4176,16,972,61,911,42,1,0
0,0,0,0,0,0,0,0,0
0,0,0,0,0,0,0,0,0
0,0,0,0,0,0,0,0,0
0,0,0,0,0,0,0,0,0
0,0,0,0,0,0,0,0,0
83416,1025,2,157,62,95,5,1,0
697253,5975,12,1135,870,265,53,1,0
117766,350,12,8,8,0,13,0,0
173789,614,3,125,123,2,7,1,0
0,0,0,0,0,0,0,0,0
591972,6004,8,620,579,41,17,1,0
75214,352,14,39,15,24,10,1,0
59921,287,13,32,17,15,10,1,0
0,0,0,0,0,0,0,0,0
0,0,0,0,0,0,0,0,0
0,0,0,0,0,0,0,0,0
0,0,0,0,0,0,0,0,0
229809,1179,14,197,182,15,14,1,0
89026,875,9,259,257,2,10,1,0
41788,304,9,50,48,2,9,1,0
0,0,0,0,0,0,0,0,0
215115,1522,6,319,284,35,1,1,0
0,0,0,0,0,0,0,0,0
78892,603,7,75,47,28,2,1,0
0,0,0,0,0,0,0,0,0
0,0,0,0,0,0,0,0,0
289107,1084,9,133,127,6,8,0,0
162287,2473,1,478,456,22,3,1,0
344917,2344,9,323,311,12,18,1,0
569337,1883,3,298,149,149,14,1,0
79643,112,1,10,7,3,2,0,0
493961,2602,6,346,294,52,19,0,0
260718,936,0,74,67,7,0,0,0
16272,100,3,3,3,0,2,1,0
472580,1864,7,124,95,29,3,1,0
115436,745,0,33,23,10,0,0,0
57787,13,0,1,1,0,0,0,0
0,0,0,0,0,0,0,0,0
1165135,2332,10,319,305,14,32,1,0
0,0,0,0,0,0,0,0,0
0,0,0,0,0,0,0,0,0
0,0,0,0,0,0,0,0,0
570125,4913,6,250,214,36,3,1,0
0,0,0,0,0,0,0,0,0
0,0,0,0,0,0,0,0,0
282034,1335,1,136,126,10,2,1,0
63857,208,2,35,25,10,2,1,0
0,0,0,0,0,0,0,0,0
4401774,7147,10,261,206,55,597,1,0
1534178,2129,9,96,79,17,119,1,0
164302,2156,1,254,230,24,46,1,0
1035518,4333,15,871,807,64,31,1,0
171170,1455,3,171,171,0,10,1,0
152234,1180,3,206,181,25,33,1,0
0,0,0,0,0,0,0,0,0
127385,1268,4,111,99,12,8,1,1
530153,1344,7,283,267,16,15,1,0
0,0,0,0,0,0,0,0,0
0,0,0,0,0,0,0,0,0
0,0,0,0,0,0,0,0,0
0,0,0,0,0,0,0,0,0
368371,3820,6,1664,952,712,7,0,0
0,0,0,0,0,0,0,0,0
134048,1058,3,278,264,14,1,1,0
54521,699,2,139,137,2,0,0,0
5291,65,2,13,12,1,0,0,0
575921,6699,11,659,637,22,6,1,1
263679,2471,4,337,327,10,3,1,0
2955834,3383,9,704,596,108,16,1,0
472683,1129,9,210,174,36,15,1,0
253892,3316,1,330,327,3,1,1,0
30240,241,1,24,21,3,1,1,0
175419,1106,2,87,25,62,3,0,0
428449,2335,11,450,414,36,31,1,0
923231,1489,2,233,202,31,2,1,0
19679,32,0,1,1,0,0,1,0
0,0,0,0,0,0,0,0,0
0,0,0,0,0,0,0,0,0
266086,3677,1,1024,900,124,128,1,0
0,0,0,0,0,0,0,0,0
154112,1290,9,336,334,2,7,1,0
0,0,0,0,0,0,0,0,0
0,0,0,0,0,0,0,0,0
193256,916,2,43,43,0,8,1,0
79247,370,3,24,23,1,5,1,0
0,0,0,0,0,0,0,0,0
616851,2135,6,441,367,74,8,0,1
0,0,0,0,0,0,0,0,0
0,0,0,0,0,0,0,0,0
111721,1417,6,295,269,26,7,1,0
13321,132,7,10,10,0,2,0,0
0,0,0,0,0,0,0,0,0
594855,1863,8,328,45,283,7,1,0
391443,1484,7,269,260,9,5,1,0
0,0,0,0,0,0,0,0,0
311694,3500,3,555,531,24,0,1,0
143504,1569,3,188,176,12,0,1,0
119770,1351,12,119,70,49,49,1,0
2347634,26331,5,1992,1676,316,15,0,0
508082,2024,4,389,379,10,14,1,0
0,0,0,0,0,0,0,0,0
248856,1789,8,74,63,11,9,1,0
248856,1789,8,74,63,11,9,1,0
57437,728,6,52,45,7,0,1,0
375098,3622,5,1391,1246,145,4,1,0
37397,564,0,29,15,14,0,1,0
37397,564,0,29,18,11,0,1,0
0,0,0,0,0,0,0,0,0
311942,1156,0,145,132,13,3,1,0
228754,2297,12,474,421,53,42,1,0
61411,578,10,128,124,4,18,1,0
0,0,0,0,0,0,0,0,0
0,0,0,0,0,0,0,0,0
152174,1101,7,149,135,14,5,1,0
0,0,0,0,0,0,0,0,0
140534,355,4,37,32,5,12,1,0
111283,144,4,14,10,4,1,1,0
0,0,0,0,0,0,0,0,0
166717,620,6,162,23,139,2,1,0
0,0,0,0,0,0,0,0,0
287357,4342,3,431,376,55,1,1,0
112624,1160,6,290,253,37,10,1,0
0,0,0,0,0,0,0,0,0
437224,1579,11,142,113,29,34,1,0
406254,1944,6,459,387,72,28,0,0
409969,1977,6,459,396,63,26,0,0
883138,953,7,124,103,21,0,1,0
883114,953,7,124,101,23,0,1,0
108940,1807,3,356,298,58,14,0,0
155966,1070,7,183,161,22,23,1,0
0,0,0,0,0,0,0,0,0
0,0,0,0,0,0,0,0,0
355513,1615,2,106,92,14,2,0,0
218392,685,7,119,104,15,0,1,0
0,0,0,0,0,0,0,0,0
0,0,0,0,0,0,0,0,0
263427,600,7,80,71,9,6,1,0
2319,19,0,0,0,0,0,0,0
0,0,0,0,0,0,0,0,0
274683,3428,3,2645,2643,2,364,1,0
177706,885,7,91,76,15,1,1,0
3068,67,1,4,4,0,0,0,0
98855,1740,1,399,340,59,10,1,0
0,0,0,0,0,0,0,0,0
0,0,0,0,0,0,0,0,0
295879,1764,4,210,200,10,9,1,0
262123,1017,3,141,118,23,67,1,0
197367,291,3,52,40,12,3,1,0
654895,2779,5,153,5,148,8,1,0
328849,130,2,7,6,1,0,1,0
1518674,2355,6,663,656,7,26,1,0
15796,149,2,23,21,2,0,1,1
1014435,2415,7,331,275,56,14,1,0
45553,258,6,9,3,6,6,0,0
0,0,0,0,0,0,0,0,0
219612,1292,15,220,201,19,28,1,0
446238,2848,1,328,322,6,79,1,0
0,0,0,0,0,0,0,0,0
289263,1391,1,246,171,75,12,1,0
34805,188,4,26,15,11,3,1,0
30200,144,3,7,5,2,0,1,0
20494,87,3,3,3,0,0,1,0
101457,841,12,179,144,35,4,1,0
0,0,0,0,0,0,0,0,0
229364,338,0,17,14,3,0,1,0
0,0,0,0,0,0,0,0,0
182146,996,9,113,19,94,1,1,0
0,0,0,0,0,0,0,0,0
461120,3049,6,740,712,28,9,1,0
311487,1586,6,268,235,33,6,1,0
10542,115,0,5,5,0,3,1,0
0,0,0,0,0,0,0,0,0
252109,1232,8,154,148,6,15,1,0
130558,625,9,120,106,14,4,1,0
179438,1466,12,183,170,13,21,1,0
179280,1299,9,277,265,12,13,1,0
179280,1299,9,277,265,12,13,1,0
0,0,0,0,0,0,0,0,0
272134,1522,6,197,181,16,6,1,0
127607,284,2,25,24,1,1,1,0
185885,1210,6,149,133,16,5,1,0
118720,417,6,58,34,24,3,1,0
0,0,0,0,0,0,0,0,0
180776,1299,9,144,132,12,13,1,0
0,0,0,0,0,0,0,0,0
99583,701,6,265,262,3,1,1,0
427493,666,3,113,108,5,0,1,0
0,0,0,0,0,0,0,0,0
0,0,0,0,0,0,0,0,0
499875,2765,10,545,432,113,5,1,0
34480,73,5,0,0,0,2,1,0
64793,686,6,125,52,73,1,1,0
323192,2882,2,549,547,2,4,1,0
128569,308,3,20,18,2,6,1,0
102299,692,9,114,100,14,29,1,0
23705,159,4,28,21,7,2,1,0
9323,142,4,16,15,1,1,1,0
8795,123,5,20,16,4,1,1,0
62905,676,6,51,19,32,4,1,0
0,0,0,0,0,0,0,0,0
0,0,0,0,0,0,0,0,0
17510,80,1,18,18,0,0,0,0
348839,3431,15,750,713,37,146,1,0
1234663,11433,6,860,446,414,39,1,0
203680,955,5,90,58,32,10,1,0
508113,3690,4,480,468,12,5,1,0
2078499,5826,8,686,670,16,16,1,0
0,0,0,0,0,0,0,0,0
0,0,0,0,0,0,0,0,0
79187,1193,2,262,247,15,2,1,0
2074357,2481,9,328,313,15,15,1,0
0,0,0,0,0,0,0,0,0
486185,1553,4,132,129,3,6,1,0
65263,379,4,49,37,12,4,1,0
0,0,0,0,0,0,0,0,0
0,0,0,0,0,0,0,0,0
383066,1388,5,42,41,1,0,1,0
94844,228,2,24,23,1,0,1,0
150918,724,2,179,119,60,3,1,0
571064,3673,10,433,383,50,18,1,1
0,0,0,0,0,0,0,0,0
859408,860,6,204,103,101,12,1,0
109157,716,8,106,103,3,8,0,0
0,0,0,0,0,0,0,0,0
124085,317,1,19,2,17,0,1,0
191841,83,0,6,6,0,2,1,0
769048,3164,10,467,326,141,41,1,0
735677,3120,10,466,326,140,37,1,0
86005,684,9,18,13,5,13,1,0
85630,1067,6,152,140,12,3,1,0
0,0,0,0,0,0,0,0,0
0,0,0,0,0,0,0,0,0
458684,3142,4,687,641,46,13,0,0
66907,444,4,41,33,8,0,0,0
0,0,0,0,0,0,0,0,0
28699,320,1,18,10,8,0,1,0
0,0,0,0,0,0,0,0,0
92468,1041,2,60,33,27,2,1,0
366145,2827,11,180,165,15,70,1,0
150591,2024,9,339,320,19,74,1,1
132968,1235,3,258,174,84,10,1,0
67424,291,2,41,30,11,3,1,0
92476,1217,4,149,137,12,10,1,0
3094,47,1,2,1,1,0,1,0
77801,559,6,71,66,5,0,1,0
38736,303,7,31,29,2,29,1,0
12653,120,6,19,19,0,0,1,0
0,0,0,0,0,0,0,0,0
57135,633,8,97,77,20,4,0,0
0,0,0,0,0,0,0,0,0
0,0,0,0,0,0,0,0,0
893537,1727,6,144,131,13,39,1,0
91233,1011,0,131,128,3,3,1,0
0,0,0,0,0,0,0,0,0
114564,530,8,94,86,8,0,1,0
4884,80,1,19,19,0,1,0,0
0,0,0,0,0,0,0,0,0
0,0,0,0,0,0,0,0,0
0,0,0,0,0,0,0,0,0
0,0,0,0,0,0,0,0,0
432128,1658,1,297,286,11,12,1,1
129176,1152,4,236,225,11,0,1,0
423874,3387,2,737,706,31,26,1,0
0,0,0,0,0,0,0,0,0
61948,402,9,73,71,2,2,1,0
198826,279,4,9,6,3,8,1,0
1243019,8781,6,542,409,133,28,1,0
8747,87,0,4,1,3,3,0,0
823637,1580,2,164,10,154,15,1,0
39526,810,4,157,130,27,0,1,0
501796,1398,3,120,120,0,20,1,0
472743,1538,7,266,233,33,7,1,0
146055,1506,5,169,94,75,0,1,0
235133,1177,5,114,111,3,15,0,0
69387,1742,4,275,273,2,2,1,0
159041,1122,8,298,193,105,34,1,0
159236,1458,6,278,239,39,6,1,0
94184,833,5,157,131,26,8,1,0
417532,1483,4,325,318,7,0,1,0
379163,2394,6,291,283,8,5,1,0
244056,1776,6,267,234,33,7,1,0
18470,160,5,20,7,13,0,1,0
0,0,0,0,0,0,0,0,0
142338,1275,7,420,399,21,5,1,0
37235,236,12,10,10,0,9,1,0
11408,133,3,23,10,13,5,1,0
329371,5173,8,935,613,322,137,1,0
80066,1243,5,288,260,28,9,1,0
34609,266,3,42,38,4,0,1,0
0,0,0,0,0,0,0,0,0
297525,2995,7,205,167,38,8,1,0
213963,2360,5,19,16,3,5,1,0
0,0,0,0,0,0,0,0,0
0,0,0,0,0,0,0,0,0
0,0,0,0,0,0,0,0,0
0,0,0,0,0,0,0,0,0
239685,1376,4,221,206,15,6,0,0
854018,2216,4,210,204,6,15,1,0
154175,270,3,4,4,0,6,1,0
205136,2042,3,363,352,11,1,1,0
248708,904,6,83,56,27,10,1,0
0,0,0,0,0,0,0,0,0
89168,561,10,95,90,5,65,1,0
29000,308,3,67,61,6,4,0,0
90923,797,6,157,129,28,0,1,0
256996,1205,6,153,142,11,6,1,0
70777,635,3,71,53,18,9,1,0
0,0,0,0,0,0,0,0,0
0,0,0,0,0,0,0,0,0
0,0,0,0,0,0,0,0,0
0,0,0,0,0,0,0,0,0
342116,2079,5,315,144,171,11,1,0
0,0,0,0,0,0,0,0,0
138658,588,5,162,145,17,1,1,0
18062,116,3,7,7,0,0,0,0
92593,427,5,71,71,0,2,1,0
895018,961,7,96,90,6,1,1,0
855733,807,8,106,98,8,1,1,0
125491,1141,5,235,205,30,11,1,0
17996,339,0,49,45,4,1,0,0
68257,629,7,86,83,3,0,1,0
11698,175,7,33,31,2,0,1,0
0,0,0,0,0,0,0,0,0
515840,2216,5,463,420,43,29,0,0
0,0,0,0,0,0,0,0,0
0,0,0,0,0,0,0,0,0
0,0,0,0,0,0,0,0,0
940691,2498,9,305,284,21,9,1,0
139543,2026,5,214,186,28,7,1,0
25873,295,5,67,51,16,0,1,0
804666,2110,6,291,275,16,20,1,0
245521,484,7,6,5,1,5,0,0
360288,867,8,68,68,0,8,1,0
0,0,0,0,0,0,0,0,0
0,0,0,0,0,0,0,0,0
127175,1860,4,624,565,59,20,0,0
521072,2649,9,524,473,51,23,1,0
159816,1229,5,271,252,19,18,1,0
11871,222,2,44,40,4,0,1,0
129337,965,5,217,205,12,12,0,0
0,0,0,0,0,0,0,0,0
0,0,0,0,0,0,0,0,0
122289,1164,5,123,105,18,4,1,0
176117,1060,8,74,57,17,23,1,0
104679,423,3,38,23,15,14,1,0
0,0,0,0,0,0,0,0,0
246087,1784,13,156,133,23,248,0,0
0,0,0,0,0,0,0,0,0
0,0,0,0,0,0,0,0,0
0,0,0,0,0,0,0,0,0
244917,1461,4,204,12,192,6,0,0
8844,100,0,6,6,0,0,0,0
1878350,9035,5,2114,2104,10,74,1,0
289602,354,0,17,13,4,2,1,0
1003613,3639,7,840,833,7,20,1,0
76807,990,2,164,160,4,7,1,0
0,0,0,0,0,0,0,0,0
0,0,0,0,0,0,0,0,0
0,0,0,0,0,0,0,0,0
0,0,0,0,0,0,0,0,0
0,0,0,0,0,0,0,0,0
310194,1342,2,261,252,9,3,0,0
41435,263,1,35,30,5,4,1,0
45809,516,3,138,138,0,2,0,0
0,0,0,0,0,0,0,0,0
0,0,0,0,0,0,0,0,0
42534,518,6,122,120,2,2,1,0
97881,861,0,142,100,42,11,1,0
116427,1227,8,302,286,16,6,1,0
23318,101,6,10,10,0,4,0,0
0,0,0,0,0,0,0,0,0
31108,318,4,19,19,0,6,1,0
0,0,0,0,0,0,0,0,0
314564,811,1,92,88,4,0,1,0
149858,462,2,23,23,0,0,1,0
111028,1058,3,236,186,50,5,1,0
569,7,0,0,0,0,0,0,0
1014764,6694,0,331,316,15,2,1,0
0,0,0,0,0,0,0,0,0
446539,1045,7,119,112,7,6,1,0
14750,101,2,7,7,0,0,0,0
249013,2727,6,305,266,39,11,1,0
89354,285,6,35,28,7,12,1,0
78862,566,5,89,64,25,2,1,0
175876,1424,13,283,281,2,3,0,1
565048,329,4,64,60,4,3,1,0
554636,177,1,15,10,5,5,1,0
37327,328,7,29,29,0,0,1,0
3788,45,6,1,0,1,0,0,0
0,0,0,0,0,0,0,0,0
0,0,0,0,0,0,0,0,0
0,0,0,0,0,0,0,0,0
146776,1039,3,151,151,0,6,1,0
12492,114,2,18,17,1,5,1,0
0,0,0,0,0,0,0,0,0
88145,600,6,112,110,2,3,1,0
191379,83,0,6,6,0,2,1,0
134495,1617,7,287,273,14,12,0,0
0,0,0,0,0,0,0,0,0
0,0,0,0,0,0,0,0,0
337631,1941,9,318,299,19,5,0,0
0,0,0,0,0,0,0,0,0
185131,2046,4,201,193,8,9,0,0
129590,553,5,78,70,8,15,1,0
103922,158,6,2,2,0,11,0,0
299667,3655,12,647,608,39,164,0,0
228072,1099,5,136,123,13,5,1,0
548651,5154,10,850,827,23,21,1,1
1004524,2018,8,295,280,15,110,1,0
425265,674,8,59,46,13,5,1,0
199555,1197,8,303,279,24,0,1,0
814501,1406,8,159,67,92,9,1,0
0,0,0,0,0,0,0,0,0
1632013,10114,5,1076,996,80,258,1,0
552457,423,1,37,14,23,7,1,0
35438,649,1,194,184,10,3,1,0
1175218,3599,3,962,591,371,227,1,0
47276,174,5,6,0,6,7,1,0
62886,858,4,197,119,78,13,1,0
0,0,0,0,0,0,0,0,0
0,0,0,0,0,0,0,0,0
575781,2196,4,559,367,192,11,1,0
6832,78,4,4,3,1,0,0,0
0,0,0,0,0,0,0,0,0
382637,3906,5,363,355,8,6,1,0
86525,691,4,84,77,7,3,1,0
313807,1529,8,194,159,35,18,1,0
0,0,0,0,0,0,0,0,0
103172,1074,3,168,155,13,7,1,0
109937,926,3,145,112,33,2,1,0
21891,253,3,49,48,1,0,1,0
79845,1359,7,327,323,4,4,1,0
36691,777,4,250,247,3,2,1,0
21946,35,0,1,1,0,0,1,0
441594,5343,4,1569,1514,55,1,1,0
0,0,0,0,0,0,0,0,0
51087,750,13,192,192,0,12,1,0
92618,705,5,229,49,180,2,1,0
90333,261,0,48,24,24,0,1,1
1062354,409,2,38,34,4,0,1,0
9989,122,3,10,10,0,1,1,0
0,0,0,0,0,0,0,0,0
5108862,2154,7,281,236,45,26,1,0
504492,3863,6,752,722,30,18,0,1
903516,3052,9,392,315,77,34,1,0
261973,958,6,192,123,69,17,1,0
144130,1426,7,133,128,5,11,0,0
8764,66,1,8,8,0,0,1,0
184370,1866,10,502,484,18,29,1,0
0,0,0,0,0,0,0,0,0
23441,37,0,2,1,1,0,1,0
0,0,0,0,0,0,0,0,0
384388,3409,5,723,710,13,11,1,0
141013,1837,9,234,207,27,6,1,0
239389,1919,7,78,67,11,10,1,0
239387,1919,7,78,64,14,10,1,0
0,0,0,0,0,0,0,0,0
0,0,0,0,0,0,0,0,0
221765,1526,3,247,174,73,3,0,0
69186,260,3,37,29,8,3,0,0
101332,540,5,54,53,1,3,1,0
0,0,0,0,0,0,0,0,0
0,0,0,0,0,0,0,0,0
52871,414,0,96,93,3,0,0,0
0,0,0,0,0,0,0,0,0
43042,355,7,75,72,3,15,1,0
0,0,0,0,0,0,0,0,0
0,0,0,0,0,0,0,0,0
197283,1560,2,249,248,1,32,1,0
0,0,0,0,0,0,0,0,0
5033,55,1,4,3,1,1,0,0
122609,675,8,119,119,0,19,0,0
863618,2302,5,188,150,38,4,1,0
0,0,0,0,0,0,0,0,0
0,0,0,0,0,0,0,0,0
4278247,2709,7,443,385,58,16,1,1
167383,4224,3,751,747,4,0,1,0
172654,1219,2,122,97,25,0,1,0
146263,855,2,70,62,8,4,1,0
180070,945,4,147,99,48,9,0,0
784139,3270,6,158,143,15,21,0,0
654409,2777,7,244,203,41,5,1,0
119600,1273,5,209,206,3,2,1,0
187535,1125,6,231,214,17,9,1,0
0,0,0,0,0,0,0,0,0
23176,40,0,3,1,2,0,1,0
0,0,0,0,0,0,0,0,0
158272,1168,5,252,224,28,28,0,0
612305,5390,8,666,651,15,216,0,0
181339,1177,7,301,267,34,11,1,0
402055,3962,12,350,241,109,1,1,0
0,0,0,0,0,0,0,0,0
654546,3363,5,156,68,88,9,1,0
3597652,3631,7,497,489,8,26,1,0
0,0,0,0,0,0,0,0,0
484968,6058,1,998,997,1,182,1,0
179664,2021,7,351,319,32,19,1,0
0,0,0,0,0,0,0,0,0
42198,484,0,261,257,4,0,1,0
16110,148,2,20,16,4,1,1,0
17189,199,6,16,16,0,2,0,0
7241,115,6,15,15,0,1,0,0
44838,734,0,143,132,11,0,0,0
0,0,0,0,0,0,0,0,0
122050,856,8,162,146,16,12,1,0
1576,11,0,1,1,0,0,0,0
671408,1255,11,201,196,5,36,1,0
597609,589,12,61,53,8,38,1,0
2169,38,2,5,4,1,0,1,0
0,0,0,0,0,0,0,0,0
288436,2006,5,364,353,11,10,1,0
1741050,1588,8,198,173,25,9,1,0
13315,186,5,18,16,2,2,1,0
441016,6976,4,2673,2597,76,36,1,0
11287,111,6,9,8,1,0,1,0
955225,1474,9,216,191,25,22,1,0
66189,389,4,79,68,11,3,1,0
0,0,0,0,0,0,0,0,0
1429182,737,4,5,1,4,2,1,0
607632,1961,1,49,46,3,12,1,0
323397,1318,7,99,81,18,52,0,0
176212,608,11,7,4,3,5,0,0
226392,1509,10,205,196,9,18,1,0
739518,2501,5,820,812,8,12,1,0
200543,987,6,92,75,17,16,1,0
0,0,0,0,0,0,0,0,0
3125116,13644,6,1044,1005,39,5,1,0
332866,2357,12,63,10,53,10,1,0
824129,2619,10,323,68,255,42,1,0
0,0,0,0,0,0,0,0,0
66307,528,6,28,24,4,29,1,0
73122,483,7,89,78,11,3,1,0
363328,2848,4,274,253,21,30,1,0
97465,256,5,17,16,1,2,0,0
222656,3548,12,627,624,3,9,1,0
31001,260,8,30,23,7,6,1,0
0,0,0,0,0,0,0,0,0
0,0,0,0,0,0,0,0,0
271906,2392,4,616,527,89,1,0,1
302105,819,4,100,85,15,0,1,0
8412,79,4,3,2,1,0,0,0
14414,213,2,19,14,5,2,0,0
105522,1588,5,394,389,5,48,1,0
25550,277,3,59,51,8,3,1,0
8019414,3604,4,105,96,9,156,1,0
35839,120,0,3,2,1,0,0,0
497120,5174,1,1487,1474,13,7,1,0
18945,322,1,88,72,16,1,1,0
399896,2610,9,178,152,26,30,1,0
45977,263,5,22,12,10,0,1,0
195290,1762,8,410,365,45,24,1,0
1054443,5388,10,253,243,10,37,1,0
745177,3218,7,14,10,4,13,1,0
57476,549,2,121,121,0,0,1,0
105693,569,0,60,3,57,48,1,0
240080,1052,7,202,168,34,14,1,0
88750,1130,5,83,78,5,2,0,0
0,0,0,0,0,0,0,0,0
0,0,0,0,0,0,0,0,0
1474699,2233,9,230,197,33,8,1,0
106605,586,2,89,87,2,12,1,0
0,0,0,0,0,0,0,0,0
1014266,1205,6,112,96,16,28,1,0
143864,1471,3,278,271,7,41,1,0
2680,36,0,1,1,0,0,0,0
240229,1270,9,123,85,38,119,0,0
647693,1533,1,149,145,4,10,1,1
277726,147,1,8,5,3,6,1,1
156982,842,8,100,96,4,14,1,0
457727,2322,6,300,204,96,48,1,0
315498,5723,0,1822,673,1149,2,0,0
5563,94,0,14,14,0,1,1,0
183031,1352,8,251,211,40,2,1,0
1253786,3729,7,976,953,23,12,1,0
0,0,0,0,0,0,0,0,0
200437,1954,7,318,287,31,41,1,0
21782,184,1,28,22,6,1,1,0
0,0,0,0,0,0,0,0,0
0,0,0,0,0,0,0,0,0
0,0,0,0,0,0,0,0,0
0,0,0,0,0,0,0,0,0
161997,1760,8,280,276,4,8,1,0
9325,136,3,14,9,5,2,1,0
347111,1051,12,15,15,0,60,0,0
0,0,0,0,0,0,0,0,0
45949,295,2,31,14,17,12,0,0
554156,2344,5,259,220,39,43,0,0
147957,525,7,78,68,10,7,1,0
53227,160,2,11,0,11,2,1,0
315382,2058,3,118,77,41,2,1,0
0,0,0,0,0,0,0,0,0
0,0,0,0,0,0,0,0,0
0,0,0,0,0,0,0,0,0
126407,1511,7,392,371,21,17,1,0
237952,4162,6,1288,1254,34,13,0,0
7638,40,0,1,1,0,0,0,0
0,0,0,0,0,0,0,0,0
204725,1126,11,137,117,20,25,1,0
0,0,0,0,0,0,0,0,0
333897,2416,3,227,210,17,3,1,0
0,0,0,0,0,0,0,0,0
201929,2232,3,665,645,20,13,1,0
0,0,0,0,0,0,0,0,0
0,0,0,0,0,0,0,0,0
0,0,0,0,0,0,0,0,0
249399,1520,4,192,161,31,6,0,0
9173,100,0,6,6,0,0,0,0
0,0,0,0,0,0,0,0,0
0,0,0,0,0,0,0,0,0
6909,64,2,2,2,0,3,0,0
0,0,0,0,0,0,0,0,0
0,0,0,0,0,0,0,0,0
310928,2070,7,408,275,133,10,1,0
0,0,0,0,0,0,0,0,0
1683712,5212,12,529,500,29,29,1,0
0,0,0,0,0,0,0,0,0
172560,888,3,108,106,2,0,1,0
0,0,0,0,0,0,0,0,0
0,0,0,0,0,0,0,0,0
154683,616,8,107,95,12,3,1,0
51232,189,9,10,8,2,3,0,0
0,0,0,0,0,0,0,0,0
843925,3980,9,856,797,59,12,1,0
60233,138,8,4,0,4,3,0,0
367604,1740,2,282,282,0,1,1,0
9509,115,2,11,11,0,4,1,0
33331,394,9,83,77,6,1,1,0
0,0,0,0,0,0,0,0,0
919908,2928,11,662,653,9,36,1,0
65720,290,2,13,8,5,6,1,0
28551,45,0,4,1,3,0,0,0
0,0,0,0,0,0,0,0,0
381877,1768,7,250,243,7,11,1,0
0,0,0,0,0,0,0,0,0
0,0,0,0,0,0,0,0,0
635883,1158,6,78,46,32,9,1,0
143826,197,6,4,4,0,8,1,0
41778,260,0,42,30,12,0,1,0
30838,370,1,82,65,17,0,1,0
426673,941,4,145,8,137,9,1,0
321786,756,4,142,115,27,10,1,0
196983,972,10,203,168,35,12,1,0
14384,173,4,12,8,4,5,1,0
7256,84,4,7,7,0,0,1,0
40734,449,5,123,123,0,4,0,0
183605,1438,11,172,117,55,11,1,0
425251,2612,8,199,86,113,63,0,0
484146,538,3,51,42,9,1,0,0
363889,1858,3,397,382,15,8,1,0
1643668,3243,6,305,192,113,30,1,0
0,0,0,0,0,0,0,0,0
795806,5971,3,1338,1268,70,29,1,0
380412,3897,3,1065,1048,17,26,1,0
78031,669,11,85,78,7,4,1,0
11818,141,6,24,18,6,2,1,0
0,0,0,0,0,0,0,0,0
5852759,326,1,12,6,6,1,1,0
5852759,326,1,12,10,2,1,1,0
231841,340,0,17,8,9,0,1,0
107342,1063,5,201,200,1,1,1,0
0,0,0,0,0,0,0,0,0
955512,1297,7,96,90,6,70,1,0
0,0,0,0,0,0,0,0,0
257897,201,2,16,15,1,1,1,0
263478,101,2,8,8,0,3,0,0
0,0,0,0,0,0,0,0,0
73342,2039,2,571,566,5,1,1,0
0,0,0,0,0,0,0,0,0
183272,389,10,34,31,3,2,1,0
433343,3131,8,309,298,11,15,1,0
0,0,0,0,0,0,0,0,0
0,0,0,0,0,0,0,0,0
0,0,0,0,0,0,0,0,0
156986,2025,6,444,88,356,11,1,1
0,0,0,0,0,0,0,0,0
31844,79,4,0,0,0,2,1,0
79981,833,11,104,11,93,0,1,0
18056,57,1,1,0,1,0,0,0
82166,530,6,78,69,9,9,1,0
0,0,0,0,0,0,0,0,0
121539,828,8,150,134,16,2,1,0
909503,3872,4,504,391,113,5,1,0
0,0,0,0,0,0,0,0,0
0,0,0,0,0,0,0,0,0
0,0,0,0,0,0,0,0,0
75960,1603,2,411,395,16,0,0,0
299823,1479,6,121,94,27,9,1,0
1232367,2400,6,5,4,1,6,0,0
208689,2438,2,783,773,10,2,0,0
320899,1047,9,169,148,21,18,1,0
154804,589,7,97,95,2,6,0,0
183624,3057,2,648,187,461,10,1,0
0,0,0,0,0,0,0,0,0
0,0,0,0,0,0,0,0,0
0,0,0,0,0,0,0,0,0
280116,1142,3,131,102,29,5,0,0
0,0,0,0,0,0,0,0,0
126437,1475,4,200,190,10,4,1,0
126437,1475,4,200,188,12,4,1,0
318965,2179,4,255,239,16,1,1,0
97802,255,5,17,16,1,2,0,0
180807,2535,8,518,496,22,9,1,0
42463,299,8,51,45,6,7,1,0
0,0,0,0,0,0,0,0,0
293293,1904,8,355,304,51,3,1,0
136739,2184,2,449,435,14,31,1,0
6481,115,0,3,3,0,0,1,0
0,0,0,0,0,0,0,0,0
0,0,0,0,0,0,0,0,0
384703,2392,4,301,285,16,10,1,0
127185,2351,2,485,475,10,9,1,0
16010,235,0,59,54,5,2,1,0
64355,999,5,95,76,19,13,0,0
13850,83,1,4,4,0,1,1,0
0,0,0,0,0,0,0,0,0
202493,548,11,61,61,0,25,1,0
845909,3455,5,342,259,83,15,1,0
64785,730,8,93,86,7,4,1,0
19359,209,8,36,30,6,4,1,0
203006,1587,6,399,399,0,8,1,0
350888,1322,11,105,85,20,5,1,0
518591,1356,7,141,124,17,7,1,0
15164,101,2,7,7,0,0,0,0
17952,332,2,72,40,32,3,1,0
564368,4394,12,706,518,188,327,0,0
33921,127,4,5,3,2,1,0,0
27981,540,6,144,142,2,0,1,0
7553,95,6,10,9,1,0,1,0
2265,37,1,2,0,2,0,1,0
0,0,0,0,0,0,0,0,0
130698,1457,2,68,54,14,2,0,0
239910,1928,4,321,309,12,9,1,0
37268,308,2,4,4,0,2,0,0
217860,847,3,79,65,14,1,1,0
179496,422,3,6,5,1,1,0,0
139139,1825,3,401,16,385,1,0,0
164307,3093,2,627,627,0,5,0,0
121517,946,6,105,64,41,6,0,0
0,0,0,0,0,0,0,0,0
63491,1395,3,209,198,11,1,1,0
19417,268,2,30,24,6,2,1,0
232889,688,18,125,119,6,22,0,0
251066,1991,5,277,195,82,33,1,0
211760,1814,5,230,163,67,24,1,0
186584,884,12,220,193,27,3,1,0
181078,1721,4,319,252,67,13,0,0
688474,5228,3,971,959,12,8,1,0
521453,3589,4,838,826,12,9,1,0
81555,1285,1,333,322,11,8,1,0
7698,52,0,6,1,5,0,0,0
0,0,0,0,0,0,0,0,0
0,0,0,0,0,0,0,0,0
449675,1955,7,187,140,47,10,1,0
64034,1698,3,750,254,496,0,1,0
397321,7079,1,1400,930,470,5,0,0
527696,2925,14,378,340,38,51,0,0
0,0,0,0,0,0,0,0,0
229618,1716,6,390,355,35,2,1,0
0,0,0,0,0,0,0,0,0
0,0,0,0,0,0,0,0,0
0,0,0,0,0,0,0,0,0
194817,933,4,196,163,33,12,1,0
172464,534,4,62,47,15,2,1,0
0,0,0,0,0,0,0,0,0
0,0,0,0,0,0,0,0,0
7698,124,5,14,7,7,0,1,0
0,0,0,0,0,0,0,0,0
917055,2732,8,781,776,5,10,1,0
22949,61,1,2,2,0,0,0,0
482340,2978,2,285,268,17,0,1,0
51785,510,8,104,93,11,2,1,0
44358,129,5,1,1,0,2,0,0
229140,1389,7,139,117,22,4,1,0
0,0,0,0,0,0,0,0,0
237383,2571,6,181,159,22,5,1,0
71905,251,5,17,13,4,4,1,0
0,0,0,0,0,0,0,0,0
30621,353,5,38,13,25,10,0,0
7322,99,5,13,12,1,0,0,0
474477,726,7,70,59,11,4,1,0
424390,340,1,16,10,6,3,1,0
321895,2818,14,638,618,20,25,1,0
0,0,0,0,0,0,0,0,0
32370,283,1,83,81,2,3,1,0
1283126,2046,3,349,334,15,16,1,0
0,0,0,0,0,0,0,0,0
0,0,0,0,0,0,0,0,0
871824,3271,2,99,78,21,0,1,0
0,0,0,0,0,0,0,0,0
0,0,0,0,0,0,0,0,0
1642724,4806,7,1021,979,42,13,1,0
733166,652,6,142,112,30,10,1,0
431531,2097,16,322,305,17,2,1,0
65383,428,4,72,66,6,0,1,0
398534,426,3,62,56,6,2,1,0
77458,1105,2,220,220,0,6,1,0
47480,207,1,22,22,0,6,1,0
0,0,0,0,0,0,0,0,0
121565,627,10,85,73,12,2,1,0
826067,3113,10,387,251,136,6,0,0
120722,671,8,127,120,7,3,1,0
16995,125,6,7,5,2,4,0,0
0,0,0,0,0,0,0,0,0
23243,452,2,89,89,0,4,1,0
15315,270,2,41,41,0,4,1,0
44996,557,1,122,81,41,0,1,0
50402,553,6,117,97,20,2,0,0
0,0,0,0,0,0,0,0,0
80150,385,1,55,53,2,1,0,0
17770,79,1,9,9,0,0,0,0
125676,1164,3,309,247,62,6,1,1
28739,298,4,71,35,36,2,1,0
1962278,1964,3,142,108,34,4,1,0
0,0,0,0,0,0,0,0,0
27810,42,0,2,1,1,0,0,0
0,0,0,0,0,0,0,0,0
0,0,0,0,0,0,0,0,0
182207,2674,8,384,361,23,2,1,0
89807,1370,1,185,177,8,3,1,0
488691,2972,6,712,708,4,5,1,0
26493,99,1,3,3,0,1,0,0
0,0,0,0,0,0,0,0,0
0,0,0,0,0,0,0,0,0
734605,6125,3,676,521,155,17,1,0
472314,3334,2,296,295,1,2,1,0
318229,806,9,115,109,6,8,1,0
170041,193,7,28,25,3,1,1,0
10963,125,1,29,26,3,0,1,0
36993,525,2,20,20,0,1,1,0
300710,1522,2,258,161,97,3,1,0
11830,87,0,5,5,0,0,0,0
0,0,0,0,0,0,0,0,0
0,0,0,0,0,0,0,0,0
521897,5432,4,1627,677,950,12,1,0
0,0,0,0,0,0,0,0,0
74080,319,4,29,27,2,0,0,0
283371,1947,11,383,360,23,33,0,0
0,0,0,0,0,0,0,0,0
0,0,0,0,0,0,0,0,0
275327,1143,9,229,219,10,25,1,0
7746,29,0,1,1,0,1,0,0
252542,2778,9,368,308,60,24,1,0
0,0,0,0,0,0,0,0,0
2187018,2634,5,644,634,10,3,1,0
2099369,1944,6,451,441,10,5,1,0
346121,1641,1,180,173,7,8,1,0
798630,6324,10,1613,1607,6,8,1,0
149131,1289,2,269,28,241,8,1,0
0,0,0,0,0,0,0,0,0
832154,2654,7,169,131,38,79,1,0
0,0,0,0,0,0,0,0,0
0,0,0,0,0,0,0,0,0
78654,1260,2,333,303,30,5,1,0
76575,1006,5,273,220,53,3,1,0
202220,1187,8,272,180,92,30,1,0
179059,1002,8,136,90,46,30,1,0
0,0,0,0,0,0,0,0,0
639205,828,5,89,79,10,10,1,0
0,0,0,0,0,0,0,0,0
289781,2172,6,321,307,14,2,1,0
224274,1437,6,193,188,5,3,1,0
785205,1386,5,76,68,8,5,1,0
0,0,0,0,0,0,0,0,0
70966,609,6,54,47,7,19,1,0
37417,288,2,36,29,7,3,1,0
394860,759,8,117,111,6,9,1,0
0,0,0,0,0,0,0,0,0
0,0,0,0,0,0,0,0,0
0,0,0,0,0,0,0,0,0
3559503,29912,5,3027,1765,1262,39,1,0
47106,132,8,3,0,3,0,1,0
1724311,976,10,238,221,17,2,1,0
0,0,0,0,0,0,0,0,0
27677,42,0,2,1,1,0,0,0
135935,1355,8,197,189,8,20,1,0
80016,821,11,195,179,16,13,1,0
172939,1631,12,333,290,43,13,1,0
17647,110,5,8,8,0,0,1,0
0,0,0,0,0,0,0,0,0
0,0,0,0,0,0,0,0,0
372291,2832,6,414,396,18,10,1,0
116820,385,5,9,8,1,6,1,0
443052,1943,18,191,171,20,30,1,0
0,0,0,0,0,0,0,0,0
659789,2339,10,327,301,26,20,1,0
641895,2114,9,305,278,27,20,1,0
0,0,0,0,0,0,0,0,0
0,0,0,0,0,0,0,0,0
106400,833,6,217,21,196,30,1,0
374577,2313,6,273,143,130,19,0,0
2169726,8537,7,1768,1702,66,21,1,0
332778,922,7,41,31,10,17,1,0
845839,5638,6,812,812,0,12,1,0
1781570,9128,14,409,399,10,24,1,0
1699962,8771,13,355,347,8,24,1,0
73315,620,3,29,28,1,2,1,0
0,0,0,0,0,0,0,0,0
2355161,16472,3,2079,1481,598,12,1,0
116002,305,5,25,24,1,3,1,0
96075,153,4,16,15,1,1,1,0
0,0,0,0,0,0,0,0,0
0,0,0,0,0,0,0,0,0
0,0,0,0,0,0,0,0,0
0,0,0,0,0,0,0,0,0
69438,512,4,123,102,21,4,1,0
20305,121,2,15,11,4,0,0,0
671108,5621,3,782,738,44,28,0,0
284894,2160,4,426,134,292,23,0,0
0,0,0,0,0,0,0,0,0
0,0,0,0,0,0,0,0,0
0,0,0,0,0,0,0,0,0
110348,498,4,76,75,1,4,1,0
848326,8596,4,1287,1262,25,1,0,0
29531,310,2,21,19,2,6,1,0
0,0,0,0,0,0,0,0,0
429517,1496,3,276,209,67,10,1,0
0,0,0,0,0,0,0,0,0
314953,1117,9,159,112,47,10,0,0
0,0,0,0,0,0,0,0,0
222024,1485,4,505,486,19,0,0,0
398032,2801,7,827,683,144,19,1,0
0,0,0,0,0,0,0,0,0
37937,247,1,12,10,2,0,0,0
0,0,0,0,0,0,0,0,0
469001,2415,7,258,231,27,3,0,0
693515,3417,5,870,842,28,2,1,0
696830,3385,4,863,837,26,2,1,0
135250,1206,4,155,130,25,15,1,0
92468,1041,2,60,33,27,2,1,0
782510,4679,5,685,678,7,13,1,0
125205,261,5,29,28,1,5,1,0
410345,2956,19,867,752,115,51,1,1
37259,419,8,81,64,17,1,1,0
0,0,0,0,0,0,0,0,0
583856,1546,3,312,215,97,2,1,0
141864,764,8,163,149,14,13,1,0
0,0,0,0,0,0,0,0,0
22451,190,3,32,27,5,2,1,0
75879,1031,4,158,124,34,19,1,0
0,0,0,0,0,0,0,0,0
1984841,7365,11,731,447,284,59,1,0
418240,658,8,58,53,5,5,1,0
0,0,0,0,0,0,0,0,0
0,0,0,0,0,0,0,0,0
0,0,0,0,0,0,0,0,0
253308,3804,2,839,838,1,3,1,0
0,0,0,0,0,0,0,0,0
211399,3087,2,878,838,40,12,0,0
24016,141,1,17,16,1,2,0,0
596028,2965,3,356,333,23,2,1,0
3874,51,1,5,5,0,0,0,0
75493,72,0,4,3,1,0,1,0
397894,2801,7,827,678,149,19,1,0
300199,1562,2,303,297,6,2,1,0
822850,6724,8,1398,1340,58,62,1,0
822457,6718,8,1398,1340,58,63,1,0
0,0,0,0,0,0,0,0,0
1192843,3400,5,251,227,24,88,1,0
7620,89,5,14,14,0,0,1,0
492184,4157,8,304,286,18,29,1,0
1087006,797,8,11,2,9,3,1,0
181453,634,3,110,97,13,2,1,0
1097,21,0,3,2,1,0,1,0
1653151,22396,3,7833,7687,146,43,0,0
1653151,22396,3,7833,7687,146,43,0,0
30767,132,1,24,24,0,1,1,0
33400,57,0,5,5,0,1,1,0
173523,1307,8,231,224,7,20,1,0
0,0,0,0,0,0,0,0,0
571433,1197,6,241,227,14,140,1,0
11313,142,0,9,6,3,0,1,0
0,0,0,0,0,0,0,0,0
0,0,0,0,0,0,0,0,0
0,0,0,0,0,0,0,0,0
79125,254,7,11,10,1,5,1,0
103376,395,9,59,47,12,9,1,0
0,0,0,0,0,0,0,0,0
480451,2136,5,356,316,40,7,1,0
0,0,0,0,0,0,0,0,0
0,0,0,0,0,0,0,0,0
0,0,0,0,0,0,0,0,0
87633,1155,2,419,258,161,5,1,0
0,0,0,0,0,0,0,0,0
314617,392,5,13,9,4,0,0,0
97826,828,9,205,203,2,1,1,0
25159,218,4,37,36,1,1,0,0
30837,94,1,0,0,0,0,0,0
102225,1504,6,316,274,42,3,0,0
46778,205,0,75,73,2,0,0,0
0,0,0,0,0,0,0,0,0
376794,925,5,63,54,9,8,1,0
394181,1085,5,64,55,9,8,1,0
195089,1099,3,288,282,6,10,1,0
31422,308,4,92,91,1,2,1,0
15513,110,3,16,15,1,0,1,0
504315,1732,8,61,57,4,18,1,0
23704,69,1,2,2,0,0,0,0
811252,2225,3,355,339,16,4,1,0
0,0,0,0,0,0,0,0,0
347248,3094,12,750,739,11,19,1,0
842935,2430,17,547,490,57,58,1,0
22642,34,0,1,1,0,0,1,0
42970,343,1,69,64,5,1,1,0
0,0,0,0,0,0,0,0,0
138352,586,5,77,71,6,19,1,0
90924,137,6,2,2,0,15,0,0
296607,2010,6,280,198,82,2,1,0
188461,1209,4,224,199,25,40,1,0
255217,687,10,72,70,2,14,1,0
38327,173,11,3,3,0,14,0,0
0,0,0,0,0,0,0,0,0
0,0,0,0,0,0,0,0,0
0,0,0,0,0,0,0,0,0
1352840,3118,4,273,258,15,12,1,0
619468,3201,10,748,735,13,8,0,0
0,0,0,0,0,0,0,0,0
209777,1439,6,317,311,6,5,1,0
69972,595,1,66,55,11,1,0,0
101268,1490,4,373,367,6,1,0,1
7616,74,3,9,9,0,0,0,0
1269581,3210,4,225,191,34,115,1,0
312330,1089,8,113,104,9,13,1,0
206590,879,7,6,6,0,2,0,0
0,0,0,0,0,0,0,0,0
0,0,0,0,0,0,0,0,0
0,0,0,0,0,0,0,0,0
794971,2243,4,433,427,6,7,1,0
167628,1792,1,322,318,4,2,0,0
495886,6519,3,829,828,1,4,1,0
472234,1451,3,152,96,56,1,1,0
21093,379,2,111,88,23,0,1,0
283292,826,6,45,38,7,10,1,0
109830,1199,5,181,172,9,13,1,0
36443,272,5,34,29,5,15,1,0
372918,3044,3,269,238,31,24,1,1
39271,309,1,94,73,21,2,1,0
0,0,0,0,0,0,0,0,0
0,0,0,0,0,0,0,0,0
978909,5784,4,924,685,239,33,0,0
89086,261,0,48,24,24,0,1,1
178525,1429,8,298,295,3,18,1,0
112888,1739,4,390,387,3,1,1,0
194581,2285,6,326,211,115,12,1,0
0,0,0,0,0,0,0,0,0
0,0,0,0,0,0,0,0,0
21255,152,10,22,17,5,0,1,0
244323,1666,1,272,261,11,0,1,0
0,0,0,0,0,0,0,0,0
620551,4328,10,235,219,16,20,1,0
270183,567,11,35,17,18,14,0,0
545952,3035,6,351,328,23,16,1,0
420928,1905,5,271,248,23,13,1,0
661464,1301,7,54,43,11,6,1,0
573885,3100,7,525,420,105,8,1,0
573885,3100,7,525,420,105,8,1,0
457362,2163,7,526,451,75,8,1,0
0,0,0,0,0,0,0,0,0
0,0,0,0,0,0,0,0,0
0,0,0,0,0,0,0,0,0
76876,750,5,79,52,27,9,1,0
41816,206,6,41,39,2,0,1,0
85732,748,5,88,69,19,0,0,0
684072,521,0,5,2,3,2,1,1
534605,2806,3,664,651,13,15,1,0
33572,116,2,8,8,0,0,0,0
180200,1818,7,425,406,19,30,1,0
0,0,0,0,0,0,0,0,0
541183,163,5,20,0,20,0,1,0
236038,4262,4,735,593,142,0,0,0
84511,1229,4,272,198,74,0,0,0
0,0,0,0,0,0,0,0,0
805326,1809,4,366,360,6,4,1,0
0,0,0,0,0,0,0,0,0
95040,432,4,46,40,6,2,1,0
0,0,0,0,0,0,0,0,0
159677,1020,0,334,240,94,2,1,0
516162,1489,2,190,174,16,10,1,0
227369,213,5,10,10,0,1,1,0
774807,1340,8,194,137,57,7,1,0
767827,1306,8,187,130,57,7,1,0
83018,765,1,149,149,0,0,1,0
0,0,0,0,0,0,0,0,0
661428,5165,3,883,869,14,0,1,0
0,0,0,0,0,0,0,0,0
43268,801,5,142,137,5,11,1,0
15500,98,3,4,4,0,4,0,0
49018,686,6,52,45,7,2,1,0
0,0,0,0,0,0,0,0,0
0,0,0,0,0,0,0,0,0
291933,1756,5,192,177,15,2,0,0
330076,1625,5,87,79,8,2,0,0
243241,1131,5,180,171,9,16,1,0
1498156,158,2,11,11,0,0,1,0
0,0,0,0,0,0,0,0,0
0,0,0,0,0,0,0,0,0
0,0,0,0,0,0,0,0,0
1484052,2232,1,286,267,19,1,1,0
45598,249,2,25,20,5,3,1,0
0,0,0,0,0,0,0,0,0
98968,1159,3,173,156,17,6,1,0
487041,3981,6,304,212,92,6,1,0
220073,2121,5,239,234,5,5,1,0
0,0,0,0,0,0,0,0,0
799922,3719,0,349,299,50,115,1,0
0,0,0,0,0,0,0,0,0
128304,1046,11,252,113,139,15,1,0
304077,887,2,215,180,35,4,0,0
66849,249,0,46,24,22,0,1,1
66847,249,0,46,39,7,0,1,1
0,0,0,0,0,0,0,0,0
21892,35,0,1,1,0,0,1,0
41419,280,2,34,17,17,10,0,0
0,0,0,0,0,0,0,0,0
320208,1529,18,256,195,61,5,1,0
120949,773,16,156,150,6,5,1,0
807214,1329,2,175,149,26,10,1,0
128811,361,2,29,25,4,12,1,0
852230,2406,15,307,269,38,30,1,0
0,0,0,0,0,0,0,0,0
603474,612,9,96,95,1,0,1,0
958961,663,6,45,1,44,1,1,0
3955,63,0,9,9,0,0,1,0
0,0,0,0,0,0,0,0,0
53818,91,5,10,2,8,2,1,0
204902,2013,1,277,262,15,53,1,0
662577,1292,1,226,211,15,10,1,0
445860,5180,3,1301,1288,13,12,1,0
24516,381,8,115,88,27,0,1,0
0,0,0,0,0,0,0,0,0
576679,3329,7,466,443,23,4,1,0
267028,2216,6,578,531,47,0,1,0
8657,71,6,3,2,1,0,0,0
68577,283,2,9,8,1,1,1,0
216229,2064,3,389,372,17,8,1,0
30080,224,4,17,11,6,14,1,0
1495317,5455,2,570,544,26,1,1,0
161544,1694,8,327,207,120,22,1,0
365293,1057,7,69,60,9,5,1,0
319750,1312,7,191,174,17,5,1,0
183058,212,7,10,9,1,3,1,0
0,0,0,0,0,0,0,0,0
47436,227,7,39,38,1,0,1,0
48077,307,7,38,37,1,0,1,0
1177780,1751,13,150,123,27,2,1,0
0,0,0,0,0,0,0,0,0
156952,1260,5,172,36,136,10,1,0
181541,617,2,102,86,16,9,1,0
0,0,0,0,0,0,0,0,0
648439,2387,16,246,192,54,27,1,0
42341,579,2,11,2,9,1,0,0
259388,889,3,87,75,12,5,1,0
0,0,0,0,0,0,0,0,0
66504,340,3,69,65,4,22,0,0
473663,1017,2,106,90,16,13,0,0
0,0,0,0,0,0,0,0,0
0,0,0,0,0,0,0,0,0
74613,922,2,258,251,7,8,1,0
0,0,0,0,0,0,0,0,0
92170,672,9,72,62,10,13,1,0
51901,143,2,108,107,1,0,0,0
22013,35,0,1,1,0,0,1,0
230422,338,0,17,8,9,0,1,0
440386,3215,5,642,25,617,4,1,0
395410,1766,13,137,122,15,39,1,0
556698,4770,2,765,753,12,2,1,0
589764,3321,1,251,204,47,3,1,0
1867865,2525,13,158,140,18,35,1,0
6418800,2005,0,0,0,0,1,1,0
1148772,2684,11,667,655,12,84,1,0
230405,338,0,17,14,3,0,1,0
7332,83,2,11,6,5,0,0,0
157350,736,15,141,141,0,46,1,0
214385,2455,7,302,269,33,8,1,0
92603,827,2,165,157,8,2,1,0
170896,714,2,131,120,11,2,1,0
23671,191,3,22,15,7,0,1,0
0,0,0,0,0,0,0,0,0
422561,1550,11,139,113,26,32,1,0
0,0,0,0,0,0,0,0,0
0,0,0,0,0,0,0,0,0
0,0,0,0,0,0,0,0,0
0,0,0,0,0,0,0,0,0
0,0,0,0,0,0,0,0,0
736308,1279,3,246,228,18,5,1,0
1894054,2681,13,575,544,31,31,1,0
750559,2015,11,460,437,23,8,1,0
90295,1095,1,195,171,24,10,1,0
20772,265,1,88,85,3,0,1,0
76164,765,0,109,85,24,0,1,0
0,0,0,0,0,0,0,0,0
153861,1183,6,259,248,11,5,1,0
154619,1208,8,284,244,40,9,1,0
2330,56,0,3,3,0,0,0,0
547961,5537,0,2421,2334,87,8,1,0
32845,237,1,45,43,2,1,1,0
174978,484,4,18,6,12,5,1,0
2610875,5396,9,156,116,40,45,1,0
40264,142,6,3,1,2,3,0,0
73333,834,11,191,150,41,5,1,0
132783,2222,3,805,804,1,14,1,0
9996,166,2,39,38,1,4,1,0
0,0,0,0,0,0,0,0,0
0,0,0,0,0,0,0,0,0
112651,621,3,77,70,7,6,1,0
126595,178,0,6,5,1,0,1,0
0,0,0,0,0,0,0,0,0
0,0,0,0,0,0,0,0,0
416917,6138,7,1311,1244,67,148,1,0
0,0,0,0,0,0,0,0,0
160289,1292,9,215,212,3,20,1,0
0,0,0,0,0,0,0,0,0
86953,659,0,136,134,2,0,0,0
45514,491,4,63,63,0,35,1,0
37147,293,4,29,29,0,31,1,0
240873,3000,3,815,815,0,6,1,0
0,0,0,0,0,0,0,0,0
767137,1580,7,358,339,19,6,1,0
1064854,3255,5,453,438,15,110,1,0
74214,750,1,168,155,13,0,1,1
93726,1392,3,335,317,18,4,0,0
569215,4142,4,676,652,24,24,1,0
283251,2323,6,523,457,66,8,0,0
0,0,0,0,0,0,0,0,0
241032,1225,1,145,119,26,6,1,0
0,0,0,0,0,0,0,0,0
0,0,0,0,0,0,0,0,0
0,0,0,0,0,0,0,0,0
56964,480,2,113,97,16,2,1,0
34931,125,2,8,5,3,3,0,0
3728170,4454,5,462,350,112,5,1,0
644273,2735,5,217,207,10,7,1,0
0,0,0,0,0,0,0,0,0
428339,1509,8,213,95,118,49,1,0
973168,3670,10,678,665,13,41,1,0
0,0,0,0,0,0,0,0,0
62850,211,4,33,33,0,0,1,0
0,0,0,0,0,0,0,0,0
0,0,0,0,0,0,0,0,0
69656,784,2,298,275,23,2,0,0
104233,468,3,98,97,1,9,1,0
770025,7341,10,2584,2550,34,68,1,0
94811,1329,3,3,3,0,7,0,0
0,0,0,0,0,0,0,0,0
138683,874,7,137,127,10,15,1,0
0,0,0,0,0,0,0,0,0
1131404,3212,8,307,114,193,21,1,0
92817,1002,2,166,152,14,3,1,0
216127,1854,4,209,163,46,1,1,0
40945,237,3,8,7,1,1,1,0
957578,3094,2,308,301,7,0,0,0
20694,177,1,14,10,4,0,0,0
0,0,0,0,0,0,0,0,0
0,0,0,0,0,0,0,0,0
6779,127,0,38,19,19,0,0,0
0,0,0,0,0,0,0,0,0
637792,1857,8,242,227,15,19,1,0
126704,1297,15,287,280,7,9,1,0
85285,761,15,132,120,12,10,1,0
0,0,0,0,0,0,0,0,0
228878,339,0,17,9,8,0,1,0
247074,1154,4,130,126,4,0,1,0
53714,173,2,3,3,0,0,0,0
132979,1699,3,289,285,4,8,1,0
50781,704,3,147,115,32,1,1,0
10419,72,3,5,5,0,0,0,0
124711,664,4,104,88,16,8,1,0
34141,399,4,44,28,16,8,1,0
269569,1064,9,183,159,24,6,1,0
149751,1930,5,786,776,10,61,0,0
30039,226,4,43,33,10,4,0,0
483983,4168,6,557,452,105,9,1,0
632791,1601,2,357,349,8,62,1,0
15983,274,1,77,74,3,3,1,0
2289449,1706,9,80,71,9,22,1,0
4385,97,2,12,12,0,0,0,0
0,0,0,0,0,0,0,0,0
0,0,0,0,0,0,0,0,0
228356,334,0,16,3,13,0,1,0
0,0,0,0,0,0,0,0,0
58525,536,8,85,79,6,0,1,0
74468,706,7,68,62,6,5,1,0
342771,1620,15,378,354,24,26,1,0
0,0,0,0,0,0,0,0,0
51886,480,1,89,61,28,19,1,0
4167,30,1,1,1,0,0,0,0
177629,1198,6,119,112,7,11,1,0
19851,108,1,3,1,2,0,0,0
432103,1108,6,234,234,0,0,1,1
82818,1028,0,247,26,221,4,0,0
5223,26,0,1,1,0,0,0,0
43893,695,6,235,232,3,0,1,0
2081,35,0,3,2,1,0,0,0
0,0,0,0,0,0,0,0,0
0,0,0,0,0,0,0,0,0
384812,8347,3,153,152,1,1,0,0
12747,276,3,41,38,3,2,0,0
79592,356,4,61,57,4,1,1,0
420223,1734,11,237,214,23,32,1,0
0,0,0,0,0,0,0,0,0
724416,1931,3,227,219,8,2,1,0
84592,228,4,42,25,17,2,1,0
0,0,0,0,0,0,0,0,0
126594,1448,2,328,323,5,10,0,0
89410,1097,2,292,287,5,10,0,0
34305,301,7,33,10,23,6,0,0
18284,104,7,7,7,0,5,0,0
108363,1426,4,268,260,8,9,1,0
0,0,0,0,0,0,0,0,0
324318,1986,5,313,305,8,12,0,0
26272,424,0,77,70,7,1,1,0
6933,78,0,12,10,2,1,0,0
0,0,0,0,0,0,0,0,0
0,0,0,0,0,0,0,0,0
171002,1347,2,236,214,22,3,0,0
288789,354,0,17,13,4,2,1,0
0,0,0,0,0,0,0,0,0
27258,318,4,58,57,1,0,0,0
18917,254,4,52,52,0,0,0,0
145787,1857,5,507,505,2,6,1,0
7097,88,3,17,17,0,1,0,0
381619,2048,7,486,451,35,22,1,0
158647,1534,9,346,318,28,15,1,0
0,0,0,0,0,0,0,0,0
340282,1440,4,256,243,13,3,1,0
0,0,0,0,0,0,0,0,0
837231,3244,6,506,504,2,6,1,0
738242,2937,6,472,470,2,8,1,0
34685,18,0,1,1,0,0,0,0
0,0,0,0,0,0,0,0,0
448139,1983,9,268,223,45,45,0,0
0,0,0,0,0,0,0,0,0
457785,1536,4,125,105,20,6,0,0
629492,4019,0,333,298,35,4,1,0
141637,722,3,82,59,23,41,1,0
0,0,0,0,0,0,0,0,0
176997,2550,5,513,507,6,4,1,0
366925,2492,0,300,294,6,12,1,0
86140,552,0,68,66,2,5,1,0
104900,982,1,220,215,5,3,1,0
32080,347,1,109,102,7,2,1,0
0,0,0,0,0,0,0,0,0
29683,61,2,3,0,3,0,0,0
193908,1260,7,310,301,9,21,1,0
106308,426,8,93,85,8,4,1,0
0,0,0,0,0,0,0,0,0
0,0,0,0,0,0,0,0,0
349319,1315,5,61,56,5,12,1,0
0,0,0,0,0,0,0,0,0
0,0,0,0,0,0,0,0,0
0,0,0,0,0,0,0,0,0
234454,3356,14,444,422,22,22,1,0
80080,766,14,187,181,6,19,1,0
20990,260,3,9,8,1,0,1,0
481814,1532,1,103,99,4,1,1,0
387184,3465,7,813,797,16,18,1,0
46443,300,7,6,6,0,8,1,0
0,0,0,0,0,0,0,0,0
52112,502,3,88,86,2,6,1,0
7682,52,0,6,1,5,0,0,0
263601,1229,7,85,37,48,6,1,0
590295,2056,1,154,151,3,1,1,0
131788,1703,9,364,344,20,0,0,0
0,0,0,0,0,0,0,0,0
0,0,0,0,0,0,0,0,0
0,0,0,0,0,0,0,0,0
0,0,0,0,0,0,0,0,0
285404,1987,9,443,405,38,29,0,0
168073,1211,5,108,95,13,19,1,0
168118,1210,5,108,94,14,19,1,0
0,0,0,0,0,0,0,0,0
329702,803,0,72,65,7,2,0,0
61154,606,5,143,134,9,7,0,0
0,0,0,0,0,0,0,0,0
0,0,0,0,0,0,0,0,0
231356,1610,5,340,335,5,4,1,0
87061,414,5,41,37,4,7,1,0
212930,2271,3,362,350,12,8,1,0
684126,521,0,5,2,3,2,1,1
152851,1067,2,301,298,3,9,0,0
923416,2625,4,304,272,32,165,1,0
23245,249,9,17,17,0,0,1,0
172855,882,6,202,197,5,0,1,0
59250,708,6,74,70,4,10,0,0
20012,262,6,43,36,7,0,0,0
90278,1463,1,480,480,0,1,1,0
92467,1041,2,60,33,27,2,1,0
339842,3599,2,1244,390,854,31,1,0
384469,2934,0,298,11,287,2,1,0
35372,86,0,2,1,1,1,0,0
206343,1377,6,278,261,17,64,0,0
0,0,0,0,0,0,0,0,0
140982,1033,3,91,77,14,16,0,0
0,0,0,0,0,0,0,0,0
22062,35,0,1,1,0,0,1,0
230820,1819,9,323,319,4,10,1,0
162342,1204,11,239,231,8,11,1,0
0,0,0,0,0,0,0,0,0
0,0,0,0,0,0,0,0,0
0,0,0,0,0,0,0,0,0
40016,259,7,33,29,4,7,1,0
816671,2670,2,218,101,117,37,0,0
129971,768,5,244,242,2,5,1,0
0,0,0,0,0,0,0,0,0
75855,477,1,76,62,14,0,1,0
0,0,0,0,0,0,0,0,0
150795,1576,7,330,296,34,6,1,0
159328,1287,15,159,87,72,31,1,0
197800,2779,9,533,501,32,18,1,0
0,0,0,0,0,0,0,0,0
306992,828,8,87,81,6,6,1,0
106761,1184,1,214,183,31,4,1,0
34459,389,1,67,53,14,6,1,0
0,0,0,0,0,0,0,0,0
1845833,11874,8,3506,3500,6,1868,1,0
0,0,0,0,0,0,0,0,0
0,0,0,0,0,0,0,0,0
0,0,0,0,0,0,0,0,0
67140,872,3,20,14,6,20,0,0
387232,2649,4,253,198,55,16,0,0
167970,174,5,7,2,5,3,0,0
163763,1994,14,313,281,32,18,1,0
51358,354,7,50,45,5,10,1,0
0,0,0,0,0,0,0,0,0
0,0,0,0,0,0,0,0,0
0,0,0,0,0,0,0,0,0
320391,1883,5,228,217,11,3,1,0
140395,1269,5,255,229,26,6,1,0
103372,1798,2,469,365,104,2,1,0
449510,1816,3,266,236,30,15,1,0
520338,1494,5,288,253,35,9,1,1
209895,567,5,70,53,17,4,1,0
320248,3562,2,1333,1243,90,15,1,0
390334,3137,14,695,654,41,0,1,1
7346,75,1,9,7,2,0,1,0
0,0,0,0,0,0,0,0,0
218907,1089,14,260,238,22,9,1,0
193543,767,16,160,139,21,14,1,0
213062,2703,2,468,303,165,0,1,0
107021,1368,4,303,303,0,21,1,0
516185,2219,11,423,109,314,14,0,0
365355,1813,9,140,118,22,12,1,0
0,0,0,0,0,0,0,0,0
0,0,0,0,0,0,0,0,0
645242,1738,2,386,376,10,15,1,0
62144,812,3,227,185,42,5,1,0
382794,1347,8,117,96,21,9,1,0
0,0,0,0,0,0,0,0,0
722136,4249,7,342,334,8,13,1,0
231071,568,5,72,19,53,8,1,0
179003,374,5,41,31,10,6,1,0
0,0,0,0,0,0,0,0,0
291880,2471,3,407,400,7,3,1,0
126361,1663,5,266,235,31,30,1,0
52090,170,2,44,31,13,5,1,0
39513,705,3,175,173,2,13,1,0
43262,449,4,122,102,20,6,1,0
142563,2181,4,465,447,18,22,0,0
938251,5912,3,497,454,43,5,1,0
145333,1188,6,257,208,49,5,0,0
435298,3660,10,833,810,23,17,0,0
0,0,0,0,0,0,0,0,0
630262,2803,8,436,423,13,32,1,0
537479,3114,8,438,333,105,32,1,0
0,0,0,0,0,0,0,0,0
109535,1103,7,233,218,15,10,1,0
19729,203,5,24,24,0,2,1,0
452194,569,4,15,9,6,3,0,0
94442,766,7,225,212,13,1,1,0
28487,599,0,107,107,0,0,1,0
538794,5779,2,1218,1218,0,3,1,0
6643,71,7,1,1,0,0,0,0
28595,45,0,4,1,3,0,0,0
0,0,0,0,0,0,0,0,0
193825,2232,1,123,12,111,0,0,0
269029,1309,12,160,150,10,21,1,0
859610,2139,8,165,108,57,4,1,0
289826,1682,5,350,308,42,5,1,0
0,0,0,0,0,0,0,0,0
292975,777,8,203,189,14,38,1,0
73540,558,9,65,51,14,55,1,0
490571,2197,1,109,97,12,2,1,0
26992,415,0,103,103,0,0,0,0
0,0,0,0,0,0,0,0,0
156629,988,5,170,168,2,22,1,0
238564,1423,12,137,130,7,6,1,0
61375,513,10,41,30,11,10,1,0
61249,512,10,41,30,11,10,1,0
0,0,0,0,0,0,0,0,0
724416,866,4,90,82,8,8,1,0
0,0,0,0,0,0,0,0,0
0,0,0,0,0,0,0,0,0
0,0,0,0,0,0,0,0,0
16980,124,1,5,5,0,5,0,0
198868,1366,15,218,175,43,5,1,0
291381,2636,2,370,369,1,1,1,0
0,0,0,0,0,0,0,0,0
0,0,0,0,0,0,0,0,0
255745,3124,1,1852,1851,1,0,1,0
129344,165,1,22,17,5,2,1,0
1617592,12482,4,983,974,9,2,1,0
0,0,0,0,0,0,0,0,0
2340,27,0,1,1,0,2,0,0
1004187,3020,3,643,590,53,24,1,0
0,0,0,0,0,0,0,0,0
598648,2573,0,306,295,11,12,0,0
107219,180,0,10,10,0,0,0,0
553501,2010,7,150,140,10,12,1,0
518799,233,2,14,8,6,0,1,0
567566,1822,4,273,265,8,2,1,0
704099,2721,5,545,515,30,3,1,0
274454,840,6,46,22,24,24,1,0
78164,206,1,5,5,0,2,0,0
440275,3039,8,354,346,8,7,1,0
142843,595,4,74,74,0,3,0,0
121009,992,2,94,84,10,12,0,0
13019,99,2,10,2,8,0,0,0
116526,345,10,20,11,9,32,1,0
183314,1118,17,175,139,36,21,1,0
0,0,0,0,0,0,0,0,0
1001653,2854,6,133,128,5,7,1,0
846586,351,7,5,4,1,6,1,0
2195829,6641,11,639,580,59,43,1,0
48236,181,4,1,1,0,3,0,0
58860,704,1,132,131,1,0,0,0
50678,749,3,137,134,3,2,1,0
130550,695,3,85,46,39,3,1,0
0,0,0,0,0,0,0,0,0
0,0,0,0,0,0,0,0,0
0,0,0,0,0,0,0,0,0
495876,6519,3,829,184,645,4,1,0
0,0,0,0,0,0,0,0,0
0,0,0,0,0,0,0,0,0
212119,882,3,108,5,103,0,0,0
345948,1283,7,81,62,19,88,1,0
191562,1588,1,202,174,28,0,1,0
130589,863,6,138,123,15,0,0,0
30185,135,2,9,1,8,4,0,0
409384,1661,2,174,165,9,4,1,0
335324,1237,2,131,127,4,3,1,0
187775,2519,4,515,512,3,6,1,0
104154,282,9,24,20,4,15,1,0
54853,373,6,26,26,0,0,1,0
526604,4643,2,763,757,6,23,1,0
399282,3737,3,638,632,6,20,1,0
1481108,13973,1,1106,1086,20,2,1,0
0,0,0,0,0,0,0,0,0
0,0,0,0,0,0,0,0,0
158583,2007,2,573,556,17,10,0,0
55644,970,2,274,270,4,1,1,0
167183,726,6,78,76,2,4,1,0
0,0,0,0,0,0,0,0,0
44567,249,7,40,39,1,0,1,0
47875,346,7,42,41,1,0,1,0
192123,4159,4,574,573,1,3,1,0
256381,883,3,167,157,10,6,0,0
99293,434,4,108,98,10,6,0,0
0,0,0,0,0,0,0,0,0
0,0,0,0,0,0,0,0,0
470202,3495,2,305,285,20,9,1,0
0,0,0,0,0,0,0,0,0
0,0,0,0,0,0,0,0,0
0,0,0,0,0,0,0,0,0
0,0,0,0,0,0,0,0,0
25494,491,4,116,108,8,0,1,0
490560,1128,11,154,134,20,1,1,0
9333,91,3,4,2,2,0,0,0
123715,577,6,89,52,37,14,1,0
11400,81,7,6,6,0,0,1,0
797251,1798,5,161,154,7,25,1,0
347506,490,2,13,10,3,0,0,0
873888,1759,11,159,138,21,29,1,0
0,0,0,0,0,0,0,0,0
221087,2235,9,234,222,12,27,1,0
127571,1238,4,210,208,2,1,1,0
39017,287,5,54,52,2,3,1,0
61662,624,3,145,144,1,18,1,0
807140,2175,3,206,189,17,13,1,0
257429,1571,5,149,140,9,4,1,0
513714,2269,4,365,321,44,20,1,0
13608,78,5,6,6,0,1,0,0
1080051,2698,11,485,449,36,37,1,0
384132,1851,14,408,391,17,29,1,0
0,0,0,0,0,0,0,0,0
40358,403,3,70,66,4,0,1,0
17663,59,3,9,9,0,0,0,0
388785,3111,12,646,625,21,54,1,1
0,0,0,0,0,0,0,0,0
610127,3260,6,373,336,37,125,1,0
313322,690,7,80,68,12,7,1,0
15038,101,2,7,7,0,0,0,0
0,0,0,0,0,0,0,0,0
0,0,0,0,0,0,0,0,0
65561,610,4,201,186,15,1,1,0
310969,1204,6,268,230,38,102,1,0
0,0,0,0,0,0,0,0,0
0,0,0,0,0,0,0,0,0
0,0,0,0,0,0,0,0,0
0,0,0,0,0,0,0,0,0
11517,327,1,8,8,0,0,1,0
395081,2790,3,383,364,19,2,1,0
0,0,0,0,0,0,0,0,0
92430,1041,2,60,33,27,2,1,0
298675,2437,3,6,1,5,22,1,0
0,0,0,0,0,0,0,0,0
166778,2112,4,657,636,21,15,1,0
3798856,4281,2,737,698,39,6,1,0
343714,1827,8,177,171,6,25,1,0
1411448,3034,8,90,84,6,28,0,0
20130,88,3,4,4,0,0,0,0
0,0,0,0,0,0,0,0,0
815847,2936,4,318,280,38,8,1,0
21490,167,2,10,10,0,1,0,0
0,0,0,0,0,0,0,0,0
0,0,0,0,0,0,0,0,0
40603,327,1,37,15,22,0,1,0
93466,992,4,164,158,6,48,1,0
86295,556,2,69,67,2,9,1,0
24444,160,2,19,18,1,12,1,0
932145,1858,13,227,216,11,31,1,0
714014,2229,2,122,113,9,1,0,0
924614,6260,9,648,620,28,204,0,0
0,0,0,0,0,0,0,0,0
0,0,0,0,0,0,0,0,0
0,0,0,0,0,0,0,0,0
410097,2805,13,301,286,15,2,1,0
0,0,0,0,0,0,0,0,0
0,0,0,0,0,0,0,0,0
0,0,0,0,0,0,0,0,0
0,0,0,0,0,0,0,0,0
0,0,0,0,0,0,0,0,0
0,0,0,0,0,0,0,0,0
0,0,0,0,0,0,0,0,0
0,0,0,0,0,0,0,0,0
0,0,0,0,0,0,0,0,0
148024,2083,3,366,323,43,15,1,0
0,0,0,0,0,0,0,0,0
0,0,0,0,0,0,0,0,0
0,0,0,0,0,0,0,0,0
0,0,0,0,0,0,0,0,0
230775,341,0,17,14,3,0,1,0
0,0,0,0,0,0,0,0,0
0,0,0,0,0,0,0,0,0
209494,2218,11,429,361,68,4,1,0
0,0,0,0,0,0,0,0,0
307340,1458,6,145,108,37,4,1,0
566760,635,7,12,5,7,2,1,0
17859,256,0,25,24,1,0,0,0
0,0,0,0,0,0,0,0,0
453294,1239,3,112,106,6,0,1,0
0,0,0,0,0,0,0,0,0
780457,2735,15,335,301,34,30,1,0
259589,1569,12,189,163,26,10,1,0
350748,72,0,8,6,2,0,0,0
994188,4934,12,186,174,12,18,1,0
194642,581,3,55,28,27,4,1,0
10972,67,0,4,4,0,0,0,0
0,0,0,0,0,0,0,0,0
0,0,0,0,0,0,0,0,0
309115,1106,4,170,146,24,18,1,0
79966,712,10,180,5,175,2,1,0
0,0,0,0,0,0,0,0,0
880072,2426,12,183,164,19,39,1,0
0,0,0,0,0,0,0,0,0
737366,2531,5,293,281,12,1,1,0
92467,1041,2,60,33,27,2,1,0
87726,895,3,99,89,10,1,0,0
18754,106,3,4,4,0,2,0,0
0,0,0,0,0,0,0,0,0
21549,367,0,102,89,13,0,1,0
201126,58,0,9,5,4,0,1,0
0,0,0,0,0,0,0,0,0
0,0,0,0,0,0,0,0,0
0,0,0,0,0,0,0,0,0
6212406,3366,1,565,540,25,43,1,0
635299,1755,6,248,156,92,13,1,1
257630,1187,5,160,131,29,13,1,0
0,0,0,0,0,0,0,0,0
954297,1192,7,116,83,33,29,1,0
337182,2480,13,517,234,283,18,1,0
3666747,29924,5,3027,1772,1255,39,1,0
47106,132,8,3,0,3,0,1,0
104888,865,9,127,104,23,2,1,0
0,0,0,0,0,0,0,0,0
0,0,0,0,0,0,0,0,0
101407,1281,2,188,171,17,8,1,0
22987,39,0,2,2,0,0,1,0
0,0,0,0,0,0,0,0,0
510777,4161,8,363,196,167,43,1,0
302576,1513,2,115,111,4,6,1,0
0,0,0,0,0,0,0,0,0
69335,665,11,67,66,1,13,0,0
675734,555,0,4,0,4,2,1,1
54928,563,5,85,43,42,0,1,0
375313,6394,5,521,499,22,20,0,0
0,0,0,0,0,0,0,0,0
421924,3751,13,810,792,18,7,1,0
643075,6206,2,1807,1806,1,2,1,0
51647,286,2,50,12,38,5,1,0
0,0,0,0,0,0,0,0,0
0,0,0,0,0,0,0,0,0
53639,518,4,42,39,3,2,1,0
164420,2709,3,599,535,64,8,1,0
0,0,0,0,0,0,0,0,0
87023,1224,5,272,265,7,1,1,0
56545,903,4,228,226,2,0,1,0
88822,1116,5,311,307,4,9,1,0
43047,254,4,10,10,0,1,0,0
79326,416,6,62,53,9,1,0,0
583236,1989,5,279,247,32,18,1,0
108083,956,3,137,114,23,5,1,0
0,0,0,0,0,0,0,0,0
1437118,6997,6,27,26,1,51,0,0
498495,1057,7,132,126,6,8,1,0
19829,86,1,4,3,1,0,0,0
0,0,0,0,0,0,0,0,0
71543,806,1,215,204,11,5,1,0
21860,35,0,1,1,0,0,1,0
1154878,7915,5,584,570,14,3,1,0
0,0,0,0,0,0,0,0,0
165932,431,2,52,41,11,5,1,0
23893,315,4,53,49,4,2,1,0
28820,237,7,51,48,3,0,1,0
0,0,0,0,0,0,0,0,0
22049,33,0,1,1,0,0,1,0
0,0,0,0,0,0,0,0,0
217173,597,7,115,105,10,26,1,0
0,0,0,0,0,0,0,0,0
0,0,0,0,0,0,0,0,0
736694,2820,3,325,325,0,15,0,0
234257,2349,7,426,346,80,26,1,0
179782,2281,6,608,532,76,19,1,0
90766,223,4,12,8,4,9,1,0
0,0,0,0,0,0,0,0,0
134949,601,8,173,153,20,11,1,0
557275,3941,17,719,689,30,27,1,0
0,0,0,0,0,0,0,0,0
0,0,0,0,0,0,0,0,0
339777,3013,8,273,183,90,165,0,0
62891,728,1,251,250,1,8,0,0
493906,1544,4,141,102,39,36,1,0
395997,2778,3,385,366,19,2,1,0
0,0,0,0,0,0,0,0,0
131100,1815,1,497,496,1,0,0,0
60491,669,7,73,57,16,6,1,0
277030,2429,5,339,318,21,11,0,0
44125,281,4,30,25,5,12,0,0
148799,1524,13,618,617,1,1,1,0
0,0,0,0,0,0,0,0,0
116581,675,8,63,59,4,0,0,0
0,0,0,0,0,0,0,0,0
401747,2998,3,232,230,2,21,1,0
0,0,0,0,0,0,0,0,0
7692,63,0,25,22,3,0,0,0
4923,77,0,11,10,1,0,0,0
309261,961,4,40,30,10,0,1,0
565,7,0,0,0,0,0,0,0
398924,978,7,182,170,12,14,1,0
0,0,0,0,0,0,0,0,0
0,0,0,0,0,0,0,0,0
214798,1287,2,372,369,3,123,1,0
0,0,0,0,0,0,0,0,0
3666355,1482,4,172,143,29,4,0,0
420134,3184,8,222,209,13,4,1,0
668457,5157,7,34,27,7,2,1,0
195027,1277,9,200,187,13,12,1,0
536820,2184,2,137,68,69,2,1,0
0,0,0,0,0,0,0,0,0
193242,704,5,116,102,14,10,1,0
266391,2116,5,150,134,16,6,1,0
162784,522,6,44,34,10,11,1,0
283810,494,1,13,7,6,1,1,0
409743,690,6,110,79,31,5,1,0
332332,1089,1,235,196,39,8,1,0
0,0,0,0,0,0,0,0,0
0,0,0,0,0,0,0,0,0
0,0,0,0,0,0,0,0,0
125489,1031,8,236,228,8,11,1,0
244675,1738,3,179,175,4,0,1,0
0,0,0,0,0,0,0,0,0
88297,1097,2,253,239,14,0,1,0
72699,855,3,224,207,17,3,1,0
0,0,0,0,0,0,0,0,0
0,0,0,0,0,0,0,0,0
0,0,0,0,0,0,0,0,0
422704,1870,5,233,192,41,14,1,0
125062,1462,2,413,356,57,18,1,0
124032,685,14,65,50,15,11,1,0
58817,1049,2,186,184,2,0,1,0
825692,1371,3,165,134,31,16,1,0
15411,145,0,35,31,4,2,1,0
0,0,0,0,0,0,0,0,0
554714,1469,8,93,68,25,35,1,0
375596,727,9,60,49,11,11,1,0
202571,1009,10,241,191,50,9,1,0
93361,88,2,7,2,5,3,0,0
581885,8904,5,598,541,57,17,0,0
109083,534,10,82,58,24,16,0,0
39397,727,1,326,325,1,1,1,0
16107,108,0,53,52,1,0,1,0
124060,1154,7,62,60,2,0,0,0
1141,28,0,2,2,0,0,0,0
283697,4119,3,683,578,105,8,1,0
283461,3878,6,871,868,3,10,1,0
82634,217,0,46,23,23,0,1,1
445010,1053,18,155,149,6,16,1,0
858395,7424,11,859,762,97,23,1,0
875202,7489,11,865,779,86,23,1,0
181986,783,8,158,152,6,14,1,0
75772,171,0,27,26,1,0,1,0
8100,62,0,4,1,3,0,0,0
215615,1727,8,493,476,17,3,1,0
0,0,0,0,0,0,0,0,0
323019,1737,3,236,211,25,63,0,0
1443422,2170,3,339,332,7,157,1,0
763246,337,6,48,40,8,5,1,0
0,0,0,0,0,0,0,0,0
0,0,0,0,0,0,0,0,0
27575,42,0,2,1,1,0,0,0
0,0,0,0,0,0,0,0,0
214782,2379,13,497,445,52,5,1,0
1404211,5877,12,482,407,75,71,1,0
66913,893,6,170,169,1,3,1,0
11347,258,0,55,55,0,0,1,0
492792,1024,2,124,63,61,4,1,0
95904,826,7,121,112,9,0,0,0
14505,207,3,49,36,13,3,0,0
5293797,2513,7,447,9,438,13,1,0
217054,567,1,14,13,1,0,1,0
272011,2375,4,375,340,35,3,1,0
0,0,0,0,0,0,0,0,0
95076,893,10,212,190,22,54,1,0
44423,628,6,192,170,22,14,1,0
0,0,0,0,0,0,0,0,0
7807,124,4,6,6,0,2,1,0
0,0,0,0,0,0,0,0,0
314949,2265,2,347,322,25,3,1,0
78315,775,1,194,188,6,7,1,0
109603,963,3,216,210,6,18,1,0
380873,3200,5,523,517,6,7,0,0
60715,696,1,1,0,1,0,0,0
0,0,0,0,0,0,0,0,0
558003,3431,6,626,603,23,12,1,0
78730,379,7,81,79,2,0,1,0
182208,2653,2,420,398,22,0,1,0
719212,2035,10,195,188,7,20,1,0
465154,948,10,72,64,8,20,1,0
47571,741,3,149,142,7,1,1,0
166303,1264,8,172,150,22,53,1,0
166558,1264,8,172,150,22,53,1,0
0,0,0,0,0,0,0,0,0
834361,2561,16,248,239,9,15,1,0
721969,1880,16,211,203,8,16,1,0
100472,1451,2,415,413,2,9,0,0
16717,188,0,21,21,0,2,0,0
0,0,0,0,0,0,0,0,0
311743,3748,5,857,833,24,15,0,0
338610,4097,8,916,816,100,26,1,0
150574,1146,11,323,300,23,30,1,0
0,0,0,0,0,0,0,0,0
0,0,0,0,0,0,0,0,0
46152,706,8,88,77,11,7,1,0
0,0,0,0,0,0,0,0,0
197935,2179,3,581,539,42,10,1,1
150982,314,7,14,12,2,6,1,0
202541,481,7,79,54,25,9,0,0
248900,840,4,70,44,26,1,1,0
260219,1663,2,186,67,119,0,1,0
43969,938,1,23,14,9,1,1,0
1019809,2448,2,372,356,16,0,1,0
9989,122,3,10,10,0,1,1,0
181003,640,2,73,27,46,0,1,0
19972,411,1,161,133,28,1,1,0
938632,1403,7,114,102,12,6,1,0
138910,753,6,110,100,10,6,1,0
88539,809,3,17,4,13,0,0,0
0,0,0,0,0,0,0,0,0
223662,765,6,139,115,24,12,0,0
1019150,1311,6,123,99,24,27,1,0
326295,2425,5,720,699,21,3,0,0
365536,2420,0,586,574,12,10,1,0
414865,2800,4,344,288,56,49,1,0
9940,95,2,9,9,0,1,1,0
0,0,0,0,0,0,0,0,0
281379,1367,4,473,453,20,5,1,0
108119,169,3,4,4,0,5,1,0
1135787,2114,10,325,290,35,28,1,0
0,0,0,0,0,0,0,0,0
0,0,0,0,0,0,0,0,0
490304,3337,6,314,294,20,15,1,1
5351,70,2,12,12,0,0,0,0
310367,514,2,41,19,22,6,0,0
0,0,0,0,0,0,0,0,0
664807,1049,7,100,84,16,17,1,0
273181,1047,5,181,178,3,12,0,0
0,0,0,0,0,0,0,0,0
293465,1098,10,113,108,5,27,1,0
566,7,0,0,0,0,0,0,0
82305,1531,5,279,274,5,1,1,0
27024,767,1,342,339,3,0,1,0
0,0,0,0,0,0,0,0,0
315261,2486,1,550,532,18,19,1,0
41088,236,1,9,4,5,7,1,0
27346,409,4,92,58,34,1,1,0
179054,2237,2,202,196,6,29,1,0
20174,264,4,62,36,26,1,0,0
15488,188,5,34,34,0,3,1,0
852612,4326,10,807,781,26,170,1,0
0,0,0,0,0,0,0,0,0
113576,1363,3,249,195,54,2,1,0
185860,1215,8,199,176,23,33,1,0
4909,75,1,5,3,2,0,1,0
17303,325,0,122,121,1,1,1,0
656388,5868,3,491,372,119,16,1,1
784531,2929,4,412,237,175,14,1,0
734579,3387,7,175,167,8,14,1,0
144906,217,4,41,34,7,1,1,0
132470,1771,9,390,315,75,104,1,0
65248,659,9,143,74,69,26,1,0
0,0,0,0,0,0,0,0,0
599461,2652,12,457,388,69,21,1,0
370710,546,10,54,38,16,13,1,0
111506,1896,6,421,393,28,2,1,0
75161,1048,5,258,244,14,1,0,0
86674,926,7,205,202,3,81,1,0
171322,1691,5,304,297,7,16,0,0
16177,209,2,55,40,15,0,1,0
57748,587,4,107,23,84,18,1,0
577577,1346,6,224,189,35,27,0,0
0,0,0,0,0,0,0,0,0
562367,7470,10,1483,442,1041,110,1,1
18595,423,0,130,129,1,0,1,0
16653,332,0,91,90,1,0,1,0
344572,792,6,62,57,5,9,1,0
505811,2588,9,317,299,18,16,1,0
92467,1041,2,60,33,27,2,1,0
233668,1336,4,136,93,43,33,1,0
0,0,0,0,0,0,0,0,0
914218,5815,9,1125,1097,28,51,1,0
198951,1526,8,33,23,10,48,0,0
52060,306,6,20,4,16,5,1,0
61561,296,4,25,23,2,4,1,0
259992,1300,1,211,185,26,7,1,0
0,0,0,0,0,0,0,0,0
400486,1766,5,274,249,25,8,1,0
0,0,0,0,0,0,0,0,0
35291,248,5,47,4,43,5,1,0
32592,229,5,45,22,23,5,1,0
0,0,0,0,0,0,0,0,0
38343,284,4,29,20,9,6,1,0
38343,284,4,29,20,9,6,1,0
105124,1114,4,137,136,1,9,0,0
34534,259,4,49,48,1,9,0,0
256877,733,4,116,109,7,0,1,0
0,0,0,0,0,0,0,0,0
99390,1195,11,269,250,19,0,0,0
150136,799,4,146,136,10,43,0,0
394073,1120,8,76,68,8,5,1,1
256299,3334,9,634,621,13,10,1,0
261903,1647,15,375,336,39,11,1,0
66989,395,1,88,85,3,1,1,0
0,0,0,0,0,0,0,0,0
0,0,0,0,0,0,0,0,0
0,0,0,0,0,0,0,0,0
0,0,0,0,0,0,0,0,0
80963,460,1,118,111,7,2,1,0
0,0,0,0,0,0,0,0,0
289649,1086,13,199,170,29,6,1,0
0,0,0,0,0,0,0,0,0
0,0,0,0,0,0,0,0,0
249924,1523,5,260,230,30,7,0,0
9301,100,0,6,6,0,0,0,0
0,0,0,0,0,0,0,0,0
231886,341,0,17,9,8,0,1,0
994063,1838,11,147,131,16,28,1,0
0,0,0,0,0,0,0,0,0
0,0,0,0,0,0,0,0,0
209241,1024,3,80,75,5,18,1,0
0,0,0,0,0,0,0,0,0
0,0,0,0,0,0,0,0,0
213373,1508,7,166,158,8,11,0,0
0,0,0,0,0,0,0,0,0
0,0,0,0,0,0,0,0,0
57469,495,6,97,93,4,0,1,0
0,0,0,0,0,0,0,0,0
287681,1851,8,281,257,24,11,1,0
46926,294,6,10,10,0,3,1,0
360129,1497,1,309,288,21,1,1,0
0,0,0,0,0,0,0,0,0
489645,2205,5,507,431,76,5,1,0
100583,828,3,194,182,12,4,1,0
384776,1188,2,136,129,7,1,0,0
0,0,0,0,0,0,0,0,0
506365,2179,3,327,308,19,5,1,0
27424,270,6,70,67,3,14,1,0
0,0,0,0,0,0,0,0,0
338754,2954,4,450,435,15,39,1,0
0,0,0,0,0,0,0,0,0
229543,1336,7,203,172,31,3,1,0
26655,222,7,13,12,1,8,1,0
184394,2110,1,426,419,7,0,1,0
85091,637,1,149,142,7,0,1,0
298843,1283,11,179,173,6,6,1,0
257183,568,13,119,113,6,4,1,0
717232,2244,15,377,350,27,43,1,0
626852,1646,15,262,241,21,42,1,0
0,0,0,0,0,0,0,0,0
0,0,0,0,0,0,0,0,0
0,0,0,0,0,0,0,0,0
280133,1614,6,343,293,50,22,1,0
0,0,0,0,0,0,0,0,0
468971,4647,8,1287,1275,12,13,1,0
252491,873,5,126,76,50,35,1,0
312380,914,11,119,107,12,2,1,0
156769,1048,10,209,199,10,5,1,0
83519,453,10,85,76,9,4,1,0
74317,1933,2,569,568,1,1,1,0
450049,938,2,40,3,37,7,0,0
0,0,0,0,0,0,0,0,0
0,0,0,0,0,0,0,0,0
121066,1237,5,217,208,9,2,1,0
0,0,0,0,0,0,0,0,0
282857,1519,1,179,153,26,7,1,0
215542,1688,0,346,332,14,2,1,0
50353,366,6,28,10,18,0,1,0
17705,97,3,5,5,0,1,0,0
215756,2563,2,331,164,167,7,1,0
22497,196,3,20,15,5,0,1,0
0,0,0,0,0,0,0,0,0
0,0,0,0,0,0,0,0,0
0,0,0,0,0,0,0,0,0
105745,1019,9,169,133,36,5,1,0
0,0,0,0,0,0,0,0,0
863624,2446,5,300,280,20,39,1,0
528059,2502,6,154,68,86,8,0,0
513740,2907,7,1140,1133,7,23,1,0
0,0,0,0,0,0,0,0,0
0,0,0,0,0,0,0,0,0
8564,172,2,24,22,2,0,1,0
10022,154,3,24,22,2,2,1,0
1991,28,1,7,3,4,0,1,0
12702,174,6,13,10,3,2,0,0
0,0,0,0,0,0,0,0,0
0,0,0,0,0,0,0,0,0
0,0,0,0,0,0,0,0,0
780249,1109,4,78,69,9,0,1,0
197825,1122,5,214,209,5,23,1,0
145302,576,7,109,106,3,25,0,0
0,0,0,0,0,0,0,0,0
209781,2398,8,694,393,301,17,1,0
339316,2269,3,226,208,18,0,1,0
232075,1331,4,136,102,34,30,1,0
0,0,0,0,0,0,0,0,0
0,0,0,0,0,0,0,0,0
0,0,0,0,0,0,0,0,0
4838,83,1,21,21,0,0,0,0
8979,183,3,29,24,5,0,0,0
1115729,1818,9,168,147,21,16,1,0
103708,431,7,55,43,12,14,1,0
377632,1109,16,139,127,12,8,1,0
0,0,0,0,0,0,0,0,0
0,0,0,0,0,0,0,0,0
496846,1102,9,123,91,32,20,1,0
477396,868,5,90,70,20,13,1,0
2145485,9781,7,790,782,8,310,1,0
0,0,0,0,0,0,0,0,0
234759,866,6,94,91,3,1,1,0
0,0,0,0,0,0,0,0,0
571653,3174,8,674,656,18,8,1,0
51133,143,2,10,7,3,2,0,0
1082412,2046,10,291,277,14,34,1,0
0,0,0,0,0,0,0,0,0
151804,1265,2,351,251,100,0,1,0
83276,61,0,6,6,0,6,0,0
13887,262,0,62,61,1,0,1,0
111883,1039,8,203,189,14,7,1,0
112240,997,9,290,289,1,8,1,0
0,0,0,0,0,0,0,0,0
1140601,2667,4,274,262,12,13,1,0
183687,554,4,20,13,7,1,1,0
474145,6363,8,1158,1158,0,3,1,0
379475,1554,8,168,153,15,19,1,0
276810,835,9,11,1,10,5,1,0
92467,1041,2,60,33,27,2,1,0
222322,1299,6,261,227,34,1,1,0
0,0,0,0,0,0,0,0,0
380781,2221,10,412,396,16,20,1,0
710456,2984,4,487,478,9,1,1,0
162581,159,4,3,3,0,1,1,0
265096,2337,9,170,129,41,10,0,0
28804,104,6,6,6,0,0,0,0
284989,632,1,59,42,17,0,1,0
0,0,0,0,0,0,0,0,0
0,0,0,0,0,0,0,0,0
0,0,0,0,0,0,0,0,0
925023,1884,8,345,336,9,20,1,0
329052,350,8,49,38,11,13,1,0
0,0,0,0,0,0,0,0,0
586841,5052,5,233,224,9,23,0,0
116477,307,2,23,15,8,0,1,0
153285,3609,2,764,761,3,271,1,0
13259,113,2,10,10,0,1,1,0
0,0,0,0,0,0,0,0,0
0,0,0,0,0,0,0,0,0
0,0,0,0,0,0,0,0,0
30808,215,0,55,45,10,0,0,0
4928544,36102,8,3566,1910,1656,4,1,0
14915,142,3,2,1,1,4,0,0
23379,81,3,1,0,1,2,1,0
2536063,1472,4,142,91,51,57,1,0
6138738,1394,4,117,53,64,52,1,0
0,0,0,0,0,0,0,0,0
461640,1868,3,239,211,28,8,1,0
572541,3354,12,160,146,14,46,1,0
0,0,0,0,0,0,0,0,0
0,0,0,0,0,0,0,0,0
189807,3074,3,905,898,7,4,0,0
0,0,0,0,0,0,0,0,0
0,0,0,0,0,0,0,0,0
27970,42,0,2,1,1,0,0,0
0,0,0,0,0,0,0,0,0
179924,1875,6,442,432,10,7,1,0
0,0,0,0,0,0,0,0,0
747879,2065,9,637,568,69,5,1,0
643134,1295,2,278,201,77,6,1,0
275035,211,0,20,5,15,5,1,0
435668,1086,7,119,112,7,2,1,0
34863,155,0,30,21,9,1,1,0
0,0,0,0,0,0,0,0,0
144042,1514,9,339,325,14,15,0,0
57536,504,6,109,96,13,13,0,0
0,0,0,0,0,0,0,0,0
0,0,0,0,0,0,0,0,0
0,0,0,0,0,0,0,0,0
0,0,0,0,0,0,0,0,0
0,0,0,0,0,0,0,0,0
139683,1471,1,371,361,10,6,0,0
0,0,0,0,0,0,0,0,0
0,0,0,0,0,0,0,0,0
20221,182,4,62,56,6,0,1,0
287421,1724,8,355,348,7,4,1,0
608331,1302,6,284,272,12,1,1,0
182878,1319,11,263,257,6,8,1,0
219998,1641,7,340,321,19,31,1,0
0,0,0,0,0,0,0,0,0
38578,729,4,122,122,0,2,1,0
4335,66,3,9,9,0,0,1,0
0,0,0,0,0,0,0,0,0
198952,1655,2,378,371,7,1,1,0
22775,164,1,31,28,3,0,1,0
475528,3294,8,659,656,3,21,1,0
200028,1643,8,248,240,8,17,1,0
407742,3613,5,938,903,35,73,1,0
19915,100,3,11,6,5,1,1,0
583039,2086,7,234,51,183,1,1,0
0,0,0,0,0,0,0,0,0
488640,1773,7,283,267,16,21,1,0
0,0,0,0,0,0,0,0,0
540967,5833,3,750,744,6,3,0,0
23795,379,0,23,16,7,2,1,1
887633,3523,5,389,341,48,6,1,0
381767,755,14,61,54,7,2,1,0
476183,4878,3,1897,1830,67,23,0,0
0,0,0,0,0,0,0,0,0
0,0,0,0,0,0,0,0,0
84874,684,5,96,94,2,21,1,0
0,0,0,0,0,0,0,0,0
891687,3447,5,417,405,12,81,1,0
35998,434,2,74,72,2,2,0,0
36454,658,3,33,32,1,2,0,0
585405,3121,6,167,158,9,130,1,0
326902,1893,5,169,153,16,33,1,0
103890,1107,3,132,125,7,3,1,0
0,0,0,0,0,0,0,0,0
82139,802,6,243,229,14,21,0,0
0,0,0,0,0,0,0,0,0
211462,2419,1,151,148,3,1,1,0
39753,448,1,31,28,3,1,1,0
0,0,0,0,0,0,0,0,0
221404,1387,4,171,90,81,0,1,0
184439,581,6,136,123,13,25,1,0
486997,2870,4,382,372,10,8,1,0
10342,108,4,2,2,0,0,0,0
1208039,2302,10,143,137,6,30,1,0
12118,75,2,0,0,0,2,0,0
1705,24,6,1,1,0,0,0,0
8100,71,6,3,2,1,0,0,0
0,0,0,0,0,0,0,0,0
401017,2144,3,514,296,218,8,1,0
194844,2869,11,415,407,8,12,1,0
37788,450,7,69,63,6,5,0,0
115700,816,1,153,149,4,4,0,0
0,0,0,0,0,0,0,0,0
0,0,0,0,0,0,0,0,0
0,0,0,0,0,0,0,0,0
902065,624,1,11,9,2,3,1,0
258344,2428,10,357,312,45,9,1,1
172778,1322,2,221,204,17,45,0,0
0,0,0,0,0,0,0,0,0
0,0,0,0,0,0,0,0,0
146170,341,10,37,32,5,3,1,0
561702,2079,2,234,43,191,2,1,0
25958,123,1,13,13,0,0,1,0
0,0,0,0,0,0,0,0,0
0,0,0,0,0,0,0,0,0
0,0,0,0,0,0,0,0,0
0,0,0,0,0,0,0,0,0
64779,251,3,51,51,0,2,1,0
51313,350,5,41,30,11,2,1,0
89701,68,0,9,8,1,6,0,0
0,0,0,0,0,0,0,0,0
279805,2796,4,586,576,10,2,1,0
255572,2770,4,585,575,10,2,1,0
92642,581,2,180,179,1,9,1,0
7227,82,2,5,5,0,2,1,0
228935,339,0,17,9,8,0,1,0
87767,938,8,113,63,50,0,1,0
45446,256,7,7,6,1,0,1,0
178086,2668,1,601,594,7,2,1,0
78981,1189,1,304,297,7,2,1,0
940805,5926,3,498,457,41,4,1,0
0,0,0,0,0,0,0,0,0
608703,3712,8,347,341,6,17,0,0
0,0,0,0,0,0,0,0,0
0,0,0,0,0,0,0,0,0
0,0,0,0,0,0,0,0,0
0,0,0,0,0,0,0,0,0
61474,842,1,156,156,0,4,0,0
0,0,0,0,0,0,0,0,0
2105,25,2,1,1,0,0,0,0
0,0,0,0,0,0,0,0,0
141069,1048,4,131,118,13,6,1,0
0,0,0,0,0,0,0,0,0
0,0,0,0,0,0,0,0,0
200520,2710,5,801,793,8,12,1,0
98585,1155,11,287,281,6,11,1,0
441644,1155,5,206,193,13,50,1,1
847635,2381,3,240,176,64,2,1,0
0,0,0,0,0,0,0,0,0
374102,1617,7,326,318,8,24,1,0
15718,54,1,2,0,2,0,0,0
201695,1378,3,229,212,17,31,0,0
0,0,0,0,0,0,0,0,0
0,0,0,0,0,0,0,0,0
0,0,0,0,0,0,0,0,0
0,0,0,0,0,0,0,0,0
0,0,0,0,0,0,0,0,0
167138,2406,9,598,558,40,6,0,0
0,0,0,0,0,0,0,0,0
0,0,0,0,0,0,0,0,0
0,0,0,0,0,0,0,0,0
116372,1743,1,322,278,44,2,1,0
404191,1835,4,326,287,39,9,1,0
20536,75,1,2,2,0,0,0,0
719428,2736,12,504,470,34,92,0,0
179554,1496,2,180,139,41,1,1,0
0,0,0,0,0,0,0,0,0
160377,1938,7,213,200,13,17,0,0
343556,1349,10,252,239,13,21,1,0
0,0,0,0,0,0,0,0,0
0,0,0,0,0,0,0,0,0
985938,1758,7,214,169,45,29,1,0
142048,1220,9,350,323,27,8,0,0
21001,306,0,63,58,5,0,1,0
10236,120,0,10,10,0,0,0,0
234601,2679,4,723,711,12,5,1,0
0,0,0,0,0,0,0,0,0
264066,1045,9,147,136,11,9,1,0
23423,74,2,4,0,4,2,0,0
0,0,0,0,0,0,0,0,0
465506,3964,11,810,783,27,23,1,0
0,0,0,0,0,0,0,0,0
242343,1446,5,155,57,98,28,1,0
1598869,8504,5,528,459,69,5,1,0
751167,2095,6,372,332,40,18,1,0
18196,232,0,40,31,9,0,1,0
0,0,0,0,0,0,0,0,0
0,0,0,0,0,0,0,0,0
831575,3653,8,381,360,21,23,1,1
14793,137,9,15,14,1,0,0,0
0,0,0,0,0,0,0,0,0
0,0,0,0,0,0,0,0,0
217809,2791,4,753,753,0,3,1,0
192422,812,17,79,70,9,11,1,0
356206,983,11,102,90,12,12,1,0
116869,1397,3,101,77,24,17,1,0
27254,388,2,31,19,12,0,1,0
252157,756,7,58,56,2,47,1,0
0,0,0,0,0,0,0,0,0
190564,927,3,136,120,16,0,0,0
24008,131,6,3,2,1,1,0,0
1574,27,0,0,0,0,0,0,0
0,0,0,0,0,0,0,0,0
0,0,0,0,0,0,0,0,0
365057,1064,2,98,83,15,4,0,0
176627,1124,10,196,176,20,3,1,0
0,0,0,0,0,0,0,0,0
0,0,0,0,0,0,0,0,0
430218,1600,3,219,207,12,1,0,0
289011,1515,3,235,207,28,2,1,0
93258,1014,3,357,266,91,8,1,0
23779,179,2,24,17,7,3,0,0
0,0,0,0,0,0,0,0,0
0,0,0,0,0,0,0,0,0
0,0,0,0,0,0,0,0,0
0,0,0,0,0,0,0,0,0
444501,1080,4,153,141,12,2,1,0
2216,31,1,1,0,1,0,0,0
123414,1653,8,260,252,8,4,0,1
848919,1379,7,74,62,12,11,1,0
0,0,0,0,0,0,0,0,0
255095,1405,4,200,182,18,6,0,0
21937,35,0,1,1,0,0,1,0
89501,592,2,40,23,17,9,0,0
426862,1988,1,202,188,14,2,1,0
231809,341,0,17,10,7,0,1,0
498116,1187,2,310,307,3,12,1,0
436458,259,4,46,45,1,8,1,0
176937,1337,7,173,88,85,1,1,0
275876,1189,10,130,128,2,71,1,0
0,0,0,0,0,0,0,0,0
77935,1014,8,44,36,8,24,1,0
31291,224,4,30,24,6,1,0,0
0,0,0,0,0,0,0,0,0
215033,2304,5,501,62,439,15,1,1
5740,97,3,9,0,9,0,1,0
63324,910,8,214,173,41,2,1,0
0,0,0,0,0,0,0,0,0
44840,338,7,62,60,2,1,1,0
5768,58,6,3,2,1,0,0,0
170797,1585,6,202,188,14,9,1,0
84573,606,5,102,96,6,6,1,0
36148,452,1,73,53,20,0,1,0
0,0,0,0,0,0,0,0,0
2256154,1439,2,184,170,14,7,1,0
230816,2120,11,299,252,47,85,0,0
183929,2104,3,626,621,5,10,1,0
0,0,0,0,0,0,0,0,0
0,0,0,0,0,0,0,0,0
221128,1759,11,302,282,20,11,1,0
0,0,0,0,0,0,0,0,0
0,0,0,0,0,0,0,0,0
0,0,0,0,0,0,0,0,0
0,0,0,0,0,0,0,0,0
379398,1150,9,179,78,101,14,1,0
0,0,0,0,0,0,0,0,0
798028,6229,6,1721,1707,14,4,1,0
146078,1207,5,293,290,3,10,1,0
93406,903,5,123,91,32,7,1,0
189887,585,4,141,120,21,1,1,0
669660,555,0,4,0,4,2,1,1
1114947,800,2,54,44,10,7,1,0
0,0,0,0,0,0,0,0,0
0,0,0,0,0,0,0,0,0
157357,1397,3,324,218,106,6,1,1
0,0,0,0,0,0,0,0,0
0,0,0,0,0,0,0,0,0
1424490,2625,11,189,169,20,28,1,0
181088,898,6,123,114,9,1,1,0
0,0,0,0,0,0,0,0,0
0,0,0,0,0,0,0,0,0
0,0,0,0,0,0,0,0,0
0,0,0,0,0,0,0,0,0
17304,253,3,51,51,0,0,1,0
0,0,0,0,0,0,0,0,0
0,0,0,0,0,0,0,0,0
37690,282,3,57,56,1,2,1,0
91125,856,10,140,135,5,21,0,0
28116,207,9,28,26,2,5,0,0
5240773,39025,9,4365,2713,1652,19,1,1
47106,132,8,3,0,3,0,1,0
343928,1871,5,464,451,13,36,1,0
0,0,0,0,0,0,0,0,0
245475,1466,4,204,187,17,6,0,0
8844,100,0,6,6,0,0,0,0
528384,3956,4,226,202,24,31,1,0
0,0,0,0,0,0,0,0,0
23338,179,1,47,43,4,0,1,0
18438,172,4,19,11,8,2,1,0
261737,2738,3,692,452,240,31,1,0
2211089,22411,2,825,491,334,14,1,1
227177,1739,5,52,52,0,11,0,0
0,0,0,0,0,0,0,0,0
2432964,3662,7,126,114,12,6,1,0
0,0,0,0,0,0,0,0,0
82739,884,5,275,272,3,4,1,0
107574,566,7,162,160,2,0,1,0
539202,2671,15,283,234,49,27,1,0
404948,2740,5,592,535,57,2,1,0
166288,748,5,116,107,9,6,1,0
500265,1659,12,132,114,18,17,1,0
62174,943,3,584,583,1,0,0,0
263333,1963,11,173,167,6,10,1,0
179367,1195,11,137,133,4,10,1,0
107389,634,3,156,149,7,8,1,0
46685,157,2,17,15,2,5,1,0
496300,819,9,87,72,15,11,1,0
0,0,0,0,0,0,0,0,0
37189,732,2,165,164,1,0,1,0
6103,103,2,20,19,1,0,1,0
0,0,0,0,0,0,0,0,0
501353,2589,7,410,327,83,25,1,0
122878,716,8,84,72,12,10,1,0
0,0,0,0,0,0,0,0,0
0,0,0,0,0,0,0,0,0
0,0,0,0,0,0,0,0,0
212951,553,5,50,28,22,3,1,0
215176,1097,3,119,113,6,1,0,0
0,0,0,0,0,0,0,0,0
0,0,0,0,0,0,0,0,0
230902,567,5,72,61,11,8,1,0
178783,374,5,41,31,10,6,1,0
0,0,0,0,0,0,0,0,0
0,0,0,0,0,0,0,0,0
16292,89,0,15,1,14,0,1,0
113029,78,3,6,2,4,1,0,0
334545,1671,6,277,237,40,3,1,0
0,0,0,0,0,0,0,0,0
303790,1560,8,192,176,16,2,1,0
2014761,5371,10,848,843,5,28,1,0
81281,730,1,61,52,9,2,1,0
0,0,0,0,0,0,0,0,0
1266935,7285,6,1610,1308,302,16,1,0
137616,968,10,190,165,25,0,1,0
128465,1062,4,129,118,11,3,1,0
35543,257,0,8,4,4,3,0,0
85756,1112,4,205,199,6,9,1,0
97114,1051,0,3,2,1,0,0,0
185810,1604,5,166,126,40,0,1,0
30300,89,2,1,1,0,0,0,0
44771,459,3,107,103,4,8,1,0
0,0,0,0,0,0,0,0,0
394616,3042,6,375,289,86,57,1,0
0,0,0,0,0,0,0,0,0
49171,398,2,99,88,11,0,1,0
35542,210,2,15,11,4,0,1,0
414604,3585,5,350,322,28,35,1,0
87867,1390,1,367,355,12,5,1,0
0,0,0,0,0,0,0,0,0
548954,1626,2,264,232,32,2,1,0
0,0,0,0,0,0,0,0,0
146350,1118,7,180,171,9,27,1,0
14179,270,4,67,67,0,3,1,0
7418654,20388,7,89,87,2,663,0,0
139111,897,2,111,90,21,2,0,0
231486,337,0,16,3,13,0,1,0
380258,1519,2,278,226,52,1,1,0
39902,129,5,9,9,0,0,1,0
40335,254,4,20,7,13,0,1,0
68002,1112,4,95,95,0,14,1,0
11796,129,2,11,11,0,4,1,0
24399,141,0,9,5,4,5,1,0
28249,45,0,4,1,3,0,0,0
0,0,0,0,0,0,0,0,0
0,0,0,0,0,0,0,0,0
206110,1962,8,263,248,15,8,1,1
907510,10261,11,2898,2889,9,1,1,0
41361,1032,5,325,310,15,9,1,0
208593,984,18,183,54,129,6,1,0
42548,88,0,3,2,1,0,0,0
235759,1133,23,141,131,10,26,0,0
67805,700,10,80,24,56,5,1,0
0,0,0,0,0,0,0,0,0
31618,502,1,40,40,0,0,1,0
0,0,0,0,0,0,0,0,0
0,0,0,0,0,0,0,0,0
786851,2094,6,99,45,54,14,1,0
0,0,0,0,0,0,0,0,0
329643,1497,5,161,141,20,26,1,0
6144,94,1,17,5,12,0,1,0
696520,1753,2,153,148,5,10,1,1
278608,148,1,8,6,2,6,1,1
0,0,0,0,0,0,0,0,0
0,0,0,0,0,0,0,0,0
519381,7034,6,944,912,32,20,1,0
84808,459,6,67,51,16,12,1,0
29387,393,0,119,97,22,0,1,0
214008,1450,10,197,192,5,0,1,0
239174,974,3,250,245,5,24,1,0
75977,430,2,116,115,1,7,1,0
832521,2901,13,241,221,20,40,0,0
0,0,0,0,0,0,0,0,0
406236,2212,5,337,252,85,5,1,0
143756,661,6,181,178,3,2,0,0
2441,52,0,1,1,0,0,0,0
373251,2537,0,300,292,8,12,1,0
86055,552,0,68,66,2,5,1,0
181322,585,11,47,37,10,7,1,0
156280,368,11,35,25,10,7,1,0
3309,38,2,1,1,0,0,0,0
0,0,0,0,0,0,0,0,0
21064,205,5,39,39,0,4,0,0
1691453,417,6,73,68,5,5,1,0
0,0,0,0,0,0,0,0,0
760085,1914,4,120,111,9,1,1,0
15149,16,0,1,0,1,0,0,0
132777,1343,9,214,205,9,11,0,0
334086,2554,4,226,214,12,9,1,0
13565,179,2,32,30,2,0,1,0
3840,53,1,4,4,0,0,0,0
0,0,0,0,0,0,0,0,0
1810365,6240,5,414,406,8,0,1,0
114811,108,0,15,8,7,0,1,0
90229,478,10,106,103,3,8,1,0
0,0,0,0,0,0,0,0,0
70287,677,6,154,149,5,13,1,0
41570,316,5,76,72,4,6,1,0
974319,1099,7,145,45,100,0,1,0
226381,1092,4,220,195,25,11,1,0
0,0,0,0,0,0,0,0,0
1976577,4935,6,421,397,24,5,1,0
806045,2047,3,429,403,26,6,1,0
0,0,0,0,0,0,0,0,0
771050,1928,6,251,243,8,18,0,0
546508,197,6,3,3,0,11,0,0
201995,2700,7,244,237,7,1,0,0
631703,2240,6,311,286,25,19,1,0
0,0,0,0,0,0,0,0,0
373935,1757,5,534,487,47,7,1,0
309354,1375,3,147,140,7,5,1,0
5277,74,0,0,0,0,0,0,0
571934,1239,3,160,149,11,1,1,0
176387,1495,5,404,384,20,25,1,0
41736,758,3,110,99,11,0,0,0
3037,101,0,14,14,0,0,0,0
232901,415,3,41,35,6,1,1,0
275611,3848,6,1719,1685,34,75,1,0
324705,2206,16,552,189,363,2,1,0
12400,91,2,9,5,4,0,1,0
722669,2076,1,378,354,24,11,1,0
332467,1308,1,87,73,14,5,1,0
93038,1428,3,268,266,2,4,1,0
376465,4404,13,1120,1081,39,28,1,0
102356,444,9,20,19,1,22,1,0
0,0,0,0,0,0,0,0,0
0,0,0,0,0,0,0,0,0
0,0,0,0,0,0,0,0,0
0,0,0,0,0,0,0,0,0
58667,329,8,76,66,10,9,1,0
1472840,1194,1,158,147,11,1,1,0
356681,105,0,5,5,0,0,1,0
131871,1093,7,240,209,31,11,1,0
230551,1788,8,438,360,78,13,1,0
657124,2556,6,207,191,16,8,0,0
1014110,2891,4,256,233,23,59,1,0
247831,2833,4,85,73,12,14,1,0
0,0,0,0,0,0,0,0,0
311780,1928,4,252,232,20,1,1,0
98792,255,5,17,16,1,2,0,0
0,0,0,0,0,0,0,0,0
0,0,0,0,0,0,0,0,0
128833,1044,9,184,176,8,21,1,0
95539,304,1,78,43,35,2,0,0
0,0,0,0,0,0,0,0,0
0,0,0,0,0,0,0,0,0
0,0,0,0,0,0,0,0,0
0,0,0,0,0,0,0,0,0
210682,1449,5,253,229,24,4,1,0
74775,949,3,220,208,12,9,1,0
9656,103,3,5,5,0,2,1,0
182662,1269,12,146,81,65,18,1,0
434511,2955,8,311,284,27,11,1,0
793377,2108,13,286,282,4,23,1,0
295504,1566,9,114,103,11,154,1,0
366404,2095,3,226,91,135,25,1,0
319945,2367,8,544,277,267,6,1,0
179653,441,8,45,44,1,33,1,0
98037,1046,2,175,172,3,3,1,0
0,0,0,0,0,0,0,0,0
0,0,0,0,0,0,0,0,0
273479,1465,5,269,255,14,3,1,0
0,0,0,0,0,0,0,0,0
0,0,0,0,0,0,0,0,0
126650,1565,3,406,403,3,10,1,0
0,0,0,0,0,0,0,0,0
1491737,11422,5,4922,4880,42,20,1,0
51511,193,0,15,15,0,1,1,0
19308,347,1,55,52,3,0,1,0
39456,935,3,298,260,38,0,0,0
21959,35,0,1,1,0,0,1,0
0,0,0,0,0,0,0,0,0
55948,358,5,25,9,16,9,0,0
461779,5099,6,187,177,10,19,1,0
547024,3651,4,461,437,24,3,0,0
236291,535,2,35,11,24,13,1,0
145433,275,1,17,3,14,0,0,0
813567,596,5,91,86,5,5,1,0
349195,2993,9,215,209,6,30,1,0
190722,1383,10,84,78,6,30,1,0
274971,2467,6,535,254,281,78,1,0
60746,733,5,249,64,185,1,1,0
0,0,0,0,0,0,0,0,0
0,0,0,0,0,0,0,0,0
534028,43,2,1,0,1,0,0,0
0,0,0,0,0,0,0,0,0
0,0,0,0,0,0,0,0,0
14754,312,4,113,72,41,1,1,0
0,0,0,0,0,0,0,0,0
62323,378,5,40,3,37,0,1,0
0,0,0,0,0,0,0,0,0
201276,2042,0,763,712,51,11,0,0
338758,387,2,77,71,6,5,1,0
277056,146,1,8,0,8,6,1,0
315717,1948,1,296,285,11,1,1,0
32681,439,4,105,98,7,1,1,0
0,0,0,0,0,0,0,0,0
0,0,0,0,0,0,0,0,0
0,0,0,0,0,0,0,0,0
0,0,0,0,0,0,0,0,0
515788,1104,2,131,93,38,5,0,0
173401,693,1,170,96,74,2,1,0
351660,802,4,105,81,24,4,1,0
296205,1901,4,484,453,31,2,1,0
256692,525,4,42,40,2,2,1,0
389258,2714,2,244,241,3,49,0,0
11175,80,3,4,4,0,2,0,0
0,0,0,0,0,0,0,0,0
0,0,0,0,0,0,0,0,0
81681,829,5,189,188,1,12,0,0
0,0,0,0,0,0,0,0,0
0,0,0,0,0,0,0,0,0
0,0,0,0,0,0,0,0,0
317906,5037,7,700,630,70,11,1,0
5591,60,5,7,7,0,3,0,0
0,0,0,0,0,0,0,0,0
1572,11,0,1,1,0,0,0,0
133617,1140,13,161,139,22,13,1,0
252908,720,9,209,204,5,17,1,0
638346,1986,2,170,159,11,8,1,0
1113498,6920,2,879,754,125,2,1,0
173824,363,2,28,25,3,1,1,0
232868,1893,9,346,329,17,3,1,0
0,0,0,0,0,0,0,0,0
0,0,0,0,0,0,0,0,0
731974,2621,16,359,310,49,34,1,1
191143,530,9,58,51,7,0,1,0
0,0,0,0,0,0,0,0,0
24973,218,0,49,48,1,2,1,0
0,0,0,0,0,0,0,0,0
121613,1044,2,201,201,0,7,1,0
0,0,0,0,0,0,0,0,0
7019,191,3,35,35,0,0,0,0
81395,546,4,83,74,9,5,1,0
74683,549,4,64,59,5,5,1,0
347855,1405,4,219,202,17,2,1,0
0,0,0,0,0,0,0,0,0
139451,1231,5,334,274,60,3,1,0
0,0,0,0,0,0,0,0,0
0,0,0,0,0,0,0,0,0
286870,1186,8,102,64,38,17,1,0
1300677,1723,4,460,433,27,12,1,0
88274,259,0,48,24,24,0,1,1
0,0,0,0,0,0,0,0,0
0,0,0,0,0,0,0,0,0
109913,759,13,79,58,21,22,1,0
144052,1032,13,96,61,35,41,1,0
41358,515,6,79,75,4,4,1,0
0,0,0,0,0,0,0,0,0
236670,1283,6,176,106,70,2,1,0
20733,145,1,19,6,13,0,0,0
795640,3184,7,312,284,28,14,1,0
267866,2573,9,435,401,34,28,1,0
0,0,0,0,0,0,0,0,0
73367,499,7,51,50,1,15,1,0
39065,368,1,48,42,6,10,1,0
0,0,0,0,0,0,0,0,0
0,0,0,0,0,0,0,0,0
190467,1047,5,246,236,10,1,0,0
110128,710,8,196,186,10,13,0,0
223323,1241,3,161,145,16,3,1,0
0,0,0,0,0,0,0,0,0
0,0,0,0,0,0,0,0,0
446912,1210,9,161,142,19,19,1,0
59810,626,6,64,51,13,7,1,0
40614,323,6,56,47,9,4,1,0
0,0,0,0,0,0,0,0,0
123387,1636,6,361,342,19,19,0,0
596692,10190,7,3441,745,2696,29,1,0
0,0,0,0,0,0,0,0,0
0,0,0,0,0,0,0,0,0
0,0,0,0,0,0,0,0,0
0,0,0,0,0,0,0,0,0
92610,1029,8,217,217,0,10,1,0
39496,392,4,86,79,7,2,0,0
35206,228,4,44,39,5,0,0,0
1474043,4273,8,710,700,10,2,1,0
201321,1058,4,232,218,14,1,1,0
170719,532,4,119,108,11,0,1,0
0,0,0,0,0,0,0,0,0
0,0,0,0,0,0,0,0,0
219998,2582,2,529,522,7,0,0,0
103120,1045,2,257,250,7,0,0,0
0,0,0,0,0,0,0,0,0
0,0,0,0,0,0,0,0,0
0,0,0,0,0,0,0,0,0
70505,418,10,72,68,4,19,1,0
319445,2385,2,209,204,5,1,0,0
873755,8451,15,151,43,108,6,1,0
0,0,0,0,0,0,0,0,0
180708,164,0,2,2,0,1,1,0
205287,702,4,66,40,26,1,1,0
7364,94,2,18,15,3,2,1,0
0,0,0,0,0,0,0,0,0
0,0,0,0,0,0,0,0,0
0,0,0,0,0,0,0,0,0
1031406,3097,16,353,318,35,43,1,0
131170,1679,2,406,357,49,26,0,0
92467,1041,2,60,33,27,2,1,0
15180,181,1,40,37,3,0,1,0
421256,3796,5,276,250,26,5,1,0
0,0,0,0,0,0,0,0,0
540059,2582,5,240,218,22,12,1,0
43976,695,3,152,120,32,0,0,0
150746,1621,2,459,428,31,2,0,0
474226,1436,1,219,200,19,1,1,0
0,0,0,0,0,0,0,0,0
855156,2357,7,376,345,31,26,1,0
1462957,9999,7,14,6,8,10,1,0
146625,1978,4,533,479,54,0,0,0
236285,2168,3,83,33,50,62,1,0
418147,1909,9,530,517,13,2,1,0
208727,321,6,33,30,3,4,1,0
71590,1179,2,402,341,61,5,1,0
89191,733,4,77,75,2,10,1,0
448778,4505,10,675,644,31,18,1,0
657766,2748,10,384,356,28,14,1,0
0,0,0,0,0,0,0,0,0
33810,377,4,80,52,28,0,1,0
232127,341,0,17,8,9,0,1,0
112883,985,11,150,136,14,6,1,0
0,0,0,0,0,0,0,0,0
1050789,5107,15,731,550,181,77,1,0
510323,1492,17,266,238,28,30,1,0
0,0,0,0,0,0,0,0,0
0,0,0,0,0,0,0,0,0
0,0,0,0,0,0,0,0,0
0,0,0,0,0,0,0,0,0
0,0,0,0,0,0,0,0,0
389664,6149,7,1595,1583,12,13,1,0
333042,1862,6,554,547,7,48,1,0
1568695,2668,12,322,308,14,14,1,0
0,0,0,0,0,0,0,0,0
0,0,0,0,0,0,0,0,0
136525,1001,2,121,39,82,6,1,0
254968,1381,4,219,135,84,0,1,0
156281,3121,1,870,849,21,0,1,0
140308,1588,4,261,246,15,9,1,0
52991,504,0,114,105,9,1,1,0
4537,42,2,3,3,0,0,0,0
29577,256,1,61,21,40,0,1,0
19464,161,1,37,7,30,1,1,0
1106396,3339,11,305,257,48,28,1,0
93108,430,7,114,111,3,4,1,0
30628,207,10,25,22,3,4,1,0
44624,328,0,7,4,3,0,1,0
77182,876,4,206,139,67,1,1,0
91416,384,5,82,80,2,28,1,0
75630,1187,3,292,269,23,6,0,0
93022,586,5,113,113,0,8,1,0
52988,310,5,47,45,2,5,1,0
0,0,0,0,0,0,0,0,0
0,0,0,0,0,0,0,0,0
702355,3018,3,503,495,8,1,1,0
162368,169,4,3,3,0,1,1,0
269878,2277,3,658,581,77,8,1,0
2204972,2892,10,200,163,37,3,1,0
227890,2241,3,317,289,28,34,0,0
1185837,2253,3,239,224,15,13,1,0
850161,940,3,88,55,33,6,1,0
0,0,0,0,0,0,0,0,0
740829,4816,1,645,624,21,8,1,0
23522,277,4,21,20,1,0,1,0
63117,937,7,171,25,146,5,1,0
0,0,0,0,0,0,0,0,0
21250,219,1,17,14,3,2,0,0
242222,1274,2,257,191,66,2,1,0
773622,2739,3,545,535,10,16,1,0
179927,1323,3,387,354,33,3,1,0
1957546,67411,8,16712,478,16234,90,1,0
187850,898,8,217,205,12,2,1,0
372963,1763,5,153,18,135,13,1,0
1392248,12614,8,55,55,0,19,1,0
0,0,0,0,0,0,0,0,0
553756,4158,7,432,380,52,174,1,0
0,0,0,0,0,0,0,0,0
476525,2074,6,390,378,12,2,1,0
553950,4029,1,307,296,11,1,0,0
188247,595,11,71,69,2,26,1,0
150926,784,6,157,92,65,14,1,0
60778,186,9,6,4,2,1,0,0
0,0,0,0,0,0,0,0,0
0,0,0,0,0,0,0,0,0
251284,695,1,35,29,6,0,1,0
223240,2587,9,429,323,106,17,0,0
0,0,0,0,0,0,0,0,0
108000,1503,5,234,210,24,1,1,0
20015,125,3,7,4,3,5,0,0
0,0,0,0,0,0,0,0,0
0,0,0,0,0,0,0,0,0
50551,428,6,58,54,4,3,1,0
453254,1368,8,188,177,11,31,1,0
156326,694,7,145,137,8,9,1,0
0,0,0,0,0,0,0,0,0
155292,442,7,59,56,3,1,1,0
569891,3664,5,721,700,21,8,1,0
355920,3150,7,659,633,26,3,1,0
0,0,0,0,0,0,0,0,0
177323,3941,1,1132,1131,1,3,0,0
177251,3941,1,1132,1132,0,3,0,0
0,0,0,0,0,0,0,0,0
8192,92,3,8,8,0,0,1,0
0,0,0,0,0,0,0,0,0
173484,735,3,54,53,1,5,0,0
172206,731,3,57,53,4,5,0,0
0,0,0,0,0,0,0,0,0
778991,9223,9,2010,793,1217,4,1,0
47654,280,8,15,15,0,3,1,0
13955,178,5,39,31,8,0,1,0
301219,2142,9,338,322,16,15,1,0
17064,265,4,59,52,7,0,1,0
6790,83,1,7,7,0,2,1,0
449545,826,2,168,123,45,3,0,0
292466,354,0,17,13,4,2,1,0
238377,2245,2,523,466,57,64,0,0
0,0,0,0,0,0,0,0,0
765536,3168,9,358,315,43,0,1,0
867428,2944,3,609,575,34,6,1,0
1347253,14099,2,760,469,291,19,1,1
113763,1611,3,241,230,11,3,1,0
24810,326,3,91,78,13,3,1,0
0,0,0,0,0,0,0,0,0
185334,1590,8,284,245,39,30,1,0
185530,1590,8,284,244,40,30,1,0
1805647,3374,6,347,1,346,37,1,0
5482,36,0,0,0,0,0,1,0
180190,902,1,283,248,35,26,1,0
281055,1505,4,238,234,4,8,1,0
31530,315,4,72,69,3,3,1,0
394960,2124,3,239,205,34,10,1,0
70961,534,3,131,105,26,6,1,0
23681,160,9,14,9,5,0,1,0
0,0,0,0,0,0,0,0,0
0,0,0,0,0,0,0,0,0
0,0,0,0,0,0,0,0,0
390590,3051,5,252,203,49,221,0,0
456940,1065,7,114,110,4,5,1,0
0,0,0,0,0,0,0,0,0
23470,37,0,2,1,1,0,1,0
29908,138,9,14,13,1,0,1,0
457393,2497,6,543,496,47,5,1,0
574891,1995,3,617,591,26,2,1,0
387050,2319,4,557,531,26,7,1,0
0,0,0,0,0,0,0,0,0
121850,1867,4,257,211,46,10,1,0
195788,2499,5,598,596,2,1,1,0
0,0,0,0,0,0,0,0,0
214028,1483,9,190,146,44,19,0,0
75868,2040,2,572,568,4,1,1,0
140580,974,3,160,159,1,0,1,0
0,0,0,0,0,0,0,0,0
54110,724,1,128,117,11,1,0,0
98218,959,3,58,43,15,0,1,0
983204,4512,9,666,639,27,93,1,0
1019035,3861,8,651,583,68,111,1,0
982786,5789,6,1035,981,54,12,1,0
119477,1925,2,226,210,16,1,0,0
0,0,0,0,0,0,0,0,0
114484,896,1,211,135,76,3,1,0
412811,3198,13,849,823,26,14,0,0
386666,3045,13,912,882,30,32,0,0
3016,31,2,5,4,1,0,1,0
5303,68,1,3,0,3,1,1,0
0,0,0,0,0,0,0,0,0
9812,164,0,41,40,1,0,0,0
87102,541,11,104,98,6,33,1,0
93383,453,4,80,80,0,0,1,0
407373,3493,12,661,127,534,9,1,0
388045,2936,12,681,582,99,5,1,0
106334,1243,0,354,354,0,0,1,0
16478,224,0,53,53,0,0,1,0
0,0,0,0,0,0,0,0,0
84354,171,4,7,7,0,2,0,0
0,0,0,0,0,0,0,0,0
370466,1446,12,233,203,30,14,1,0
238806,676,12,128,98,30,11,1,0
720667,1674,2,200,159,41,11,1,0
432694,3580,10,460,429,31,8,1,0
122945,2201,2,756,752,4,1,1,0
1834309,853,7,57,48,9,7,1,0
0,0,0,0,0,0,0,0,0
0,0,0,0,0,0,0,0,0
0,0,0,0,0,0,0,0,0
0,0,0,0,0,0,0,0,0
105200,90,0,14,13,1,6,0,0
255243,2223,10,298,279,19,8,1,0
0,0,0,0,0,0,0,0,0
109441,422,4,106,90,16,1,1,0
9849,107,3,7,7,0,3,0,0
274367,1366,10,263,253,10,13,1,0
112237,792,7,239,222,17,0,1,0
96905,619,7,219,205,14,0,1,0
0,0,0,0,0,0,0,0,0
472532,5708,4,1118,1116,2,0,1,0
916841,521,10,27,25,2,4,1,0
0,0,0,0,0,0,0,0,0
862000,2666,9,322,68,254,51,1,0
0,0,0,0,0,0,0,0,0
81996,591,4,82,81,1,18,1,0
311391,799,4,113,112,1,51,1,0
207523,1603,8,389,375,14,18,1,0
190780,1288,9,192,183,9,19,1,0
1137267,9062,5,1962,1949,13,5,1,0
390430,1073,3,182,174,8,0,1,0
374584,895,3,158,150,8,0,1,0
604460,11945,5,3735,3734,1,6,1,1
544800,10869,5,3543,3531,12,5,1,0
51079,237,1,23,1,22,3,1,0
52097,246,0,16,8,8,3,0,0
175306,1710,8,470,460,10,8,1,0
108925,538,8,80,66,14,3,0,0
182932,311,7,33,25,8,4,0,0
0,0,0,0,0,0,0,0,0
364633,4027,10,391,352,39,13,1,0
87775,191,4,12,11,1,6,1,0
71936,540,8,98,88,10,6,1,0
0,0,0,0,0,0,0,0,0
365869,1885,3,146,146,0,16,1,0
47750,253,2,31,31,0,5,1,0
46701,445,4,17,10,7,4,1,0
46718,445,4,17,10,7,4,1,0
0,0,0,0,0,0,0,0,0
36004,481,7,54,50,4,0,1,0
33530,405,9,52,48,4,2,1,0
354025,626,4,90,86,4,26,1,0
27502,427,4,40,30,10,0,1,0
0,0,0,0,0,0,0,0,0
473428,3838,5,442,427,15,13,1,0
91023,610,5,173,172,1,13,1,0
1418448,4036,10,586,536,50,10,1,0
285242,4031,7,953,865,88,81,1,0
5408,76,3,4,4,0,0,0,0
0,0,0,0,0,0,0,0,0
0,0,0,0,0,0,0,0,0
0,0,0,0,0,0,0,0,0
0,0,0,0,0,0,0,0,0
147946,979,6,274,249,25,0,1,0
0,0,0,0,0,0,0,0,0
0,0,0,0,0,0,0,0,0
561135,3296,4,364,353,11,3,0,0
0,0,0,0,0,0,0,0,0
473385,1066,2,45,6,39,7,0,0
260917,907,8,42,41,1,11,1,0
0,0,0,0,0,0,0,0,0
128074,1937,6,287,281,6,4,1,0
0,0,0,0,0,0,0,0,0
109150,1268,9,162,145,17,5,1,0
197265,708,10,89,74,15,10,0,0
0,0,0,0,0,0,0,0,0
1423519,3060,12,381,368,13,20,1,0
0,0,0,0,0,0,0,0,0
1148513,2719,9,334,292,42,3,1,0
29717,138,5,8,7,1,3,0,0
76210,488,13,72,61,11,3,1,0
0,0,0,0,0,0,0,0,0
445392,1131,2,96,84,12,1,1,0
0,0,0,0,0,0,0,0,0
0,0,0,0,0,0,0,0,0
4796970,4758,2,474,289,185,14,1,0
457380,2316,9,483,481,2,20,1,0
0,0,0,0,0,0,0,0,0
0,0,0,0,0,0,0,0,0
504203,1423,4,187,174,13,23,1,0
0,0,0,0,0,0,0,0,0
0,0,0,0,0,0,0,0,0
365417,2337,7,305,57,248,108,1,0
393624,3627,8,781,738,43,5,1,0
0,0,0,0,0,0,0,0,0
0,0,0,0,0,0,0,0,0
0,0,0,0,0,0,0,0,0
171291,537,5,46,42,4,8,1,0
355383,1740,2,237,209,28,2,1,0
208304,944,2,37,18,19,2,1,0
286543,3033,6,830,800,30,19,1,0
153277,1704,8,505,500,5,12,1,0
526443,932,12,223,206,17,2,1,0
56013,589,3,100,97,3,5,1,0
0,0,0,0,0,0,0,0,0
0,0,0,0,0,0,0,0,0
0,0,0,0,0,0,0,0,0
116226,719,5,94,86,8,8,1,0
0,0,0,0,0,0,0,0,0
0,0,0,0,0,0,0,0,0
1632,11,0,1,1,0,0,0,0
133645,686,3,101,89,12,0,1,0
0,0,0,0,0,0,0,0,0
64967,413,4,66,44,22,2,0,0
1302125,6009,2,472,432,40,3,1,0
0,0,0,0,0,0,0,0,0
711133,3302,4,369,345,24,5,1,0
294311,1768,4,123,121,2,5,0,0
205786,2273,2,929,924,5,2,1,0
695070,3894,15,618,450,168,16,1,0
170138,183,1,64,34,30,0,1,0
0,0,0,0,0,0,0,0,0
0,0,0,0,0,0,0,0,0
0,0,0,0,0,0,0,0,0
0,0,0,0,0,0,0,0,0
100537,653,11,103,92,11,4,1,0
203180,1982,6,369,352,17,46,1,0
103805,387,5,16,15,1,41,1,0
68827,1269,4,413,412,1,1,1,0
74249,322,1,9,2,7,9,1,0
120678,1404,1,286,244,42,0,1,0
171689,1807,8,418,326,92,22,1,0
0,0,0,0,0,0,0,0,0
1547911,1323,2,169,158,11,0,1,0
377099,91,0,2,2,0,0,1,0
138496,1126,9,248,242,6,3,1,0
31936,395,8,81,75,6,1,1,0
0,0,0,0,0,0,0,0,0
0,0,0,0,0,0,0,0,0
0,0,0,0,0,0,0,0,0
299921,1665,9,60,51,9,15,1,0
3843229,5017,5,102,102,0,243,1,0
31031,181,5,11,9,2,6,0,0
0,0,0,0,0,0,0,0,0
475704,4035,4,364,318,46,7,1,0
484605,3277,9,243,221,22,20,0,0
223893,1246,17,244,237,7,11,1,0
131674,504,5,8,7,1,0,1,0
14442,213,4,72,72,0,3,1,0
234546,1159,8,149,137,12,1,1,0
18056,57,1,1,0,1,0,0,0
638961,1178,4,201,188,13,9,1,0
162673,1348,3,426,403,23,1,1,0
2967,30,0,3,2,1,0,1,0
24871,218,0,49,4,45,2,1,0
232133,2514,3,651,537,114,1,1,0
245069,987,1,74,39,35,0,0,0
0,0,0,0,0,0,0,0,0
0,0,0,0,0,0,0,0,0
145315,1843,6,113,99,14,12,1,0
1389793,1703,2,283,275,8,0,1,0
1264511,167,2,26,19,7,0,1,0
82134,797,5,114,111,3,7,0,0
611346,1734,4,272,262,10,7,0,0
1457875,4924,9,392,331,61,1,1,0
1808756,3553,7,267,257,10,28,1,0
350968,309,6,4,4,0,13,1,0
0,0,0,0,0,0,0,0,0
70426,413,7,52,52,0,0,1,0
222631,904,8,116,96,20,1,1,0
490437,4876,1,451,411,40,10,1,0
16262,212,2,26,23,3,4,1,0
20988,322,4,72,62,10,0,1,0
0,0,0,0,0,0,0,0,0
22891,666,3,270,232,38,0,1,0
387034,2030,2,270,250,20,4,1,0
269449,1234,2,135,117,18,1,1,0
336226,2448,1,224,184,40,32,0,0
418180,2842,5,600,17,583,3,1,0
214732,1801,4,246,246,0,11,1,0
551270,2524,1,141,133,8,25,1,0
100048,2032,2,439,431,8,8,1,0
388231,2565,8,247,242,5,25,1,0
190430,362,6,12,10,2,6,1,0
0,0,0,0,0,0,0,0,0
188496,1935,1,381,354,27,0,1,0
0,0,0,0,0,0,0,0,0
1669382,182,1,2,0,2,0,0,0
189107,679,1,113,113,0,0,1,0
694277,4848,7,835,821,14,41,1,0
242497,2147,4,510,465,45,7,1,0
65857,280,3,35,30,5,5,1,0
261967,1469,13,367,353,14,57,1,0
0,0,0,0,0,0,0,0,0
0,0,0,0,0,0,0,0,0
0,0,0,0,0,0,0,0,0
146717,1195,6,141,83,58,2,0,0
0,0,0,0,0,0,0,0,0
643760,484,2,72,63,9,5,1,0
259485,1290,9,277,266,11,13,1,0
64608,64,2,2,2,0,0,1,0
467441,1686,7,123,112,11,94,1,0
354196,1409,5,176,141,35,10,1,0
119866,843,7,142,71,71,4,0,0
73852,611,4,60,40,20,2,1,0
108506,125,2,5,3,2,0,1,0
0,0,0,0,0,0,0,0,0
77829,1119,5,240,69,171,5,1,0
0,0,0,0,0,0,0,0,0
194722,1671,3,384,375,9,11,1,0
825785,4375,7,1144,1097,47,102,0,0
0,0,0,0,0,0,0,0,0
1084002,3644,1,263,170,93,5,1,0
294895,311,0,12,6,6,2,1,0
104412,1069,8,221,201,20,3,1,0
22822,414,2,113,104,9,3,1,0
0,0,0,0,0,0,0,0,0
250630,1186,15,160,152,8,12,1,0
28543,95,1,6,4,2,10,0,0
0,0,0,0,0,0,0,0,0
2210844,1887,4,271,203,68,24,1,0
0,0,0,0,0,0,0,0,0
0,0,0,0,0,0,0,0,0
173248,1388,9,308,288,20,12,0,0
0,0,0,0,0,0,0,0,0
0,0,0,0,0,0,0,0,0
612699,2149,2,250,214,36,4,1,0
0,0,0,0,0,0,0,0,0
474913,1054,2,79,69,10,1,1,0
479358,1085,3,79,71,8,4,1,0
414875,4437,5,589,529,60,5,1,0
0,0,0,0,0,0,0,0,0
0,0,0,0,0,0,0,0,0
471364,2392,3,792,783,9,3,1,0
172129,2475,10,490,385,105,3,1,0
44164,161,3,3,3,0,1,0,0
814438,4529,6,464,430,34,84,1,0
6845,81,0,13,13,0,0,1,0
3754,50,2,8,8,0,0,0,0
5240,65,2,10,9,1,0,1,0
0,0,0,0,0,0,0,0,0
0,0,0,0,0,0,0,0,0
141222,1630,14,312,247,65,9,1,0
445405,2670,10,669,581,88,12,0,0
192600,478,9,104,90,14,13,0,0
0,0,0,0,0,0,0,0,0
58820,584,7,141,114,27,13,1,0
12602,215,2,38,36,2,0,1,0
12697,227,2,38,36,2,0,1,0
891164,1883,11,186,167,19,28,1,0
382340,5042,3,1453,1450,3,21,0,0
16643,157,3,22,22,0,0,0,0
9762,247,0,77,54,23,0,1,0
202368,1059,16,135,124,11,18,1,0
1948329,6595,9,1333,1197,136,22,0,0
56535,705,3,87,74,13,8,1,0
161073,2228,6,668,667,1,20,1,0
189678,613,5,48,16,32,2,1,0
1406120,13029,5,303,119,184,19,1,0
62438,536,10,120,95,25,5,1,0
338467,1224,10,182,168,14,19,1,0
1969,28,2,2,1,1,0,1,0
0,0,0,0,0,0,0,0,0
0,0,0,0,0,0,0,0,0
485876,2856,6,299,283,16,2,1,0
0,0,0,0,0,0,0,0,0
410617,2958,7,325,278,47,14,1,1
128976,205,7,8,8,0,2,0,0
166016,1834,9,336,325,11,4,1,0
93614,713,9,157,146,11,6,1,0
326563,1652,7,382,351,31,8,1,0
0,0,0,0,0,0,0,0,0
88952,766,1,145,142,3,0,0,0
356478,890,3,89,75,14,2,1,0
51211,433,7,44,24,20,0,1,0
199203,2383,5,217,102,115,9,1,0
30993,216,5,36,32,4,3,1,0
86666,585,1,89,86,3,5,1,0
0,0,0,0,0,0,0,0,0
0,0,0,0,0,0,0,0,0
185265,974,6,92,5,87,2,1,0
0,0,0,0,0,0,0,0,0
0,0,0,0,0,0,0,0,0
0,0,0,0,0,0,0,0,0
0,0,0,0,0,0,0,0,0
0,0,0,0,0,0,0,0,0
204680,1691,6,458,220,238,14,1,0
60749,972,2,258,224,34,0,0,0
7166,111,2,23,15,8,0,0,0
156507,1316,1,710,659,51,1,1,0
86781,607,2,7,7,0,3,0,0
0,0,0,0,0,0,0,0,0
206558,832,9,134,98,36,1,1,0
0,0,0,0,0,0,0,0,0
99458,926,10,167,119,48,3,1,0
0,0,0,0,0,0,0,0,0
0,0,0,0,0,0,0,0,0
0,0,0,0,0,0,0,0,0
4429679,2029,0,83,81,2,0,1,0
67731,320,1,16,12,4,2,1,0
226959,593,10,88,81,7,14,1,0
166496,1014,2,122,104,18,3,1,0
0,0,0,0,0,0,0,0,0
406660,917,5,63,55,8,8,1,0
425474,1084,5,64,56,8,9,1,0
12099,234,1,73,73,0,0,1,0
12274,126,4,23,19,4,0,1,0
13007,142,4,24,20,4,0,1,0
0,0,0,0,0,0,0,0,0
710187,6245,6,591,572,19,143,1,0
0,0,0,0,0,0,0,0,0
197064,2032,16,446,369,77,20,1,0
31120,158,6,8,7,1,5,0,0
40915,239,5,17,17,0,0,1,0
12409,134,4,14,14,0,0,1,0
55873,477,5,71,67,4,0,1,0
15217,175,3,43,41,2,3,1,0
11182,118,5,14,13,1,0,1,0
661677,2308,7,475,394,81,6,1,0
78553,406,3,62,21,41,4,1,0
140466,810,4,71,69,2,63,1,0
0,0,0,0,0,0,0,0,0
613459,4343,8,564,542,22,4,1,0
144633,689,4,73,55,18,2,1,0
144645,689,4,73,55,18,2,1,0
617854,3209,3,274,248,26,129,1,0
52922,161,2,6,6,0,2,1,0
155087,801,7,134,133,1,13,0,0
254589,1614,10,264,229,35,4,1,0
949621,4191,11,432,420,12,19,1,0
19805,104,0,2,2,0,2,0,0
1472203,1271,2,176,167,9,4,1,0
355424,101,0,3,3,0,0,1,0
35302,519,4,195,194,1,0,1,0
10598,165,4,38,37,1,0,1,0
99452,512,7,40,34,6,10,1,0
26832,172,8,27,19,8,1,1,0
403778,1849,8,124,109,15,24,1,0
88117,67,0,9,4,5,5,0,0
250001,992,4,198,194,4,8,1,0
0,0,0,0,0,0,0,0,0
0,0,0,0,0,0,0,0,0
253105,1882,3,560,509,51,7,0,0
0,0,0,0,0,0,0,0,0
601743,3686,4,644,629,15,7,1,0
0,0,0,0,0,0,0,0,0
0,0,0,0,0,0,0,0,0
0,0,0,0,0,0,0,0,0
0,0,0,0,0,0,0,0,0
49149,542,6,322,317,5,17,1,0
280075,1538,6,186,179,7,46,1,0
232699,343,0,17,11,6,0,1,0
0,0,0,0,0,0,0,0,0
58167,512,5,206,5,201,0,1,0
1018759,2201,6,309,236,73,6,1,0
143409,1297,7,262,238,24,7,1,0
5561,51,4,5,5,0,0,1,0
86521,444,8,9,8,1,1,1,0
410481,1963,24,273,178,95,19,0,0
0,0,0,0,0,0,0,0,0
124486,843,14,92,76,16,12,1,0
993984,9563,4,3677,1638,2039,0,1,1
0,0,0,0,0,0,0,0,0
108319,683,7,178,172,6,5,0,0
0,0,0,0,0,0,0,0,0
269103,1459,1,223,192,31,7,1,0
0,0,0,0,0,0,0,0,0
427146,1199,2,240,197,43,3,1,0
226438,195,0,17,6,11,5,1,0
11808,178,3,26,18,8,0,1,0
266102,3263,5,538,8,530,17,0,0
645708,14896,6,127,124,3,17,1,0
9036,217,3,56,56,0,1,1,0
256543,1281,13,175,161,14,4,1,0
49860,481,5,44,42,2,6,0,0
114051,1138,8,263,263,0,9,1,0
0,0,0,0,0,0,0,0,0
73877,778,12,199,135,64,0,1,0
264995,2701,1,335,215,120,3,0,0
305795,1173,2,171,113,58,1,1,0
0,0,0,0,0,0,0,0,0
0,0,0,0,0,0,0,0,0
0,0,0,0,0,0,0,0,0
212190,3303,7,740,684,56,4,0,0
110886,1917,6,410,405,5,4,0,0
202310,1625,8,330,327,3,15,1,0
7402,60,4,3,3,0,1,1,0
23741,418,3,118,108,10,0,1,0
0,0,0,0,0,0,0,0,0
0,0,0,0,0,0,0,0,0
136638,1780,9,228,152,76,5,1,0
58509,421,7,80,66,14,4,1,0
186996,750,10,87,73,14,20,1,0
0,0,0,0,0,0,0,0,0
35627,371,0,82,78,4,0,1,0
219647,1921,4,96,35,61,6,1,0
149954,370,6,5,3,2,10,0,0
334227,1723,4,334,310,24,14,1,0
281831,857,15,155,145,10,27,1,0
0,0,0,0,0,0,0,0,0
0,0,0,0,0,0,0,0,0
0,0,0,0,0,0,0,0,0
75585,339,2,28,25,3,8,1,0
37538,471,4,79,67,12,0,1,0
0,0,0,0,0,0,0,0,0
41994,572,3,105,97,8,0,1,0
31901,245,3,60,56,4,0,1,0
0,0,0,0,0,0,0,0,0
720804,2811,1,422,313,109,30,1,0
0,0,0,0,0,0,0,0,0
95195,989,0,357,353,4,0,0,0
0,0,0,0,0,0,0,0,0
191419,911,1,104,96,8,1,1,0
93170,1681,7,91,86,5,0,1,0
40168,356,9,24,20,4,6,1,0
336949,2849,4,710,697,13,8,1,0
77891,1301,2,467,456,11,5,1,0
0,0,0,0,0,0,0,0,0
0,0,0,0,0,0,0,0,0
101841,1086,6,219,209,10,12,1,0
0,0,0,0,0,0,0,0,0
35572,279,0,48,48,0,2,1,0
0,0,0,0,0,0,0,0,0
244077,1163,4,167,155,12,2,1,0
0,0,0,0,0,0,0,0,0
130199,863,9,32,10,22,0,1,0
302269,1521,8,119,63,56,9,1,0
50958,175,6,4,3,1,0,0,0
603166,1997,9,277,187,90,26,1,0
42231,296,5,83,62,21,0,0,0
231611,341,0,17,10,7,0,1,0
0,0,0,0,0,0,0,0,0
143766,601,8,52,51,1,17,0,0
441756,1094,10,232,222,10,15,1,0
150774,1223,8,216,211,5,17,1,0
120470,899,6,175,171,4,17,1,0
302798,1521,11,137,110,27,18,1,0
211067,623,11,54,48,6,18,1,0
424383,3459,13,415,403,12,34,0,0
0,0,0,0,0,0,0,0,0
94282,80,3,2,0,2,2,0,0
569000,2312,5,359,349,10,17,0,0
333018,2240,5,301,280,21,7,0,0
0,0,0,0,0,0,0,0,0
554374,2842,11,446,439,7,24,1,1
0,0,0,0,0,0,0,0,0
185141,1268,3,229,224,5,0,1,0
0,0,0,0,0,0,0,0,0
34337,603,4,133,127,6,0,1,0
197498,285,5,69,63,6,2,1,0
55501,633,4,44,43,1,0,1,0
21989,214,5,21,21,0,4,1,0
19738,304,3,45,40,5,2,0,0
287734,886,6,222,209,13,16,0,0
0,0,0,0,0,0,0,0,0
176843,1245,1,85,50,35,1,1,0
0,0,0,0,0,0,0,0,0
134984,1037,0,55,40,15,10,1,0
141151,1214,12,261,235,26,9,1,0
0,0,0,0,0,0,0,0,0
0,0,0,0,0,0,0,0,0
0,0,0,0,0,0,0,0,0
0,0,0,0,0,0,0,0,0
49338,548,6,75,63,12,3,0,0
0,0,0,0,0,0,0,0,0
0,0,0,0,0,0,0,0,0
183169,2213,3,763,743,20,3,0,0
461629,2797,13,424,406,18,18,1,0
998106,6097,11,1633,1588,45,264,1,0
51164,123,2,1,1,0,0,1,0
201676,1236,7,51,31,20,13,1,0
16105,114,4,4,2,2,4,0,0
106719,786,4,178,175,3,9,1,0
0,0,0,0,0,0,0,0,0
18056,57,1,1,0,1,0,0,0
0,0,0,0,0,0,0,0,0
255884,2342,5,312,268,44,6,1,0
47742,349,4,48,27,21,1,0,0
0,0,0,0,0,0,0,0,0
118464,984,8,101,95,6,34,1,0
4651532,3742,7,381,328,53,6,1,0
1026028,1145,8,225,185,40,5,1,0
0,0,0,0,0,0,0,0,0
0,0,0,0,0,0,0,0,0
16736,272,1,48,36,12,1,1,0
68772,845,4,227,112,115,3,1,0
124312,644,2,194,191,3,14,1,0
441053,2524,1,185,168,17,1,1,0
569,7,0,0,0,0,0,0,0
0,0,0,0,0,0,0,0,0
224667,2680,10,306,292,14,41,1,0
82390,619,9,86,71,15,36,1,0
178798,763,2,21,19,2,0,1,0
0,0,0,0,0,0,0,0,0
24209,172,1,23,14,9,3,1,0
235793,1233,9,268,262,6,14,1,0
56852,355,5,33,32,1,10,1,0
431062,1591,5,304,283,21,9,1,0
69758,777,1,60,46,14,0,0,0
4097,48,3,1,1,0,4,0,0
169630,1155,4,251,237,14,13,1,0
0,0,0,0,0,0,0,0,0
0,0,0,0,0,0,0,0,0
361620,2132,13,238,218,20,18,0,0
0,0,0,0,0,0,0,0,0
0,0,0,0,0,0,0,0,0
84809,575,6,79,35,44,1,1,0
178272,1250,4,164,2,162,0,1,0
1094492,8362,5,595,549,46,4,1,0
0,0,0,0,0,0,0,0,0
26144,247,0,37,27,10,4,1,0
804870,2085,7,178,167,11,4,1,0
777373,220,6,2,2,0,3,1,0
496213,1628,5,104,93,11,0,1,0
29051,101,2,2,0,2,0,1,0
0,0,0,0,0,0,0,0,0
138164,1088,6,115,67,48,7,1,0
257378,824,4,75,62,13,7,1,0
74729,78,1,3,3,0,0,1,0
0,0,0,0,0,0,0,0,0
418110,2813,5,594,17,577,4,1,0
15457,125,8,23,21,2,0,1,0
0,0,0,0,0,0,0,0,0
55607,392,8,57,51,6,20,1,0
171424,1212,11,270,171,99,3,1,0
0,0,0,0,0,0,0,0,0
68019,630,7,111,102,9,13,1,0
0,0,0,0,0,0,0,0,0
535907,3738,5,684,681,3,7,1,0
128259,181,2,14,13,1,0,1,0
247035,4193,1,1984,1975,9,27,1,0
460608,1846,6,140,138,2,0,1,0
209062,892,3,160,147,13,27,1,0
1032553,906,2,50,46,4,0,1,0
250282,1443,2,219,187,32,3,1,0
0,0,0,0,0,0,0,0,0
39732,404,5,44,38,6,8,1,0
20153,214,2,62,62,0,0,1,0
90666,686,0,133,129,4,6,1,0
87444,610,0,133,129,4,5,1,0
224000,2643,7,315,293,22,2,0,0
6550,60,3,6,6,0,2,0,0
388368,2378,7,484,417,67,6,1,0
15002,163,3,24,3,21,0,1,0
275072,885,8,88,56,32,4,1,0
8781,96,6,0,0,0,5,0,0
0,0,0,0,0,0,0,0,0
21203,301,1,15,15,0,1,1,0
261973,1647,4,367,276,91,17,1,0
0,0,0,0,0,0,0,0,0
5473199,36619,3,3528,2011,1517,7,1,0
47106,132,8,3,0,3,0,1,0
150743,479,1,56,50,6,23,1,0
12735,222,1,10,9,1,0,0,0
188207,925,5,187,172,15,3,1,0
3094346,13314,9,393,377,16,23,0,0
264613,461,13,17,12,5,18,0,0
210344,776,4,105,103,2,0,0,0
728972,4086,3,678,660,18,8,0,0
169493,973,7,139,134,5,7,1,0
83862,239,3,11,11,0,0,1,0
362731,1893,9,330,275,55,30,1,1
0,0,0,0,0,0,0,0,0
78978,964,5,237,235,2,1,1,0
133952,95,1,2,2,0,0,1,0
753596,3452,3,590,546,44,3,1,0
240088,677,3,96,4,92,0,1,0
421144,1275,1,254,187,67,2,1,0
39784,441,0,88,80,8,2,1,0
92563,233,7,24,19,5,1,1,0
13535,114,4,6,6,0,0,0,0
0,0,0,0,0,0,0,0,0
0,0,0,0,0,0,0,0,0
0,0,0,0,0,0,0,0,0
412953,3386,2,956,814,142,0,1,0
21953,239,6,38,32,6,1,1,0
0,0,0,0,0,0,0,0,0
1113236,2086,10,305,289,16,37,1,0
254319,1788,4,390,385,5,14,0,0
0,0,0,0,0,0,0,0,0
42349,405,6,59,52,7,5,1,0
245078,495,1,184,104,80,2,1,0
168690,170,0,73,52,21,0,1,0
0,0,0,0,0,0,0,0,0
0,0,0,0,0,0,0,0,0
47668,647,5,76,63,13,4,1,0
3039,21,2,0,0,0,0,0,0
216634,1548,6,418,407,11,12,1,0
358555,1110,15,105,100,5,20,1,0
0,0,0,0,0,0,0,0,0
1116595,5174,13,1320,1302,18,29,1,0
719867,1295,10,197,136,61,20,1,0
270620,3625,0,383,307,76,9,0,0
95028,665,6,70,40,30,2,1,0
90054,259,0,48,24,24,0,1,1
0,0,0,0,0,0,0,0,0
236174,1815,6,281,261,20,9,0,1
164150,3930,3,1090,1074,16,10,1,0
247601,229,1,12,7,5,3,1,0
26009,160,1,7,7,0,2,0,0
527668,2948,1,169,84,85,6,0,0
73391,265,3,20,8,12,1,0,0
0,0,0,0,0,0,0,0,0
72526,565,5,119,97,22,42,1,0
0,0,0,0,0,0,0,0,0
0,0,0,0,0,0,0,0,0
101979,2012,3,613,554,59,17,1,0
40382,657,0,144,137,7,3,1,0
24811,425,3,85,76,9,7,0,0
0,0,0,0,0,0,0,0,0
3240,39,0,7,7,0,0,0,0
226128,2568,8,761,716,45,18,1,0
24892,195,6,27,27,0,0,1,0
221390,572,3,101,92,9,12,1,0
0,0,0,0,0,0,0,0,0
463168,2098,8,258,245,13,24,1,0
0,0,0,0,0,0,0,0,0
532128,2704,11,203,193,10,19,1,0
0,0,0,0,0,0,0,0,0
239614,1436,6,246,214,32,13,1,0
114854,262,4,13,13,0,2,1,0
0,0,0,0,0,0,0,0,0
0,0,0,0,0,0,0,0,0
0,0,0,0,0,0,0,0,0
106313,1354,8,264,188,76,2,0,0
0,0,0,0,0,0,0,0,0
0,0,0,0,0,0,0,0,0
516979,1096,7,150,141,9,28,1,0
466830,1441,11,207,199,8,20,1,0
313404,2232,6,330,60,270,2,1,0
211388,101,6,2,0,2,0,1,0
0,0,0,0,0,0,0,0,0
303275,1346,8,203,194,9,34,1,0
137119,1789,7,474,443,31,14,1,0
37219,308,7,66,56,10,5,0,0
120599,1121,4,181,169,12,14,1,0
0,0,0,0,0,0,0,0,0
0,0,0,0,0,0,0,0,0
331099,2370,7,412,387,25,44,1,0
102431,333,6,13,9,4,15,1,0
0,0,0,0,0,0,0,0,0
0,0,0,0,0,0,0,0,0
0,0,0,0,0,0,0,0,0
36828,475,7,103,94,9,3,1,0
84515,653,6,97,95,2,12,1,0
54842,320,5,26,24,2,11,1,0
0,0,0,0,0,0,0,0,0
17205,152,3,3,3,0,0,0,0
0,0,0,0,0,0,0,0,0
34306,301,7,33,10,23,6,0,0
27066,119,7,3,2,1,6,0,0
502658,2465,3,280,251,29,26,1,0
758142,1068,2,140,136,4,0,1,0
380250,127,2,9,8,1,2,1,0
518533,2019,6,363,334,29,31,1,0
36669,685,0,126,93,33,0,1,0
14361,275,0,70,59,11,1,1,0
0,0,0,0,0,0,0,0,0
0,0,0,0,0,0,0,0,0
0,0,0,0,0,0,0,0,0
0,0,0,0,0,0,0,0,0
210450,856,9,143,129,14,15,1,0
659186,2339,7,529,414,115,10,1,0
2999,46,3,3,3,0,0,0,0
231421,1898,6,402,395,7,4,0,0
83753,840,6,86,71,15,1,1,0
1159512,4017,9,424,352,72,16,1,0
402502,1522,18,309,293,16,24,1,0
31132,589,0,49,27,22,0,1,0
2856,53,0,4,2,2,0,0,0
174766,3323,2,816,813,3,13,1,0
115470,1239,7,335,324,11,8,1,0
0,0,0,0,0,0,0,0,0
19677,384,3,63,59,4,3,1,0
8018,88,1,11,10,1,1,1,0
185233,1395,6,280,257,23,12,1,0
0,0,0,0,0,0,0,0,0
69311,734,6,259,258,1,6,1,0
253869,696,6,22,11,11,50,1,0
46463,527,8,65,65,0,6,1,0
0,0,0,0,0,0,0,0,0
769382,1395,5,81,36,45,3,1,0
146141,529,3,50,42,8,3,0,0
73810,157,7,6,6,0,8,1,0
57150,305,6,0,0,0,11,0,0
313617,1967,3,80,79,1,60,0,0
1205266,2035,5,415,346,69,64,1,0
511159,1409,5,196,157,39,10,1,0
361530,2453,10,323,317,6,17,1,0
34995,248,5,47,4,43,5,1,0
32592,229,5,45,22,23,5,1,0
22565,34,0,1,1,0,0,1,0
65176,1699,1,357,353,4,0,0,0
0,0,0,0,0,0,0,0,0
0,0,0,0,0,0,0,0,0
13042,155,2,30,30,0,2,1,0
297222,2203,3,539,415,124,6,1,0
436066,6640,10,1508,1167,341,7,1,0
0,0,0,0,0,0,0,0,0
0,0,0,0,0,0,0,0,0
0,0,0,0,0,0,0,0,0
0,0,0,0,0,0,0,0,0
0,0,0,0,0,0,0,0,0
208598,3234,5,600,41,559,10,0,1
62396,586,5,92,28,64,11,0,0
0,0,0,0,0,0,0,0,0
899678,898,5,73,55,18,3,1,0
0,0,0,0,0,0,0,0,0
0,0,0,0,0,0,0,0,0
0,0,0,0,0,0,0,0,0
111760,245,3,69,31,38,3,0,0
7683,86,1,6,3,3,0,0,0
0,0,0,0,0,0,0,0,0
0,0,0,0,0,0,0,0,0
0,0,0,0,0,0,0,0,0
2896888,9424,2,682,649,33,134,1,0
0,0,0,0,0,0,0,0,0
0,0,0,0,0,0,0,0,0
159614,1284,3,286,251,35,34,1,0
556441,1782,1,268,140,128,11,1,0
79645,112,1,10,7,3,2,0,0
144009,961,8,175,158,17,4,1,0
21289,229,3,33,30,3,6,1,0
371102,1230,7,133,117,16,2,1,0
0,0,0,0,0,0,0,0,0
84269,1053,5,213,189,24,3,0,0
0,0,0,0,0,0,0,0,0
271871,3047,7,467,461,6,3,1,0
64453,627,7,179,174,5,3,1,0
0,0,0,0,0,0,0,0,0
852707,5014,20,960,934,26,43,1,0
853936,5016,20,960,934,26,43,1,0
0,0,0,0,0,0,0,0,0
98967,785,10,112,105,7,7,0,0
180944,1401,8,314,307,7,15,1,0
0,0,0,0,0,0,0,0,0
52007,143,2,108,107,1,0,0,0
0,0,0,0,0,0,0,0,0
172495,1457,7,249,226,23,18,1,0
309569,2345,7,329,320,9,45,0,0
72922,893,4,165,134,31,2,0,0
594417,1613,10,127,112,15,1,1,0
317768,2379,4,362,340,22,14,1,0
21645,120,5,2,1,1,11,1,0
141694,332,2,0,0,0,0,1,0
73715,67,3,0,0,0,6,0,0
265606,1205,6,121,85,36,12,0,0
447498,3277,3,539,484,55,2,1,0
39538,189,5,5,5,0,6,1,0
0,0,0,0,0,0,0,0,0
297855,1039,1,248,192,56,1,0,0
0,0,0,0,0,0,0,0,0
0,0,0,0,0,0,0,0,0
0,0,0,0,0,0,0,0,0
237577,1743,12,493,478,15,4,0,0
605505,3163,2,297,285,12,1,1,0
502558,2767,2,38,30,8,1,1,0
0,0,0,0,0,0,0,0,0
253000,1358,7,187,176,11,24,1,0
92711,983,4,158,151,7,6,1,0
33694,245,4,57,57,0,0,1,0
0,0,0,0,0,0,0,0,0
179799,579,13,74,62,12,6,1,0
1771234,6075,5,364,353,11,0,1,0
0,0,0,0,0,0,0,0,0
0,0,0,0,0,0,0,0,0
0,0,0,0,0,0,0,0,0
0,0,0,0,0,0,0,0,0
287569,3051,4,732,683,49,130,1,0
103587,873,7,108,100,8,7,1,0
307086,1936,7,431,413,18,27,1,0
472408,5339,5,1400,1373,27,8,1,0
338783,3697,5,1188,1159,29,13,1,0
0,0,0,0,0,0,0,0,0
385732,4330,8,565,544,21,9,1,0
58806,446,8,61,52,9,5,1,0
0,0,0,0,0,0,0,0,0
1252212,6013,7,384,371,13,79,1,0
0,0,0,0,0,0,0,0,0
101844,512,4,27,24,3,1,1,0
2500,36,0,4,4,0,0,0,0
196494,1396,4,208,188,20,1,1,0
0,0,0,0,0,0,0,0,0
0,0,0,0,0,0,0,0,0
0,0,0,0,0,0,0,0,0
260407,1761,7,506,464,42,6,1,0
92346,231,5,31,29,2,3,1,0
21895,35,0,1,1,0,0,1,0
0,0,0,0,0,0,0,0,0
0,0,0,0,0,0,0,0,0
0,0,0,0,0,0,0,0,0
296578,1213,5,156,143,13,13,0,0
0,0,0,0,0,0,0,0,0
55837,338,9,37,8,29,1,1,0
0,0,0,0,0,0,0,0,0
157995,651,7,145,144,1,5,1,0
0,0,0,0,0,0,0,0,0
0,0,0,0,0,0,0,0,0
0,0,0,0,0,0,0,0,0
1237957,7224,6,2522,2215,307,11,1,0
486171,2404,9,239,165,74,26,1,0
0,0,0,0,0,0,0,0,0
201578,2897,8,486,295,191,3,0,0
59888,500,7,67,42,25,2,0,0
0,0,0,0,0,0,0,0,0
0,0,0,0,0,0,0,0,0
255505,1661,9,256,105,151,2,1,0
0,0,0,0,0,0,0,0,0
0,0,0,0,0,0,0,0,0
45082,253,8,87,82,5,0,0,0
168745,1164,8,196,146,50,5,1,0
0,0,0,0,0,0,0,0,0
0,0,0,0,0,0,0,0,0
8678,70,6,3,2,1,0,0,0
17586,224,3,40,36,4,4,1,0
17580,224,3,40,36,4,4,1,0
0,0,0,0,0,0,0,0,0
198607,2363,11,380,373,7,3,1,0
0,0,0,0,0,0,0,0,0
1182177,4065,8,187,177,10,38,1,0
473640,4569,10,645,628,17,29,1,0
364138,6076,5,2089,1628,461,71,0,0
230528,340,0,16,3,13,0,1,0
363918,1154,12,149,137,12,38,1,0
174229,755,7,83,83,0,19,1,0
31533,403,5,44,39,5,2,0,0
2011077,9461,4,218,175,43,0,1,0
249182,709,2,53,11,42,4,1,0
0,0,0,0,0,0,0,0,0
0,0,0,0,0,0,0,0,0
193544,1848,9,301,273,28,3,1,0
130455,875,9,118,103,15,6,1,0
0,0,0,0,0,0,0,0,0
272747,1581,8,156,151,5,41,0,0
0,0,0,0,0,0,0,0,0
0,0,0,0,0,0,0,0,0
13522,158,0,20,11,9,1,1,0
227025,1472,7,237,195,42,5,1,0
117070,953,4,223,25,198,4,1,0
275498,837,4,67,46,21,2,1,0
1157423,7316,5,2930,2895,35,12,1,0
1125388,7085,5,2914,2880,34,14,1,0
25962,347,2,38,33,5,2,1,0
482534,4437,9,658,639,19,134,1,0
1125594,29921,3,9817,8,9809,11,0,0
0,0,0,0,0,0,0,0,0
394298,2792,3,383,364,19,2,1,0
180100,590,2,88,25,63,1,1,0
153778,782,3,122,114,8,2,1,0
0,0,0,0,0,0,0,0,0
0,0,0,0,0,0,0,0,0
0,0,0,0,0,0,0,0,0
112434,1613,4,336,325,11,2,1,0
327123,1428,11,192,181,11,10,1,0
0,0,0,0,0,0,0,0,0
0,0,0,0,0,0,0,0,0
136332,1398,4,249,238,11,2,1,0
67692,739,4,112,109,3,6,1,0
80171,968,4,127,106,21,20,1,0
1772150,1761,2,275,271,4,0,1,0
1206110,1275,7,98,0,98,2,1,0
11915,118,0,5,4,1,4,1,0
0,0,0,0,0,0,0,0,0
0,0,0,0,0,0,0,0,0
462337,1469,1,106,42,64,6,1,0
179727,1237,8,209,59,150,6,1,0
9712,153,2,25,25,0,0,1,0
38355,524,4,25,24,1,3,1,0
121212,957,7,221,198,23,12,1,0
72430,553,6,145,121,24,6,1,0
18518,318,3,35,26,9,0,1,0
217671,1372,11,341,309,32,9,1,0
49840,101,2,8,0,8,2,0,0
21947,33,0,1,1,0,0,1,0
437008,1866,6,185,157,28,6,1,0
73902,845,4,119,109,10,14,1,0
3422,53,1,3,3,0,0,0,0
0,0,0,0,0,0,0,0,0
216365,979,7,82,6,76,2,1,0
26592,482,5,82,64,18,0,0,0
458493,1494,5,147,134,13,42,1,0
387550,919,7,111,100,11,6,1,0
15105,101,2,7,7,0,0,0,0
285399,1679,5,224,200,24,7,0,0
0,0,0,0,0,0,0,0,0
157624,1363,4,313,298,15,4,1,1
49091,442,5,95,83,12,6,1,0
0,0,0,0,0,0,0,0,0
0,0,0,0,0,0,0,0,0
69334,490,8,113,104,9,6,1,0
34517,229,7,44,44,0,3,1,0
105993,974,7,81,61,20,2,1,0
0,0,0,0,0,0,0,0,0
223777,2005,0,307,299,8,2,0,0
204409,2168,3,83,50,33,62,1,0
0,0,0,0,0,0,0,0,0
110227,735,8,126,97,29,8,0,0
25589,290,6,49,44,5,2,0,0
0,0,0,0,0,0,0,0,0
69973,847,4,141,140,1,1,1,0
28046,42,0,2,1,1,0,0,0
181137,1053,7,202,179,23,1,1,0
364212,2447,12,407,391,16,19,1,0
109701,695,13,183,182,1,16,0,0
0,0,0,0,0,0,0,0,0
309521,1540,3,184,20,164,9,0,0
82787,416,4,103,100,3,0,1,0
22807,666,3,270,232,38,0,1,0
0,0,0,0,0,0,0,0,0
60884,531,10,102,101,1,0,0,0
287300,1809,13,199,195,4,16,1,0
0,0,0,0,0,0,0,0,0
22802,483,0,134,121,13,0,1,0
4772,97,0,17,15,2,0,1,0
0,0,0,0,0,0,0,0,0
510805,5149,4,962,659,303,4,0,0
8630,128,1,11,1,10,0,0,0
208834,1177,7,481,113,368,0,1,0
0,0,0,0,0,0,0,0,0
97425,758,6,131,128,3,24,1,0
117956,285,7,35,32,3,18,1,0
370689,1394,9,146,135,11,19,1,0
0,0,0,0,0,0,0,0,0
1188057,2171,9,439,345,94,25,1,0
0,0,0,0,0,0,0,0,0
108939,756,3,30,18,12,0,0,0
0,0,0,0,0,0,0,0,0
636832,1969,8,238,217,21,9,1,0
611866,1739,8,218,196,22,12,1,0
104322,1579,1,620,620,0,2,1,0
3310,55,1,11,11,0,0,1,0
296881,1053,1,249,244,5,1,0,0
168841,939,8,174,162,12,2,1,0
284502,3166,7,736,629,107,9,1,0
0,0,0,0,0,0,0,0,0
178437,2869,4,479,478,1,6,1,0
254754,773,11,139,111,28,36,1,0
1583629,3735,2,481,451,30,1,1,0
0,0,0,0,0,0,0,0,0
30991,421,7,118,115,3,5,1,0
0,0,0,0,0,0,0,0,0
133989,1020,9,193,151,42,14,0,0
664855,4187,4,353,353,0,3,1,0
53347,504,0,114,107,7,1,1,0
4488,42,2,3,3,0,0,0,0
0,0,0,0,0,0,0,0,0
0,0,0,0,0,0,0,0,0
93121,1260,3,82,76,6,2,1,0
19021,54,1,1,1,0,1,0,0
19319,203,3,48,32,16,2,1,0
17617,103,2,21,6,15,0,1,0
0,0,0,0,0,0,0,0,0
131280,894,8,113,91,22,13,1,0
7507,131,0,13,7,6,1,1,0
185472,1043,5,105,102,3,3,0,0
84498,308,11,46,44,2,9,0,0
27817,429,6,144,140,4,3,0,0
92467,1041,2,60,33,27,2,1,0
0,0,0,0,0,0,0,0,0
0,0,0,0,0,0,0,0,0
69369,236,9,40,26,14,2,1,0
15498,107,6,13,13,0,4,0,0
340842,1882,6,374,305,69,30,1,0
0,0,0,0,0,0,0,0,0
0,0,0,0,0,0,0,0,0
274994,2052,11,452,319,133,5,1,0
126657,290,2,12,1,11,0,0,0
0,0,0,0,0,0,0,0,0
5688006,2511,6,447,11,436,10,1,0
168187,2372,8,626,527,99,5,1,0
532225,3191,13,232,188,44,27,1,0
0,0,0,0,0,0,0,0,0
76873,800,2,205,188,17,7,1,0
0,0,0,0,0,0,0,0,0
823476,2044,10,297,287,10,14,1,0
483465,1225,9,120,104,16,27,1,0
14713,101,2,7,7,0,0,0,0
215272,1558,5,158,41,117,3,1,0
183842,3755,0,449,362,87,1,1,0
4127,81,1,11,10,1,0,0,0
0,0,0,0,0,0,0,0,0
432671,1486,7,126,119,7,9,1,0
73366,467,4,20,13,7,6,1,0
169693,981,2,305,280,25,1,1,0
177093,1773,11,357,313,44,27,0,0
23939,40,0,2,2,0,0,0,0
188390,917,3,187,17,170,5,0,0
484664,3255,6,683,655,28,5,1,0
5157693,38713,8,4114,2554,1560,18,1,0
47106,132,8,3,0,3,0,1,0
0,0,0,0,0,0,0,0,0
0,0,0,0,0,0,0,0,0
0,0,0,0,0,0,0,0,0
47893,299,4,47,28,19,6,1,0
175035,981,7,163,153,10,10,1,0
226892,941,4,162,155,7,1,1,0
226894,941,4,162,155,7,1,1,0
63523,696,1,173,166,7,0,0,0
299089,814,5,84,74,10,24,1,0
0,0,0,0,0,0,0,0,0
725891,6918,11,795,695,100,2,0,0
725889,6918,11,795,695,100,2,0,0
0,0,0,0,0,0,0,0,0
223088,1120,5,51,30,21,0,0,0
150177,1439,4,244,233,11,2,1,0
119670,568,12,51,47,4,4,1,1
0,0,0,0,0,0,0,0,0
230477,345,0,17,9,8,0,1,0
0,0,0,0,0,0,0,0,0
26274,34,0,2,1,1,0,0,0
260742,1361,5,229,206,23,31,1,0
365427,3093,7,260,248,12,17,1,0
246802,3011,2,366,250,116,11,1,0
45563,608,8,150,150,0,8,1,0
77864,609,8,71,63,8,4,1,0
0,0,0,0,0,0,0,0,0
232087,1695,4,291,120,171,8,1,0
0,0,0,0,0,0,0,0,0
45185,697,3,117,117,0,0,0,0
10720,140,3,21,21,0,0,0,0
962396,342,3,40,33,7,1,1,0
0,0,0,0,0,0,0,0,0
0,0,0,0,0,0,0,0,0
0,0,0,0,0,0,0,0,0
218693,1443,8,95,90,5,25,1,0
376410,2566,7,361,229,132,13,1,0
134845,242,3,13,10,3,2,0,0
417928,2693,4,382,5,377,8,1,0
0,0,0,0,0,0,0,0,0
318843,3284,6,547,539,8,4,1,0
0,0,0,0,0,0,0,0,0
0,0,0,0,0,0,0,0,0
36737,322,5,29,26,3,1,0,0
0,0,0,0,0,0,0,0,0
179865,1049,2,298,289,9,16,1,0
1546,26,0,0,0,0,0,0,0
333830,1464,8,148,131,17,10,1,0
222640,802,8,10,8,2,10,0,0
15153,287,3,37,33,4,0,1,0
10222,212,3,37,33,4,0,1,0
486332,4032,3,626,433,193,1,1,0
0,0,0,0,0,0,0,0,0
3858,76,0,0,0,0,0,1,0
275844,1960,1,351,45,306,4,1,0
276428,940,3,88,82,6,1,1,0
0,0,0,0,0,0,0,0,0
0,0,0,0,0,0,0,0,0
339747,2772,7,546,534,12,55,1,0
61493,860,1,238,230,8,1,1,0
0,0,0,0,0,0,0,0,0
0,0,0,0,0,0,0,0,0
167956,1172,8,278,274,4,10,0,0
1083546,191,5,20,14,6,1,1,0
0,0,0,0,0,0,0,0,0
344350,854,1,35,35,0,16,0,0
140674,420,9,93,69,24,2,1,0
534474,2779,14,221,191,30,10,1,0
366139,1836,13,196,178,18,10,1,0
188713,1146,8,269,165,104,19,1,0
166375,961,8,132,76,56,16,1,0
63725,787,2,196,164,32,0,0,0
0,0,0,0,0,0,0,0,0
164795,898,7,209,204,5,1,1,0
0,0,0,0,0,0,0,0,0
156393,580,5,139,139,0,21,1,0
0,0,0,0,0,0,0,0,0
215294,535,9,136,135,1,0,0,0
185737,87,9,2,2,0,0,1,0
0,0,0,0,0,0,0,0,0
0,0,0,0,0,0,0,0,0
234511,2599,6,473,456,17,16,1,0
330176,3219,8,453,423,30,6,1,1
421,8,0,0,0,0,0,0,0
0,0,0,0,0,0,0,0,0
60427,892,0,37,34,3,4,1,0
253309,1472,4,117,117,0,1,1,0
0,0,0,0,0,0,0,0,0
350030,1391,3,134,131,3,3,0,0
337264,96,6,6,4,2,0,1,0
315815,877,6,122,97,25,17,1,0
0,0,0,0,0,0,0,0,0
193229,1636,10,273,257,16,56,1,0
39884,197,6,14,13,1,5,0,0
0,0,0,0,0,0,0,0,0
451088,2726,2,445,397,48,5,1,0
163817,332,1,74,24,50,0,1,0
0,0,0,0,0,0,0,0,0
79839,590,13,99,94,5,4,1,0
26539,196,12,22,20,2,0,1,0
58786,458,3,121,118,3,11,0,0
9156,111,3,27,24,3,4,0,0
457469,2020,5,309,291,18,10,1,0
1004425,1648,5,273,269,4,268,1,0
79851,623,6,78,77,1,10,0,0
0,0,0,0,0,0,0,0,0
0,0,0,0,0,0,0,0,0
23689,331,10,79,73,6,2,1,0
491341,1853,2,305,292,13,4,1,0
0,0,0,0,0,0,0,0,0
6446,101,0,4,4,0,0,0,0
66571,858,1,303,278,25,0,1,0
11699,105,1,18,13,5,0,1,0
72989,762,2,138,132,6,4,0,0
0,0,0,0,0,0,0,0,0
927735,2342,10,306,290,16,27,1,0
0,0,0,0,0,0,0,0,0
216664,1377,2,230,229,1,4,1,1
310098,2292,2,333,245,88,45,1,0
0,0,0,0,0,0,0,0,0
295893,2622,9,262,251,11,0,1,0
18908,383,3,6,4,2,2,1,0
0,0,0,0,0,0,0,0,0
210825,3006,3,706,670,36,25,1,0
99793,1199,2,406,399,7,9,1,0
0,0,0,0,0,0,0,0,0
211828,1830,5,377,358,19,5,0,0
0,0,0,0,0,0,0,0,0
0,0,0,0,0,0,0,0,0
45179,619,7,189,188,1,1,0,0
232584,1299,17,273,264,9,6,1,0
232441,1299,17,273,264,9,6,1,0
0,0,0,0,0,0,0,0,0
0,0,0,0,0,0,0,0,0
0,0,0,0,0,0,0,0,0
12328,159,8,5,1,4,0,0,0
0,0,0,0,0,0,0,0,0
0,0,0,0,0,0,0,0,0
106028,1009,3,251,231,20,7,0,0
256558,1101,5,263,257,6,13,1,0
24020,330,3,68,63,5,0,1,0
649993,2406,9,209,179,30,8,1,0
54687,187,7,5,3,2,11,0,0
0,0,0,0,0,0,0,0,0
92136,921,9,130,123,7,6,1,0
681177,2025,3,165,156,9,11,1,0
527947,1150,3,4,4,0,6,0,0
321661,1698,6,279,247,32,4,0,0
692215,2781,7,150,105,45,11,1,0
369115,551,7,122,118,4,0,1,0
56649,307,2,3,2,1,2,0,0
0,0,0,0,0,0,0,0,0
0,0,0,0,0,0,0,0,0
0,0,0,0,0,0,0,0,0
787826,2700,9,420,394,26,49,0,0
290036,1198,16,183,92,91,24,1,0
0,0,0,0,0,0,0,0,0
142305,1904,10,344,338,6,2,0,0
75727,274,10,29,25,4,2,0,0
371366,3576,4,305,297,8,20,1,0
0,0,0,0,0,0,0,0,0
1445274,1567,3,195,182,13,20,1,0
0,0,0,0,0,0,0,0,0
0,0,0,0,0,0,0,0,0
310013,2730,8,350,169,181,15,1,0
177741,1719,7,202,37,165,14,0,0
344852,2298,6,439,392,47,19,0,0
12138,163,3,23,23,0,0,1,0
156453,2391,2,194,193,1,33,1,0
36806,485,3,137,135,2,2,1,0
1474820,2049,6,212,151,61,17,1,0
0,0,0,0,0,0,0,0,0
0,0,0,0,0,0,0,0,0
384893,2063,10,326,218,108,10,1,0
0,0,0,0,0,0,0,0,0
362910,1529,6,317,282,35,15,1,0
0,0,0,0,0,0,0,0,0
0,0,0,0,0,0,0,0,0
283318,823,5,87,76,11,2,1,0
0,0,0,0,0,0,0,0,0
0,0,0,0,0,0,0,0,0
37891,345,4,49,41,8,0,1,0
49408,374,6,165,165,0,9,1,0
2050661,11218,4,191,160,31,0,1,0
0,0,0,0,0,0,0,0,0
0,0,0,0,0,0,0,0,0
315628,2464,4,523,502,21,25,1,0
1432510,1202,2,156,149,7,4,1,0
354202,101,0,3,3,0,0,1,0
86052,657,3,185,175,10,11,1,0
235388,1949,5,427,401,26,14,1,0
285479,2529,11,516,476,40,28,1,0
0,0,0,0,0,0,0,0,0
53651,931,4,179,60,119,6,1,0
40158,640,3,149,46,103,6,1,0
89017,400,1,48,44,4,0,0,0
0,0,0,0,0,0,0,0,0
28282,233,0,32,25,7,3,1,0
789867,2879,1,285,229,56,3,1,0
0,0,0,0,0,0,0,0,0
0,0,0,0,0,0,0,0,0
0,0,0,0,0,0,0,0,0
617089,2022,2,345,288,57,2,1,0
157198,640,12,95,35,60,10,1,0
21042,93,0,15,10,5,4,0,0
7540,90,0,17,14,3,0,0,0
0,0,0,0,0,0,0,0,0
276307,3100,10,568,553,15,10,0,1
204671,1912,3,264,255,9,15,0,0
0,0,0,0,0,0,0,0,0
92815,979,5,187,170,17,17,0,0
0,0,0,0,0,0,0,0,0
0,0,0,0,0,0,0,0,0
198633,2449,1,515,508,7,0,1,0
101260,1035,1,259,252,7,0,1,0
352478,6219,13,965,946,19,28,1,0
0,0,0,0,0,0,0,0,0
361962,2438,4,437,380,57,13,1,0
70802,244,3,29,21,8,0,1,0
798174,1839,5,244,123,121,12,1,0
0,0,0,0,0,0,0,0,0
176856,1368,9,321,36,285,11,1,0
147789,841,8,192,187,5,11,1,0
0,0,0,0,0,0,0,0,0
0,0,0,0,0,0,0,0,0
0,0,0,0,0,0,0,0,0
0,0,0,0,0,0,0,0,0
217822,2862,1,608,601,7,0,1,0
99928,1037,1,265,258,7,0,1,0
324887,1907,2,182,131,51,37,1,0
65423,927,6,285,257,28,0,1,0
217422,5703,3,1914,1183,731,10,0,0
248679,1009,1,172,17,155,7,1,0
0,0,0,0,0,0,0,0,0
108491,720,2,178,162,16,5,1,0
452613,1204,8,92,74,18,8,1,0
465772,5469,1,1458,1436,22,9,1,0
263414,1016,10,164,152,12,29,1,0
384527,961,4,48,39,9,1,1,0
120920,145,0,10,10,0,0,1,0
1281156,6621,5,931,846,85,18,1,0
302572,582,8,115,92,23,5,1,0
0,0,0,0,0,0,0,0,0
0,0,0,0,0,0,0,0,0
96189,969,3,121,118,3,10,1,0
129236,994,7,78,25,53,0,1,0
1018530,10343,10,518,509,9,77,0,0
260652,191,10,2,2,0,0,0,0
8896,147,4,12,5,7,0,1,0
0,0,0,0,0,0,0,0,0
83142,132,8,14,12,2,0,1,0
54707,368,2,44,34,10,7,0,0
141250,1818,7,304,286,18,10,1,0
0,0,0,0,0,0,0,0,0
50200,857,2,128,113,15,0,1,0
1111373,1343,0,63,27,36,2,1,0
0,0,0,0,0,0,0,0,0
93749,855,10,166,153,13,0,0,0
72528,744,11,161,146,15,4,0,0
18537,282,1,79,67,12,0,1,0
129203,2167,3,366,359,7,2,0,0
122115,749,1,97,96,1,1,1,0
6681,66,1,3,3,0,0,0,0
555620,6942,9,795,792,3,11,1,0
142601,716,10,65,38,27,9,1,0
753968,3463,1,149,116,33,10,1,0
40062,111,4,7,4,3,0,0,0
0,0,0,0,0,0,0,0,0
260672,721,2,75,71,4,3,1,0
0,0,0,0,0,0,0,0,0
83370,330,6,38,38,0,8,1,0
193343,1738,1,203,162,41,0,1,0
38310,225,1,8,7,1,0,1,0
0,0,0,0,0,0,0,0,0
0,0,0,0,0,0,0,0,0
0,0,0,0,0,0,0,0,0
0,0,0,0,0,0,0,0,0
0,0,0,0,0,0,0,0,0
0,0,0,0,0,0,0,0,0
23596,283,5,55,43,12,0,1,0
0,0,0,0,0,0,0,0,0
0,0,0,0,0,0,0,0,0
28874,116,1,21,21,0,0,1,0
25355,98,1,10,10,0,1,1,0
0,0,0,0,0,0,0,0,0
0,0,0,0,0,0,0,0,0
120379,1317,5,210,181,29,8,1,0
0,0,0,0,0,0,0,0,0
318507,809,6,163,139,24,4,1,0
91389,1108,7,159,151,8,17,1,0
0,0,0,0,0,0,0,0,0
0,0,0,0,0,0,0,0,0
0,0,0,0,0,0,0,0,0
179703,605,5,26,11,15,1,0,0
0,0,0,0,0,0,0,0,0
75499,1256,2,397,357,40,0,0,0
7986,83,2,15,15,0,0,0,0
142070,1182,10,269,259,10,7,1,0
352695,1112,9,172,167,5,5,1,0
352695,1112,9,172,167,5,5,1,0
692739,537,0,5,2,3,2,1,1
0,0,0,0,0,0,0,0,0
275339,1374,6,118,115,3,4,1,0
370760,4041,6,717,573,144,2,1,0
0,0,0,0,0,0,0,0,0
264254,2690,3,665,568,97,6,0,0
232108,1595,3,179,3,176,12,0,0
49547,192,4,9,2,7,13,0,0
142299,699,3,379,368,11,1,0,0
90651,1010,10,192,176,16,22,1,0
330452,2319,5,270,254,16,1,0,0
17768,363,2,34,30,4,0,1,0
5302,113,2,13,13,0,0,1,0
289019,369,0,17,13,4,2,1,0
291145,367,0,20,16,4,2,1,0
0,0,0,0,0,0,0,0,0
123147,650,3,105,74,31,0,1,0
377631,1390,3,105,101,4,8,1,0
237849,2950,3,600,574,26,11,1,0
692293,537,0,5,3,2,2,1,1
0,0,0,0,0,0,0,0,0
0,0,0,0,0,0,0,0,0
69765,843,8,132,104,28,7,1,0
0,0,0,0,0,0,0,0,0
394803,3339,1,50,25,25,30,1,0
78861,1077,3,344,337,7,1,0,0
19484,143,4,14,14,0,4,0,0
0,0,0,0,0,0,0,0,0
0,0,0,0,0,0,0,0,0
0,0,0,0,0,0,0,0,0
64346,734,2,208,208,0,4,1,0
0,0,0,0,0,0,0,0,0
779053,1166,3,111,92,19,10,1,0
47370,462,3,27,23,4,8,0,0
0,0,0,0,0,0,0,0,0
0,0,0,0,0,0,0,0,0
685863,5710,6,853,848,5,3,1,0
95846,943,6,194,175,19,8,0,0
30270,215,8,20,20,0,3,0,0
2270191,2498,9,265,252,13,2,1,0
64229,641,1,71,55,16,0,1,0
132126,626,1,93,68,25,2,1,0
0,0,0,0,0,0,0,0,0
790516,4874,11,843,827,16,13,1,0
790801,2952,9,312,259,53,13,1,0
502710,1567,5,46,42,4,5,1,0
16880,365,0,83,79,4,0,0,0
130392,1615,4,489,476,13,0,1,0
8937,72,3,7,7,0,0,1,0
31648,21,3,2,2,0,0,0,0
497266,1755,11,318,288,30,24,1,0
175143,1403,15,168,167,1,6,1,0
283212,964,4,242,227,15,2,1,0
44461,561,6,154,142,12,11,1,0
63735,536,10,67,10,57,0,1,0
1503767,2777,11,228,194,34,247,1,0
1437589,1900,12,163,152,11,75,1,0
313814,2075,4,252,234,18,1,1,0
408485,2897,5,907,867,40,3,0,0
0,0,0,0,0,0,0,0,0
0,0,0,0,0,0,0,0,0
160365,1984,3,421,407,14,4,0,0
285843,1539,9,226,208,18,17,1,0
185390,677,13,98,82,16,34,1,0
0,0,0,0,0,0,0,0,0
543411,3403,11,645,513,132,29,1,0
773528,2890,10,272,263,9,40,0,0
253169,1114,10,186,157,29,4,1,0
8420,56,1,1,1,0,1,1,0
8420,56,1,1,1,0,1,1,0
870879,535,8,92,79,13,1,1,0
0,0,0,0,0,0,0,0,0
98460,1130,5,161,134,27,4,1,0
0,0,0,0,0,0,0,0,0
0,0,0,0,0,0,0,0,0
170685,1069,14,251,241,10,25,1,0
71068,421,9,110,108,2,6,0,0
852322,5050,17,342,242,100,19,1,0
418649,2296,17,197,182,15,11,1,0
870709,3869,4,494,402,92,5,1,0
0,0,0,0,0,0,0,0,0
0,0,0,0,0,0,0,0,0
0,0,0,0,0,0,0,0,0
0,0,0,0,0,0,0,0,0
46174,471,2,110,96,14,5,0,0
227484,4035,7,581,578,3,13,0,0
58160,744,7,95,91,4,12,0,0
1116567,2692,1,336,277,59,2,1,0
0,0,0,0,0,0,0,0,0
0,0,0,0,0,0,0,0,0
0,0,0,0,0,0,0,0,0
158847,1639,5,355,320,35,8,1,0
0,0,0,0,0,0,0,0,0
377820,4398,8,705,686,19,26,1,0
1490093,2003,5,137,115,22,47,1,0
813026,5179,16,1494,1481,13,22,1,0
141074,1397,4,188,172,16,19,1,0
20412,110,5,5,5,0,5,1,0
0,0,0,0,0,0,0,0,0
143967,298,2,23,7,16,0,1,0
103568,434,6,55,54,1,17,1,0
7312,17,0,2,0,2,0,0,0
817105,2984,5,244,222,22,6,1,0
0,0,0,0,0,0,0,0,0
327729,980,16,257,238,19,1,1,0
101526,728,8,46,29,17,7,1,0
27502,217,5,6,6,0,0,0,0
0,0,0,0,0,0,0,0,0
410217,989,7,111,98,13,7,1,0
14378,101,2,7,7,0,0,0,0
0,0,0,0,0,0,0,0,0
0,0,0,0,0,0,0,0,0
1791774,1996,11,160,126,34,34,1,0
214253,1167,10,231,128,103,5,1,0
112623,1309,2,328,311,17,13,1,0
0,0,0,0,0,0,0,0,0
104791,909,9,153,147,6,18,1,0
180073,2918,1,58,45,13,130,1,0
835342,1148,8,110,97,13,10,1,0
244610,800,8,143,135,8,2,1,0
233739,983,7,143,140,3,1,1,0
0,0,0,0,0,0,0,0,0
117273,909,8,167,158,9,16,1,0
446860,5171,6,780,725,55,16,1,0
230937,343,0,16,3,13,0,1,0
0,0,0,0,0,0,0,0,0
1511986,15558,2,794,493,301,14,1,1
262484,938,4,133,104,29,23,1,0
154811,405,4,53,41,12,23,1,0
250435,1902,5,611,597,14,9,1,0
0,0,0,0,0,0,0,0,0
472658,1666,2,381,364,17,9,1,0
384135,2412,14,411,263,148,10,1,0
90789,845,0,19,8,11,0,0,0
0,0,0,0,0,0,0,0,0
251006,2083,4,107,96,11,17,1,0
47518,685,8,81,64,17,3,1,0
75866,1048,8,243,240,3,5,1,0
68601,493,7,52,49,3,11,1,0
0,0,0,0,0,0,0,0,0
205227,4152,5,1599,1596,3,0,1,0
354892,2205,11,366,355,11,42,1,0
111042,240,11,10,6,4,7,1,0
0,0,0,0,0,0,0,0,0
161481,1501,2,297,281,16,8,1,1
849904,3548,13,602,558,44,101,1,0
452155,1876,3,268,253,15,5,1,0
10589,113,3,14,1,13,3,1,0
0,0,0,0,0,0,0,0,0
121266,1357,11,350,337,13,20,1,0
106509,1050,5,272,263,9,21,1,0
14792,137,7,20,9,11,0,1,0
0,0,0,0,0,0,0,0,0
0,0,0,0,0,0,0,0,0
197361,1084,5,95,76,19,3,0,0
311711,1506,1,155,126,29,2,1,0
0,0,0,0,0,0,0,0,0
0,0,0,0,0,0,0,0,0
210682,800,11,114,106,8,13,1,0
205985,667,14,90,75,15,18,1,0
35095,126,6,31,31,0,7,1,0
58008,352,5,46,39,7,11,1,0
81267,943,7,110,103,7,7,0,0
51219,439,8,35,35,0,3,1,0
0,0,0,0,0,0,0,0,0
205344,1803,4,204,162,42,5,1,0
40509,237,3,8,7,1,1,1,0
0,0,0,0,0,0,0,0,0
98463,587,3,75,51,24,2,1,0
21937,33,0,1,1,0,0,1,0
845504,1804,6,263,236,27,4,0,0
0,0,0,0,0,0,0,0,0
0,0,0,0,0,0,0,0,0
0,0,0,0,0,0,0,0,0
83117,1030,6,177,105,72,1,1,0
6980,129,2,9,8,1,1,0,0
272511,2632,10,548,540,8,19,0,1
849993,2402,6,314,288,26,19,1,0
244853,474,7,6,1,5,5,0,0
21951,35,0,1,1,0,0,1,0
223669,3462,6,655,648,7,2,1,0
7283,113,3,2,2,0,0,0,0
588625,1819,6,137,66,71,44,1,0
520797,289,4,5,4,1,8,0,0
2722411,21602,5,6913,6523,390,6,1,0
629606,8231,5,1216,1199,17,9,1,0
598583,2500,8,461,407,54,17,1,0
48800,365,7,84,64,20,16,1,0
0,0,0,0,0,0,0,0,0
712146,6493,16,1815,1753,62,5,0,0
88572,255,0,48,24,24,0,1,1
350133,2226,17,467,371,96,28,1,0
194139,2707,2,557,512,45,10,1,0
0,0,0,0,0,0,0,0,0
1191739,8032,6,1777,1356,421,7,1,0
154854,1178,10,141,90,51,3,0,0
0,0,0,0,0,0,0,0,0
0,0,0,0,0,0,0,0,0
398008,13149,3,654,648,6,2,0,0
233774,1707,14,335,269,66,20,1,1
0,0,0,0,0,0,0,0,0
0,0,0,0,0,0,0,0,0
0,0,0,0,0,0,0,0,0
0,0,0,0,0,0,0,0,0
0,0,0,0,0,0,0,0,0
155120,2540,3,599,584,15,8,1,0
403198,2169,6,402,391,11,18,1,0
929912,1915,8,139,31,108,3,1,0
452208,985,8,135,113,22,3,1,0
76336,861,3,110,105,5,10,0,0
27967,53,1,5,0,5,0,0,0
113615,1120,1,253,245,8,3,1,1
112525,690,10,83,65,18,2,1,0
0,0,0,0,0,0,0,0,0
358599,1817,11,426,399,27,31,1,0
0,0,0,0,0,0,0,0,0
132073,949,4,65,58,7,9,1,0
33791,233,2,18,3,15,7,1,0
0,0,0,0,0,0,0,0,0
573,7,0,0,0,0,0,0,0
0,0,0,0,0,0,0,0,0
0,0,0,0,0,0,0,0,0
12820,66,2,1,1,0,1,0,0
346046,1821,4,244,219,25,6,1,0
92467,1041,2,60,33,27,2,1,0
332437,1183,14,155,126,29,7,1,0
114843,146,7,5,4,1,3,1,0
618463,2721,3,632,607,25,3,0,0
384351,569,8,25,20,5,14,1,0
177118,501,5,32,26,6,2,1,0
0,0,0,0,0,0,0,0,0
0,0,0,0,0,0,0,0,0
1639546,2990,7,284,253,31,30,1,0
0,0,0,0,0,0,0,0,0
238717,1240,3,130,28,102,2,1,0
6026,67,4,10,10,0,0,0,0
528865,1361,2,338,327,11,6,1,0
118815,824,5,73,40,33,2,1,0
120298,854,5,76,43,33,2,1,0
30183,437,4,125,111,14,0,1,0
146147,1770,4,165,152,13,23,0,0
240967,2027,4,154,133,21,1,0,0
0,0,0,0,0,0,0,0,0
811110,2816,13,325,263,62,44,1,0
237803,2240,6,398,390,8,1,1,0
21948,283,6,51,44,7,1,1,0
123673,1069,2,215,215,0,10,1,0
223034,432,6,59,54,5,2,0,0
159165,1476,2,247,219,28,6,0,0
175223,1255,2,241,239,2,3,0,0
0,0,0,0,0,0,0,0,0
173072,1217,8,218,204,14,14,1,0
1113297,4809,6,1430,1396,34,6,1,0
0,0,0,0,0,0,0,0,0
0,0,0,0,0,0,0,0,0
25496,320,3,45,41,4,3,0,0
0,0,0,0,0,0,0,0,0
0,0,0,0,0,0,0,0,0
31852,637,2,128,79,49,9,1,0
136655,1161,11,238,226,12,8,1,0
383988,1451,5,406,386,20,14,1,0
34770,318,5,52,50,2,13,0,0
0,0,0,0,0,0,0,0,0
438386,4348,3,465,444,21,1,0,0
107314,1404,3,249,244,5,2,0,0
0,0,0,0,0,0,0,0,0
0,0,0,0,0,0,0,0,0
709690,2430,2,356,342,14,6,0,0
0,0,0,0,0,0,0,0,0
67299,592,5,184,181,3,1,1,0
305879,1511,7,242,191,51,18,1,0
23271,199,6,7,6,1,7,0,0
0,0,0,0,0,0,0,0,0
0,0,0,0,0,0,0,0,0
0,0,0,0,0,0,0,0,0
34015,148,5,19,12,7,1,0,0
0,0,0,0,0,0,0,0,0
0,0,0,0,0,0,0,0,0
22024,35,0,1,1,0,0,1,0
0,0,0,0,0,0,0,0,0
218609,447,6,73,34,39,0,1,0
40424,278,4,21,18,3,1,1,0
844669,1319,6,133,121,12,49,1,0
54207,346,10,50,41,9,15,1,0
0,0,0,0,0,0,0,0,0
0,0,0,0,0,0,0,0,0
0,0,0,0,0,0,0,0,0
0,0,0,0,0,0,0,0,0
383793,2624,2,263,27,236,20,1,0
140574,1517,2,281,272,9,6,1,0
141796,971,3,83,70,13,2,1,0
0,0,0,0,0,0,0,0,0
68496,901,9,201,199,2,13,1,0
34699,345,9,44,41,3,12,1,0
0,0,0,0,0,0,0,0,0
195209,647,4,49,41,8,1,1,0
191810,598,4,37,30,7,1,1,0
466590,832,1,25,19,6,10,1,0
11898,52,0,0,0,0,2,0,0
0,0,0,0,0,0,0,0,0
174773,1560,6,515,498,17,15,1,0
12402,74,1,7,7,0,1,0,0
40689,572,0,470,30,440,0,0,0
317464,1733,10,238,184,54,6,1,0
0,0,0,0,0,0,0,0,0
257974,1265,6,167,164,3,3,1,0
140537,1915,6,345,326,19,4,0,0
43596,38,0,6,2,4,0,1,0
38030,247,3,22,19,3,4,1,0
0,0,0,0,0,0,0,0,0
521387,1540,9,213,198,15,13,1,0
38085,757,2,211,209,2,5,0,0
0,0,0,0,0,0,0,0,0
222937,1289,2,169,140,29,82,1,0
88590,1056,4,241,229,12,0,1,0
83449,656,5,40,30,10,20,1,0
197072,1502,8,424,390,34,36,1,0
0,0,0,0,0,0,0,0,0
269753,1909,1,324,287,37,10,0,0
0,0,0,0,0,0,0,0,0
0,0,0,0,0,0,0,0,0
0,0,0,0,0,0,0,0,0
0,0,0,0,0,0,0,0,0
0,0,0,0,0,0,0,0,0
0,0,0,0,0,0,0,0,0
0,0,0,0,0,0,0,0,0
0,0,0,0,0,0,0,0,0
0,0,0,0,0,0,0,0,0
0,0,0,0,0,0,0,0,0
87471,952,5,170,147,23,29,0,0
86984,928,9,125,121,4,2,1,0
0,0,0,0,0,0,0,0,0
19236,207,8,21,19,2,4,1,0
0,0,0,0,0,0,0,0,0
0,0,0,0,0,0,0,0,0
352190,4083,6,561,561,0,112,1,0
44535,248,7,24,24,0,5,0,0
182366,2676,0,822,809,13,5,0,0
0,0,0,0,0,0,0,0,0
0,0,0,0,0,0,0,0,0
90987,991,8,245,203,42,2,1,0
0,0,0,0,0,0,0,0,0
244579,3476,5,870,792,78,6,1,0
136041,1252,3,259,187,72,11,1,0
66766,291,2,41,30,11,3,1,0
8727,123,0,24,24,0,0,1,0
8122,117,0,27,27,0,0,1,0
0,0,0,0,0,0,0,0,0
97574,587,17,101,0,101,9,1,0
168213,1303,7,213,201,12,0,1,0
749524,63,1,3,2,1,0,1,0
47845,636,2,73,25,48,11,1,0
398612,2665,6,302,252,50,10,0,0
0,0,0,0,0,0,0,0,0
217679,1059,8,128,8,120,3,1,0
423588,2432,3,337,326,11,1,1,0
281843,1178,2,208,202,6,1,1,0
0,0,0,0,0,0,0,0,0
0,0,0,0,0,0,0,0,0
0,0,0,0,0,0,0,0,0
1240166,1459,2,262,210,52,14,1,1
74614,318,5,7,7,0,10,1,0
422219,371,7,61,58,3,15,1,0
455666,1789,4,574,561,13,29,1,0
31332,220,5,25,22,3,1,1,0
86102,746,8,167,134,33,10,0,0
0,0,0,0,0,0,0,0,0
519227,1636,6,556,555,1,3,1,0
327693,979,5,423,423,0,3,1,0
259188,3995,10,684,679,5,18,1,0
327896,1049,11,149,134,15,32,1,0
205468,1326,6,258,240,18,7,1,0
138379,1457,6,339,302,37,9,1,0
0,0,0,0,0,0,0,0,0
0,0,0,0,0,0,0,0,0
153004,1944,4,324,320,4,16,1,0
138896,667,7,91,91,0,15,1,0
0,0,0,0,0,0,0,0,0
69231,617,7,85,49,36,1,1,0
146309,1751,6,564,458,106,2,0,0
99441,1663,7,49,47,2,5,0,0
247840,796,16,154,139,15,10,1,0
333461,3411,0,802,773,29,10,0,0
0,0,0,0,0,0,0,0,0
195776,1663,5,357,347,10,0,1,0
183649,1171,2,142,131,11,14,1,0
0,0,0,0,0,0,0,0,0
254735,1257,7,183,164,19,47,1,0
0,0,0,0,0,0,0,0,0
1792552,2564,9,319,300,19,17,1,0
45993,582,7,133,92,41,8,1,0
120725,1225,8,457,451,6,2,1,0
135464,1239,8,457,451,6,2,1,0
256683,1328,6,204,107,97,15,1,0
0,0,0,0,0,0,0,0,0
63815,899,0,269,269,0,0,1,0
83588,510,6,67,65,2,8,1,0
123245,345,9,52,6,46,3,1,0
0,0,0,0,0,0,0,0,0
1784088,2323,10,299,285,14,26,1,0
432713,4954,4,771,759,12,17,0,0
197725,1830,11,341,270,71,26,0,1
271002,1277,8,178,163,15,3,1,0
64392,113,2,12,12,0,0,1,0
196719,492,9,75,70,5,4,1,0
105696,854,10,178,162,16,25,0,0
157326,1482,3,347,345,2,6,1,0
276832,737,14,119,81,38,4,0,0
55828,516,2,94,78,16,5,1,0
436823,1213,7,182,167,15,5,1,0
357021,524,7,44,34,10,5,1,0
273694,4568,6,632,625,7,2,1,0
123779,2161,5,413,412,1,0,1,0
0,0,0,0,0,0,0,0,0
0,0,0,0,0,0,0,0,0
0,0,0,0,0,0,0,0,0
259697,1795,3,491,478,13,7,1,0
360964,1900,9,462,451,11,53,1,0
32053,292,6,72,72,0,4,1,0
0,0,0,0,0,0,0,0,0
270067,884,2,127,118,9,17,0,0
0,0,0,0,0,0,0,0,0
303422,4708,6,740,714,26,33,1,0
0,0,0,0,0,0,0,0,0
189554,2327,4,818,802,16,15,1,0
21301,122,3,17,17,0,0,1,0
0,0,0,0,0,0,0,0,0
0,0,0,0,0,0,0,0,0
464676,1537,9,194,181,13,15,1,0
115592,1340,2,383,379,4,57,1,0
41437,269,2,42,38,4,6,1,0
0,0,0,0,0,0,0,0,0
713811,3079,5,405,388,17,0,1,0
74319,1694,1,567,566,1,0,1,0
7183,156,0,63,51,12,0,0,0
0,0,0,0,0,0,0,0,0
260932,4632,1,1434,1351,83,15,1,0
289281,2434,9,368,351,17,20,0,0
485310,2392,5,222,186,36,4,1,0
66837,136,0,12,11,1,0,1,0
0,0,0,0,0,0,0,0,0
290139,1500,5,170,117,53,10,1,0
146859,383,6,13,3,10,9,0,0
106131,1390,4,421,416,5,10,1,0
41892,346,5,44,38,6,11,1,0
1248982,9893,10,1018,1003,15,19,1,0
394860,3973,8,820,811,9,17,1,0
0,0,0,0,0,0,0,0,0
297825,2477,5,394,366,28,13,0,0
16719,144,2,12,10,2,0,0,0
116718,957,6,233,220,13,5,1,0
106869,1649,1,556,424,132,0,1,0
5889,109,1,11,10,1,0,1,0
0,0,0,0,0,0,0,0,0
38020,384,7,89,86,3,4,1,0
11181,197,2,7,6,1,0,1,0
438416,1299,3,233,220,13,2,1,0
358725,216,2,7,6,1,1,0,0
70418,582,2,119,110,9,2,1,0
51762,330,4,62,55,7,2,1,0
436466,1016,7,113,99,14,6,1,0
14378,101,2,7,7,0,0,0,0
0,0,0,0,0,0,0,0,0
560,7,0,0,0,0,0,0,0
0,0,0,0,0,0,0,0,0
147934,645,10,35,29,6,10,1,0
295608,1406,5,246,240,6,11,1,0
128451,895,10,178,172,6,11,1,0
187392,1170,3,213,202,11,1,1,0
0,0,0,0,0,0,0,0,0
22923,184,2,22,21,1,0,1,0
0,0,0,0,0,0,0,0,0
28767,45,0,4,1,3,0,0,0
0,0,0,0,0,0,0,0,0
0,0,0,0,0,0,0,0,0
0,0,0,0,0,0,0,0,0
158105,1216,2,117,104,13,4,1,0
52629,401,2,39,35,4,0,1,0
1456962,8264,3,1020,818,202,12,1,0
186266,1117,6,103,87,16,13,1,0
514347,2063,15,392,329,63,20,1,0
24952,289,9,63,53,10,3,1,0
122463,1273,5,150,100,50,11,1,0
0,0,0,0,0,0,0,0,0
87334,1046,3,128,125,3,0,1,0
199173,711,2,113,8,105,15,1,0
12388,271,1,61,60,1,0,0,0
0,0,0,0,0,0,0,0,0
694630,3209,11,310,255,55,48,1,0
170816,860,14,236,229,7,12,0,0
29978,762,1,204,204,0,2,1,0
212046,1555,7,339,309,30,5,1,0
89209,255,0,48,24,24,0,1,1
462025,2336,6,384,363,21,4,1,0
185004,865,1,48,32,16,8,1,0
21327,297,4,69,69,0,0,0,0
346788,2642,3,633,615,18,7,1,0
0,0,0,0,0,0,0,0,0
1305280,4469,6,638,551,87,9,1,0
10678,61,2,4,4,0,0,1,0
0,0,0,0,0,0,0,0,0
603030,4129,7,603,591,12,50,1,0
57609,512,3,63,53,10,0,0,0
0,0,0,0,0,0,0,0,0
0,0,0,0,0,0,0,0,0
0,0,0,0,0,0,0,0,0
0,0,0,0,0,0,0,0,0
0,0,0,0,0,0,0,0,0
38953,292,3,14,11,3,0,1,0
24820,68,0,2,2,0,2,0,0
0,0,0,0,0,0,0,0,0
749514,6148,10,849,837,12,11,1,0
538233,3031,10,218,211,7,24,1,0
0,0,0,0,0,0,0,0,0
165389,1097,3,326,248,78,7,1,0
254721,1788,7,212,177,35,18,1,0
253844,1083,3,248,241,7,7,0,0
345823,3372,13,827,782,45,51,1,0
179453,1325,12,366,348,18,22,1,0
286545,2146,4,402,393,9,10,1,0
5705655,234,1,15,9,6,5,1,0
145918,524,9,67,63,4,6,1,0
244668,332,3,63,53,10,0,0,0
211586,1060,1,139,133,6,0,1,0
0,0,0,0,0,0,0,0,0
595562,8980,5,2675,2661,14,19,1,0
103976,1472,1,287,287,0,1,1,0
0,0,0,0,0,0,0,0,0
0,0,0,0,0,0,0,0,0
202311,1384,7,191,168,23,15,1,0
0,0,0,0,0,0,0,0,0
71840,819,10,142,118,24,7,1,0
0,0,0,0,0,0,0,0,0
2922636,4441,8,463,439,24,30,1,0
165202,1916,2,442,417,25,9,1,1
0,0,0,0,0,0,0,0,0
0,0,0,0,0,0,0,0,0
0,0,0,0,0,0,0,0,0
112156,1264,5,333,333,0,10,0,0
60775,319,6,29,15,14,9,1,0
0,0,0,0,0,0,0,0,0
166898,816,9,124,111,13,11,1,0
0,0,0,0,0,0,0,0,0
0,0,0,0,0,0,0,0,0
55523,616,7,166,149,17,7,1,0
0,0,0,0,0,0,0,0,0
271655,1136,8,139,131,8,10,1,0
0,0,0,0,0,0,0,0,0
56529,790,11,211,182,29,1,1,0
163422,1014,12,103,99,4,1,1,0
166039,835,2,7,6,1,0,0,0
608100,4399,2,990,927,63,28,1,0
350263,3085,2,778,741,37,28,1,0
0,0,0,0,0,0,0,0,0
0,0,0,0,0,0,0,0,0
179058,633,5,101,17,84,13,1,0
0,0,0,0,0,0,0,0,0
0,0,0,0,0,0,0,0,0
0,0,0,0,0,0,0,0,0
132131,255,0,16,12,4,0,1,0
0,0,0,0,0,0,0,0,0
127086,874,12,77,70,7,1,1,0
29144,110,8,5,3,2,2,0,0
0,0,0,0,0,0,0,0,0
4595,78,1,4,4,0,0,1,0
111267,1031,0,145,18,127,4,1,0
58619,608,5,46,44,2,11,1,0
10212,159,1,32,31,1,0,0,0
7401,121,1,19,18,1,0,0,0
0,0,0,0,0,0,0,0,0
0,0,0,0,0,0,0,0,0
174742,867,5,137,123,14,4,1,0
0,0,0,0,0,0,0,0,0
476849,1695,14,126,121,5,33,1,0
445996,1548,13,50,42,8,60,1,0
1086019,2465,7,338,332,6,5,1,0
861484,235,7,37,33,4,5,1,0
45255,288,3,62,56,6,7,1,0
77400,581,7,155,145,10,2,1,0
0,0,0,0,0,0,0,0,0
258132,1187,14,157,129,28,2,1,0
0,0,0,0,0,0,0,0,0
0,0,0,0,0,0,0,0,0
0,0,0,0,0,0,0,0,0
123223,238,1,15,14,1,2,0,0
112536,38,0,1,1,0,2,0,0
675068,3506,12,713,658,55,25,1,0
188990,707,11,34,18,16,50,0,0
0,0,0,0,0,0,0,0,0
0,0,0,0,0,0,0,0,0
0,0,0,0,0,0,0,0,0
0,0,0,0,0,0,0,0,0
0,0,0,0,0,0,0,0,0
173657,1427,4,438,438,0,0,1,0
0,0,0,0,0,0,0,0,0
224565,630,7,101,93,8,0,1,0
0,0,0,0,0,0,0,0,0
279412,1185,5,233,218,15,3,1,0
485467,3331,9,636,628,8,17,1,0
109324,1045,12,217,207,10,14,1,0
28641,45,0,4,1,3,0,0,0
0,0,0,0,0,0,0,0,0
149367,888,4,74,45,29,1,1,0
676761,556,0,4,0,4,2,1,1
0,0,0,0,0,0,0,0,0
58352,373,6,73,46,27,0,0,0
0,0,0,0,0,0,0,0,0
0,0,0,0,0,0,0,0,0
0,0,0,0,0,0,0,0,0
0,0,0,0,0,0,0,0,0
0,0,0,0,0,0,0,0,0
0,0,0,0,0,0,0,0,0
722944,3177,6,259,240,19,24,0,0
0,0,0,0,0,0,0,0,0
950550,2178,10,274,260,14,9,1,0
114836,109,0,15,8,7,0,1,0
0,0,0,0,0,0,0,0,0
0,0,0,0,0,0,0,0,0
71097,772,7,143,139,4,0,1,0
63339,272,2,36,5,31,0,0,0
22428,144,1,4,3,1,0,0,0
87160,931,4,271,271,0,6,0,0
150934,1441,1,435,315,120,2,1,0
0,0,0,0,0,0,0,0,0
0,0,0,0,0,0,0,0,0
1396520,1514,1,180,52,128,32,1,0
152855,1056,4,232,226,6,3,1,0
81394,546,4,83,74,9,5,1,0
74703,549,4,64,59,5,5,1,0
0,0,0,0,0,0,0,0,0
0,0,0,0,0,0,0,0,0
0,0,0,0,0,0,0,0,0
136409,1261,5,264,253,11,12,1,0
60523,866,3,15,15,0,10,1,0
161478,937,6,124,101,23,2,1,0
0,0,0,0,0,0,0,0,0
0,0,0,0,0,0,0,0,0
81319,440,12,55,43,12,5,1,0
215878,160,5,11,8,3,3,1,0
0,0,0,0,0,0,0,0,0
0,0,0,0,0,0,0,0,0
395470,2790,2,383,364,19,2,1,0
0,0,0,0,0,0,0,0,0
72515,868,5,197,177,20,2,1,0
1487200,1275,1,192,183,9,1,1,0
378942,92,0,2,2,0,0,1,0
0,0,0,0,0,0,0,0,0
507766,4029,3,623,422,201,8,0,0
520803,1354,14,262,216,46,60,1,0
190715,579,6,106,95,11,14,1,0
181118,491,7,83,73,10,17,1,0
0,0,0,0,0,0,0,0,0
205873,878,11,153,147,6,19,1,0
142714,406,11,33,27,6,16,1,0
163623,1891,7,467,455,12,15,1,0
0,0,0,0,0,0,0,0,0
0,0,0,0,0,0,0,0,0
7707,65,0,3,3,0,0,0,0
0,0,0,0,0,0,0,0,0
0,0,0,0,0,0,0,0,0
0,0,0,0,0,0,0,0,0
156013,1420,10,399,367,32,8,1,0
64932,721,10,195,181,14,8,1,0
264111,1851,3,320,309,11,1,1,0
155430,969,3,210,200,10,1,1,0
0,0,0,0,0,0,0,0,0
78020,917,4,274,272,2,14,1,0
0,0,0,0,0,0,0,0,0
0,0,0,0,0,0,0,0,0
3014159,32287,2,864,553,311,17,1,1
271082,862,7,77,61,16,1,1,0
0,0,0,0,0,0,0,0,0
206923,2395,8,564,549,15,18,1,0
32513,380,3,63,52,11,6,1,0
2900474,4942,6,697,584,113,25,1,0
435646,2652,11,515,504,11,28,1,0
29736,672,1,86,83,3,20,1,0
16326,123,1,10,8,2,3,1,0
786191,817,3,128,91,37,4,1,0
0,0,0,0,0,0,0,0,0
0,0,0,0,0,0,0,0,0
337191,2002,4,703,697,6,6,1,0
125525,1723,2,482,458,24,10,1,0
0,0,0,0,0,0,0,0,0
31281,413,1,130,130,0,0,0,0
305089,1949,5,282,237,45,18,1,0
518753,2666,4,245,177,68,5,1,0
331546,178,8,14,6,8,1,1,0
53323,672,2,182,180,2,1,1,0
24789,141,2,25,25,0,0,0,0
254152,1347,15,245,238,7,29,0,0
307110,1627,16,252,228,24,30,0,0
0,0,0,0,0,0,0,0,0
0,0,0,0,0,0,0,0,0
243607,3137,8,364,357,7,12,1,0
92146,1205,8,158,155,3,0,0,0
150867,1296,5,237,203,34,9,0,0
0,0,0,0,0,0,0,0,0
642136,2620,8,350,326,24,104,1,0
8128,118,0,23,17,6,0,1,0
0,0,0,0,0,0,0,0,0
28885,221,5,33,29,4,19,0,0
184948,2112,11,252,233,19,34,1,0
281589,3412,5,294,218,76,3,1,0
104129,682,5,57,7,50,5,0,0
0,0,0,0,0,0,0,0,0
0,0,0,0,0,0,0,0,0
3203,39,0,0,0,0,0,0,0
45340,685,1,179,178,1,0,0,0
18844,200,1,35,34,1,1,0,0
111430,224,0,2,2,0,2,0,0
630304,4876,9,923,845,78,19,1,0
321130,770,3,115,106,9,2,1,0
977066,5939,12,668,659,9,3,0,0
655959,2819,11,465,464,1,2,0,0
0,0,0,0,0,0,0,0,0
0,0,0,0,0,0,0,0,0
0,0,0,0,0,0,0,0,0
0,0,0,0,0,0,0,0,0
125655,999,11,330,313,17,7,1,0
0,0,0,0,0,0,0,0,0
287750,3109,6,427,425,2,20,1,0
0,0,0,0,0,0,0,0,0
52885,679,3,174,174,0,7,1,0
126153,1047,11,130,66,64,5,1,0
0,0,0,0,0,0,0,0,0
188405,1443,8,134,131,3,35,1,0
0,0,0,0,0,0,0,0,0
0,0,0,0,0,0,0,0,0
0,0,0,0,0,0,0,0,0
0,0,0,0,0,0,0,0,0
0,0,0,0,0,0,0,0,0
331255,1549,7,131,112,19,17,0,0
370976,1969,1,431,416,15,3,1,0
571482,2212,0,470,11,459,0,0,0
99426,1021,9,150,101,49,11,1,0
0,0,0,0,0,0,0,0,0
0,0,0,0,0,0,0,0,0
0,0,0,0,0,0,0,0,0
309,6,0,0,0,0,0,0,0
0,0,0,0,0,0,0,0,0
36485,260,5,20,17,3,0,0,0
0,0,0,0,0,0,0,0,0
0,0,0,0,0,0,0,0,0
74725,782,9,120,115,5,9,0,0
0,0,0,0,0,0,0,0,0
1080430,4226,11,377,344,33,21,1,0
0,0,0,0,0,0,0,0,0
41721,208,4,8,8,0,11,1,0
243345,1742,6,199,179,20,4,1,0
94425,112,2,1,0,1,3,1,0
55979,595,2,94,91,3,11,1,0
0,0,0,0,0,0,0,0,0
120026,856,1,175,163,12,2,1,0
165735,1822,4,318,168,150,23,1,0
847424,1338,6,120,111,9,2,1,0
0,0,0,0,0,0,0,0,0
402884,2300,9,226,190,36,29,1,0
218273,1268,8,141,106,35,17,1,0
1288343,9516,6,335,307,28,233,1,0
406709,1165,5,121,93,28,13,1,0
0,0,0,0,0,0,0,0,0
7039,45,0,5,5,0,1,0,0
0,0,0,0,0,0,0,0,0
108108,1325,9,258,253,5,16,0,0
51295,464,9,120,115,5,8,0,0
1444951,2983,12,284,260,24,135,1,0
0,0,0,0,0,0,0,0,0
0,0,0,0,0,0,0,0,0
36506,312,1,43,33,10,0,1,0
77780,694,5,45,36,9,0,0,0
37352,236,5,3,1,2,0,0,0
574138,2723,4,446,436,10,3,1,0
1305657,1860,4,60,51,9,2,1,0
93886,390,6,32,27,5,9,1,0
170812,1083,6,204,178,26,14,1,0
305932,1760,6,214,141,73,3,0,0
5851,59,2,5,4,1,2,0,0
0,0,0,0,0,0,0,0,0
561736,2114,5,581,442,139,16,1,0
339197,1168,5,414,395,19,1,1,0
0,0,0,0,0,0,0,0,0
316222,1419,8,39,27,12,6,1,0
0,0,0,0,0,0,0,0,0
47684,367,4,55,49,6,5,1,0
242123,691,4,102,89,13,12,0,0
242193,691,4,102,89,13,12,0,0
0,0,0,0,0,0,0,0,0
187985,590,3,46,46,0,10,1,0
349514,3423,3,778,749,29,6,1,0
0,0,0,0,0,0,0,0,0
83098,712,4,103,99,4,10,1,0
18902,177,5,32,28,4,1,1,0
81139,699,6,33,32,1,4,0,0
149378,2480,5,452,443,9,1,0,0
305580,2086,3,407,397,10,4,1,0
265468,2037,7,530,56,474,1,1,0
266289,925,9,83,75,8,36,1,0
338456,94,6,0,0,0,1,1,0
441377,2179,19,313,295,18,11,1,0
230336,343,0,16,3,13,0,1,0
0,0,0,0,0,0,0,0,0
0,0,0,0,0,0,0,0,0
0,0,0,0,0,0,0,0,0
0,0,0,0,0,0,0,0,0
0,0,0,0,0,0,0,0,0
98068,1094,17,24,19,5,3,1,0
551034,5267,5,1209,1205,4,46,1,0
829126,5514,2,780,751,29,17,1,0
181487,1007,3,87,79,8,11,1,0
456377,1627,15,211,196,15,3,1,0
165539,310,2,14,14,0,2,1,0
680676,1167,9,53,35,18,41,1,0
197199,779,5,131,126,5,13,1,0
0,0,0,0,0,0,0,0,0
412457,3214,5,588,417,171,12,1,0
0,0,0,0,0,0,0,0,0
15446,147,1,29,23,6,0,0,0
0,0,0,0,0,0,0,0,0
0,0,0,0,0,0,0,0,0
158183,1698,4,458,448,10,9,1,0
0,0,0,0,0,0,0,0,0
20644,375,4,89,88,1,0,1,0
79936,1152,5,269,269,0,13,1,0
25938,386,3,7,6,1,0,0,0
0,0,0,0,0,0,0,0,0
106452,1617,2,502,488,14,8,0,0
14442,278,1,82,81,1,1,0,0
66645,696,2,172,133,39,10,1,0
0,0,0,0,0,0,0,0,0
0,0,0,0,0,0,0,0,0
128765,193,3,12,0,12,6,0,1
731263,9594,4,3515,3476,39,18,1,0
51059,203,3,8,6,2,1,1,0
128779,1319,2,347,316,31,3,1,0
0,0,0,0,0,0,0,0,0
290035,1625,5,374,335,39,16,1,0
111325,215,4,9,1,8,0,0,0
124318,884,9,129,112,17,11,0,0
690913,536,0,4,3,1,2,1,1
2489072,8796,4,525,312,213,2,1,0
199993,1111,6,108,84,24,25,1,0
24951,214,7,63,62,1,2,1,0
15799,127,7,21,18,3,2,1,0
345564,1744,4,195,190,5,2,1,0
0,0,0,0,0,0,0,0,0
0,0,0,0,0,0,0,0,0
609288,5383,4,229,219,10,6,1,0
46240,577,4,79,73,6,0,1,0
0,0,0,0,0,0,0,0,0
373343,7429,3,1856,1851,5,4,1,0
17604,256,3,35,32,3,3,1,0
156168,2019,1,286,284,2,6,1,0
232045,346,0,17,9,8,0,1,0
270866,855,7,153,108,45,17,1,0
272287,768,7,99,87,12,18,1,0
0,0,0,0,0,0,0,0,0
671836,2781,9,263,240,23,23,1,0
0,0,0,0,0,0,0,0,0
113576,1276,2,271,266,5,2,1,0
562341,1840,3,283,135,148,15,1,0
80832,112,1,10,10,0,2,0,0
93600,530,4,99,96,3,2,1,0
14097,148,4,21,21,0,0,0,0
570296,3319,7,463,272,191,20,1,0
112221,1366,0,401,401,0,1,1,0
40997,168,1,20,20,0,3,1,0
80672,827,3,127,108,19,7,1,0
144691,1435,7,223,197,26,17,0,0
90914,847,2,88,87,1,0,0,0
14140,183,5,34,33,1,0,0,0
0,0,0,0,0,0,0,0,0
179370,769,8,116,107,9,11,0,0
135332,339,6,24,17,7,4,0,0
832054,10198,3,2965,2739,226,9,0,0
276868,1973,4,186,154,32,2,1,0
175897,1096,4,58,40,18,2,1,0
0,0,0,0,0,0,0,0,0
0,0,0,0,0,0,0,0,0
0,0,0,0,0,0,0,0,0
65513,184,6,11,8,3,8,1,0
322794,1802,6,180,149,31,39,1,0
0,0,0,0,0,0,0,0,0
239927,933,3,84,70,14,1,0,0
1790874,15227,17,139,9,130,35,1,0
1007723,8645,17,116,102,14,13,0,0
576184,3165,8,370,342,28,14,1,0
0,0,0,0,0,0,0,0,0
0,0,0,0,0,0,0,0,0
0,0,0,0,0,0,0,0,0
0,0,0,0,0,0,0,0,0
0,0,0,0,0,0,0,0,0
244520,1089,4,191,184,7,2,1,0
293231,2788,10,392,346,46,19,0,0
186371,1390,9,181,139,42,27,0,0
0,0,0,0,0,0,0,0,0
0,0,0,0,0,0,0,0,0
185993,1493,7,298,262,36,11,1,0
0,0,0,0,0,0,0,0,0
61680,602,4,131,97,34,6,1,0
123034,2413,3,490,399,91,3,1,0
0,0,0,0,0,0,0,0,0
198632,1266,7,114,111,3,7,1,0
99723,411,7,43,43,0,3,1,0
872475,4969,4,202,189,13,113,1,0
599371,2012,4,69,55,14,3,1,0
0,0,0,0,0,0,0,0,0
482324,963,1,5,4,1,10,0,0
41704,667,6,149,119,30,3,1,0
70032,452,4,86,81,5,2,1,0
0,0,0,0,0,0,0,0,0
222438,988,8,79,72,7,2,1,0
241151,268,8,25,22,3,0,0,0
32500,438,8,47,28,19,1,0,0
27770,42,0,2,1,1,0,0,0
146425,668,3,65,48,17,3,1,0
26359,127,0,21,21,0,0,0,0
0,0,0,0,0,0,0,0,0
0,0,0,0,0,0,0,0,0
0,0,0,0,0,0,0,0,0
28358,45,0,4,1,3,0,0,0
96397,667,3,155,142,13,0,1,0
0,0,0,0,0,0,0,0,0
11897,198,0,70,0,70,0,0,0
667502,5329,8,682,572,110,73,1,0
1627523,5897,1,586,517,69,4,0,0
1627770,5897,1,586,564,22,4,0,0
231059,931,4,113,102,11,38,0,0
175193,594,4,62,51,11,30,0,0
139170,1040,6,118,118,0,1,1,0
0,0,0,0,0,0,0,0,0
0,0,0,0,0,0,0,0,0
285796,1153,4,168,142,26,0,1,0
349118,1239,5,10,3,7,2,0,0
0,0,0,0,0,0,0,0,0
0,0,0,0,0,0,0,0,0
214612,969,12,124,118,6,3,1,0
57634,529,7,87,83,4,5,1,0
0,0,0,0,0,0,0,0,0
0,0,0,0,0,0,0,0,0
363791,498,11,49,42,7,61,1,0
329274,299,11,23,18,5,61,1,0
0,0,0,0,0,0,0,0,0
0,0,0,0,0,0,0,0,0
10487,56,3,12,11,1,0,1,0
32389,707,1,201,159,42,0,1,0
0,0,0,0,0,0,0,0,0
86747,128,5,4,2,2,1,0,0
0,0,0,0,0,0,0,0,0
0,0,0,0,0,0,0,0,0
143082,681,1,74,72,2,1,0,0
162881,500,1,49,46,3,3,1,0
52219,143,2,108,107,1,0,0,0
499818,4415,4,149,74,75,45,1,0
0,0,0,0,0,0,0,0,0
0,0,0,0,0,0,0,0,0
76745,769,7,198,189,9,13,0,0
410850,1104,0,27,26,1,0,1,0
91185,269,2,37,12,25,2,1,0
0,0,0,0,0,0,0,0,0
1308896,1547,7,78,39,39,7,1,0
0,0,0,0,0,0,0,0,0
260612,1134,5,148,141,7,3,1,0
117168,468,6,66,59,7,7,1,0
0,0,0,0,0,0,0,0,0
15524,290,1,67,41,26,0,0,0
47155,525,5,108,101,7,2,1,0
12172,82,5,9,9,0,0,0,0
0,0,0,0,0,0,0,0,0
241876,1443,8,111,87,24,13,1,0
0,0,0,0,0,0,0,0,0
538877,3326,7,586,570,16,21,1,0
412048,2820,7,562,546,16,12,1,0
1359092,4259,0,380,359,21,4,1,0
126531,801,3,2,1,1,1,0,0
290008,2130,3,267,260,7,7,1,0
159600,619,2,130,114,16,2,1,0
403110,4265,9,782,767,15,27,1,1
3748,50,4,3,2,1,0,0,0
168481,1583,11,189,118,71,27,1,0
66678,430,7,74,39,35,16,1,0
180287,1218,14,227,158,69,38,1,0
6739,66,5,3,2,1,0,0,0
552796,1200,4,233,204,29,1,1,0
71228,486,9,89,83,6,10,1,0
71237,486,9,89,83,6,10,1,0
0,0,0,0,0,0,0,0,0
91436,1400,3,363,235,128,1,1,0
3053,45,2,3,3,0,0,0,0
514407,2164,2,193,89,104,6,1,0
0,0,0,0,0,0,0,0,0
92430,1041,2,60,33,27,2,1,0
0,0,0,0,0,0,0,0,0
0,0,0,0,0,0,0,0,0
434633,3964,8,828,690,138,17,1,0
0,0,0,0,0,0,0,0,0
7524,95,0,16,15,1,1,1,0
71672,1819,2,568,568,0,2,1,0
0,0,0,0,0,0,0,0,0
15398,165,5,15,11,4,1,1,0
64166,453,3,145,139,6,7,1,0
28183,432,9,100,88,12,13,1,0
104638,942,3,134,126,8,3,1,0
20098,177,2,19,18,1,5,1,0
128892,499,3,120,116,4,2,0,0
8643,65,1,9,3,6,0,0,0
27691,42,0,2,1,1,0,0,0
71586,1385,5,278,246,32,1,1,0
0,0,0,0,0,0,0,0,0
0,0,0,0,0,0,0,0,0
0,0,0,0,0,0,0,0,0
51939,574,3,165,162,3,9,1,0
0,0,0,0,0,0,0,0,0
0,0,0,0,0,0,0,0,0
142128,1578,6,299,182,117,26,1,0
0,0,0,0,0,0,0,0,0
0,0,0,0,0,0,0,0,0
464030,1854,3,250,233,17,13,1,0
862158,1942,7,231,197,34,24,1,0
0,0,0,0,0,0,0,0,0
685844,2049,14,183,165,18,36,1,0
88870,594,7,64,5,59,15,1,0
392298,1549,7,178,125,53,8,1,0
0,0,0,0,0,0,0,0,0
120638,1032,5,235,233,2,34,0,0
86426,791,4,281,267,14,0,0,0
1077681,1038,2,278,278,0,11,1,0
0,0,0,0,0,0,0,0,0
37577,243,0,39,37,2,0,1,0
0,0,0,0,0,0,0,0,0
365980,2081,2,628,545,83,83,1,0
12019,183,1,35,35,0,1,1,0
0,0,0,0,0,0,0,0,0
0,0,0,0,0,0,0,0,0
466066,866,6,63,60,3,4,1,0
104296,976,2,237,235,2,1,0,0
22321,347,2,77,77,0,3,1,0
0,0,0,0,0,0,0,0,0
0,0,0,0,0,0,0,0,0
260637,1669,10,151,132,19,49,1,0
535534,4711,9,920,903,17,7,1,0
294913,762,9,103,84,19,3,1,0
355184,1677,7,187,156,31,3,1,0
0,0,0,0,0,0,0,0,0
0,0,0,0,0,0,0,0,0
0,0,0,0,0,0,0,0,0
545331,2491,12,736,730,6,2,1,0
435086,2266,13,711,705,6,4,1,0
0,0,0,0,0,0,0,0,0
0,0,0,0,0,0,0,0,0
461986,1689,4,221,15,206,14,1,0
284541,3408,6,379,370,9,78,1,0
51585,803,1,188,177,11,4,1,0
50718,771,3,38,31,7,5,1,0
499932,2156,4,151,137,14,5,1,0
530158,2493,1,103,70,33,4,1,0
32413,325,2,18,10,8,24,1,0
790363,1370,18,229,214,15,31,1,0
973646,1706,9,193,173,20,4,1,1
199420,860,3,57,32,25,5,1,0
62666,458,3,52,28,24,16,1,0
853617,4149,18,624,602,22,67,1,0
354703,1822,15,285,272,13,5,0,0
34218,118,3,7,7,0,2,1,0
120485,2147,6,150,144,6,4,1,0
42772,692,8,183,165,18,6,1,0
345996,899,2,115,47,68,0,0,0
79885,1281,1,213,210,3,9,1,0
323203,1973,1,480,472,8,2,1,0
236193,2507,8,478,467,11,9,0,0
92467,1041,2,60,33,27,2,1,0
365972,1511,1,194,176,18,11,1,0
199595,1041,12,133,126,7,7,1,0
158732,736,4,72,46,26,1,1,0
100554,727,3,209,202,7,7,1,0
450126,1927,4,269,30,239,3,1,0
373795,5376,5,565,541,24,3,1,0
225803,1002,4,140,138,2,0,1,0
0,0,0,0,0,0,0,0,0
43997,691,2,90,87,3,3,1,0
93041,894,6,173,155,18,11,1,0
0,0,0,0,0,0,0,0,0
0,0,0,0,0,0,0,0,0
173708,797,4,126,93,33,14,0,0
268186,1441,7,142,117,25,80,1,0
0,0,0,0,0,0,0,0,0
1840867,1489,2,221,202,19,1,1,0
466804,1874,4,178,149,29,106,1,0
370221,1137,2,124,120,4,10,0,0
0,0,0,0,0,0,0,0,0
214702,2380,6,405,370,35,18,1,0
114131,929,4,238,209,29,8,1,0
0,0,0,0,0,0,0,0,0
152361,1006,7,242,240,2,19,1,0
87868,427,6,72,71,1,15,1,0
12872,150,6,2,2,0,5,0,0
83171,878,2,160,156,4,13,1,0
691670,537,0,5,2,3,2,1,1
365650,2676,6,480,314,166,58,1,0
305628,1544,6,339,9,330,35,1,0
257278,1282,6,180,146,34,2,0,0
0,0,0,0,0,0,0,0,0
3657,65,3,1,0,1,0,0,0
2416496,2835,8,455,422,33,66,1,0
165516,425,7,17,10,7,6,1,0
356207,3555,11,851,826,25,73,1,0
0,0,0,0,0,0,0,0,0
101657,1233,3,165,61,104,8,1,0
0,0,0,0,0,0,0,0,0
202519,954,1,117,92,25,0,1,0
0,0,0,0,0,0,0,0,0
1135940,15647,7,837,627,210,532,1,0
77291,320,6,7,6,1,11,1,0
152566,1202,9,289,275,14,12,1,0
0,0,0,0,0,0,0,0,0
118413,482,11,84,77,7,20,1,0
174816,1024,5,167,142,25,12,1,0
0,0,0,0,0,0,0,0,0
352069,1365,8,136,125,11,48,1,0
19471,113,2,6,6,0,0,0,0
145075,492,5,29,21,8,1,0,0
174085,1531,10,275,266,9,37,0,0
951730,15155,7,1173,1172,1,10,0,0
395946,2072,2,172,153,19,3,1,0
0,0,0,0,0,0,0,0,0
190696,1261,1,187,187,0,1,1,0
333804,1766,15,288,257,31,24,0,1
0,0,0,0,0,0,0,0,0
0,0,0,0,0,0,0,0,0
217217,592,5,44,42,2,0,0,0
0,0,0,0,0,0,0,0,0
0,0,0,0,0,0,0,0,0
121485,1361,2,442,438,4,6,0,0
0,0,0,0,0,0,0,0,0
637393,1362,2,121,116,5,10,1,1
279766,148,1,8,5,3,6,1,1
29511,116,5,7,7,0,0,1,0
31475,186,6,3,1,2,0,1,0
53044,206,7,6,5,1,12,1,0
231583,343,0,16,3,13,0,1,0
125173,868,6,94,57,37,14,0,0
124546,850,6,94,57,37,14,0,0
118039,627,1,73,63,10,1,1,0
138938,2405,5,586,530,56,4,1,0
431254,1276,6,190,182,8,6,0,0
0,0,0,0,0,0,0,0,0
342162,1081,3,100,90,10,5,0,0
84316,686,0,3,2,1,0,0,0
0,0,0,0,0,0,0,0,0
8987,135,0,16,16,0,0,0,0
190217,1148,2,248,222,26,3,1,0
0,0,0,0,0,0,0,0,0
104348,881,3,229,210,19,9,0,0
162313,1001,7,99,67,32,8,1,0
9864,152,2,25,25,0,0,0,0
121779,1255,4,266,253,13,21,1,0
32349,323,2,29,28,1,3,1,0
0,0,0,0,0,0,0,0,0
415901,1108,9,139,130,9,11,1,0
162035,536,10,94,85,9,8,1,0
346086,1200,4,148,145,3,35,1,0
109308,1898,1,351,342,9,1,1,0
166169,1833,6,430,424,6,17,1,0
481704,4258,7,1136,1135,1,20,1,0
247251,926,13,189,186,3,18,1,0
6712,63,6,3,2,1,0,0,0
0,0,0,0,0,0,0,0,0
200763,1286,9,222,206,16,8,1,0
65430,193,4,7,6,1,7,1,0
22710,37,0,2,1,1,0,1,0
392460,1812,5,279,273,6,5,1,0
542545,2587,5,298,290,8,13,1,0
548816,1528,4,149,113,36,0,1,0
1179730,2616,10,327,309,18,16,1,0
0,0,0,0,0,0,0,0,0
0,0,0,0,0,0,0,0,0
0,0,0,0,0,0,0,0,0
2619616,1327,9,234,228,6,13,1,0
357899,536,3,100,85,15,6,1,0
354730,348,6,75,59,16,6,1,0
0,0,0,0,0,0,0,0,0
235260,2273,8,410,385,25,36,1,0
68353,884,5,217,191,26,13,1,0
0,0,0,0,0,0,0,0,0
0,0,0,0,0,0,0,0,0
60034,737,5,216,205,11,7,0,0
10835,124,1,7,6,1,0,0,0
1518847,17676,9,1586,1572,14,30,0,0
308267,2005,9,363,344,19,18,1,1
13553,222,3,48,47,1,0,1,0
9749,153,1,30,29,1,0,1,0
0,0,0,0,0,0,0,0,0
197505,1129,3,485,485,0,4,1,0
0,0,0,0,0,0,0,0,0
218097,1341,10,240,232,8,11,1,0
0,0,0,0,0,0,0,0,0
72690,1159,9,176,175,1,2,1,0
42395,400,10,93,92,1,2,1,0
492269,1777,9,218,37,181,20,1,0
291349,845,9,11,5,6,6,1,0
48893,552,8,105,89,16,2,1,0
1291471,4375,15,333,229,104,46,1,0
22688,313,2,57,57,0,4,0,0
0,0,0,0,0,0,0,0,0
226678,319,2,26,26,0,8,1,0
0,0,0,0,0,0,0,0,0
0,0,0,0,0,0,0,0,0
429327,5187,10,932,893,39,34,1,0
97053,479,5,67,67,0,8,1,0
99537,566,4,88,84,4,24,1,0
208747,202,3,22,22,0,11,1,0
0,0,0,0,0,0,0,0,0
447109,1569,7,139,108,31,1,0,0
1349,34,0,1,1,0,0,0,0
232950,2182,4,301,265,36,30,1,0
37898,536,3,94,85,9,5,1,0
33879,196,2,51,51,0,8,1,0
347277,1643,11,341,318,23,29,1,0
0,0,0,0,0,0,0,0,0
0,0,0,0,0,0,0,0,0
129626,1009,12,153,152,1,5,1,0
66620,917,5,236,235,1,9,0,0
0,0,0,0,0,0,0,0,0
0,0,0,0,0,0,0,0,0
387864,1492,5,329,321,8,2,1,0
0,0,0,0,0,0,0,0,0
131617,1214,3,72,45,27,2,1,0
0,0,0,0,0,0,0,0,0
48533,538,8,62,58,4,5,1,0
280257,1117,8,99,92,7,10,1,0
0,0,0,0,0,0,0,0,0
60042,666,9,122,116,6,7,1,0
0,0,0,0,0,0,0,0,0
0,0,0,0,0,0,0,0,0
685507,5391,10,749,736,13,29,1,0
0,0,0,0,0,0,0,0,0
28546,417,2,103,101,2,2,1,0
72723,699,1,266,265,1,0,0,0
424903,4146,3,375,288,87,0,1,0
4018,78,1,12,9,3,0,1,0
0,0,0,0,0,0,0,0,0
127792,535,10,43,37,6,5,1,0
64178,1023,2,149,133,16,0,1,0
0,0,0,0,0,0,0,0,0
233891,2820,1,444,374,70,4,1,0
1775432,6109,5,361,353,8,0,1,0
188529,918,3,187,172,15,6,0,0
148218,683,13,124,106,18,45,1,0
177869,671,9,120,118,2,18,1,0
0,0,0,0,0,0,0,0,0
0,0,0,0,0,0,0,0,0
0,0,0,0,0,0,0,0,0
0,0,0,0,0,0,0,0,0
0,0,0,0,0,0,0,0,0
0,0,0,0,0,0,0,0,0
0,0,0,0,0,0,0,0,0
0,0,0,0,0,0,0,0,0
0,0,0,0,0,0,0,0,0
0,0,0,0,0,0,0,0,0
0,0,0,0,0,0,0,0,0
0,0,0,0,0,0,0,0,0
0,0,0,0,0,0,0,0,0
0,0,0,0,0,0,0,0,0
0,0,0,0,0,0,0,0,0
0,0,0,0,0,0,0,0,0
0,0,0,0,0,0,0,0,0
0,0,0,0,0,0,0,0,0
0,0,0,0,0,0,0,0,0
0,0,0,0,0,0,0,0,0
0,0,0,0,0,0,0,0,0
0,0,0,0,0,0,0,0,0
0,0,0,0,0,0,0,0,0
0,0,0,0,0,0,0,0,0
0,0,0,0,0,0,0,0,0
0,0,0,0,0,0,0,0,0
0,0,0,0,0,0,0,0,0
0,0,0,0,0,0,0,0,0
0,0,0,0,0,0,0,0,0
0,0,0,0,0,0,0,0,0
0,0,0,0,0,0,0,0,0
0,0,0,0,0,0,0,0,0
0,0,0,0,0,0,0,0,0
0,0,0,0,0,0,0,0,0
0,0,0,0,0,0,0,0,0
0,0,0,0,0,0,0,0,0
0,0,0,0,0,0,0,0,0
0,0,0,0,0,0,0,0,0
0,0,0,0,0,0,0,0,0
0,0,0,0,0,0,0,0,0
0,0,0,0,0,0,0,0,0
0,0,0,0,0,0,0,0,0
0,0,0,0,0,0,0,0,0
0,0,0,0,0,0,0,0,0
0,0,0,0,0,0,0,0,0
0,0,0,0,0,0,0,0,0
0,0,0,0,0,0,0,0,0
0,0,0,0,0,0,0,0,0
0,0,0,0,0,0,0,0,0
0,0,0,0,0,0,0,0,0
0,0,0,0,0,0,0,0,0
0,0,0,0,0,0,0,0,0
0,0,0,0,0,0,0,0,0
0,0,0,0,0,0,0,0,0
0,0,0,0,0,0,0,0,0
0,0,0,0,0,0,0,0,0
0,0,0,0,0,0,0,0,0
0,0,0,0,0,0,0,0,0
0,0,0,0,0,0,0,0,0
0,0,0,0,0,0,0,0,0
0,0,0,0,0,0,0,0,0
0,0,0,0,0,0,0,0,0
0,0,0,0,0,0,0,0,0
0,0,0,0,0,0,0,0,0
0,0,0,0,0,0,0,0,0
0,0,0,0,0,0,0,0,0
0,0,0,0,0,0,0,0,0
0,0,0,0,0,0,0,0,0
0,0,0,0,0,0,0,0,0
0,0,0,0,0,0,0,0,0
0,0,0,0,0,0,0,0,0
0,0,0,0,0,0,0,0,0
0,0,0,0,0,0,0,0,0
0,0,0,0,0,0,0,0,0
0,0,0,0,0,0,0,0,0
0,0,0,0,0,0,0,0,0
0,0,0,0,0,0,0,0,0
0,0,0,0,0,0,0,0,0
0,0,0,0,0,0,0,0,0
0,0,0,0,0,0,0,0,0
0,0,0,0,0,0,0,0,0
0,0,0,0,0,0,0,0,0
0,0,0,0,0,0,0,0,0
0,0,0,0,0,0,0,0,0
0,0,0,0,0,0,0,0,0
0,0,0,0,0,0,0,0,0
0,0,0,0,0,0,0,0,0
0,0,0,0,0,0,0,0,0
0,0,0,0,0,0,0,0,0
0,0,0,0,0,0,0,0,0
0,0,0,0,0,0,0,0,0
0,0,0,0,0,0,0,0,0
0,0,0,0,0,0,0,0,0
0,0,0,0,0,0,0,0,0
0,0,0,0,0,0,0,0,0
0,0,0,0,0,0,0,0,0
0,0,0,0,0,0,0,0,0
0,0,0,0,0,0,0,0,0
0,0,0,0,0,0,0,0,0
0,0,0,0,0,0,0,0,0
0,0,0,0,0,0,0,0,0
0,0,0,0,0,0,0,0,0
0,0,0,0,0,0,0,0,0
0,0,0,0,0,0,0,0,0
0,0,0,0,0,0,0,0,0
0,0,0,0,0,0,0,0,0
0,0,0,0,0,0,0,0,0
0,0,0,0,0,0,0,0,0
0,0,0,0,0,0,0,0,0
0,0,0,0,0,0,0,0,0
0,0,0,0,0,0,0,0,0
0,0,0,0,0,0,0,0,0
0,0,0,0,0,0,0,0,0
0,0,0,0,0,0,0,0,0
0,0,0,0,0,0,0,0,0
0,0,0,0,0,0,0,0,0
0,0,0,0,0,0,0,0,0
0,0,0,0,0,0,0,0,0
0,0,0,0,0,0,0,0,0
0,0,0,0,0,0,0,0,0
0,0,0,0,0,0,0,0,0
0,0,0,0,0,0,0,0,0
0,0,0,0,0,0,0,0,0
0,0,0,0,0,0,0,0,0
0,0,0,0,0,0,0,0,0
0,0,0,0,0,0,0,0,0
0,0,0,0,0,0,0,0,0
0,0,0,0,0,0,0,0,0
0,0,0,0,0,0,0,0,0
0,0,0,0,0,0,0,0,0
0,0,0,0,0,0,0,0,0
0,0,0,0,0,0,0,0,0
0,0,0,0,0,0,0,0,0
0,0,0,0,0,0,0,0,0
0,0,0,0,0,0,0,0,0
0,0,0,0,0,0,0,0,0
0,0,0,0,0,0,0,0,0
0,0,0,0,0,0,0,0,0
0,0,0,0,0,0,0,0,0
0,0,0,0,0,0,0,0,0
0,0,0,0,0,0,0,0,0
0,0,0,0,0,0,0,0,0
0,0,0,0,0,0,0,0,0
0,0,0,0,0,0,0,0,0
0,0,0,0,0,0,0,0,0
0,0,0,0,0,0,0,0,0
0,0,0,0,0,0,0,0,0
0,0,0,0,0,0,0,0,0
0,0,0,0,0,0,0,0,0
0,0,0,0,0,0,0,0,0
0,0,0,0,0,0,0,0,0
0,0,0,0,0,0,0,0,0
0,0,0,0,0,0,0,0,0
0,0,0,0,0,0,0,0,0
0,0,0,0,0,0,0,0,0
0,0,0,0,0,0,0,0,0
0,0,0,0,0,0,0,0,0
0,0,0,0,0,0,0,0,0
0,0,0,0,0,0,0,0,0
0,0,0,0,0,0,0,0,0
0,0,0,0,0,0,0,0,0
0,0,0,0,0,0,0,0,0
0,0,0,0,0,0,0,0,0
0,0,0,0,0,0,0,0,0
0,0,0,0,0,0,0,0,0
0,0,0,0,0,0,0,0,0
0,0,0,0,0,0,0,0,0
0,0,0,0,0,0,0,0,0
0,0,0,0,0,0,0,0,0
0,0,0,0,0,0,0,0,0
0,0,0,0,0,0,0,0,0
0,0,0,0,0,0,0,0,0
0,0,0,0,0,0,0,0,0
0,0,0,0,0,0,0,0,0
0,0,0,0,0,0,0,0,0
0,0,0,0,0,0,0,0,0
0,0,0,0,0,0,0,0,0
0,0,0,0,0,0,0,0,0
0,0,0,0,0,0,0,0,0
0,0,0,0,0,0,0,0,0
0,0,0,0,0,0,0,0,0
0,0,0,0,0,0,0,0,0
0,0,0,0,0,0,0,0,0
0,0,0,0,0,0,0,0,0
0,0,0,0,0,0,0,0,0
0,0,0,0,0,0,0,0,0
0,0,0,0,0,0,0,0,0
0,0,0,0,0,0,0,0,0
0,0,0,0,0,0,0,0,0
0,0,0,0,0,0,0,0,0
0,0,0,0,0,0,0,0,0
0,0,0,0,0,0,0,0,0
0,0,0,0,0,0,0,0,0
0,0,0,0,0,0,0,0,0
0,0,0,0,0,0,0,0,0
0,0,0,0,0,0,0,0,0
0,0,0,0,0,0,0,0,0
0,0,0,0,0,0,0,0,0
0,0,0,0,0,0,0,0,0
0,0,0,0,0,0,0,0,0
0,0,0,0,0,0,0,0,0
0,0,0,0,0,0,0,0,0
0,0,0,0,0,0,0,0,0
0,0,0,0,0,0,0,0,0
0,0,0,0,0,0,0,0,0
0,0,0,0,0,0,0,0,0
0,0,0,0,0,0,0,0,0
0,0,0,0,0,0,0,0,0
0,0,0,0,0,0,0,0,0
0,0,0,0,0,0,0,0,0
0,0,0,0,0,0,0,0,0
0,0,0,0,0,0,0,0,0
0,0,0,0,0,0,0,0,0
0,0,0,0,0,0,0,0,0
169432,1567,8,476,338,138,10,1,0
72495,565,10,81,72,9,9,1,0
33880,262,8,29,23,6,7,0,0
0,0,0,0,0,0,0,0,0
0,0,0,0,0,0,0,0,0
209626,1753,8,515,493,22,51,1,0
113920,2409,5,523,507,16,3,1,0
60146,703,6,246,242,4,10,1,0
25770,184,6,32,30,2,5,1,0
0,0,0,0,0,0,0,0,0
308664,868,2,143,134,9,2,1,0
233559,952,7,174,167,7,26,1,0
0,0,0,0,0,0,0,0,0
7985,131,2,15,7,8,0,1,0
175819,1550,2,346,328,18,8,0,0
162791,1128,5,202,194,8,3,1,0
0,0,0,0,0,0,0,0,0
232894,347,0,17,9,8,0,1,0
798313,3727,16,421,372,49,11,1,0
182052,161,4,10,7,3,3,1,0
1020968,131,5,4,4,0,5,1,0
119315,1274,6,282,260,22,11,1,0
59724,756,3,92,75,17,8,1,0
0,0,0,0,0,0,0,0,0
121061,738,10,181,150,31,12,1,0
0,0,0,0,0,0,0,0,0
25986,221,1,31,31,0,10,1,0
6911,163,0,29,28,1,0,1,0
61408,1182,4,296,271,25,8,1,0
0,0,0,0,0,0,0,0,0
344745,1218,16,182,168,14,30,0,0
11625,148,5,3,3,0,3,0,0
0,0,0,0,0,0,0,0,0
996858,5256,10,275,257,18,49,1,0
218891,441,10,5,4,1,7,0,0
550908,4009,12,375,347,28,7,0,1
63842,895,1,293,291,2,6,1,0
480158,1726,9,399,385,14,10,1,0
4135,46,3,4,4,0,0,0,0
0,0,0,0,0,0,0,0,0
125784,1478,10,287,286,1,1,0,0
5836,57,7,3,2,1,0,0,0
86228,359,9,29,28,1,2,0,0
9354,168,2,72,66,6,3,1,0
77347,1047,6,234,229,5,10,0,0
31502,333,6,53,48,5,9,0,0
0,0,0,0,0,0,0,0,0
79592,302,5,33,30,3,1,1,0
149771,1132,7,274,265,9,4,0,0
227580,908,6,247,106,141,4,0,0
0,0,0,0,0,0,0,0,0
0,0,0,0,0,0,0,0,0
206032,736,4,146,145,1,6,1,0
1928134,1057,5,67,49,18,1,1,0
0,0,0,0,0,0,0,0,0
0,0,0,0,0,0,0,0,0
252355,1489,8,204,185,19,2,1,0
0,0,0,0,0,0,0,0,0
283242,2095,5,259,238,21,8,0,0
0,0,0,0,0,0,0,0,0
0,0,0,0,0,0,0,0,0
0,0,0,0,0,0,0,0,0
177831,2092,3,495,490,5,13,1,0
0,0,0,0,0,0,0,0,0
108808,891,11,185,180,5,32,1,0
48181,148,6,13,8,5,1,1,0
0,0,0,0,0,0,0,0,0
474346,1341,8,129,25,104,10,1,0
8309,90,2,5,2,3,0,1,0
0,0,0,0,0,0,0,0,0
446886,3853,4,618,459,159,71,1,0
0,0,0,0,0,0,0,0,0
142338,2933,2,822,811,11,16,1,0
208220,1031,9,138,132,6,8,1,0
172958,656,7,83,71,12,6,1,0
0,0,0,0,0,0,0,0,0
0,0,0,0,0,0,0,0,0
0,0,0,0,0,0,0,0,0
53360,527,5,84,74,10,2,1,0
0,0,0,0,0,0,0,0,0
401781,465,3,63,63,0,0,1,0
391827,260,3,48,48,0,2,1,0
68164,925,7,293,287,6,2,1,0
72141,722,4,122,119,3,9,1,0
345102,1986,20,330,244,86,14,1,0
953305,4214,6,726,692,34,94,1,0
0,0,0,0,0,0,0,0,0
210358,653,7,80,80,0,8,0,0
0,0,0,0,0,0,0,0,0
18864,163,1,19,17,2,3,1,0
10157,87,0,12,11,1,1,1,0
0,0,0,0,0,0,0,0,0
0,0,0,0,0,0,0,0,0
12574,225,0,112,109,3,0,0,0
2678,51,1,2,1,1,0,0,0
251023,1474,12,336,309,27,39,1,0
0,0,0,0,0,0,0,0,0
1466795,699,6,31,25,6,17,1,0
369384,1110,12,200,175,25,86,1,0
390523,5397,5,1253,1124,129,3,1,0
120223,751,3,269,217,52,11,1,0
0,0,0,0,0,0,0,0,0
338578,1388,12,209,180,29,2,1,0
0,0,0,0,0,0,0,0,0
0,0,0,0,0,0,0,0,0
0,0,0,0,0,0,0,0,0
0,0,0,0,0,0,0,0,0
0,0,0,0,0,0,0,0,0
11193,96,3,13,13,0,0,1,0
1417845,972,2,77,54,23,2,1,0
385805,119,0,5,5,0,0,1,0
296519,835,5,12,10,2,5,1,0
0,0,0,0,0,0,0,0,0
0,0,0,0,0,0,0,0,0
0,0,0,0,0,0,0,0,0
70640,397,3,68,64,4,7,0,0
80986,355,2,25,20,5,2,1,0
95191,815,8,169,158,11,7,1,0
0,0,0,0,0,0,0,0,0
0,0,0,0,0,0,0,0,0
253682,823,3,151,143,8,2,1,0
46510,162,3,17,1,16,1,1,0
0,0,0,0,0,0,0,0,0
392503,1772,8,553,527,26,53,1,0
18745,236,3,11,1,10,3,1,0
7486,89,3,11,11,0,3,1,0
0,0,0,0,0,0,0,0,0
417422,942,6,52,46,6,7,1,0
512836,3937,6,672,662,10,8,1,0
0,0,0,0,0,0,0,0,0
65678,483,10,139,88,51,3,0,0
164308,714,5,64,40,24,8,0,0
0,0,0,0,0,0,0,0,0
0,0,0,0,0,0,0,0,0
0,0,0,0,0,0,0,0,0
0,0,0,0,0,0,0,0,0
42138,671,3,182,172,10,2,0,0
0,0,0,0,0,0,0,0,0
0,0,0,0,0,0,0,0,0
617608,3567,7,638,610,28,9,0,0
0,0,0,0,0,0,0,0,0
20499,345,1,78,61,17,0,1,0
12330,176,2,40,7,33,0,1,0
600582,4294,5,434,421,13,15,1,0
32625,157,4,5,4,1,2,0,0
513169,1539,17,235,209,26,44,0,0
0,0,0,0,0,0,0,0,0
624123,1648,3,483,470,13,2,1,0
51728,1038,6,311,310,1,0,0,0
0,0,0,0,0,0,0,0,0
47078,626,4,105,105,0,2,1,0
424249,4511,4,1162,543,619,103,1,0
148726,799,6,154,127,27,8,1,0
1008611,10595,8,1014,397,617,271,1,0
11235,132,2,13,13,0,2,1,0
0,0,0,0,0,0,0,0,0
22091,205,7,51,51,0,1,1,0
9657,246,0,77,54,23,0,1,0
92805,885,5,131,126,5,3,0,0
0,0,0,0,0,0,0,0,0
146833,1527,3,299,293,6,1,0,0
0,0,0,0,0,0,0,0,0
272182,1827,10,305,285,20,5,1,0
111058,1110,2,150,76,74,14,1,0
11646,47,0,3,2,1,1,0,0
0,0,0,0,0,0,0,0,0
188284,1955,8,394,358,36,45,1,0
897409,2764,10,475,454,21,20,1,0
219411,2471,3,583,395,188,6,1,0
0,0,0,0,0,0,0,0,0
0,0,0,0,0,0,0,0,0
0,0,0,0,0,0,0,0,0
1514939,1159,7,83,82,1,5,1,0
1065250,11000,2,415,415,0,0,0,0
311345,2045,13,204,52,152,3,1,0
309490,1564,5,351,343,8,1,1,0
258756,1155,5,287,279,8,1,1,0
138722,217,4,10,10,0,5,1,0
67335,824,2,210,207,3,2,1,0
0,0,0,0,0,0,0,0,0
331338,2204,5,261,249,12,11,1,1
0,0,0,0,0,0,0,0,0
67300,1066,4,195,169,26,3,1,0
26903,407,3,131,106,25,1,1,0
139758,786,5,79,74,5,2,1,0
0,0,0,0,0,0,0,0,0
92430,1041,2,60,33,27,2,1,0
264483,3616,12,610,593,17,0,1,0
0,0,0,0,0,0,0,0,0
119462,997,4,151,114,37,2,1,0
25652,168,2,20,19,1,0,1,0
0,0,0,0,0,0,0,0,0
36740,629,1,93,89,4,11,0,0
15423,296,1,57,56,1,0,1,0
205747,1552,1,324,323,1,2,1,1
401894,2556,4,466,376,90,7,1,1
0,0,0,0,0,0,0,0,0
29415,342,5,62,61,1,0,0,0
60946,663,4,161,160,1,10,1,0
724932,6850,8,519,351,168,614,1,0
0,0,0,0,0,0,0,0,0
0,0,0,0,0,0,0,0,0
0,0,0,0,0,0,0,0,0
13804,266,1,142,137,5,0,1,0
0,0,0,0,0,0,0,0,0
207160,1693,6,1132,1131,1,0,1,0
32807,337,6,80,79,1,0,1,0
311970,1812,10,416,29,387,5,1,0
239826,1556,12,134,86,48,16,1,0
741954,1799,3,225,219,6,0,1,0
135263,798,0,137,130,7,0,0,0
177926,427,7,3,3,0,43,0,0
0,0,0,0,0,0,0,0,0
438264,2363,6,565,543,22,13,1,0
64884,742,6,223,220,3,7,1,0
0,0,0,0,0,0,0,0,0
379380,1418,5,247,238,9,12,1,0
203136,340,4,84,72,12,1,1,0
1390963,4601,9,490,457,33,20,1,0
231007,347,0,17,12,5,0,1,0
0,0,0,0,0,0,0,0,0
9768,46,0,2,0,2,0,0,0
0,0,0,0,0,0,0,0,0
139664,1558,2,603,592,11,5,0,0
10568,206,1,32,23,9,3,0,0
0,0,0,0,0,0,0,0,0
0,0,0,0,0,0,0,0,0
0,0,0,0,0,0,0,0,0
56186,398,5,34,34,0,19,0,0
0,0,0,0,0,0,0,0,0
165808,1801,7,467,440,27,29,1,0
0,0,0,0,0,0,0,0,0
146786,1183,9,129,119,10,0,1,0
42604,292,9,48,43,5,2,1,0
234570,744,4,32,28,4,0,1,0
116821,333,4,27,22,5,0,1,0
0,0,0,0,0,0,0,0,0
202465,455,5,33,28,5,19,1,0
0,0,0,0,0,0,0,0,0
0,0,0,0,0,0,0,0,0
94117,608,6,77,41,36,1,1,0
123640,848,3,73,47,26,9,1,0
0,0,0,0,0,0,0,0,0
656194,1626,6,144,137,7,79,1,0
4950037,36840,10,3667,2166,1501,9,1,0
47106,132,8,3,0,3,0,1,0
1449946,5694,6,1179,1155,24,4,0,0
22902,37,0,2,1,1,0,1,0
0,0,0,0,0,0,0,0,0
0,0,0,0,0,0,0,0,0
0,0,0,0,0,0,0,0,0
0,0,0,0,0,0,0,0,0
886732,5017,3,613,169,444,542,1,0
0,0,0,0,0,0,0,0,0
0,0,0,0,0,0,0,0,0
0,0,0,0,0,0,0,0,0
61648,881,0,511,468,43,0,0,0
107548,949,7,162,159,3,29,0,0
54729,239,7,1,1,0,28,1,0
0,0,0,0,0,0,0,0,0
841283,3217,14,568,532,36,31,1,0
0,0,0,0,0,0,0,0,0
0,0,0,0,0,0,0,0,0
0,0,0,0,0,0,0,0,0
26023,97,1,9,8,1,3,0,0
532856,3042,6,838,838,0,19,1,0
459926,2067,7,499,499,0,15,1,0
96511,1005,2,109,98,11,22,0,0
5307,91,3,14,13,1,1,0,0
0,0,0,0,0,0,0,0,0
1167420,3850,6,506,481,25,7,1,0
18824,59,0,0,0,0,1,0,0
0,0,0,0,0,0,0,0,0
781280,2280,5,287,278,9,2,1,0
43763,428,4,52,44,8,2,1,0
114870,934,8,144,77,67,7,1,0
479881,2370,10,237,188,49,27,1,0
0,0,0,0,0,0,0,0,0
0,0,0,0,0,0,0,0,0
64456,622,3,96,74,22,2,1,0
48269,156,4,4,3,1,3,0,0
514066,4287,6,2007,2004,3,4,1,0
0,0,0,0,0,0,0,0,0
0,0,0,0,0,0,0,0,0
113266,1387,2,91,90,1,10,1,0
1159678,1279,1,44,29,15,7,1,0
265538,1497,11,244,224,20,67,1,0
23409,37,0,2,1,1,0,1,0
0,0,0,0,0,0,0,0,0
0,0,0,0,0,0,0,0,0
0,0,0,0,0,0,0,0,0
3767879,3242,6,316,252,64,7,1,0
1053861,959,7,169,137,32,5,1,0
0,0,0,0,0,0,0,0,0
620960,4517,12,1194,1186,8,28,1,0
579767,2071,8,255,229,26,20,1,0
0,0,0,0,0,0,0,0,0
175532,607,1,17,13,4,2,1,0
0,0,0,0,0,0,0,0,0
215365,3376,1,811,668,143,1,0,0
0,0,0,0,0,0,0,0,0
0,0,0,0,0,0,0,0,0
238227,985,2,203,197,6,5,1,0
8914,72,0,4,4,0,1,1,0
123324,891,1,208,198,10,4,1,0
205560,554,4,13,3,10,6,1,0
639423,1044,11,101,79,22,1,1,0
10268,143,3,8,8,0,5,0,0
0,0,0,0,0,0,0,0,0
0,0,0,0,0,0,0,0,0
0,0,0,0,0,0,0,0,0
23605,229,7,33,25,8,2,1,0
0,0,0,0,0,0,0,0,0
0,0,0,0,0,0,0,0,0
0,0,0,0,0,0,0,0,0
0,0,0,0,0,0,0,0,0
172679,587,4,53,35,18,9,1,0
0,0,0,0,0,0,0,0,0
0,0,0,0,0,0,0,0,0
0,0,0,0,0,0,0,0,0
0,0,0,0,0,0,0,0,0
0,0,0,0,0,0,0,0,0
1584942,2423,14,402,207,195,65,1,0
147010,1009,5,58,50,8,1,0,0
135453,1120,6,212,200,12,11,1,0
270895,2561,7,310,247,63,14,0,0
270895,2561,7,310,280,30,14,0,0
209277,3851,7,624,578,46,1,1,0
238269,1606,9,333,319,14,8,1,0
151770,957,10,373,369,4,2,1,0
536754,1842,7,355,333,22,9,1,0
555134,2009,6,335,322,13,6,1,0
0,0,0,0,0,0,0,0,0
68346,538,4,99,95,4,5,1,0
129435,1442,5,216,209,7,7,1,0
0,0,0,0,0,0,0,0,0
0,0,0,0,0,0,0,0,0
297642,1042,1,245,192,53,1,0,0
101836,590,16,76,71,5,11,1,0
108911,664,11,111,107,4,0,1,0
307036,1258,8,218,184,34,4,1,0
0,0,0,0,0,0,0,0,0
0,0,0,0,0,0,0,0,0
27947,42,0,2,1,1,0,0,0
22515,39,0,3,1,2,0,1,0
205412,1849,6,503,499,4,8,1,0
234822,1883,5,503,497,6,9,1,0
132820,1501,2,234,234,0,8,0,0
997662,5299,4,997,997,0,4,1,0
194517,1138,9,178,155,23,18,1,0
87267,312,5,6,6,0,7,1,0
0,0,0,0,0,0,0,0,0
57629,961,4,320,296,24,0,0,0
10447,206,5,27,26,1,0,0,0
9808,112,3,7,5,2,1,0,0
138626,418,2,83,16,67,3,0,0
0,0,0,0,0,0,0,0,0
138336,872,5,183,165,18,9,1,0
0,0,0,0,0,0,0,0,0
87744,781,1,320,270,50,3,1,0
0,0,0,0,0,0,0,0,0
0,0,0,0,0,0,0,0,0
0,0,0,0,0,0,0,0,0
0,0,0,0,0,0,0,0,0
274707,1391,2,192,181,11,0,1,0
0,0,0,0,0,0,0,0,0
154136,804,6,142,118,24,12,0,0
0,0,0,0,0,0,0,0,0
102750,1009,10,169,161,8,7,1,0
103162,967,10,165,159,6,7,1,0
111956,1167,4,208,166,42,5,1,0
78536,1788,2,603,588,15,0,1,0
561872,2589,4,18,1,17,13,0,0
86544,1499,2,362,358,4,8,1,0
50572,941,2,227,225,2,10,1,0
118462,530,4,67,64,3,9,0,0
45264,792,3,116,111,5,6,1,0
104345,1707,4,473,465,8,14,0,0
26983,144,2,16,15,1,3,1,0
319563,1493,14,125,113,12,22,1,0
376913,2922,5,110,102,8,7,1,0
849319,499,5,84,77,7,2,1,0
262186,2137,0,355,320,35,45,1,0
0,0,0,0,0,0,0,0,0
0,0,0,0,0,0,0,0,0
0,0,0,0,0,0,0,0,0
1344685,8161,1,351,341,10,26,0,0
58063,451,0,90,81,9,12,0,0
263377,3270,3,863,859,4,13,1,0
121509,940,8,150,130,20,3,1,0
319725,1846,7,427,402,25,66,1,0
275529,3379,1,1005,983,22,25,1,0
0,0,0,0,0,0,0,0,0
172637,2257,11,359,350,9,32,1,0
458097,1532,9,295,284,11,6,1,0
207288,783,11,99,87,12,1,1,0
74485,73,8,7,7,0,1,0,1
28533,45,0,4,1,3,0,0,0
135686,775,4,137,132,5,19,1,0
767929,2304,13,256,231,25,30,0,0
0,0,0,0,0,0,0,0,0
0,0,0,0,0,0,0,0,0
256824,1356,7,299,287,12,4,1,0
115498,141,6,5,3,2,5,0,0
0,0,0,0,0,0,0,0,0
0,0,0,0,0,0,0,0,0
1412940,9941,12,2004,1649,355,72,1,0
451931,1503,11,237,29,208,18,0,0
76637,383,6,100,93,7,0,1,0
370702,1931,11,176,157,19,17,1,0
35934,641,0,235,235,0,0,0,0
5870,124,0,25,25,0,0,0,0
207570,864,6,278,271,7,3,1,0
0,0,0,0,0,0,0,0,0
24562,320,4,45,8,37,0,1,0
124351,1135,4,205,198,7,0,1,0
0,0,0,0,0,0,0,0,0
459901,1782,5,257,255,2,2,1,0
244704,648,6,104,98,6,7,1,0
156885,410,6,54,46,8,7,1,0
0,0,0,0,0,0,0,0,0
242896,770,3,146,139,7,2,1,0
45736,162,3,17,1,16,1,1,0
700013,4538,5,274,229,45,93,1,0
0,0,0,0,0,0,0,0,0
0,0,0,0,0,0,0,0,0
0,0,0,0,0,0,0,0,0
321649,2958,3,979,832,147,5,1,0
120223,751,3,269,217,52,11,1,0
36384,502,4,138,103,35,0,0,0
284091,1741,1,320,319,1,11,1,0
1820700,5845,3,412,360,52,31,1,0
358131,461,3,72,49,23,6,1,0
14240,361,0,68,62,6,0,0,0
0,0,0,0,0,0,0,0,0
32299,477,5,140,113,27,0,1,0
276817,1160,2,71,42,29,1,0,0
57675,144,6,12,11,1,5,0,0
145328,1031,7,104,97,7,8,1,0
78877,433,4,47,41,6,2,1,0
569290,1644,2,121,115,6,1,1,0
56831,427,1,62,56,6,0,1,0
178100,1169,3,283,269,14,1,1,0
0,0,0,0,0,0,0,0,0
0,0,0,0,0,0,0,0,0
70917,765,1,128,126,2,6,0,0
17503,285,1,22,20,2,2,0,0
0,0,0,0,0,0,0,0,0
0,0,0,0,0,0,0,0,0
45525,323,6,44,39,5,3,1,0
122774,538,5,109,96,13,25,1,0
94130,143,6,2,2,0,11,0,0
700691,2364,7,391,377,14,6,0,0
0,0,0,0,0,0,0,0,0
0,0,0,0,0,0,0,0,0
119834,767,4,43,30,13,0,1,0
364045,5820,5,1164,83,1081,4,1,0
0,0,0,0,0,0,0,0,0
0,0,0,0,0,0,0,0,0
138840,1291,5,228,143,85,1,0,0
73995,664,2,105,104,1,27,0,0
46632,307,0,76,69,7,0,1,0
460292,3226,17,946,841,105,20,1,0
268561,2190,16,630,604,26,22,1,0
98690,2444,2,738,730,8,4,1,0
0,0,0,0,0,0,0,0,0
0,0,0,0,0,0,0,0,0
213248,1161,8,267,242,25,7,1,0
169118,871,8,180,156,24,7,1,0
0,0,0,0,0,0,0,0,0
1881,26,1,1,1,0,0,0,0
404980,887,9,113,60,53,15,1,0
0,0,0,0,0,0,0,0,0
198262,1509,10,343,111,232,33,1,0
371363,3159,9,320,297,23,80,1,0
0,0,0,0,0,0,0,0,0
0,0,0,0,0,0,0,0,0
156688,1031,5,148,138,10,9,1,0
325333,687,6,119,116,3,19,1,0
20193,113,6,13,12,1,4,0,0
0,0,0,0,0,0,0,0,0
230987,347,0,17,8,9,0,1,0
348920,3094,10,781,750,31,42,1,0
690019,3771,4,239,222,17,5,1,0
0,0,0,0,0,0,0,0,0
934039,2649,7,306,174,132,14,1,0
0,0,0,0,0,0,0,0,0
802296,1902,15,429,18,411,2,1,0
90789,845,0,19,8,11,0,0,0
44384,575,1,55,40,15,0,1,0
26196,532,4,3,3,0,2,0,0
273591,3259,2,890,886,4,23,1,0
358377,3693,2,726,717,9,1,1,0
701798,2513,3,150,139,11,11,1,0
959432,1310,7,110,94,16,52,1,0
0,0,0,0,0,0,0,0,0
180300,2858,9,747,735,12,22,1,0
28270,42,0,2,1,1,0,0,0
388894,1602,8,166,154,12,29,1,0
17106,258,2,3,2,1,0,1,0
0,0,0,0,0,0,0,0,0
185108,644,5,30,16,14,12,1,0
0,0,0,0,0,0,0,0,0
1374816,12889,5,68,38,30,7,1,0
0,0,0,0,0,0,0,0,0
0,0,0,0,0,0,0,0,0
319997,3128,9,503,492,11,14,1,0
85358,819,9,158,146,12,11,1,0
0,0,0,0,0,0,0,0,0
187858,1110,2,136,95,41,4,1,0
115076,582,1,82,61,21,4,1,0
527645,5803,5,1042,505,537,12,1,0
50793,659,3,237,234,3,3,1,0
129018,1883,6,369,361,8,15,0,0
0,0,0,0,0,0,0,0,0
126611,1982,5,328,321,7,5,1,1
0,0,0,0,0,0,0,0,0
0,0,0,0,0,0,0,0,0
0,0,0,0,0,0,0,0,0
0,0,0,0,0,0,0,0,0
1423096,3045,8,253,228,25,10,1,0
105360,262,7,44,26,18,5,1,0
94567,209,5,37,21,16,4,1,0
0,0,0,0,0,0,0,0,0
146480,1717,6,240,201,39,19,1,0
19641,139,3,3,3,0,0,0,0
153024,981,5,151,137,14,17,1,0
25106,129,0,21,8,13,4,1,0
510558,2117,10,512,450,62,19,1,0
0,0,0,0,0,0,0,0,0
27780,42,0,2,1,1,0,0,0
644674,1566,7,352,302,50,1,1,0
1154786,3630,10,507,478,29,60,0,0
68340,940,8,163,156,7,2,1,0
177255,1242,2,151,141,10,4,1,1
0,0,0,0,0,0,0,0,0
2719,36,0,1,1,0,0,0,0
0,0,0,0,0,0,0,0,0
193246,2265,15,195,165,30,34,1,0
1196645,5245,4,1124,1079,45,16,1,0
225146,789,5,109,98,11,6,1,0
441294,1533,3,28,28,0,16,0,0
0,0,0,0,0,0,0,0,0
0,0,0,0,0,0,0,0,0
9421,205,4,52,51,1,0,1,0
6635,65,4,7,7,0,0,0,0
0,0,0,0,0,0,0,0,0
312026,1538,13,352,332,20,27,1,0
0,0,0,0,0,0,0,0,0
0,0,0,0,0,0,0,0,0
369064,961,11,107,89,18,21,1,0
18758,57,1,4,3,1,0,1,0
0,0,0,0,0,0,0,0,0
439327,1289,1,185,153,32,60,0,0
72554,737,6,183,73,110,0,1,0
468005,1856,10,227,204,23,23,1,0
0,0,0,0,0,0,0,0,0
0,0,0,0,0,0,0,0,0
0,0,0,0,0,0,0,0,0
740596,1781,2,149,140,9,10,1,1
278840,147,1,8,5,3,6,1,1
71152,714,5,91,84,7,8,1,0
283892,1482,6,101,63,38,15,1,0
197161,1888,10,287,209,78,12,1,0
0,0,0,0,0,0,0,0,0
402229,1539,6,281,245,36,3,1,0
275158,3259,3,1037,1021,16,7,1,0
241986,2026,8,463,463,0,13,1,0
484541,1338,9,208,200,8,1,1,0
74651,1056,7,235,204,31,4,1,0
0,0,0,0,0,0,0,0,0
0,0,0,0,0,0,0,0,0
0,0,0,0,0,0,0,0,0
292730,1714,6,526,507,19,12,1,0
167042,257,6,2,0,2,2,1,0
242206,2141,9,468,458,10,13,1,0
122159,1364,1,427,321,106,3,1,0
0,0,0,0,0,0,0,0,0
120336,1067,2,224,224,0,7,1,0
268116,3655,1,1021,896,125,127,1,0
92467,1041,2,60,33,27,2,1,0
0,0,0,0,0,0,0,0,0
201250,3011,5,1057,1057,0,13,1,0
20293,297,1,96,96,0,0,1,0
53103,585,10,91,79,12,6,1,0
59607,349,6,48,31,17,5,1,0
164247,1276,4,395,135,260,2,1,0
60746,733,5,249,64,185,1,1,0
230223,1158,9,152,130,22,13,1,0
196051,2149,4,612,527,85,6,1,0
91905,475,8,54,43,11,17,0,0
60538,367,5,32,22,10,2,0,0
127770,648,1,52,6,46,4,1,0
0,0,0,0,0,0,0,0,0
44136,425,4,101,99,2,8,1,0
101262,628,4,177,164,13,16,1,0
0,0,0,0,0,0,0,0,0
0,0,0,0,0,0,0,0,0
0,0,0,0,0,0,0,0,0
0,0,0,0,0,0,0,0,0
0,0,0,0,0,0,0,0,0
0,0,0,0,0,0,0,0,0
0,0,0,0,0,0,0,0,0
839398,8135,8,428,387,41,30,1,0
305607,2441,3,432,413,19,63,1,0
200401,1494,14,182,172,10,9,1,0
146461,771,4,105,91,14,6,0,0
0,0,0,0,0,0,0,0,0
130051,517,6,49,49,0,0,1,0
20044,268,0,45,41,4,12,0,0
1221880,2173,4,195,191,4,23,1,0
387941,919,4,96,90,6,16,1,0
274603,4133,2,697,695,2,1,1,0
0,0,0,0,0,0,0,0,0
41688,50,0,5,1,4,0,1,0
0,0,0,0,0,0,0,0,0
30396,450,2,66,61,5,5,1,0
1161254,3953,11,448,385,63,19,1,0
328139,1466,4,174,164,10,4,1,0
77729,1206,6,348,348,0,40,1,0
326939,1226,11,259,256,3,6,0,0
196754,2090,6,298,238,60,206,1,0
567654,2530,2,215,164,51,0,1,0
433467,1892,5,215,28,187,0,1,0
493087,2105,3,121,107,14,3,0,0
255012,1091,5,54,46,8,3,0,0
314739,3377,6,402,397,5,5,1,0
237294,2845,6,360,356,4,4,1,0
42597,577,5,161,154,7,19,1,0
842361,7552,3,585,427,158,16,1,1
110550,617,7,48,41,7,5,0,0
0,0,0,0,0,0,0,0,0
915052,1436,12,205,195,10,56,0,0
13235,127,5,13,11,2,0,1,0
663900,14292,7,1046,1036,10,32,0,0
1696990,2650,8,221,200,21,26,0,0
98902,1450,9,378,64,314,12,1,0
0,0,0,0,0,0,0,0,0
3127821,52865,12,1554,147,1407,1,1,0
47106,132,8,3,0,3,0,1,0
295216,1743,1,284,253,31,1,1,0
409044,1005,6,182,158,24,8,1,0
402756,2872,4,324,285,39,4,1,0
0,0,0,0,0,0,0,0,0
1053235,3912,9,682,594,88,18,1,1
64383,157,14,7,5,2,1,0,0
0,0,0,0,0,0,0,0,0
0,0,0,0,0,0,0,0,0
0,0,0,0,0,0,0,0,0
0,0,0,0,0,0,0,0,0
0,0,0,0,0,0,0,0,0
0,0,0,0,0,0,0,0,0
316055,1944,9,457,449,8,10,1,1
0,0,0,0,0,0,0,0,0
395281,2790,2,383,364,19,2,1,0
1429537,152,0,11,8,3,0,1,0
155060,56,3,9,6,3,1,1,0
285676,825,4,147,141,6,2,1,0
91938,172,3,15,9,6,1,1,0
0,0,0,0,0,0,0,0,0
967565,3620,5,128,72,56,6,1,0
813592,2252,3,6,6,0,8,1,0
46317,179,6,34,10,24,8,1,0
84135,860,3,235,232,3,2,1,0
23280,286,1,6,4,2,0,1,0
1799257,6323,5,411,403,8,0,1,0
508789,1220,9,202,197,5,1,1,0
41505,484,5,109,98,11,8,1,0
0,0,0,0,0,0,0,0,0
225348,985,11,182,178,4,4,1,0
605597,3983,8,933,929,4,21,0,0
416173,1295,21,183,161,22,3,1,0
0,0,0,0,0,0,0,0,0
0,0,0,0,0,0,0,0,0
0,0,0,0,0,0,0,0,0
84830,1159,5,140,125,15,25,1,0
22680,170,4,27,25,2,10,1,0
0,0,0,0,0,0,0,0,0
154798,1729,8,117,103,14,12,1,0
123600,1353,5,56,42,14,12,1,0
15756475,2541,6,48,41,7,136,1,0
139438,148,5,1,1,0,0,0,0
0,0,0,0,0,0,0,0,0
259820,386,6,10,6,4,0,1,0
156856,1220,9,116,106,10,59,0,0
45851,392,3,10,8,2,2,1,0
410636,1564,7,217,209,8,19,1,0
372306,1150,7,208,201,7,30,1,0
609935,3003,5,301,268,33,13,1,0
2886,44,0,9,9,0,3,0,0
249585,669,7,126,99,27,11,1,0
0,0,0,0,0,0,0,0,0
51554,582,5,23,15,8,0,1,0
0,0,0,0,0,0,0,0,0
0,0,0,0,0,0,0,0,0
577942,2679,6,254,200,54,33,1,0
0,0,0,0,0,0,0,0,0
43039,720,4,82,81,1,4,1,0
27254,310,7,49,49,0,1,0,0
317417,2302,7,174,167,7,22,1,0
94494,728,6,49,42,7,4,1,0
86436,1276,3,77,66,11,10,1,0
27334,165,3,50,37,13,6,1,0
421646,1327,5,263,255,8,3,1,0
329814,1847,1,380,339,41,1,1,0
0,0,0,0,0,0,0,0,0
141997,701,10,114,113,1,11,1,0
109504,1745,9,122,120,2,6,1,0
16841,131,6,11,11,0,0,1,0
0,0,0,0,0,0,0,0,0
105100,1200,3,178,166,12,0,1,0
97045,1122,4,194,135,59,2,1,0
0,0,0,0,0,0,0,0,0
0,0,0,0,0,0,0,0,0
0,0,0,0,0,0,0,0,0
681084,4082,7,423,394,29,5,1,0
3939,62,4,7,7,0,0,1,0
3790,36,5,0,0,0,0,0,0
279962,3121,6,620,588,32,11,0,0
139619,1231,5,334,268,66,3,1,0
9131,106,5,3,3,0,3,1,0
77441,798,9,152,138,14,1,1,0
352288,846,3,74,52,22,2,1,0
0,0,0,0,0,0,0,0,0
393101,2824,6,351,285,66,7,1,0
844344,2150,6,220,176,44,3,0,0
0,0,0,0,0,0,0,0,0
82043,773,4,275,136,139,1,1,0
14685,313,1,92,91,1,0,1,0
29258,375,2,80,66,14,1,0,0
372216,2024,7,271,203,68,41,1,0
145484,4339,1,68,64,4,12,0,0
73481,1476,2,262,261,1,8,1,0
362480,2838,6,437,406,31,16,1,0
0,0,0,0,0,0,0,0,0
87601,844,8,112,110,2,4,0,0
2096,13,0,1,0,1,0,0,0
0,0,0,0,0,0,0,0,0
23550,35,0,2,1,1,0,1,0
488596,4862,4,761,760,1,207,0,0
0,0,0,0,0,0,0,0,0
152543,1515,4,356,276,80,10,1,0
55656,408,4,60,51,9,11,1,0
0,0,0,0,0,0,0,0,0
637342,3002,5,316,311,5,2,1,0
13877,185,4,36,31,5,1,1,0
0,0,0,0,0,0,0,0,0
321568,1020,12,167,141,26,19,1,0
6377,36,2,3,1,2,0,0,0
445956,1294,6,356,274,82,4,1,0
335947,1567,3,119,96,23,2,1,0
0,0,0,0,0,0,0,0,0
128745,696,3,109,104,5,3,1,0
244926,1493,9,115,90,25,22,0,0
226267,644,3,113,70,43,0,1,0
499359,1035,8,192,170,22,3,0,0
0,0,0,0,0,0,0,0,0
58205,899,2,146,144,2,0,1,0
13552,159,4,18,14,4,2,1,0
0,0,0,0,0,0,0,0,0
420118,2970,2,544,409,135,2,1,0
154328,1684,3,321,314,7,4,0,0
20975,330,0,26,20,6,0,0,0
674671,5009,17,1000,989,11,16,1,0
102456,947,0,158,139,19,24,0,0
28067,42,0,2,1,1,0,0,0
409511,1117,1,178,146,32,0,1,0
60486,319,5,43,42,1,0,1,0
690770,966,3,154,142,12,6,0,0
101118,933,2,236,169,67,2,1,0
0,0,0,0,0,0,0,0,0
642540,1954,1,253,155,98,10,1,0
40774,362,0,8,5,3,6,0,0
972558,4375,9,1053,1043,10,11,0,0
373527,400,6,14,12,2,8,0,0
236786,2767,9,419,400,19,14,0,0
50711,598,2,64,33,31,14,1,0
11054,43,0,2,0,2,1,0,0
0,0,0,0,0,0,0,0,0
122859,1466,2,394,383,11,1,0,0
39992,565,2,49,22,27,3,0,0
109455,1165,3,167,155,12,0,1,0
402148,8043,10,541,462,79,17,1,0
47216,684,9,130,73,57,7,1,0
0,0,0,0,0,0,0,0,0
102247,634,5,56,56,0,0,1,0
0,0,0,0,0,0,0,0,0
509599,3658,9,543,514,29,10,1,0
0,0,0,0,0,0,0,0,0
0,0,0,0,0,0,0,0,0
0,0,0,0,0,0,0,0,0
226930,938,1,40,37,3,22,1,0
226891,953,1,40,37,3,22,1,0
162922,2179,9,203,191,12,12,1,0
214198,1962,13,342,315,27,45,1,1
293960,470,3,47,27,20,4,1,0
0,0,0,0,0,0,0,0,0
0,0,0,0,0,0,0,0,0
0,0,0,0,0,0,0,0,0
0,0,0,0,0,0,0,0,0
42481,517,3,74,72,2,1,1,0
0,0,0,0,0,0,0,0,0
30577,140,4,15,13,2,2,1,0
0,0,0,0,0,0,0,0,0
619988,3071,7,247,193,54,17,1,0
0,0,0,0,0,0,0,0,0
1689155,1614,7,174,148,26,1,1,0
37104,209,5,24,12,12,0,1,0
22705,37,0,2,1,1,0,1,0
225882,657,7,137,123,14,0,1,0
217354,461,4,71,50,21,0,1,0
0,0,0,0,0,0,0,0,0
328754,2131,4,222,199,23,4,0,0
0,0,0,0,0,0,0,0,0
0,0,0,0,0,0,0,0,0
166815,995,5,161,51,110,3,0,0
52957,553,3,50,47,3,8,0,0
767413,2482,5,152,147,5,13,0,0
69200,970,9,162,158,4,1,1,0
31718,498,8,113,109,4,1,1,0
151911,1846,9,234,226,8,7,1,0
0,0,0,0,0,0,0,0,0
188983,916,9,137,111,26,4,0,0
288684,1435,11,284,271,13,24,1,0
0,0,0,0,0,0,0,0,0
0,0,0,0,0,0,0,0,0
431115,1108,6,162,103,59,9,1,0
165784,1853,4,457,417,40,4,0,0
0,0,0,0,0,0,0,0,0
0,0,0,0,0,0,0,0,0
0,0,0,0,0,0,0,0,0
25452,403,2,44,44,0,3,0,0
165313,546,6,68,63,5,23,1,0
50920,305,3,26,23,3,4,1,0
115287,445,3,40,36,4,0,1,0
0,0,0,0,0,0,0,0,0
0,0,0,0,0,0,0,0,0
553912,1406,2,190,155,35,1,1,0
15810,166,0,13,2,11,2,1,0
27146,572,5,82,75,7,1,0,0
641564,2419,6,387,373,14,13,1,0
123425,1090,6,353,303,50,2,0,0
0,0,0,0,0,0,0,0,0
0,0,0,0,0,0,0,0,0
306585,2684,1,461,423,38,1,1,0
0,0,0,0,0,0,0,0,0
0,0,0,0,0,0,0,0,0
27854,238,1,56,56,0,3,0,0
468403,1692,3,531,530,1,9,1,0
633259,2102,16,208,203,5,53,1,0
0,0,0,0,0,0,0,0,0
0,0,0,0,0,0,0,0,0
667657,2338,13,113,93,20,16,1,0
130857,395,3,40,26,14,0,1,0
398032,2094,11,282,199,83,11,1,0
294974,2022,11,269,194,75,11,1,0
0,0,0,0,0,0,0,0,0
661120,2162,4,301,279,22,3,1,0
457064,1050,4,162,149,13,3,1,0
132711,1861,3,600,585,15,38,1,0
1112050,4053,3,373,238,135,18,1,0
1341478,10627,2,1050,870,180,4,1,0
0,0,0,0,0,0,0,0,0
1714900,2942,5,293,276,17,8,1,0
0,0,0,0,0,0,0,0,0
0,0,0,0,0,0,0,0,0
1407082,1575,3,229,214,15,8,1,0
0,0,0,0,0,0,0,0,0
393134,2772,3,373,359,14,2,1,0
87244,883,10,44,37,7,3,1,0
0,0,0,0,0,0,0,0,0
197295,917,8,155,139,16,13,1,0
64388,113,3,8,6,2,2,0,0
402040,4534,6,503,488,15,67,1,0
257729,2936,7,241,238,3,69,1,0
0,0,0,0,0,0,0,0,0
0,0,0,0,0,0,0,0,0
284100,3011,2,602,602,0,3,1,0
24042,277,2,27,27,0,3,1,0
411723,1510,4,157,127,30,1,1,0
30710,76,1,6,1,5,2,0,0
20097,274,1,61,36,25,0,1,0
76365,1208,1,303,303,0,1,1,0
135164,475,3,60,55,5,0,1,0
84553,922,6,132,126,6,11,0,0
0,0,0,0,0,0,0,0,0
0,0,0,0,0,0,0,0,0
185275,2289,1,257,214,43,46,1,0
86005,789,3,155,152,3,0,1,0
50933,332,3,33,30,3,2,1,0
312465,1005,4,62,55,7,15,0,0
0,0,0,0,0,0,0,0,0
63081,727,3,250,245,5,18,1,0
288109,2015,13,434,413,21,57,1,0
0,0,0,0,0,0,0,0,0
0,0,0,0,0,0,0,0,0
239149,1620,4,148,96,52,1,1,0
85360,409,4,89,56,33,1,1,0
81056,353,2,41,25,16,5,1,1
37414,564,0,29,16,13,0,1,0
0,0,0,0,0,0,0,0,0
37088,508,11,82,75,7,2,1,0
0,0,0,0,0,0,0,0,0
670312,4139,8,814,788,26,16,1,0
0,0,0,0,0,0,0,0,0
252900,385,0,69,69,0,9,0,0
36504,205,4,37,36,1,2,0,0
678199,4177,1,423,374,49,3,1,0
0,0,0,0,0,0,0,0,0
0,0,0,0,0,0,0,0,0
21900,33,0,1,1,0,0,1,0
234853,364,0,18,9,9,0,1,0
15524,170,2,30,30,0,0,1,0
28348,45,0,4,1,3,0,0,0
0,0,0,0,0,0,0,0,0
0,0,0,0,0,0,0,0,0
0,0,0,0,0,0,0,0,0
0,0,0,0,0,0,0,0,0
87049,297,2,30,30,0,0,0,0
91513,1719,3,373,277,96,0,1,0
0,0,0,0,0,0,0,0,0
11220,87,3,2,0,2,3,1,0
0,0,0,0,0,0,0,0,0
0,0,0,0,0,0,0,0,0
0,0,0,0,0,0,0,0,0
143783,1166,8,170,165,5,21,1,1
44220,208,5,26,23,3,7,1,1
0,0,0,0,0,0,0,0,0
0,0,0,0,0,0,0,0,0
7314,17,0,2,0,2,0,0,0
197181,783,8,33,25,8,0,1,0
0,0,0,0,0,0,0,0,0
3627853,3345,8,441,400,41,19,1,1
127025,557,5,68,64,4,6,1,0
3159,31,0,2,2,0,0,1,0
0,0,0,0,0,0,0,0,0
0,0,0,0,0,0,0,0,0
365418,2687,6,104,100,4,5,1,0
0,0,0,0,0,0,0,0,0
0,0,0,0,0,0,0,0,0
160843,448,7,71,1,70,8,1,0
57886,631,2,73,62,11,1,1,0
3214658,1432,9,93,78,15,75,1,0
1803044,1600,9,82,67,15,112,1,0
0,0,0,0,0,0,0,0,0
0,0,0,0,0,0,0,0,0
135268,767,2,270,270,0,0,1,0
66010,579,4,57,49,8,2,1,0
31468,171,4,27,19,8,1,1,0
35610,795,2,262,261,1,0,1,0
5987,99,2,16,16,0,0,1,0
0,0,0,0,0,0,0,0,0
0,0,0,0,0,0,0,0,0
303224,1948,1,63,60,3,9,0,0
878838,4851,8,950,910,40,35,1,0
460101,416,6,21,17,4,10,1,0
184274,1268,2,185,149,36,12,0,0
0,0,0,0,0,0,0,0,0
567983,2989,5,485,472,13,12,1,0
194534,366,6,14,13,1,15,1,0
0,0,0,0,0,0,0,0,0
0,0,0,0,0,0,0,0,0
0,0,0,0,0,0,0,0,0
357167,1106,9,79,75,4,12,1,0
318370,953,10,74,70,4,12,1,0
0,0,0,0,0,0,0,0,0
0,0,0,0,0,0,0,0,0
26900,134,4,17,15,2,5,1,0
414013,2702,11,742,651,91,145,1,0
531560,5275,3,494,483,11,6,1,0
75039,585,2,123,115,8,4,1,0
64867,355,8,35,30,5,1,1,0
2098,19,1,0,0,0,0,1,0
0,0,0,0,0,0,0,0,0
260181,591,8,132,130,2,1,1,0
0,0,0,0,0,0,0,0,0
398279,710,4,34,31,3,3,1,0
0,0,0,0,0,0,0,0,0
37614,417,9,88,88,0,8,1,0
64347,711,10,201,96,105,0,0,0
34612,664,2,209,209,0,0,1,0
75918,530,2,110,104,6,2,1,0
31497,136,4,4,4,0,0,0,0
122320,1432,3,303,290,13,15,0,0
44306,504,3,93,70,23,3,1,0
8401,126,5,14,13,1,8,0,0
649996,3153,7,527,412,115,140,1,0
459458,2165,7,527,452,75,8,1,0
0,0,0,0,0,0,0,0,0
23215,400,3,116,106,10,0,1,0
125461,228,3,7,3,4,1,0,0
0,0,0,0,0,0,0,0,0
36584,195,6,10,6,4,7,1,0
0,0,0,0,0,0,0,0,0
0,0,0,0,0,0,0,0,0
185074,661,7,98,94,4,1,1,0
192396,1290,7,102,89,13,1,1,0
0,0,0,0,0,0,0,0,0
0,0,0,0,0,0,0,0,0
43306,649,6,97,73,24,0,1,0
16293,256,4,77,68,9,0,1,0
91887,879,1,156,142,14,9,1,0
0,0,0,0,0,0,0,0,0
0,0,0,0,0,0,0,0,0
271578,1439,2,168,101,67,8,1,0
14268,52,3,3,3,0,3,0,0
0,0,0,0,0,0,0,0,0
84909,950,4,179,171,8,6,1,0
658276,4528,6,531,492,39,11,1,0
0,0,0,0,0,0,0,0,0
472420,1729,2,136,107,29,0,1,0
6094,108,2,21,9,12,0,1,0
0,0,0,0,0,0,0,0,0
764513,4218,3,329,293,36,56,1,0
93957,333,5,10,9,1,8,0,0
27574,39,0,2,1,1,0,0,0
0,0,0,0,0,0,0,0,0
455451,928,2,52,50,2,6,1,0
0,0,0,0,0,0,0,0,0
0,0,0,0,0,0,0,0,0
0,0,0,0,0,0,0,0,0
0,0,0,0,0,0,0,0,0
244755,896,11,144,119,25,35,1,0
0,0,0,0,0,0,0,0,0
0,0,0,0,0,0,0,0,0
135260,1284,6,179,138,41,3,1,0
135211,1284,6,179,140,39,3,1,0
0,0,0,0,0,0,0,0,0
279153,1857,2,367,333,34,10,1,0
13682,37,1,0,0,0,1,0,0
293686,1073,7,181,144,37,25,1,0
106899,900,3,149,125,24,23,1,0
0,0,0,0,0,0,0,0,0
0,0,0,0,0,0,0,0,0
7541,75,5,3,1,2,0,1,0
0,0,0,0,0,0,0,0,0
722809,2399,18,217,140,77,68,1,0
38499,458,2,11,2,9,1,0,0
288269,1659,6,315,303,12,3,1,0
233648,1295,7,122,114,8,3,1,0
0,0,0,0,0,0,0,0,0
571384,722,8,79,73,6,0,1,0
31536,107,2,3,3,0,0,0,0
81358,567,2,85,47,38,0,1,0
702855,552,0,5,0,5,2,1,1
23502,38,0,2,1,1,0,1,0
107469,525,4,64,49,15,0,1,0
0,0,0,0,0,0,0,0,0
99386,1334,5,398,394,4,12,1,0
57303,1339,1,294,288,6,0,0,0
57822,498,1,102,86,16,0,1,0
0,0,0,0,0,0,0,0,0
444306,1204,7,128,116,12,8,1,0
0,0,0,0,0,0,0,0,0
18603,93,0,13,9,4,0,1,0
234451,545,9,95,84,11,16,1,0
0,0,0,0,0,0,0,0,0
0,0,0,0,0,0,0,0,0
537906,1864,11,231,217,14,36,1,0
99707,846,1,188,176,12,0,1,0
171653,1083,6,241,241,0,7,0,0
0,0,0,0,0,0,0,0,0
232177,3636,3,907,893,14,6,1,0
948896,6096,0,305,290,15,2,1,0
90644,999,5,209,198,11,9,1,0
48611,426,5,103,94,9,6,1,0
0,0,0,0,0,0,0,0,0
323357,2238,5,195,155,40,14,1,0
0,0,0,0,0,0,0,0,0
1371948,4907,4,1486,1470,16,5,1,0
0,0,0,0,0,0,0,0,0
589495,1430,6,98,86,12,3,1,0
13355,146,1,18,12,6,4,1,0
68420,408,4,13,10,3,3,1,0
12670,81,2,3,2,1,0,0,0
0,0,0,0,0,0,0,0,0
0,0,0,0,0,0,0,0,0
170681,1487,8,167,149,18,6,1,0
0,0,0,0,0,0,0,0,0
155444,2002,6,569,548,21,12,1,0
129501,643,4,70,62,8,10,0,0
144702,203,8,10,10,0,9,0,0
0,0,0,0,0,0,0,0,0
0,0,0,0,0,0,0,0,0
4765,46,3,2,1,1,0,1,0
27007,275,3,29,20,9,16,1,0
84244,944,3,170,160,10,16,1,0
51531,267,1,125,124,1,1,1,0
0,0,0,0,0,0,0,0,0
268147,1377,3,220,189,31,6,1,0
227661,1306,11,203,187,16,23,1,0
0,0,0,0,0,0,0,0,0
29317,485,3,122,121,1,0,1,0
0,0,0,0,0,0,0,0,0
145280,1421,10,288,228,60,17,1,0
19217,256,5,44,10,34,3,0,0
60670,743,5,33,15,18,0,1,0
0,0,0,0,0,0,0,0,0
4206,51,0,10,8,2,1,0,0
75763,941,9,207,198,9,4,1,0
992237,8506,9,1306,1287,19,7,1,0
128437,542,3,68,37,31,0,0,0
136167,537,4,125,109,16,2,0,0
22609,362,7,102,60,42,3,1,0
162360,970,10,162,154,8,16,1,0
24911,117,1,9,9,0,0,1,0
1087538,2320,8,283,270,13,16,0,0
0,0,0,0,0,0,0,0,0
138730,1466,6,151,127,24,5,1,0
0,0,0,0,0,0,0,0,0
153188,1836,2,814,479,335,4,1,0
0,0,0,0,0,0,0,0,0
0,0,0,0,0,0,0,0,0
0,0,0,0,0,0,0,0,0
101408,1071,1,208,206,2,32,1,0
735690,4388,8,783,699,84,4,1,0
7973,128,1,10,10,0,0,0,0
0,0,0,0,0,0,0,0,0
966811,1247,3,237,144,93,14,1,0
0,0,0,0,0,0,0,0,0
357505,3978,7,684,676,8,58,1,0
48014,533,5,25,16,9,0,1,0
0,0,0,0,0,0,0,0,0
0,0,0,0,0,0,0,0,0
0,0,0,0,0,0,0,0,0
96392,1266,5,458,452,6,1,1,0
58641,127,2,4,0,4,0,1,0
0,0,0,0,0,0,0,0,0
166699,1546,7,229,229,0,14,1,0
89232,757,7,152,151,1,8,1,0
0,0,0,0,0,0,0,0,0
65221,834,6,128,126,2,5,1,0
56983,290,7,30,29,1,3,1,0
39719,547,0,187,166,21,0,1,0
3041,71,0,6,6,0,0,0,0
730021,1558,7,227,225,2,9,1,0
0,0,0,0,0,0,0,0,0
0,0,0,0,0,0,0,0,0
0,0,0,0,0,0,0,0,0
0,0,0,0,0,0,0,0,0
147565,1537,9,200,176,24,80,1,0
11419,98,3,22,16,6,3,0,0
0,0,0,0,0,0,0,0,0
124558,503,11,103,84,19,3,0,0
47736,145,3,4,4,0,0,1,0
0,0,0,0,0,0,0,0,0
0,0,0,0,0,0,0,0,0
0,0,0,0,0,0,0,0,0
0,0,0,0,0,0,0,0,0
0,0,0,0,0,0,0,0,0
175605,635,8,153,153,0,8,1,0
152367,180,8,25,25,0,7,1,0
0,0,0,0,0,0,0,0,0
692994,4961,5,250,131,119,4,1,0
403278,2218,5,114,96,18,2,1,0
0,0,0,0,0,0,0,0,0
0,0,0,0,0,0,0,0,0
111810,1021,7,201,174,27,4,1,0
0,0,0,0,0,0,0,0,0
0,0,0,0,0,0,0,0,0
43579,419,4,37,33,4,8,1,0
335484,1306,6,151,138,13,4,1,0
24344,126,0,9,9,0,0,0,0
1743324,2785,2,222,206,16,1,1,0
358924,105,0,5,5,0,0,1,0
81131,1430,4,281,215,66,8,1,0
1627686,4695,14,247,64,183,12,1,0
13238,212,0,30,12,18,0,0,0
38003,353,4,101,93,8,5,1,0
0,0,0,0,0,0,0,0,0
0,0,0,0,0,0,0,0,0
11597,203,2,60,58,2,5,1,0
0,0,0,0,0,0,0,0,0
269717,1728,16,184,164,20,4,1,0
354401,4111,15,217,175,42,12,1,0
0,0,0,0,0,0,0,0,0
351372,1493,2,65,52,13,2,1,0
0,0,0,0,0,0,0,0,0
0,0,0,0,0,0,0,0,0
0,0,0,0,0,0,0,0,0
0,0,0,0,0,0,0,0,0
237279,1627,13,322,298,24,0,1,0
0,0,0,0,0,0,0,0,0
117450,1073,4,231,228,3,13,1,0
160044,533,5,5,4,1,3,0,0
159034,528,5,3,3,0,3,0,0
0,0,0,0,0,0,0,0,0
0,0,0,0,0,0,0,0,0
928978,700,3,114,104,10,4,1,0
0,0,0,0,0,0,0,0,0
98171,927,5,165,97,68,3,0,0
22944,37,0,2,1,1,0,1,0
61867,576,6,130,54,76,2,1,0
49959,408,6,116,35,81,3,1,0
117381,701,3,115,110,5,12,1,0
718783,102,4,2,2,0,2,0,0
340764,643,3,1,1,0,3,0,0
0,0,0,0,0,0,0,0,0
371025,5668,6,931,880,51,1,1,0
0,0,0,0,0,0,0,0,0
0,0,0,0,0,0,0,0,0
393435,2693,1,668,649,19,1,0,0
0,0,0,0,0,0,0,0,0
194604,1404,10,283,263,20,6,1,0
346110,894,8,102,12,90,13,1,0
147999,2582,6,635,526,109,12,1,0
29388,238,4,65,12,53,0,1,0
0,0,0,0,0,0,0,0,0
80674,851,1,72,58,14,1,1,0
161338,1102,8,232,187,45,7,1,0
483107,2314,5,405,281,124,18,1,0
252709,750,5,17,11,6,6,1,0
197151,1025,9,75,70,5,0,1,0
52448,1130,3,380,380,0,48,0,0
5659,81,3,2,2,0,0,0,0
0,0,0,0,0,0,0,0,0
114997,1588,4,341,272,69,6,1,0
0,0,0,0,0,0,0,0,0
139891,1882,3,437,435,2,8,1,0
186123,2249,6,355,350,5,3,1,0
0,0,0,0,0,0,0,0,0
0,0,0,0,0,0,0,0,0
82860,815,0,115,88,27,0,1,0
0,0,0,0,0,0,0,0,0
0,0,0,0,0,0,0,0,0
0,0,0,0,0,0,0,0,0
75319,913,3,151,147,4,0,1,0
105753,696,13,154,137,17,5,1,0
47717,212,6,4,4,0,2,0,0
716237,2795,9,560,503,57,12,1,0
60269,138,8,4,0,4,3,0,0
9372,103,4,11,7,4,0,1,0
22829,276,1,58,51,7,2,0,0
0,0,0,0,0,0,0,0,0
159515,2298,2,702,533,169,9,1,0
0,0,0,0,0,0,0,0,0
455651,1119,4,156,144,12,2,1,0
60035,167,0,14,14,0,0,1,0
0,0,0,0,0,0,0,0,0
0,0,0,0,0,0,0,0,0
346991,1281,5,214,205,9,3,1,1
52740,1019,2,283,254,29,0,1,0
6546,98,2,19,19,0,0,0,0
247309,970,5,94,80,14,2,1,0
198195,604,5,29,21,8,0,0,0
0,0,0,0,0,0,0,0,0
142400,726,4,116,95,21,4,1,0
118072,344,7,15,6,9,2,1,0
39776,689,2,124,119,5,0,1,0
0,0,0,0,0,0,0,0,0
0,0,0,0,0,0,0,0,0
0,0,0,0,0,0,0,0,0
130778,1071,9,267,26,241,2,1,0
130778,1071,9,267,26,241,2,1,0
0,0,0,0,0,0,0,0,0
73486,457,2,163,161,2,0,0,0
157086,602,6,43,40,3,9,0,0
312046,1779,8,323,308,15,87,1,0
61275,247,9,7,4,3,12,0,0
0,0,0,0,0,0,0,0,0
0,0,0,0,0,0,0,0,0
134331,1382,7,240,165,75,14,1,0
134244,1381,6,240,165,75,14,1,0
219431,629,4,75,65,10,4,1,0
219560,629,4,75,61,14,4,1,0
761927,2989,8,281,126,155,13,1,0
331021,130,2,7,6,1,0,1,0
0,0,0,0,0,0,0,0,0
342397,699,9,69,63,6,12,1,0
0,0,0,0,0,0,0,0,0
158470,1089,5,129,121,8,10,1,0
304871,1798,0,4,4,0,0,0,0
0,0,0,0,0,0,0,0,0
0,0,0,0,0,0,0,0,0
52540,427,8,132,113,19,1,0,0
0,0,0,0,0,0,0,0,0
207356,1517,20,225,221,4,18,1,0
118870,258,13,22,15,7,7,1,0
0,0,0,0,0,0,0,0,0
46962,401,8,45,35,10,3,0,0
0,0,0,0,0,0,0,0,0
4403396,2616,7,601,593,8,67,1,0
0,0,0,0,0,0,0,0,0
518960,4293,17,580,548,32,14,1,0
8998,149,5,26,25,1,1,0,0
0,0,0,0,0,0,0,0,0
13358,91,7,0,0,0,5,0,0
2051774,1565,4,134,121,13,6,1,0
1883747,610,4,68,57,11,7,1,0
426469,1222,6,147,129,18,21,1,0
0,0,0,0,0,0,0,0,0
0,0,0,0,0,0,0,0,0
78585,293,3,27,18,9,7,0,0
0,0,0,0,0,0,0,0,0
43110,388,8,50,48,2,0,1,0
171787,504,6,95,71,24,6,1,0
0,0,0,0,0,0,0,0,0
0,0,0,0,0,0,0,0,0
423034,2223,8,331,301,30,8,0,0
8134,86,6,6,5,1,0,0,0
0,0,0,0,0,0,0,0,0
197512,2514,6,358,351,7,51,1,0
28018,42,0,2,1,1,0,0,0
56226,905,5,123,115,8,3,1,0
0,0,0,0,0,0,0,0,0
1646650,5274,12,1266,1221,45,55,1,0
0,0,0,0,0,0,0,0,0
21964,33,0,1,1,0,0,1,0
0,0,0,0,0,0,0,0,0
457003,974,4,178,115,63,2,0,0
675504,556,0,4,0,4,2,1,1
236577,544,3,68,60,8,0,1,0
0,0,0,0,0,0,0,0,0
0,0,0,0,0,0,0,0,0
7647574,39726,5,3806,2307,1499,26,1,0
47106,132,8,3,0,3,0,1,0
273507,1679,10,584,574,10,19,1,0
323191,1072,13,114,105,9,52,1,0
403783,1529,8,251,226,25,14,1,0
370826,1876,12,369,349,20,8,1,0
0,0,0,0,0,0,0,0,0
301565,1262,9,193,172,21,7,1,0
37537,316,9,59,46,13,5,1,0
0,0,0,0,0,0,0,0,0
0,0,0,0,0,0,0,0,0
0,0,0,0,0,0,0,0,0
1084148,285,8,19,19,0,14,0,0
426226,1622,13,170,10,160,29,1,0
0,0,0,0,0,0,0,0,0
61999,928,6,151,133,18,0,1,0
370231,1283,1,177,166,11,7,1,0
154772,266,1,50,42,8,7,1,0
0,0,0,0,0,0,0,0,0
0,0,0,0,0,0,0,0,0
4046,36,2,3,1,2,0,0,0
0,0,0,0,0,0,0,0,0
291117,1579,7,335,240,95,11,1,0
0,0,0,0,0,0,0,0,0
0,0,0,0,0,0,0,0,0
70658,487,10,49,48,1,3,0,0
27986,44,0,4,3,1,0,0,0
404548,2034,5,333,237,96,79,1,0
154937,462,3,42,40,2,2,1,0
386101,1873,3,319,307,12,4,1,0
0,0,0,0,0,0,0,0,0
248612,1492,1,210,77,133,9,0,0
87716,1409,3,228,220,8,15,1,0
30122,284,3,68,68,0,5,1,0
138815,389,7,56,52,4,36,0,0
22073,312,0,52,52,0,1,1,0
149941,959,8,171,111,60,1,0,0
0,0,0,0,0,0,0,0,0
14762,152,2,27,25,2,0,0,0
0,0,0,0,0,0,0,0,0
53260,176,4,15,1,14,20,1,0
7486,89,3,11,11,0,3,1,0
22639,248,3,59,44,15,2,1,0
930604,3015,5,200,187,13,19,1,0
67042,300,6,7,5,2,11,0,0
0,0,0,0,0,0,0,0,0
0,0,0,0,0,0,0,0,0
0,0,0,0,0,0,0,0,0
0,0,0,0,0,0,0,0,0
95718,933,8,164,156,8,10,1,0
0,0,0,0,0,0,0,0,0
0,0,0,0,0,0,0,0,0
0,0,0,0,0,0,0,0,0
0,0,0,0,0,0,0,0,0
0,0,0,0,0,0,0,0,0
0,0,0,0,0,0,0,0,0
21459,312,0,52,52,0,1,1,0
0,0,0,0,0,0,0,0,0
8452,85,1,25,14,11,0,0,0
177591,880,4,133,79,54,41,1,0
101702,746,6,194,193,1,1,1,0
651737,1456,3,63,36,27,39,0,0
4873,27,4,2,1,1,0,0,0
22056,312,0,52,52,0,1,1,0
304820,3045,3,356,309,47,1,1,0
0,0,0,0,0,0,0,0,0
142985,537,3,78,59,19,4,1,0
280949,1821,2,260,244,16,3,1,0
1898,23,4,0,0,0,0,0,0
1226416,12171,6,312,291,21,27,0,0
121902,892,5,201,199,2,27,0,0
589482,3680,10,697,642,55,49,1,1
94846,682,7,196,95,101,6,1,0
26877,244,6,20,14,6,9,1,0
58453,222,7,31,31,0,0,1,0
305129,1852,6,396,384,12,21,1,0
120283,604,5,125,119,6,2,1,1
0,0,0,0,0,0,0,0,0
0,0,0,0,0,0,0,0,0
228631,2993,6,548,526,22,1,1,0
280238,1186,0,245,233,12,5,1,0
2071,26,0,3,3,0,0,1,0
240216,792,7,151,115,36,2,1,0
0,0,0,0,0,0,0,0,0
242063,6134,6,1530,1529,1,27,1,0
81989,552,4,27,27,0,11,1,0
1097598,3251,5,138,103,35,38,1,0
230809,1457,8,121,112,9,8,1,0
155305,998,15,109,75,34,42,1,0
519953,1779,12,333,289,44,44,1,0
174759,414,5,49,35,14,16,1,0
164327,1177,9,131,98,33,10,1,0
0,0,0,0,0,0,0,0,0
125220,1420,3,167,157,10,4,1,0
0,0,0,0,0,0,0,0,0
103483,586,15,95,64,31,9,1,0
271790,1203,9,237,217,20,21,1,1
107003,906,14,113,110,3,34,1,0
22197,355,6,59,57,2,5,1,0
90595,897,2,219,185,34,4,1,0
0,0,0,0,0,0,0,0,0
0,0,0,0,0,0,0,0,0
393142,870,6,169,53,116,12,1,0
0,0,0,0,0,0,0,0,0
326284,996,7,55,48,7,12,1,0
321901,994,7,55,48,7,11,1,0
83852,1754,2,314,294,20,5,1,0
0,0,0,0,0,0,0,0,0
395279,3558,10,531,524,7,38,1,0
153559,1561,8,316,308,8,9,1,0
0,0,0,0,0,0,0,0,0
20990,369,3,69,69,0,3,1,0
4624,96,2,17,17,0,1,1,0
568853,2089,3,180,169,11,1,0,0
0,0,0,0,0,0,0,0,0
483938,2529,2,365,257,108,3,1,0
22110,35,0,1,1,0,0,1,0
79386,1119,4,173,154,19,8,0,0
479165,843,3,107,42,65,2,1,0
554923,2537,6,471,434,37,26,0,0
0,0,0,0,0,0,0,0,0
5532,85,4,16,16,0,0,1,0
242161,567,6,64,59,5,18,1,0
0,0,0,0,0,0,0,0,0
241723,1096,2,140,136,4,1,1,0
5561331,32978,7,85,69,16,81,1,0
93895,648,7,111,82,29,1,1,0
365989,1251,4,162,143,19,10,1,0
1394852,4829,11,269,235,34,8,1,0
55435,192,7,5,3,2,11,0,0
107360,960,5,269,56,213,4,1,0
277835,2771,7,559,548,11,11,1,0
87311,254,0,48,24,24,0,1,1
24592,452,4,99,15,84,0,1,0
0,0,0,0,0,0,0,0,0
208307,2008,7,77,67,10,0,1,0
240461,2168,3,83,33,50,62,1,0
440899,1241,2,459,381,78,4,1,0
493569,4088,7,781,757,24,32,1,0
127333,630,3,94,85,9,4,1,0
22202,312,0,52,52,0,1,1,0
345828,1320,5,105,88,17,15,1,0
0,0,0,0,0,0,0,0,0
0,0,0,0,0,0,0,0,0
767612,7516,1,526,523,3,2,1,0
3386,60,2,10,10,0,1,0,0
166010,2560,5,540,532,8,20,1,0
46912,498,7,45,42,3,7,0,0
31201,276,7,35,35,0,13,0,0
98509,1094,8,269,66,203,18,1,0
26168,196,6,41,35,6,3,1,0
52169,163,5,21,20,1,0,1,0
440634,3152,5,404,382,22,6,1,0
349493,2452,5,374,354,20,5,1,0
0,0,0,0,0,0,0,0,0
116844,1032,6,147,147,0,4,0,0
211268,5008,0,1283,1283,0,0,1,0
494022,3939,5,653,499,154,3,0,0
329931,2894,7,268,255,13,5,0,0
13151,87,4,6,4,2,2,0,0
313668,1209,3,74,33,41,11,1,0
0,0,0,0,0,0,0,0,0
303071,990,8,111,3,108,5,0,0
194300,746,8,111,101,10,4,0,0
218183,733,1,62,20,42,15,1,0
290176,1405,5,72,68,4,56,1,0
79002,444,6,70,69,1,33,0,0
582,7,0,0,0,0,0,0,0
47170,803,2,226,218,8,10,0,0
256505,1837,1,591,583,8,10,1,0
49294,445,2,113,105,8,6,1,0
0,0,0,0,0,0,0,0,0
0,0,0,0,0,0,0,0,0
1007221,2296,9,197,186,11,13,1,0
0,0,0,0,0,0,0,0,0
0,0,0,0,0,0,0,0,0
211146,608,5,98,80,18,4,1,0
0,0,0,0,0,0,0,0,0
0,0,0,0,0,0,0,0,0
247756,1438,4,182,160,22,11,1,0
36807,158,3,13,13,0,1,1,0
0,0,0,0,0,0,0,0,0
0,0,0,0,0,0,0,0,0
0,0,0,0,0,0,0,0,0
0,0,0,0,0,0,0,0,0
328186,1488,8,166,155,11,52,1,0
0,0,0,0,0,0,0,0,0
0,0,0,0,0,0,0,0,0
20415,494,0,85,84,1,0,1,0
0,0,0,0,0,0,0,0,0
0,0,0,0,0,0,0,0,0
1399195,2306,7,245,219,26,17,1,0
937134,696,7,41,35,6,17,1,0
464096,2421,4,299,274,25,28,1,0
600984,1149,2,211,143,68,8,1,0
547065,1185,5,186,136,50,8,0,0
7683,86,1,6,3,3,0,0,0
204680,1550,5,27,23,4,4,1,0
0,0,0,0,0,0,0,0,0
0,0,0,0,0,0,0,0,0
92853,2001,2,261,260,1,0,0,0
37515,491,3,144,116,28,0,1,0
544913,3138,10,894,836,58,24,1,0
218377,1005,6,154,133,21,7,1,0
550623,1990,9,447,350,97,27,1,0
100228,138,6,10,4,6,3,0,0
147300,1359,5,215,157,58,7,1,0
15171,274,2,11,11,0,9,0,0
1868655,3020,7,294,284,10,5,1,0
0,0,0,0,0,0,0,0,0
236784,3061,1,603,592,11,76,1,0
114519,1255,1,289,279,10,0,0,0
0,0,0,0,0,0,0,0,0
0,0,0,0,0,0,0,0,0
27416,39,0,2,1,1,0,0,0
80876,1246,7,312,312,0,19,1,0
896503,5153,9,343,298,45,14,1,0
35258,290,4,19,4,15,0,0,0
10293,230,2,72,72,0,0,0,0
0,0,0,0,0,0,0,0,0
198382,541,14,112,105,7,4,1,0
99614,1761,6,300,294,6,2,0,0
122278,1046,9,162,151,11,8,1,0
0,0,0,0,0,0,0,0,0
50763,495,4,54,46,8,1,0,0
326074,2587,6,517,509,8,75,1,0
178295,715,5,71,62,9,6,1,0
1317768,2168,3,414,386,28,11,1,0
883,23,0,2,0,2,0,0,1
213324,844,1,64,48,16,1,0,0
439788,2258,7,879,869,10,17,1,0
0,0,0,0,0,0,0,0,0
0,0,0,0,0,0,0,0,0
0,0,0,0,0,0,0,0,0
968,9,1,0,0,0,0,0,0
0,0,0,0,0,0,0,0,0
0,0,0,0,0,0,0,0,0
0,0,0,0,0,0,0,0,0
0,0,0,0,0,0,0,0,0
0,0,0,0,0,0,0,0,0
489451,1606,10,133,127,6,56,1,0
484482,1664,10,242,188,54,14,1,0
92336,338,9,17,13,4,15,1,0
1042283,1930,6,355,339,16,17,1,0
89768,383,2,49,0,49,0,1,0
515203,1761,10,217,198,19,1,1,0
469860,1058,7,94,76,18,6,1,0
482355,1221,13,171,157,14,21,1,0
0,0,0,0,0,0,0,0,0
0,0,0,0,0,0,0,0,0
295236,1928,10,212,196,16,17,1,0
367432,4377,11,409,407,2,20,0,0
57469,383,11,42,40,2,16,0,0
0,0,0,0,0,0,0,0,0
18712,295,3,63,62,1,2,1,0
233500,2063,12,586,574,12,25,1,0
0,0,0,0,0,0,0,0,0
0,0,0,0,0,0,0,0,0
103245,1013,11,189,176,13,7,1,0
0,0,0,0,0,0,0,0,0
264195,1336,4,158,149,9,3,1,0
37544,390,8,100,71,29,2,0,0
0,0,0,0,0,0,0,0,0
0,0,0,0,0,0,0,0,0
301382,2507,6,358,327,31,10,1,0
181797,638,10,139,133,6,17,1,0
10193,84,0,3,2,1,2,0,0
25891,426,2,96,23,73,2,1,0
46213,941,4,93,22,71,1,1,0
153551,248,3,10,8,2,0,0,0
1275436,1548,2,178,125,53,2,1,0
812790,470,2,32,29,3,2,1,0
99548,611,7,128,127,1,0,1,0
357452,1407,4,318,274,44,0,1,0
0,0,0,0,0,0,0,0,0
346544,1009,8,177,160,17,39,1,0
490713,1512,18,328,321,7,20,1,0
325256,1435,19,285,275,10,21,1,0
19804,256,2,45,36,9,0,1,0
19409,219,1,42,39,3,0,0,0
142468,977,2,249,248,1,4,1,0
0,0,0,0,0,0,0,0,0
0,0,0,0,0,0,0,0,0
6953,67,2,13,12,1,1,0,0
1858120,980,9,149,23,126,1,1,0
0,0,0,0,0,0,0,0,0
582464,624,9,28,16,12,16,1,0
394991,1953,11,430,406,24,29,1,0
0,0,0,0,0,0,0,0,0
60202,552,1,14,8,6,0,0,0
193311,721,16,87,81,6,23,1,0
0,0,0,0,0,0,0,0,0
0,0,0,0,0,0,0,0,0
15794,164,1,45,43,2,0,1,0
20430,110,0,20,18,2,0,1,0
266967,865,4,154,145,9,2,1,0
45978,161,2,19,1,18,1,1,0
39462,715,4,126,74,52,12,0,0
2866,31,4,4,4,0,1,0,0
1035851,2055,11,333,305,28,6,1,0
0,0,0,0,0,0,0,0,0
220294,2462,5,124,124,0,1,1,0
31053,374,3,135,110,25,0,1,0
6977,120,2,28,25,3,0,1,0
0,0,0,0,0,0,0,0,0
0,0,0,0,0,0,0,0,0
42570,397,8,63,53,10,6,1,0
1672732,1484,9,115,97,18,16,1,0
0,0,0,0,0,0,0,0,0
59062,601,1,36,35,1,0,1,0
67999,782,2,41,39,2,2,1,0
170750,1773,6,211,192,19,37,1,0
21551,219,5,28,28,0,3,1,0
29888,455,5,14,14,0,3,1,0
499456,1864,10,121,96,25,34,1,0
393907,1977,5,472,450,22,24,1,0
90697,232,7,31,26,5,1,1,0
244781,3065,2,511,379,132,31,0,0
0,0,0,0,0,0,0,0,0
560191,324,4,37,32,5,2,1,0
99346,941,6,145,143,2,9,1,0
183941,1936,10,370,329,41,7,1,0
0,0,0,0,0,0,0,0,0
0,0,0,0,0,0,0,0,0
339539,1338,4,172,158,14,0,1,0
844767,5474,4,463,454,9,767,0,0
371614,5204,4,114,113,1,7,1,0
644384,11367,4,27,26,1,3,1,0
0,0,0,0,0,0,0,0,0
715455,2655,6,250,240,10,8,1,0
0,0,0,0,0,0,0,0,0
55900,376,5,27,20,7,6,1,0
299789,2269,3,188,120,68,1,1,0
0,0,0,0,0,0,0,0,0
255447,279,6,4,3,1,3,0,0
74465,642,3,117,102,15,7,1,0
69885,906,4,242,241,1,7,1,0
68832,902,4,242,241,1,7,1,0
728671,1297,5,305,290,15,185,1,0
0,0,0,0,0,0,0,0,0
0,0,0,0,0,0,0,0,0
327432,3728,3,660,616,44,2,1,0
152416,368,2,58,29,29,10,1,0
0,0,0,0,0,0,0,0,0
364641,2519,5,263,246,17,1,0,0
243439,720,5,93,89,4,6,1,0
122447,1660,3,201,200,1,2,0,0
0,0,0,0,0,0,0,0,0
5547,86,2,11,10,1,1,1,0
228167,846,4,121,105,16,1,1,0
0,0,0,0,0,0,0,0,0
146242,1391,3,376,6,370,0,1,0
9989,122,3,10,10,0,1,1,0
179965,1248,3,184,126,58,3,1,0
278020,289,9,71,43,28,0,1,0
0,0,0,0,0,0,0,0,0
665573,974,12,121,25,96,35,1,0
726336,3649,8,300,218,82,33,1,0
59672,697,1,212,195,17,6,1,0
0,0,0,0,0,0,0,0,0
74704,596,5,63,41,22,12,1,0
202377,1071,6,205,175,30,6,1,0
180546,673,5,143,121,22,6,1,0
107499,602,4,226,14,212,0,0,0
15649,302,0,89,86,3,0,0,0
1803503,6178,5,342,334,8,0,1,0
0,0,0,0,0,0,0,0,0
0,0,0,0,0,0,0,0,0
161091,610,2,75,69,6,26,1,0
590162,2045,5,399,391,8,28,1,0
0,0,0,0,0,0,0,0,0
0,0,0,0,0,0,0,0,0
58746,411,1,38,31,7,2,1,0
0,0,0,0,0,0,0,0,0
703996,3119,4,290,267,23,39,1,0
202758,1196,4,184,160,24,3,1,0
0,0,0,0,0,0,0,0,0
187599,690,0,111,89,22,3,1,0
126019,291,0,58,34,24,1,1,0
21949,33,0,1,1,0,0,1,0
145860,1358,8,149,111,38,2,1,0
0,0,0,0,0,0,0,0,0
0,0,0,0,0,0,0,0,0
137573,831,5,143,92,51,1,0,0
39078,511,3,39,20,19,2,1,0
221602,1273,6,257,221,36,1,1,0
0,0,0,0,0,0,0,0,0
24877,108,0,7,7,0,0,0,0
60993,293,2,37,34,3,3,1,0
62474,203,7,30,25,5,5,1,0
0,0,0,0,0,0,0,0,0
39498,570,4,50,37,13,7,1,0
668,13,0,0,0,0,0,0,0
29115,210,7,23,19,4,3,1,0
303167,1818,3,513,506,7,0,1,0
60001,584,4,78,66,12,2,0,0
22797,147,4,3,3,0,3,0,0
223334,2604,8,524,397,127,55,1,0
910863,4389,8,289,273,16,16,1,0
242643,882,8,118,106,12,17,1,0
756927,5126,6,222,210,12,5,1,0
1660017,2233,7,252,96,156,35,1,0
139598,1148,1,250,247,3,8,0,0
65670,607,3,193,191,2,1,1,0
0,0,0,0,0,0,0,0,0
263448,1524,3,317,309,8,0,1,0
172869,1178,2,252,244,8,0,1,0
71131,1019,3,181,173,8,16,1,0
18561,86,3,4,4,0,3,0,0
68977,534,8,67,43,24,22,1,0
11473,143,1,44,43,1,4,0,0
2130,39,0,8,8,0,0,0,0
2896013,7932,3,2038,2013,25,1,1,0
45141,487,8,274,264,10,9,1,0
174964,535,6,91,79,12,1,1,0
0,0,0,0,0,0,0,0,0
160474,1300,2,182,166,16,20,1,0
13540,253,2,62,38,24,4,1,0
155958,218,2,8,4,4,0,0,1
2448579,4918,7,301,159,142,69,1,0
209643,1955,6,331,230,101,4,1,0
440829,2786,17,366,226,140,38,1,0
314310,1958,17,194,179,15,21,1,0
757387,3631,7,364,21,343,11,1,0
221834,1113,7,155,151,4,38,0,0
144744,719,2,37,31,6,0,1,0
646715,4679,2,123,123,0,5,0,0
5802,62,0,5,5,0,0,0,0
82685,816,7,252,250,2,10,1,0
517089,1515,4,127,102,25,5,1,0
1483250,932,5,72,69,3,73,1,0
177405,650,6,93,82,11,1,1,0
168306,563,8,49,41,8,3,1,0
525979,2536,12,335,303,32,177,1,0
927496,3183,10,258,253,5,57,1,0
114087,824,1,107,103,4,1,1,0
737,19,0,0,0,0,0,0,0
1285611,5037,4,1426,98,1328,7,1,0
68375,687,1,45,38,7,5,1,0
0,0,0,0,0,0,0,0,0
350160,7642,7,135,73,62,2,0,0
150509,2032,2,574,552,22,58,0,0
0,0,0,0,0,0,0,0,0
0,0,0,0,0,0,0,0,0
466069,2564,17,420,378,42,22,1,0
101152,1115,5,361,351,10,1,1,0
3537,48,3,7,7,0,0,1,0
261970,2590,4,467,428,39,37,1,0
0,0,0,0,0,0,0,0,0
0,0,0,0,0,0,0,0,0
86924,842,7,190,178,12,4,1,0
456839,1140,8,182,177,5,9,0,0
0,0,0,0,0,0,0,0,0
2310198,10509,7,855,824,31,88,1,0
121398,855,3,142,94,48,2,1,0
0,0,0,0,0,0,0,0,0
307302,1364,6,262,223,39,5,1,0
375908,520,8,139,120,19,2,1,0
299385,2280,5,290,247,43,29,1,0
0,0,0,0,0,0,0,0,0
0,0,0,0,0,0,0,0,0
0,0,0,0,0,0,0,0,0
0,0,0,0,0,0,0,0,0
0,0,0,0,0,0,0,0,0
37038,372,5,87,86,1,3,1,0
421131,756,7,64,42,22,5,1,0
0,0,0,0,0,0,0,0,0
0,0,0,0,0,0,0,0,0
1001477,6491,2,626,626,0,2,1,0
0,0,0,0,0,0,0,0,0
10710,126,1,22,3,19,1,0,0
273231,3192,7,683,544,139,44,1,0
94002,376,5,17,17,0,38,1,0
0,0,0,0,0,0,0,0,0
3876,61,0,12,12,0,0,1,0
142324,1588,0,474,325,149,0,0,0
4265,79,0,20,20,0,0,0,0
0,0,0,0,0,0,0,0,0
390386,2208,12,430,413,17,33,1,1
308474,812,8,157,153,4,7,1,0
0,0,0,0,0,0,0,0,0
138447,528,12,45,33,12,7,1,0
150297,297,8,4,3,1,8,1,0
487585,2302,9,371,361,10,43,1,0
335597,2662,8,444,417,27,8,1,0
285836,2245,6,392,371,21,8,1,0
0,0,0,0,0,0,0,0,0
0,0,0,0,0,0,0,0,0
223531,2041,8,505,383,122,21,1,0
686741,3903,7,674,389,285,13,1,0
29491,134,5,16,11,5,0,0,0
2453,46,2,2,2,0,1,1,0
4776224,35608,11,3456,1973,1483,6,1,0
261361,2043,5,452,360,92,10,1,0
0,0,0,0,0,0,0,0,0
103269,1181,6,252,248,4,6,1,0
80921,926,8,112,107,5,3,1,0
0,0,0,0,0,0,0,0,0
61960,479,3,119,98,21,0,0,0
0,0,0,0,0,0,0,0,0
52315,575,2,93,84,9,12,1,0
128170,805,4,180,153,27,15,1,0
181721,1878,2,265,252,13,12,1,0
0,0,0,0,0,0,0,0,0
776894,3165,7,503,496,7,8,1,0
441053,2156,8,393,386,7,10,1,0
30171,248,3,54,51,3,4,0,0
0,0,0,0,0,0,0,0,0
2592753,1360,4,138,45,93,53,1,0
833140,1278,4,112,68,44,48,1,0
1022565,4939,8,876,710,166,0,1,0
96299,420,9,53,48,5,12,0,0
21285,136,10,4,4,0,6,0,0
211389,1149,11,178,164,14,18,1,0
200701,1093,11,182,168,14,13,1,0
115362,745,0,33,3,30,0,0,0
69916,377,9,35,33,2,21,1,0
382551,1367,5,176,114,62,4,1,0
5611,62,0,9,8,1,0,0,0
0,0,0,0,0,0,0,0,0
208820,725,10,67,58,9,7,1,0
9497,69,6,2,2,0,1,0,0
242470,1975,5,368,319,49,10,1,0
20127,119,5,6,6,0,6,1,0
111401,1730,3,364,360,4,17,1,0
52555,859,1,264,67,197,0,1,0
145320,522,8,155,14,141,0,1,0
12697,89,6,7,1,6,0,0,0
124374,1331,3,153,136,17,3,0,0
210196,2418,3,530,527,3,8,1,0
317688,609,7,77,49,28,0,1,0
1037881,3378,8,327,314,13,36,1,0
29077,497,5,75,75,0,0,1,0
0,0,0,0,0,0,0,0,0
0,0,0,0,0,0,0,0,0
0,0,0,0,0,0,0,0,0
163511,1303,5,143,136,7,0,1,0
47885,85,5,2,2,0,0,1,0
105391,365,2,35,30,5,8,1,0
46808,187,5,39,33,6,9,1,0
239242,1166,3,114,99,15,3,1,0
0,0,0,0,0,0,0,0,0
36184,562,4,53,53,0,4,1,0
0,0,0,0,0,0,0,0,0
0,0,0,0,0,0,0,0,0
306156,1355,12,308,289,19,1,1,0
0,0,0,0,0,0,0,0,0
120562,547,5,34,16,18,2,1,0
0,0,0,0,0,0,0,0,0
209745,2180,3,435,412,23,5,1,0
147373,1026,4,304,99,205,3,1,0
273106,2094,6,230,199,31,7,0,0
209276,1876,5,200,171,29,6,0,0
16887,204,5,49,39,10,4,0,0
6002,29,1,2,2,0,0,0,0
1933759,2460,3,163,91,72,123,0,0
64947,322,2,50,12,38,0,1,0
79787,1185,1,207,201,6,7,1,0
676005,3456,1,477,469,8,1,1,0
200215,700,4,115,100,15,7,1,0
54586,598,3,151,151,0,10,0,0
14827,199,3,32,32,0,4,0,0
2287609,5267,3,324,270,54,19,1,0
110349,726,6,121,114,7,59,1,0
100435,605,17,101,95,6,12,1,0
0,0,0,0,0,0,0,0,0
0,0,0,0,0,0,0,0,0
0,0,0,0,0,0,0,0,0
0,0,0,0,0,0,0,0,0
67162,898,2,201,199,2,3,1,0
0,0,0,0,0,0,0,0,0
27565,407,4,108,91,17,0,0,0
408963,1158,3,101,87,14,1,1,0
120189,542,4,63,54,9,4,1,0
65856,102,5,6,6,0,0,0,0
586418,625,4,85,80,5,19,1,0
321244,3586,13,339,300,39,28,0,0
14491,101,8,4,4,0,1,0,0
22868,37,0,2,1,1,0,1,0
13689,87,3,17,12,5,7,1,0
0,0,0,0,0,0,0,0,0
0,0,0,0,0,0,0,0,0
144651,66,0,8,3,5,5,0,0
190760,855,8,120,107,13,52,1,0
82759,1262,2,267,249,18,6,1,0
72362,706,2,153,135,18,5,1,0
218570,387,7,60,58,2,0,1,0
176726,1725,4,266,254,12,50,1,0
500133,1776,9,218,37,181,20,1,0
291333,846,9,11,5,6,6,1,0
836007,4002,6,477,469,8,11,1,0
1841997,6917,8,881,628,253,27,1,0
1743558,5665,8,516,342,174,29,1,0
33842,118,10,2,1,1,4,1,0
116105,751,2,88,72,16,4,0,0
415422,3553,9,546,516,30,8,1,0
0,0,0,0,0,0,0,0,0
189198,1799,8,287,286,1,10,1,0
10122,69,3,5,5,0,0,1,0
78346,666,6,123,119,4,3,0,0
0,0,0,0,0,0,0,0,0
10543,115,2,9,5,4,1,1,0
320444,2543,6,765,561,204,40,0,0
0,0,0,0,0,0,0,0,0
492973,355,6,49,44,5,12,1,0
16843,75,2,5,4,1,2,0,0
126980,1226,2,339,335,4,1,1,1
129244,1184,5,191,184,7,12,1,0
253585,1061,4,157,138,19,39,0,0
268617,817,8,37,26,11,21,1,0
83312,163,4,1,1,0,4,0,0
34077,542,0,142,133,9,2,1,0
0,0,0,0,0,0,0,0,0
74613,1178,4,327,327,0,1,1,0
787487,2172,0,162,158,4,1,0,0
684274,2009,0,154,150,4,1,0,0
253312,1687,1,138,137,1,4,1,0
25822,297,1,11,9,2,2,1,0
74429,702,8,116,109,7,7,1,0
0,0,0,0,0,0,0,0,0
139952,815,13,49,39,10,0,1,0
394045,1548,4,40,11,29,2,1,0
0,0,0,0,0,0,0,0,0
502031,2665,7,330,317,13,155,1,0
186121,581,5,88,81,7,14,1,0
955853,8097,9,648,633,15,61,1,0
0,0,0,0,0,0,0,0,0
244981,884,2,62,49,13,2,1,0
21357,326,4,73,71,2,0,1,0
278989,1380,9,275,274,1,0,0,0
207585,1723,7,365,318,47,17,1,0
50324,91,1,7,4,3,6,1,0
113118,441,10,82,77,5,24,1,0
0,0,0,0,0,0,0,0,0
204835,2387,3,356,298,58,9,1,0
99960,1165,2,128,126,2,12,0,0
104890,1116,6,202,182,20,2,1,0
124919,1633,6,286,280,6,9,1,0
916864,723,5,83,35,48,3,1,0
0,0,0,0,0,0,0,0,0
1143739,13509,3,5601,1375,4226,163,1,0
1143740,13509,3,5601,3085,2516,163,1,0
1113568,2028,6,191,160,31,29,1,0
0,0,0,0,0,0,0,0,0
1310383,4356,7,227,189,38,2,1,0
710942,5834,1,438,436,2,0,0,0
140987,1178,5,318,244,74,4,1,0
253814,272,10,29,23,6,18,1,0
1155126,2470,11,416,363,53,11,1,0
282988,2245,10,399,352,47,51,0,0
161331,1427,0,171,138,33,1,1,0
185090,605,4,93,84,9,10,1,0
177802,1435,4,358,303,55,0,1,0
230350,2211,13,237,221,16,5,1,0
80001,803,2,221,221,0,3,1,0
11288,129,1,19,18,1,0,1,0
576714,4411,11,513,509,4,92,1,0
142219,1167,9,134,134,0,89,0,0
0,0,0,0,0,0,0,0,0
360993,2032,6,577,563,14,3,1,0
30221,113,6,7,7,0,2,0,0
0,0,0,0,0,0,0,0,0
125930,634,1,20,16,4,2,1,0
62621,162,1,21,17,4,2,1,0
52690,318,4,55,55,0,29,0,0
402366,4863,1,1382,1369,13,9,1,0
0,0,0,0,0,0,0,0,0
800969,2254,3,423,374,49,0,1,0
52834,786,5,203,202,1,3,1,0
26616,101,2,0,0,0,9,0,0
234064,831,9,198,181,17,5,1,0
4671889,2028,0,83,80,3,0,1,0
76909,334,1,16,12,4,2,1,0
0,0,0,0,0,0,0,0,0
117247,984,4,330,327,3,3,0,0
0,0,0,0,0,0,0,0,0
228259,967,13,116,109,7,2,1,0
176043,554,12,92,85,7,2,1,0
2169393,1983,5,408,405,3,10,1,0
679570,3934,4,696,693,3,44,1,0
621129,1737,13,269,257,12,21,1,0
0,0,0,0,0,0,0,0,0
0,0,0,0,0,0,0,0,0
728138,1467,6,81,67,14,20,1,0
551483,331,6,6,6,0,14,0,0
498117,1721,4,370,359,11,29,1,0
533326,1946,4,361,347,14,29,1,0
0,0,0,0,0,0,0,0,0
0,0,0,0,0,0,0,0,0
0,0,0,0,0,0,0,0,0
0,0,0,0,0,0,0,0,0
410576,2441,5,537,526,11,58,1,0
178479,1745,9,296,270,26,19,1,0
0,0,0,0,0,0,0,0,0
158927,573,10,24,24,0,0,1,0
295489,621,1,82,78,4,44,1,0
262076,1400,9,85,76,9,17,0,0
0,0,0,0,0,0,0,0,0
213951,1549,1,285,273,12,1,1,0
96892,558,3,153,147,6,0,1,0
69592,158,3,48,45,3,0,1,0
105094,1096,6,86,48,38,11,1,0
68674,1100,9,266,241,25,0,1,0
6679,70,8,7,2,5,2,1,0
459020,4625,5,905,893,12,4,1,0
0,0,0,0,0,0,0,0,0
346924,1977,2,306,269,37,1,1,0
0,0,0,0,0,0,0,0,0
212265,1161,14,213,207,6,45,1,0
166346,1775,8,120,82,38,1,0,0
88238,1154,5,8,6,2,2,0,0
491004,2274,9,647,641,6,29,1,0
14246,194,2,18,18,0,0,1,0
23311,255,1,66,66,0,2,1,0
111110,374,2,81,64,17,0,0,0
10757,143,2,28,28,0,1,0,0
162198,1180,13,183,177,6,11,1,0
147559,1017,13,159,153,6,12,1,0
0,0,0,0,0,0,0,0,0
159349,1311,6,324,320,4,4,1,0
141834,1135,5,308,304,4,6,1,0
0,0,0,0,0,0,0,0,0
0,0,0,0,0,0,0,0,0
0,0,0,0,0,0,0,0,0
102035,592,7,101,97,4,9,1,0
1617516,7110,13,897,861,36,43,1,0
762883,4698,12,645,579,66,19,1,0
76850,1173,3,284,270,14,2,1,0
0,0,0,0,0,0,0,0,0
0,0,0,0,0,0,0,0,0
14761,179,0,6,2,4,3,0,0
14757,179,0,6,6,0,3,0,0
147483,1078,5,164,152,12,0,1,0
92720,482,5,117,106,11,3,1,0
194258,1495,2,310,221,89,9,1,0
229135,1089,3,6,4,2,1,0,0
132534,1225,3,152,124,28,5,1,0
0,0,0,0,0,0,0,0,0
11501,194,2,58,38,20,0,1,0
0,0,0,0,0,0,0,0,0
19085,195,4,57,45,12,3,0,0
693495,535,0,3,3,0,2,1,1
0,0,0,0,0,0,0,0,0
10732,297,0,46,45,1,0,0,0
2270603,20416,14,180,34,146,9,0,0
2216111,17602,8,171,155,16,10,0,0
191017,876,4,97,84,13,1,1,0
13852,192,4,18,18,0,0,1,0
688885,535,0,3,0,3,2,1,1
166675,427,5,36,23,13,0,1,0
53853,126,1,12,3,9,0,0,0
0,0,0,0,0,0,0,0,0
25166,493,3,87,79,8,2,1,0
132707,1300,1,128,121,7,4,1,0
54782,725,1,38,32,6,1,1,0
0,0,0,0,0,0,0,0,0
5176,33,1,0,0,0,0,0,0
269428,2846,6,534,471,63,16,0,0
0,0,0,0,0,0,0,0,0
27699,411,4,82,81,1,0,0,0
0,0,0,0,0,0,0,0,0
0,0,0,0,0,0,0,0,0
250457,1232,5,166,159,7,0,1,0
0,0,0,0,0,0,0,0,0
285549,1840,7,203,158,45,1,1,0
22311,232,5,13,10,3,3,0,0
175967,2165,7,574,406,168,9,0,0
0,0,0,0,0,0,0,0,0
0,0,0,0,0,0,0,0,0
0,0,0,0,0,0,0,0,0
244112,573,3,70,55,15,41,1,0
169716,1650,7,153,144,9,10,1,0
212962,1655,9,376,347,29,5,1,0
0,0,0,0,0,0,0,0,0
944228,4090,16,612,597,15,18,1,0
943402,4099,16,612,597,15,19,1,0
38844,417,6,24,16,8,0,0,0
0,0,0,0,0,0,0,0,0
110415,887,1,231,223,8,8,0,0
0,0,0,0,0,0,0,0,0
1052,10,1,0,0,0,0,0,0
0,0,0,0,0,0,0,0,0
0,0,0,0,0,0,0,0,0
0,0,0,0,0,0,0,0,0
2546,37,1,4,4,0,0,0,0
0,0,0,0,0,0,0,0,0
0,0,0,0,0,0,0,0,0
390261,1928,3,312,297,15,0,0,0
0,0,0,0,0,0,0,0,0
232821,345,0,17,9,8,0,1,0
884154,6891,13,249,23,226,25,1,0
122880,1585,6,258,199,59,17,1,0
0,0,0,0,0,0,0,0,0
0,0,0,0,0,0,0,0,0
0,0,0,0,0,0,0,0,0
111276,973,4,106,106,0,0,1,0
0,0,0,0,0,0,0,0,0
291106,1091,13,123,120,3,20,1,0
259665,851,14,78,76,2,19,1,0
0,0,0,0,0,0,0,0,0
1595294,4038,9,508,447,61,25,1,0
80206,502,3,5,5,0,1,0,0
353592,2228,7,441,432,9,46,1,0
19241,137,3,5,4,1,0,0,0
116009,1168,3,318,294,24,1,1,0
186682,1146,3,277,254,23,0,1,0
28112,43,0,3,1,2,0,0,0
318062,2788,11,564,536,28,2,1,0
603443,2564,4,359,358,1,10,0,0
740712,2853,5,703,694,9,8,1,0
0,0,0,0,0,0,0,0,0
984409,3275,13,595,506,89,22,1,1
18345,110,4,4,0,4,2,1,0
41499,603,2,122,104,18,7,1,0
2684765,5506,13,268,258,10,248,1,0
180863,283,11,2,1,1,9,1,0
0,0,0,0,0,0,0,0,0
99052,1468,5,212,205,7,5,1,0
125497,578,0,81,64,17,0,1,0
628519,3323,9,242,231,11,9,1,0
0,0,0,0,0,0,0,0,0
618646,5758,9,913,749,164,38,0,0
539735,2699,10,290,283,7,61,1,0
0,0,0,0,0,0,0,0,0
36466,76,5,4,3,1,1,1,0
5873,74,5,4,3,1,1,1,0
366951,6989,2,3994,3975,19,0,0,0
0,0,0,0,0,0,0,0,0
5155,64,1,8,5,3,0,0,0
220737,2427,8,502,434,68,34,1,0
37787,193,5,10,10,0,4,1,0
740666,4522,6,746,738,8,30,0,1
0,0,0,0,0,0,0,0,0
0,0,0,0,0,0,0,0,0
286365,1764,10,411,371,40,19,1,0
1730523,6736,2,707,693,14,0,1,0
0,0,0,0,0,0,0,0,0
139838,898,8,148,142,6,11,1,0
38215,282,4,41,35,6,0,1,0
0,0,0,0,0,0,0,0,0
132918,2179,6,374,344,30,7,1,0
32621,384,2,21,11,10,3,1,0
115383,1198,4,208,205,3,18,1,0
43833,236,3,17,14,3,0,1,0
570,7,0,0,0,0,0,0,0
334957,1836,1,378,329,49,1,1,0
430666,3098,7,271,220,51,4,1,0
229257,623,8,107,85,22,0,1,0
0,0,0,0,0,0,0,0,0
142925,481,18,59,57,2,3,1,0
179583,944,10,108,107,1,4,1,0
19863,283,0,42,41,1,0,1,0
6246,149,3,38,38,0,0,1,0
18569,248,3,35,24,11,0,1,0
34115,279,3,42,29,13,2,1,0
103913,1829,3,328,327,1,3,1,0
0,0,0,0,0,0,0,0,0
0,0,0,0,0,0,0,0,0
104954,396,5,34,17,17,0,1,0
348183,1728,5,226,65,161,9,1,0
96622,702,7,115,110,5,31,1,0
53222,316,5,41,36,5,0,1,0
183874,594,2,118,109,9,0,0,0
84224,622,9,92,33,59,48,1,0
14672,129,6,13,10,3,2,1,0
117989,690,10,29,27,2,6,1,0
4195204,9281,4,1027,1017,10,15,0,0
495884,2444,7,386,371,15,15,0,0
105173,377,2,36,25,11,0,1,0
116570,754,7,119,103,16,11,1,0
16287,89,0,15,1,14,0,1,0
0,0,0,0,0,0,0,0,0
0,0,0,0,0,0,0,0,0
536271,5044,12,883,759,124,15,1,0
89020,2100,2,714,708,6,4,1,0
101266,828,4,196,179,17,11,0,0
85383,533,3,45,22,23,0,1,0
0,0,0,0,0,0,0,0,0
0,0,0,0,0,0,0,0,0
207985,702,2,126,74,52,3,0,1
0,0,0,0,0,0,0,0,0
252972,2526,4,602,577,25,10,1,0
24102,470,1,116,112,4,0,0,0
20939,145,1,8,7,1,3,0,0
419779,1521,5,104,91,13,12,1,0
1033822,3488,8,228,226,2,3,1,0
431363,1198,8,306,304,2,4,1,0
409024,1042,4,42,38,4,2,0,0
395273,1558,3,122,115,7,20,1,0
0,0,0,0,0,0,0,0,0
481937,2814,4,485,475,10,354,1,0
552630,4229,18,603,592,11,40,1,0
289264,1868,18,417,411,6,37,1,0
30659,519,1,202,201,1,9,1,0
152995,996,3,295,273,22,2,1,0
169940,329,3,31,31,0,2,1,0
671053,1531,10,205,198,7,23,1,0
463128,948,13,143,131,12,27,1,0
161708,1211,7,202,132,70,12,1,0
152889,1857,5,240,196,44,9,0,0
8998,149,5,26,25,1,1,0,0
0,0,0,0,0,0,0,0,0
283888,1698,3,350,311,39,2,1,0
251778,512,3,39,28,11,2,1,0
0,0,0,0,0,0,0,0,0
525881,4335,3,545,534,11,2,1,0
0,0,0,0,0,0,0,0,0
66483,699,8,160,135,25,8,1,0
112885,870,2,237,201,36,4,1,0
0,0,0,0,0,0,0,0,0
107876,366,3,60,54,6,1,1,0
435063,2602,6,145,53,92,38,1,0
0,0,0,0,0,0,0,0,0
134513,1024,13,195,182,13,4,1,0
305964,861,6,110,95,15,3,1,0
0,0,0,0,0,0,0,0,0
0,0,0,0,0,0,0,0,0
38532,272,2,32,26,6,3,1,0
365402,1161,2,96,93,3,11,1,0
138252,179,0,6,3,3,0,1,0
296287,3694,13,710,689,21,8,1,0
107024,709,13,147,89,58,2,1,0
795346,999,12,139,104,35,7,1,0
0,0,0,0,0,0,0,0,0
0,0,0,0,0,0,0,0,0
306217,380,1,95,46,49,0,1,0
210991,178,0,47,32,15,1,1,0
424142,1001,3,60,49,11,0,1,0
229463,2096,12,513,505,8,9,1,0
309262,1223,2,346,315,31,28,1,0
58091,510,5,71,70,1,3,1,0
157799,793,9,131,98,33,7,1,0
0,0,0,0,0,0,0,0,0
1466426,13744,2,1755,1744,11,27,1,0
0,0,0,0,0,0,0,0,0
186788,988,3,117,102,15,2,1,0
62184,119,3,7,7,0,3,1,0
0,0,0,0,0,0,0,0,0
728704,1952,3,197,189,8,9,1,0
188667,1079,3,88,78,10,6,0,0
30449,276,1,38,29,9,2,1,0
186060,1068,9,127,110,17,4,1,0
0,0,0,0,0,0,0,0,0
0,0,0,0,0,0,0,0,0
265556,1780,9,198,169,29,20,1,0
215618,1215,8,127,99,28,17,1,0
167419,716,4,55,54,1,4,0,0
0,0,0,0,0,0,0,0,0
312792,1089,8,199,153,46,11,1,0
0,0,0,0,0,0,0,0,0
0,0,0,0,0,0,0,0,0
416347,2044,5,402,371,31,46,1,0
40416,154,6,10,4,6,1,0,0
294427,1063,1,248,192,56,1,0,0
0,0,0,0,0,0,0,0,0
816938,4285,13,787,735,52,40,1,0
48219,537,4,119,107,12,1,1,0
898271,967,6,193,173,20,9,1,0
0,0,0,0,0,0,0,0,0
110101,1654,1,468,464,4,4,1,0
224259,954,3,94,89,5,2,1,0
0,0,0,0,0,0,0,0,0
916846,723,5,83,33,50,3,1,0
0,0,0,0,0,0,0,0,0
87022,637,7,40,31,9,10,1,0
0,0,0,0,0,0,0,0,0
0,0,0,0,0,0,0,0,0
3076534,21762,6,262,246,16,8,1,0
56158,200,3,45,10,35,0,1,0
320944,1255,18,164,17,147,2,1,0
13004,166,3,25,23,2,0,1,0
26185,138,4,27,23,4,4,1,0
1769735,1220,11,126,117,9,6,1,0
0,0,0,0,0,0,0,0,0
334124,1663,14,405,373,32,21,1,0
0,0,0,0,0,0,0,0,0
0,0,0,0,0,0,0,0,0
230903,346,0,17,12,5,0,1,0
0,0,0,0,0,0,0,0,0
229916,2182,6,243,233,10,16,1,0
128398,2308,3,502,403,99,16,1,0
15151,99,1,14,14,0,0,1,0
762252,3572,5,582,444,138,10,1,0
170365,723,6,42,21,21,14,1,0
534129,1082,9,61,58,3,24,1,0
52395,475,10,53,43,10,27,1,0
98065,475,2,15,13,2,11,1,0
62263,813,5,198,194,4,9,1,0
1210195,4410,3,1105,502,603,3,0,0
161669,914,1,169,164,5,16,1,0
95972,308,1,79,27,52,2,0,0
0,0,0,0,0,0,0,0,0
3252790,2088,13,254,233,21,65,1,1
276083,1940,11,248,208,40,7,1,0
201441,665,11,49,46,3,1,1,0
169064,420,9,43,40,3,0,1,0
71047,590,1,277,276,1,8,1,0
295488,2550,2,205,185,20,4,0,0
43729,238,4,25,19,6,10,1,0
26152,171,4,18,12,6,7,1,0
122975,896,5,131,125,6,5,0,0
325186,2197,7,228,203,25,11,1,0
202902,1279,10,150,121,29,11,1,0
0,0,0,0,0,0,0,0,0
267542,2415,10,212,160,52,50,0,0
89351,707,10,100,96,4,4,0,0
829794,4092,7,222,196,26,2,1,0
708059,1320,3,145,81,64,0,1,0
543123,636,3,118,101,17,0,1,0
0,0,0,0,0,0,0,0,0
51801,1132,4,267,264,3,0,1,0
37637,987,5,298,277,21,9,1,0
255740,1484,16,311,310,1,61,0,0
197735,861,13,152,152,0,40,0,0
54536,665,6,82,75,7,2,1,0
24063,261,8,38,35,3,2,1,0
0,0,0,0,0,0,0,0,0
0,0,0,0,0,0,0,0,0
21075,469,0,45,19,26,0,0,0
0,0,0,0,0,0,0,0,0
3665,50,0,9,9,0,0,0,0
0,0,0,0,0,0,0,0,0
97875,1415,3,277,116,161,0,1,0
68360,530,13,79,66,13,3,1,0
0,0,0,0,0,0,0,0,0
4631,62,1,4,4,0,0,0,0
407028,8038,5,1229,1218,11,39,1,0
89259,899,5,132,131,1,29,1,0
281842,1790,8,427,236,191,9,1,0
214741,2565,5,756,738,18,37,1,0
183073,2241,5,667,651,16,36,1,0
117795,1305,10,199,188,11,20,1,0
122788,679,12,103,91,12,2,0,0
327969,1865,1,379,359,20,1,1,0
84295,896,10,199,161,38,2,1,0
84295,896,10,199,161,38,2,1,0
15553,171,0,47,38,9,0,1,0
280856,1184,8,230,211,19,16,1,0
133310,889,7,140,123,17,10,1,0
0,0,0,0,0,0,0,0,0
132021,624,8,22,18,4,4,0,0
147938,1505,11,368,359,9,18,1,0
62788,201,3,27,17,10,2,1,0
67040,476,6,45,41,4,0,0,0
140833,1948,1,463,461,2,0,0,0
93240,634,4,131,128,3,9,0,0
181863,1313,11,182,152,30,1,1,1
0,0,0,0,0,0,0,0,0
262959,2502,5,301,270,31,5,1,0
23107,118,5,8,7,1,5,1,0
0,0,0,0,0,0,0,0,0
2086,65,1,17,17,0,0,1,0
7792,157,2,37,37,0,0,1,0
691113,537,0,5,2,3,2,1,1
561668,1363,8,131,96,35,1,1,0
0,0,0,0,0,0,0,0,0
368303,677,13,97,93,4,18,1,0
1019155,1634,6,205,187,18,50,1,0
0,0,0,0,0,0,0,0,0
0,0,0,0,0,0,0,0,0
0,0,0,0,0,0,0,0,0
504008,1657,2,203,174,29,10,1,0
454578,3178,2,424,405,19,29,0,0
186695,1608,2,332,315,17,2,0,0
209482,1304,6,60,36,24,12,1,0
103803,2637,2,899,899,0,1,1,0
86304,706,6,137,73,64,13,1,0
0,0,0,0,0,0,0,0,0
515320,5145,5,784,751,33,5,1,0
181286,882,14,119,95,24,3,1,0
0,0,0,0,0,0,0,0,0
0,0,0,0,0,0,0,0,0
69962,368,2,30,18,12,0,1,0
94161,404,1,5,5,0,1,0,0
0,0,0,0,0,0,0,0,0
66808,691,7,142,138,4,18,1,0
148334,1140,6,367,341,26,32,1,0
44737,458,4,96,78,18,1,1,0
0,0,0,0,0,0,0,0,0
31775,467,2,180,22,158,1,1,0
0,0,0,0,0,0,0,0,0
127401,854,4,107,107,0,11,1,0
245124,861,5,132,125,7,1,1,0
0,0,0,0,0,0,0,0,0
362213,2508,8,772,754,18,33,0,0
1705,19,1,1,1,0,0,0,0
1600690,7284,3,418,405,13,2,1,0
429874,2385,1,336,317,19,4,1,0
438262,2457,2,336,317,19,5,1,0
0,0,0,0,0,0,0,0,0
0,0,0,0,0,0,0,0,0
0,0,0,0,0,0,0,0,0
192705,1578,6,209,175,34,18,0,0
407358,1916,8,209,208,1,9,1,0
358185,1445,7,171,170,1,6,1,0
0,0,0,0,0,0,0,0,0
256123,1463,7,438,403,35,3,1,0
234484,3279,5,857,850,7,7,1,0
25315,129,3,7,6,1,3,1,0
63769,191,4,41,40,1,0,1,0
332977,655,1,159,150,9,2,1,0
111387,161,1,6,6,0,1,0,0
0,0,0,0,0,0,0,0,0
27764,241,0,42,27,15,2,1,0
10157,109,4,6,6,0,4,1,0
42389,710,2,82,74,8,3,1,0
8873,107,1,8,8,0,6,0,0
95821,752,3,132,129,3,3,0,0
13559,122,3,10,7,3,3,0,0
499862,4392,2,221,218,3,4,0,0
7009,22,0,0,0,0,0,0,0
0,0,0,0,0,0,0,0,0
0,0,0,0,0,0,0,0,0
32435,408,6,69,61,8,6,1,0
12223,179,6,25,19,6,6,1,0
41214,247,2,40,39,1,0,1,0
9988,111,1,19,18,1,0,1,0
0,0,0,0,0,0,0,0,0
19311,384,1,117,115,2,6,1,0
4377,56,1,3,2,1,0,0,0
377037,1878,8,307,290,17,20,1,0
0,0,0,0,0,0,0,0,0
169457,1302,3,210,195,15,23,1,0
80565,293,2,28,27,1,3,0,0
0,0,0,0,0,0,0,0,0
0,0,0,0,0,0,0,0,0
35354,302,7,71,69,2,14,1,0
1001016,9349,4,385,364,21,1,1,0
0,0,0,0,0,0,0,0,0
401951,1004,8,107,83,24,25,1,0
62139,1101,8,251,234,17,3,1,0
0,0,0,0,0,0,0,0,0
93888,486,5,125,114,11,5,1,0
84263,601,7,93,90,3,2,1,0
0,0,0,0,0,0,0,0,0
918159,1713,4,656,647,9,1,1,0
0,0,0,0,0,0,0,0,0
200340,3026,6,1378,1373,5,20,1,0
411989,3098,6,540,532,8,33,1,0
122587,911,2,241,207,34,5,1,0
0,0,0,0,0,0,0,0,0
0,0,0,0,0,0,0,0,0
80650,843,5,152,117,35,3,1,0
37247,356,7,44,40,4,3,1,0
38806,356,7,48,43,5,4,1,0
1124375,1366,7,147,129,18,11,1,0
1169191,126,3,5,3,2,0,1,0
927340,4792,8,270,268,2,22,1,0
123219,1204,8,279,271,8,6,0,0
0,0,0,0,0,0,0,0,0
0,0,0,0,0,0,0,0,0
0,0,0,0,0,0,0,0,0
177619,952,7,119,90,29,0,1,0
37804,108,7,6,6,0,1,0,0
0,0,0,0,0,0,0,0,0
524317,1175,2,60,52,8,45,0,0
0,0,0,0,0,0,0,0,0
79447,551,2,17,11,6,0,1,1
0,0,0,0,0,0,0,0,0
0,0,0,0,0,0,0,0,0
77098,205,3,25,23,2,13,1,0
14803,133,2,24,21,3,2,1,0
369448,2548,2,275,269,6,68,1,0
0,0,0,0,0,0,0,0,0
176867,3337,2,933,933,0,1,1,0
0,0,0,0,0,0,0,0,0
0,0,0,0,0,0,0,0,0
338434,1132,13,93,91,2,1,1,1
0,0,0,0,0,0,0,0,0
687722,2114,5,134,90,44,1,1,0
261994,2037,6,107,39,68,39,1,0
18010,132,5,10,5,5,2,0,0
208504,1248,6,75,12,63,9,0,0
84782,498,10,33,2,31,5,1,0
74880,808,5,132,124,8,3,0,1
0,0,0,0,0,0,0,0,0
0,0,0,0,0,0,0,0,0
259147,975,6,205,182,23,12,0,0
247285,632,6,168,135,33,12,0,0
577650,1683,2,142,11,131,6,1,0
588440,852,5,145,114,31,8,1,0
56044,433,2,83,78,5,33,1,0
123225,1823,9,390,381,9,9,1,0
375336,2946,6,678,670,8,10,1,0
145119,556,3,109,105,4,0,1,0
112902,157,3,27,26,1,0,1,0
0,0,0,0,0,0,0,0,0
0,0,0,0,0,0,0,0,0
0,0,0,0,0,0,0,0,0
395812,1322,6,186,172,14,4,1,0
131685,1026,4,170,170,0,0,1,0
66314,1111,5,213,189,24,33,0,0
19305,117,7,9,9,0,3,1,0
1304720,1837,9,257,215,42,20,1,0
0,0,0,0,0,0,0,0,0
235948,314,5,34,25,9,6,1,0
0,0,0,0,0,0,0,0,0
166960,359,5,18,9,9,0,0,0
166960,359,5,18,16,2,0,0,0
1027384,4670,3,423,355,68,1,0,0
45538,315,0,71,68,3,2,1,0
32156,181,6,18,5,13,2,1,0
102207,206,4,2,1,1,10,0,0
329180,1841,10,177,160,17,11,1,0
465642,2267,8,213,187,26,6,1,1
916062,2932,6,717,680,37,6,1,0
52367,295,9,24,19,5,16,1,0
7357,71,4,12,10,2,3,1,0
124541,1651,2,693,579,114,8,0,0
233577,3225,5,766,754,12,6,1,0
8301,57,2,3,3,0,1,0,0
476672,731,8,89,64,25,13,1,0
328922,177,7,7,7,0,9,1,0
34006,571,2,108,97,11,2,1,0
64972,1036,7,248,241,7,5,1,0
228347,875,13,87,35,52,6,1,0
61883,482,7,76,76,0,4,0,0
19668,157,4,41,41,0,1,0,0
44833,374,5,76,76,0,0,1,0
0,0,0,0,0,0,0,0,0
305460,1326,5,317,311,6,8,1,0
0,0,0,0,0,0,0,0,0
48229,501,4,135,129,6,9,1,0
252361,1315,9,235,206,29,17,1,0
1133454,6741,2,1405,1317,88,3,1,0
64196,93,5,4,4,0,0,0,0
382012,619,10,78,74,4,16,1,0
355508,2813,5,533,395,138,35,0,0
0,0,0,0,0,0,0,0,0
558665,2269,3,224,187,37,9,1,0
197533,2215,7,525,500,25,19,1,0
8408,79,3,12,11,1,5,0,0
212726,2713,17,145,138,7,6,0,0
2082839,2230,13,257,246,11,5,1,0
7215,64,0,1,1,0,0,0,0
0,0,0,0,0,0,0,0,0
119112,1347,6,225,215,10,3,1,0
77205,741,3,161,157,4,10,1,0
246173,759,5,131,131,0,11,1,0
248986,1950,10,294,111,183,62,0,0
16661,92,0,16,1,15,0,1,0
115311,1982,3,257,249,8,16,1,0
32547,286,3,43,35,8,0,1,0
0,0,0,0,0,0,0,0,0
37019,444,4,55,53,2,3,0,0
0,0,0,0,0,0,0,0,0
931592,3528,9,357,343,14,52,1,0
751893,1810,4,218,199,19,13,1,0
55903,323,2,45,44,1,0,1,0
15451,118,0,22,21,1,0,1,0
0,0,0,0,0,0,0,0,0
0,0,0,0,0,0,0,0,0
908031,2302,7,391,380,11,5,1,0
422521,1267,17,166,162,4,40,1,0
0,0,0,0,0,0,0,0,0
0,0,0,0,0,0,0,0,0
460422,2219,1,197,182,15,0,1,0
302649,3132,4,630,612,18,4,0,0
39012,418,4,85,73,12,0,0,0
36409,251,12,59,2,57,0,1,0
11820,141,6,24,18,6,2,1,0
374466,2238,11,149,141,8,8,1,0
0,0,0,0,0,0,0,0,0
70909,678,7,106,103,3,0,0,0
132534,485,5,42,34,8,7,0,0
0,0,0,0,0,0,0,0,0
4013986,2020,0,83,80,3,0,1,0
67889,319,1,16,12,4,2,1,0
117818,1223,4,94,80,14,12,1,0
22295,195,5,8,6,2,1,1,0
0,0,0,0,0,0,0,0,0
0,0,0,0,0,0,0,0,0
343178,937,10,35,20,15,68,1,0
82335,156,4,1,1,0,2,0,0
434663,1211,4,234,221,13,6,1,0
60399,650,7,136,131,5,6,0,0
231675,652,4,125,122,3,5,1,0
345380,2545,0,309,299,10,11,1,0
84669,566,0,73,68,5,5,1,0
674475,1390,3,222,173,49,12,1,0
0,0,0,0,0,0,0,0,0
118556,1563,6,262,242,20,16,0,0
71885,775,6,222,209,13,15,0,0
191642,1495,9,379,277,102,4,1,0
88154,254,0,48,24,24,0,1,1
735904,6390,2,350,323,27,6,1,0
296261,3148,3,156,152,4,3,1,0
266013,891,10,110,95,15,1,1,0
0,0,0,0,0,0,0,0,0
16666,158,3,19,15,4,2,0,0
17174,198,3,16,16,0,5,0,0
717506,3622,7,533,475,58,25,1,0
10311,107,6,10,5,5,2,1,0
198034,1194,8,142,107,35,9,1,0
172275,423,6,65,49,16,9,1,0
232660,2260,1,270,263,7,4,0,0
88988,987,7,215,207,8,5,0,0
871704,4188,2,379,367,12,4,1,0
78154,76,4,2,2,0,0,1,0
630896,1473,7,132,126,6,6,1,0
408494,570,6,71,66,5,2,1,0
257826,1512,4,139,132,7,4,1,0
15782,128,5,17,12,5,10,1,0
279285,1611,4,261,254,7,21,1,0
0,0,0,0,0,0,0,0,0
100886,852,14,61,54,7,5,1,0
57393,173,15,4,2,2,10,0,0
176669,2587,5,504,493,11,3,1,0
9224,91,0,2,2,0,0,0,0
661459,1428,6,300,286,14,7,1,0
0,0,0,0,0,0,0,0,0
15274,159,1,14,5,9,6,0,0
13270,127,2,15,14,1,6,0,0
0,0,0,0,0,0,0,0,0
1949403,3523,11,679,672,7,28,1,0
0,0,0,0,0,0,0,0,0
0,0,0,0,0,0,0,0,0
300056,1407,8,150,54,96,10,1,0
0,0,0,0,0,0,0,0,0
22186,35,0,1,1,0,0,1,0
120251,1213,4,287,284,3,3,1,0
264516,1566,8,248,196,52,12,1,0
0,0,0,0,0,0,0,0,0
129999,1445,5,289,169,120,14,1,0
127680,1605,4,252,233,19,5,1,0
19329,216,3,46,37,9,0,1,0
69548,206,6,34,31,3,17,1,0
480803,2813,9,477,464,13,23,1,0
210242,1744,5,466,452,14,17,1,0
0,0,0,0,0,0,0,0,0
267609,1368,5,80,69,11,6,1,0
324834,3209,6,2,2,0,10,0,0
118314,333,10,58,57,1,12,0,0
652872,3354,7,524,462,62,3,1,0
0,0,0,0,0,0,0,0,0
261343,2337,12,380,309,71,79,1,0
0,0,0,0,0,0,0,0,0
47965,525,7,120,87,33,12,1,0
1333656,370,8,29,17,12,4,1,0
550019,2716,6,322,173,149,18,0,0
581968,2096,8,238,225,13,2,1,0
281739,621,6,20,14,6,25,0,0
0,0,0,0,0,0,0,0,0
0,0,0,0,0,0,0,0,0
0,0,0,0,0,0,0,0,0
1227838,186,2,26,14,12,0,1,0
9989,122,3,10,10,0,1,1,0
840911,2403,7,346,319,27,23,1,0
240786,423,7,6,5,1,5,0,0
242517,3263,4,298,294,4,3,1,0
165243,1314,3,90,76,14,15,1,0
277347,1637,9,243,221,22,33,1,0
318351,1445,19,248,178,70,14,1,0
223879,409,18,24,18,6,14,1,0
0,0,0,0,0,0,0,0,0
973126,661,9,35,30,5,2,1,0
3892,56,1,9,9,0,0,0,0
115565,1618,4,593,537,56,8,1,0
419438,2286,12,591,564,27,23,1,0
72053,356,8,14,12,2,0,1,0
8795,96,7,4,4,0,2,1,0
0,0,0,0,0,0,0,0,0
0,0,0,0,0,0,0,0,0
0,0,0,0,0,0,0,0,0
455597,3659,2,579,542,37,21,0,0
253443,1951,2,342,121,221,21,0,0
0,0,0,0,0,0,0,0,0
274748,899,1,221,148,73,2,1,0
102294,376,6,42,33,9,0,1,0
238087,1458,4,198,176,22,3,1,0
160056,1182,13,171,155,16,21,1,0
0,0,0,0,0,0,0,0,0
22126,35,0,1,1,0,0,1,0
216677,1991,5,420,403,17,2,1,0
361332,719,2,61,61,0,40,0,0
279503,1164,12,139,82,57,59,1,0
0,0,0,0,0,0,0,0,0
0,0,0,0,0,0,0,0,0
0,0,0,0,0,0,0,0,0
0,0,0,0,0,0,0,0,0
0,0,0,0,0,0,0,0,0
608876,2141,8,469,441,28,5,1,0
5251824,1423,5,201,189,12,3,1,0
39263,517,3,142,134,8,0,0,0
0,0,0,0,0,0,0,0,0
0,0,0,0,0,0,0,0,0
1262397,3239,6,255,111,144,517,1,0
128771,804,4,97,62,35,12,1,0
17332,118,4,6,6,0,0,0,0
169308,922,5,147,132,15,27,1,0
0,0,0,0,0,0,0,0,0
0,0,0,0,0,0,0,0,0
374959,1101,1,27,5,22,0,1,0
339528,795,2,4,4,0,2,0,0
29436,46,0,0,0,0,0,1,0
1400698,5022,7,474,463,11,23,1,0
506836,465,7,18,13,5,6,1,0
74773,550,5,52,18,34,6,1,0
365276,2292,10,251,235,16,140,1,0
0,0,0,0,0,0,0,0,0
0,0,0,0,0,0,0,0,0
83489,1049,1,94,88,6,0,0,0
643914,3395,7,379,322,57,0,1,0
0,0,0,0,0,0,0,0,0
1036336,1949,8,209,182,27,12,1,0
159585,1293,14,250,236,14,4,1,0
31961,123,9,5,5,0,3,0,0
84929,545,6,117,112,5,13,1,0
0,0,0,0,0,0,0,0,0
0,0,0,0,0,0,0,0,0
182326,1287,9,535,519,16,15,0,0
138461,1163,0,155,139,16,13,0,0
431010,1759,3,317,302,15,7,1,0
0,0,0,0,0,0,0,0,0
1349451,3609,3,251,147,104,2,1,0
208940,1808,6,405,397,8,10,1,0
95503,896,6,135,132,3,8,1,0
201805,1282,11,196,185,11,8,1,0
0,0,0,0,0,0,0,0,0
0,0,0,0,0,0,0,0,0
0,0,0,0,0,0,0,0,0
0,0,0,0,0,0,0,0,0
49728,716,2,220,219,1,2,1,0
0,0,0,0,0,0,0,0,0
366565,1959,2,109,73,36,2,1,0
0,0,0,0,0,0,0,0,0
96763,781,5,74,42,32,4,1,0
21427,202,6,41,33,8,0,1,0
1787970,4409,7,920,854,66,14,1,0
937269,638,7,114,79,35,13,1,0
121254,1263,1,491,487,4,4,1,0
123658,412,4,52,45,7,18,1,0
0,0,0,0,0,0,0,0,0
249796,1694,13,234,195,39,4,0,0
0,0,0,0,0,0,0,0,0
0,0,0,0,0,0,0,0,0
8097,233,0,28,28,0,0,0,0
4584,128,0,23,23,0,0,0,0
0,0,0,0,0,0,0,0,0
3259,40,1,2,2,0,0,0,0
0,0,0,0,0,0,0,0,0
0,0,0,0,0,0,0,0,0
154848,722,4,77,73,4,37,0,0
99080,196,4,2,2,0,6,0,0
0,0,0,0,0,0,0,0,0
223075,1174,10,157,50,107,0,0,0
82485,619,7,91,63,28,1,1,0
412531,1671,15,477,459,18,18,1,0
55084,541,8,141,110,31,3,1,0
24974,299,8,33,28,5,4,1,0
270247,1890,10,403,402,1,7,1,0
169266,362,9,45,43,2,5,1,0
0,0,0,0,0,0,0,0,0
703608,2380,6,392,362,30,3,1,0
0,0,0,0,0,0,0,0,0
854632,4118,8,64,45,19,16,0,0
367000,1337,4,296,266,30,14,1,0
216718,2314,6,397,254,143,7,1,0
0,0,0,0,0,0,0,0,0
0,0,0,0,0,0,0,0,0
91459,311,1,60,35,25,4,0,0
0,0,0,0,0,0,0,0,0
2219808,7675,4,412,405,7,40,1,0
0,0,0,0,0,0,0,0,0
31758,558,2,55,55,0,3,0,0
14532,101,2,16,14,2,2,0,0
0,0,0,0,0,0,0,0,0
0,0,0,0,0,0,0,0,0
0,0,0,0,0,0,0,0,0
0,0,0,0,0,0,0,0,0
0,0,0,0,0,0,0,0,0
69200,90,4,14,12,2,1,0,0
8440,82,4,13,13,0,0,0,0
10476,77,4,6,6,0,3,0,0
769237,755,6,90,69,21,9,1,0
0,0,0,0,0,0,0,0,0
0,0,0,0,0,0,0,0,0
0,0,0,0,0,0,0,0,0
223223,1012,4,91,57,34,1,1,0
267669,766,9,11,8,3,4,0,0
255618,744,10,41,35,6,2,1,0
12557,261,0,17,13,4,0,0,0
3367,81,0,4,4,0,0,0,0
108743,1027,14,200,197,3,10,1,0
0,0,0,0,0,0,0,0,0
627889,2171,10,230,217,13,34,1,0
285285,842,9,11,5,6,6,1,0
685726,1305,3,240,227,13,0,1,0
240727,1188,3,224,208,16,6,1,0
97123,289,4,69,55,14,0,1,0
0,0,0,0,0,0,0,0,0
203750,2604,9,447,428,19,7,1,0
24037,111,9,2,2,0,3,0,0
97312,854,2,264,235,29,6,0,1
279075,2591,8,572,557,15,6,1,0
58478,121,9,11,8,3,2,1,0
1021061,10618,6,1665,1605,60,42,1,0
136852,1724,4,335,315,20,6,1,0
122410,656,6,125,94,31,2,1,0
10438,140,0,23,22,1,1,1,0
635468,1003,5,155,108,47,9,1,0
679093,3232,10,396,345,51,17,1,0
380631,2313,10,445,429,16,38,1,1
144735,1730,5,307,301,6,8,1,0
1160408,2888,10,404,388,16,3,1,0
525733,3589,9,66,60,6,1,1,0
0,0,0,0,0,0,0,0,0
0,0,0,0,0,0,0,0,0
282758,1486,5,107,66,41,8,1,0
27911,379,4,62,45,17,1,0,0
0,0,0,0,0,0,0,0,0
44640,563,4,176,176,0,4,1,0
0,0,0,0,0,0,0,0,0
197108,1006,9,210,190,20,16,1,0
0,0,0,0,0,0,0,0,0
545301,2342,11,253,219,34,46,1,0
223239,210,6,15,12,3,14,0,0
162432,821,10,166,162,4,7,1,0
7313,17,0,2,0,2,0,0,0
22054,33,0,1,1,0,0,1,0
0,0,0,0,0,0,0,0,0
0,0,0,0,0,0,0,0,0
11453,323,0,34,32,2,0,1,0
4412,95,0,13,11,2,0,1,0
281619,1011,9,183,179,4,10,1,0
0,0,0,0,0,0,0,0,0
80666,838,4,133,123,10,19,1,0
4622,56,0,4,1,3,0,0,0
281965,472,3,84,76,8,0,1,0
774073,1534,7,87,68,19,16,1,0
705714,706,6,52,39,13,16,1,0
0,0,0,0,0,0,0,0,0
946676,11488,9,245,228,17,7,0,0
791880,2485,6,403,386,17,10,1,0
168393,1210,6,278,261,17,8,1,0
0,0,0,0,0,0,0,0,0
128783,1017,1,104,92,12,1,1,1
280658,5332,2,1320,1086,234,35,1,0
15009,239,2,60,56,4,3,1,0
588122,5262,11,1097,1069,28,8,1,0
0,0,0,0,0,0,0,0,0
0,0,0,0,0,0,0,0,0
0,0,0,0,0,0,0,0,0
0,0,0,0,0,0,0,0,0
619437,561,4,11,7,4,1,1,0
639323,655,6,26,18,8,1,1,0
170786,783,5,115,89,26,7,1,0
0,0,0,0,0,0,0,0,0
366326,1711,3,221,221,0,40,0,0
0,0,0,0,0,0,0,0,0
135015,1145,3,308,303,5,6,1,1
139438,531,7,56,45,11,15,1,0
197911,271,4,3,2,1,14,1,0
908828,1339,2,66,50,16,8,1,0
61284,300,6,33,31,2,3,0,0
70216,290,6,33,30,3,4,0,0
0,0,0,0,0,0,0,0,0
218668,2015,9,360,351,9,9,1,0
136331,1389,3,36,29,7,7,1,0
85919,722,3,5,5,0,8,0,0
0,0,0,0,0,0,0,0,0
0,0,0,0,0,0,0,0,0
145974,1514,7,263,238,25,3,1,0
577264,3858,2,453,437,16,1,1,0
0,0,0,0,0,0,0,0,0
87637,66,0,4,2,2,4,1,0
689130,2816,7,571,483,88,66,1,0
431444,2892,9,40,30,10,29,1,0
431444,2892,9,40,37,3,29,1,0
0,0,0,0,0,0,0,0,0
0,0,0,0,0,0,0,0,0
22331,213,6,22,20,2,0,1,0
191136,607,9,100,60,40,3,0,0
0,0,0,0,0,0,0,0,0
0,0,0,0,0,0,0,0,0
231303,1627,6,329,301,28,14,1,0
0,0,0,0,0,0,0,0,0
0,0,0,0,0,0,0,0,0
0,0,0,0,0,0,0,0,0
121059,975,7,124,113,11,1,1,0
1664986,1595,2,174,14,160,1,1,0
384642,93,0,3,3,0,0,1,0
0,0,0,0,0,0,0,0,0
476944,966,2,96,83,13,4,1,0
0,0,0,0,0,0,0,0,0
146567,56,1,13,12,1,0,0,0
0,0,0,0,0,0,0,0,0
40489,461,2,15,5,10,10,0,0
411764,2806,7,628,511,117,31,1,0
50459,830,10,226,214,12,7,1,0
127631,727,1,90,77,13,0,1,0
119208,976,9,214,196,18,14,1,0
96311,576,3,57,57,0,11,1,0
0,0,0,0,0,0,0,0,0
0,0,0,0,0,0,0,0,0
62496,667,3,186,144,42,10,1,0
19829,129,2,22,16,6,0,1,0
0,0,0,0,0,0,0,0,0
21912,33,0,1,1,0,0,1,0
0,0,0,0,0,0,0,0,0
0,0,0,0,0,0,0,0,0
223809,977,9,112,27,85,29,1,0
565140,1431,2,193,146,47,1,1,0
49273,662,5,40,28,12,3,0,0
48065,173,5,14,10,4,9,1,0
91835,860,7,172,139,33,5,1,0
1224028,6583,11,1395,1204,191,20,1,0
0,0,0,0,0,0,0,0,0
0,0,0,0,0,0,0,0,0
0,0,0,0,0,0,0,0,0
65262,721,5,225,224,1,0,1,0
48730,639,5,215,214,1,1,1,0
0,0,0,0,0,0,0,0,0
0,0,0,0,0,0,0,0,0
0,0,0,0,0,0,0,0,0
0,0,0,0,0,0,0,0,0
0,0,0,0,0,0,0,0,0
0,0,0,0,0,0,0,0,0
49245,362,5,68,47,21,0,1,0
11977,171,4,28,27,1,1,1,0
18177,331,4,29,28,1,1,1,0
0,0,0,0,0,0,0,0,0
268981,1328,9,267,254,13,12,1,0
97083,368,2,81,52,29,0,1,0
120784,804,8,104,91,13,3,1,0
64704,912,1,82,74,8,0,0,0
22423,383,3,61,54,7,1,0,0
0,0,0,0,0,0,0,0,0
53554,661,5,66,60,6,1,0,0
0,0,0,0,0,0,0,0,0
120244,807,9,68,24,44,0,0,0
0,0,0,0,0,0,0,0,0
1856154,656,8,98,71,27,3,1,0
455706,1312,13,110,108,2,7,1,0
85607,108,0,15,8,7,0,1,0
277686,1473,10,247,203,44,35,1,0
0,0,0,0,0,0,0,0,0
0,0,0,0,0,0,0,0,0
0,0,0,0,0,0,0,0,0
77911,602,6,1,1,0,9,0,0
400741,2376,20,283,258,25,82,1,0
0,0,0,0,0,0,0,0,0
22021,35,0,1,1,0,0,1,0
1043407,3535,7,551,508,43,16,1,0
0,0,0,0,0,0,0,0,0
0,0,0,0,0,0,0,0,0
162246,2355,8,429,370,59,7,1,0
52921,392,10,77,67,10,1,1,0
0,0,0,0,0,0,0,0,0
1077003,2908,1,495,476,19,15,1,0
355895,1817,7,135,132,3,5,1,0
22730,37,0,2,1,1,0,1,0
50356,413,5,59,34,25,1,0,0
315595,1974,8,240,204,36,3,1,0
0,0,0,0,0,0,0,0,0
140665,1539,5,148,117,31,3,1,0
68149,411,6,57,46,11,8,1,0
22488,323,2,56,55,1,0,0,0
159132,127,8,5,5,0,2,1,0
0,0,0,0,0,0,0,0,0
0,0,0,0,0,0,0,0,0
0,0,0,0,0,0,0,0,0
110290,1206,3,164,104,60,11,1,0
280800,1123,8,6,2,4,9,0,0
46443,529,8,122,106,16,3,1,0
0,0,0,0,0,0,0,0,0
373221,2525,11,381,280,101,0,0,0
66201,486,3,128,115,13,0,1,0
689116,1245,15,96,84,12,13,1,0
60227,418,8,148,148,0,6,1,0
77589,240,10,39,32,7,0,1,0
0,0,0,0,0,0,0,0,0
296563,2203,7,300,296,4,25,1,1
72384,1265,3,319,306,13,6,0,0
0,0,0,0,0,0,0,0,0
146179,685,11,54,52,2,3,0,0
0,0,0,0,0,0,0,0,0
217466,1476,3,287,275,12,1,1,0
80785,1002,3,219,213,6,1,1,0
0,0,0,0,0,0,0,0,0
134265,1563,12,61,58,3,3,1,0
0,0,0,0,0,0,0,0,0
66661,504,5,63,61,2,6,0,0
0,0,0,0,0,0,0,0,0
0,0,0,0,0,0,0,0,0
302452,2360,7,350,309,41,27,1,0
0,0,0,0,0,0,0,0,0
129356,410,4,32,28,4,6,1,0
5363,91,1,11,10,1,0,0,0
0,0,0,0,0,0,0,0,0
0,0,0,0,0,0,0,0,0
0,0,0,0,0,0,0,0,0
111542,475,10,36,24,12,24,1,0
11870,100,3,7,6,1,1,1,0
0,0,0,0,0,0,0,0,0
548647,1344,7,50,47,3,27,1,0
254305,3623,6,1146,1142,4,16,1,0
0,0,0,0,0,0,0,0,0
0,0,0,0,0,0,0,0,0
0,0,0,0,0,0,0,0,0
0,0,0,0,0,0,0,0,0
0,0,0,0,0,0,0,0,0
0,0,0,0,0,0,0,0,0
283823,804,4,52,44,8,14,1,0
211506,344,5,5,4,1,13,0,0
0,0,0,0,0,0,0,0,0
0,0,0,0,0,0,0,0,0
0,0,0,0,0,0,0,0,0
0,0,0,0,0,0,0,0,0
90294,1584,1,740,735,5,0,1,0
28525,44,0,4,3,1,0,0,0
0,0,0,0,0,0,0,0,0
0,0,0,0,0,0,0,0,0
0,0,0,0,0,0,0,0,0
0,0,0,0,0,0,0,0,0
0,0,0,0,0,0,0,0,0
277880,1035,3,254,249,5,8,1,0
67393,340,2,117,117,0,1,0,0
0,0,0,0,0,0,0,0,0
195126,1299,11,39,7,32,3,1,0
0,0,0,0,0,0,0,0,0
56081,565,6,113,110,3,0,1,0
23304,366,2,75,55,20,1,1,0
158185,2152,6,644,637,7,1,1,0
0,0,0,0,0,0,0,0,0
0,0,0,0,0,0,0,0,0
0,0,0,0,0,0,0,0,0
0,0,0,0,0,0,0,0,0
0,0,0,0,0,0,0,0,0
0,0,0,0,0,0,0,0,0
0,0,0,0,0,0,0,0,0
450608,629,5,24,20,4,4,1,0
451697,479,7,21,17,4,2,1,0
92997,1852,8,369,310,59,17,1,0
44213,840,4,232,206,26,14,1,0
0,0,0,0,0,0,0,0,0
73423,452,11,82,82,0,8,1,0
0,0,0,0,0,0,0,0,0
394122,1167,2,163,44,119,2,1,0
41028,495,5,131,127,4,4,1,0
52054,719,1,64,26,38,0,1,0
186732,1576,7,149,143,6,10,1,0
0,0,0,0,0,0,0,0,0
43232,363,0,42,38,4,0,0,0
8044,44,0,3,3,0,0,0,0
0,0,0,0,0,0,0,0,0
930819,1189,14,204,187,17,4,1,0
0,0,0,0,0,0,0,0,0
0,0,0,0,0,0,0,0,0
82341,1014,5,286,285,1,3,0,0
0,0,0,0,0,0,0,0,0
0,0,0,0,0,0,0,0,0
241460,1169,8,224,212,12,13,1,0
0,0,0,0,0,0,0,0,0
39934,400,6,43,4,39,14,1,0
947111,2366,10,370,255,115,36,1,0
0,0,0,0,0,0,0,0,0
1235684,4377,13,725,619,106,22,1,1
17670,97,4,4,0,4,3,1,0
0,0,0,0,0,0,0,0,0
190585,1613,16,110,14,96,4,1,0
21965,33,0,1,1,0,0,1,0
712223,1791,2,114,107,7,1,1,0
64341,549,12,58,57,1,8,0,0
30505,289,5,42,42,0,3,0,0
3697,70,2,3,2,1,0,1,0
81639,445,4,74,73,1,3,1,0
0,0,0,0,0,0,0,0,0
408906,3295,3,247,225,22,3,1,0
0,0,0,0,0,0,0,0,0
46522,629,3,89,82,7,16,1,0
0,0,0,0,0,0,0,0,0
39612,465,6,98,91,7,5,1,0
223446,1861,4,169,142,27,8,1,0
185276,1322,4,124,96,28,15,1,0
0,0,0,0,0,0,0,0,0
555757,4156,6,377,375,2,10,1,0
469395,613,8,45,43,2,9,1,0
113652,1112,11,179,177,2,46,1,0
13250,29,1,0,0,0,0,1,0
252432,3156,12,515,496,19,12,0,0
0,0,0,0,0,0,0,0,0
199183,1892,11,287,209,78,12,1,0
505252,387,3,32,9,23,0,1,0
1453558,769,9,115,103,12,0,1,0
9265,91,5,7,4,3,0,0,0
34573,532,5,80,80,0,2,1,0
102359,876,6,76,75,1,15,1,0
0,0,0,0,0,0,0,0,0
6997,84,3,2,2,0,0,1,0
276521,1691,2,248,180,68,3,0,0
0,0,0,0,0,0,0,0,0
446129,1270,8,223,203,20,21,1,1
22749,37,0,2,1,1,0,1,0
113652,787,14,81,76,5,6,1,0
66805,329,14,42,41,1,8,0,0
498834,1706,5,177,172,5,20,1,0
484036,958,3,10,7,3,8,1,0
50966,779,2,146,146,0,3,1,0
9681,173,1,34,34,0,0,1,0
0,0,0,0,0,0,0,0,0
405247,1517,7,274,257,17,9,0,0
0,0,0,0,0,0,0,0,0
0,0,0,0,0,0,0,0,0
189116,1516,3,293,233,60,4,1,0
0,0,0,0,0,0,0,0,0
24420,269,2,3,1,2,2,1,0
0,0,0,0,0,0,0,0,0
0,0,0,0,0,0,0,0,0
58824,934,5,333,313,20,1,1,0
0,0,0,0,0,0,0,0,0
826898,5290,13,519,505,14,125,1,0
0,0,0,0,0,0,0,0,0
19313,337,1,133,132,1,0,1,0
0,0,0,0,0,0,0,0,0
0,0,0,0,0,0,0,0,0
0,0,0,0,0,0,0,0,0
0,0,0,0,0,0,0,0,0
0,0,0,0,0,0,0,0,0
245426,588,2,48,42,6,1,1,0
17640,105,2,3,0,3,4,0,0
53506,669,4,89,73,16,1,0,0
81427,874,5,185,168,17,2,1,0
25687,279,4,62,58,4,0,1,0
0,0,0,0,0,0,0,0,0
68066,431,1,54,51,3,1,1,0
74496,657,1,47,42,5,1,1,0
1066537,3531,10,402,390,12,4,1,0
402960,1625,10,251,239,12,4,1,0
553044,2101,11,498,488,10,10,1,0
520623,1783,13,400,390,10,10,1,0
0,0,0,0,0,0,0,0,0
0,0,0,0,0,0,0,0,0
167981,2843,4,463,250,213,8,0,0
48126,373,9,57,57,0,0,1,0
419501,1656,12,164,138,26,7,1,0
0,0,0,0,0,0,0,0,0
0,0,0,0,0,0,0,0,0
43797,382,7,55,19,36,0,1,0
776030,2596,18,391,12,379,29,1,0
53175,831,2,11,2,9,1,0,0
126644,576,10,44,34,10,6,1,0
0,0,0,0,0,0,0,0,0
0,0,0,0,0,0,0,0,0
0,0,0,0,0,0,0,0,0
1077136,1280,8,136,82,54,17,1,0
49323,138,5,7,6,1,8,0,0
0,0,0,0,0,0,0,0,0
17858,307,0,56,55,1,0,0,0
0,0,0,0,0,0,0,0,0
0,0,0,0,0,0,0,0,0
133860,942,1,138,136,2,7,0,0
84697,545,9,50,50,0,0,0,0
0,0,0,0,0,0,0,0,0
717267,3413,5,229,210,19,6,1,0
0,0,0,0,0,0,0,0,0
319294,1543,11,588,571,17,12,1,0
0,0,0,0,0,0,0,0,0
0,0,0,0,0,0,0,0,0
6155,92,0,5,5,0,0,0,0
0,0,0,0,0,0,0,0,0
1724,53,0,14,0,14,0,0,0
0,0,0,0,0,0,0,0,0
0,0,0,0,0,0,0,0,0
253309,815,5,48,47,1,0,1,0
0,0,0,0,0,0,0,0,0
0,0,0,0,0,0,0,0,0
66877,773,7,182,175,7,5,1,0
30814,438,13,29,22,7,2,1,0
19375,197,13,25,22,3,2,1,0
0,0,0,0,0,0,0,0,0
43592,481,7,123,108,15,11,1,0
164102,1997,9,333,326,7,3,1,0
214770,1995,8,358,344,14,7,1,0
21861,125,7,5,5,0,0,0,0
22958,191,6,25,22,3,0,1,0
0,0,0,0,0,0,0,0,0
188802,1795,11,522,517,5,10,1,0
0,0,0,0,0,0,0,0,0
0,0,0,0,0,0,0,0,0
4499,56,1,9,7,2,0,0,0
284367,2028,8,336,326,10,2,1,0
16349,249,6,45,31,14,0,1,0
69769,568,5,21,12,9,1,1,0
72294,267,4,50,50,0,0,1,0
36738,282,6,36,36,0,3,1,0
24563,315,10,27,10,17,2,1,0
12253,135,9,17,11,6,0,1,0
0,0,0,0,0,0,0,0,0
399643,1979,14,343,210,133,5,1,0
116987,200,8,23,3,20,2,1,0
106960,1478,5,435,408,27,8,1,0
205092,115,3,0,0,0,0,0,0
0,0,0,0,0,0,0,0,0
0,0,0,0,0,0,0,0,0
106947,1069,7,133,128,5,16,1,0
0,0,0,0,0,0,0,0,0
0,0,0,0,0,0,0,0,0
146662,1056,7,152,115,37,7,1,0
51818,451,7,23,23,0,1,0,0
166592,1398,14,186,180,6,12,1,0
0,0,0,0,0,0,0,0,0
233081,1521,7,219,195,24,11,1,0
469427,1596,11,189,157,32,31,1,0
0,0,0,0,0,0,0,0,0
0,0,0,0,0,0,0,0,0
0,0,0,0,0,0,0,0,0
54268,513,5,66,66,0,1,1,0
0,0,0,0,0,0,0,0,0
29032,549,2,123,112,11,0,0,0
10639,153,2,25,25,0,0,0,0
94682,1221,5,242,232,10,4,1,0
0,0,0,0,0,0,0,0,0
0,0,0,0,0,0,0,0,0
0,0,0,0,0,0,0,0,0
187288,1090,10,213,19,194,3,1,0
64547,105,2,5,5,0,2,1,0
16916,190,1,5,0,5,0,0,0
307681,1844,12,455,430,25,22,1,0
162004,1143,5,195,190,5,1,1,0
0,0,0,0,0,0,0,0,0
0,0,0,0,0,0,0,0,0
204732,1780,12,264,210,54,5,1,0
0,0,0,0,0,0,0,0,0
399445,1182,13,106,100,6,29,1,0
0,0,0,0,0,0,0,0,0
3117827,2566,7,442,324,118,17,1,0
21990,35,0,1,1,0,0,1,0
0,0,0,0,0,0,0,0,0
441856,1517,8,126,104,22,24,1,0
3807377,358,8,36,26,10,5,1,0
26020,596,3,146,144,2,0,1,0
0,0,0,0,0,0,0,0,0
0,0,0,0,0,0,0,0,0
867532,910,10,120,112,8,15,1,0
0,0,0,0,0,0,0,0,0
608634,1146,2,91,82,9,5,0,0
338193,2515,7,388,371,17,3,1,0
356989,1654,4,87,81,6,5,1,0
0,0,0,0,0,0,0,0,0
13412,176,9,21,21,0,0,0,0
0,0,0,0,0,0,0,0,0
76316,527,1,112,107,5,0,0,0
0,0,0,0,0,0,0,0,0
250465,814,8,110,15,95,5,1,0
0,0,0,0,0,0,0,0,0
78429,932,7,159,148,11,8,1,0
3133,77,0,29,13,16,0,0,0
425451,1785,3,163,17,146,11,0,0
536195,4615,2,604,598,6,21,0,0
16752,316,3,67,61,6,4,1,0
52254,268,4,32,27,5,7,1,0
770972,5137,8,506,494,12,63,1,0
160088,1956,5,364,359,5,6,1,0
0,0,0,0,0,0,0,0,0
785280,1513,5,59,40,19,2,0,0
16086,89,1,8,5,3,1,0,0
0,0,0,0,0,0,0,0,0
1678,61,0,0,0,0,0,1,0
830182,1971,1,121,104,17,0,1,0
317094,66,0,6,5,1,0,1,0
28595,45,0,4,1,3,0,0,0
288401,3343,4,465,407,58,1,1,0
60041,629,5,25,16,9,0,1,0
0,0,0,0,0,0,0,0,0
0,0,0,0,0,0,0,0,0
46158,564,11,89,82,7,5,1,0
0,0,0,0,0,0,0,0,0
18761,545,4,130,127,3,4,1,0
596742,5331,6,1551,1503,48,1,0,0
0,0,0,0,0,0,0,0,0
0,0,0,0,0,0,0,0,0
0,0,0,0,0,0,0,0,0
0,0,0,0,0,0,0,0,0
21933,35,0,1,1,0,0,1,0
11978,141,0,49,48,1,0,1,0
13319,222,4,44,39,5,1,1,0
0,0,0,0,0,0,0,0,0
39945,612,6,89,87,2,0,1,0
0,0,0,0,0,0,0,0,0
0,0,0,0,0,0,0,0,0
22494,39,0,3,1,2,0,1,0
1037107,2835,14,348,319,29,23,1,1
61893,368,6,52,16,36,1,0,0
0,0,0,0,0,0,0,0,0
87225,946,11,98,67,31,13,1,0
64044,595,9,76,63,13,9,1,0
119592,1173,4,353,244,109,3,1,0
19510,156,1,6,4,2,1,0,0
344915,3846,6,1142,1142,0,2,1,0
74215,1928,2,568,568,0,1,1,0
0,0,0,0,0,0,0,0,0
0,0,0,0,0,0,0,0,0
355963,1599,3,185,167,18,2,1,0
0,0,0,0,0,0,0,0,0
108743,1457,6,341,291,50,0,1,0
26324,327,5,66,63,3,0,1,0
51065,530,11,46,45,1,1,1,0
37731,362,6,43,41,2,4,1,0
21321,236,6,37,35,2,6,1,0
44075,642,12,115,108,7,3,1,0
0,0,0,0,0,0,0,0,0
277421,5335,4,511,510,1,0,1,0
0,0,0,0,0,0,0,0,0
180392,531,9,70,69,1,0,1,0
40717,525,11,84,71,13,0,1,0
0,0,0,0,0,0,0,0,0
167354,668,5,40,19,21,15,1,0
81633,513,3,65,59,6,11,1,0
0,0,0,0,0,0,0,0,0
188460,2777,12,526,523,3,3,1,0
158529,1366,6,288,231,57,16,1,0
97289,739,6,218,207,11,16,1,0
45036,560,4,116,113,3,3,1,0
22390,228,4,47,44,3,3,1,0
0,0,0,0,0,0,0,0,0
416165,857,4,200,196,4,1,1,0
87770,760,5,166,157,9,6,1,0
303568,2330,11,319,274,45,9,1,0
98126,506,8,69,69,0,4,1,0
264933,2701,1,335,146,189,3,0,0
30231,722,2,194,194,0,0,0,0
0,0,0,0,0,0,0,0,0
0,0,0,0,0,0,0,0,0
0,0,0,0,0,0,0,0,0
0,0,0,0,0,0,0,0,0
192846,2434,6,607,572,35,12,1,0
1700224,10297,8,830,822,8,400,1,0
178851,1486,7,284,276,8,44,1,0
29043,252,6,18,16,2,7,1,0
0,0,0,0,0,0,0,0,0
0,0,0,0,0,0,0,0,0
1049666,3307,4,143,129,14,0,1,0
428131,1533,10,132,122,10,13,1,0
0,0,0,0,0,0,0,0,0
0,0,0,0,0,0,0,0,0
21031,270,0,57,38,19,0,1,0
144047,813,6,109,104,5,33,0,0
25818,139,4,8,8,0,1,0,0
613631,5597,13,1442,1403,39,13,1,0
0,0,0,0,0,0,0,0,0
114245,2507,3,653,652,1,0,0,0
12303,95,1,12,10,2,0,1,0
297265,1433,6,114,105,9,4,1,0
82659,1051,6,102,100,2,5,0,0
286440,3158,8,298,270,28,53,1,0
122567,712,7,96,82,14,4,1,0
325996,2272,8,287,235,52,32,1,0
371100,1362,7,134,126,8,0,1,0
72544,430,4,79,71,8,1,0,0
448855,4667,7,506,496,10,147,1,0
150473,827,6,96,91,5,20,1,0
12219,59,3,1,1,0,2,0,0
1059980,2469,12,391,382,9,7,1,0
174846,2159,3,536,507,29,3,1,0
71694,411,2,27,22,5,0,0,0
0,0,0,0,0,0,0,0,0
96389,420,3,31,24,7,5,1,0
341360,811,8,185,153,32,5,1,0
0,0,0,0,0,0,0,0,0
24751,385,3,74,56,18,0,1,0
22389,362,3,53,36,17,2,1,0
0,0,0,0,0,0,0,0,0
100831,2846,3,669,662,7,0,0,0
328216,2073,16,534,519,15,28,1,0
0,0,0,0,0,0,0,0,0
230546,344,0,17,11,6,0,1,0
469394,84,4,2,1,1,0,0,0
0,0,0,0,0,0,0,0,0
200157,1557,6,260,234,26,20,1,0
565786,5863,16,1738,1710,28,68,1,0
144043,558,4,30,20,10,4,1,0
79025,316,9,48,47,1,3,0,0
740537,3372,3,203,149,54,3,0,0
436797,2645,2,164,111,53,3,0,0
113210,635,9,141,138,3,14,1,0
3263,40,0,1,1,0,0,1,0
111920,638,4,17,15,2,0,0,0
38516,65,3,3,3,0,0,0,0
228748,2232,10,409,61,348,18,0,0
0,0,0,0,0,0,0,0,0
632280,1836,5,490,490,0,1,1,0
563888,1716,5,453,452,1,1,1,0
22013,34,0,1,1,0,0,1,0
0,0,0,0,0,0,0,0,0
891996,5092,2,17,9,8,0,1,0
0,0,0,0,0,0,0,0,0
0,0,0,0,0,0,0,0,0
389,7,0,0,0,0,0,0,0
575423,3169,16,446,413,33,20,1,0
381381,1366,16,222,196,26,10,1,0
158815,2466,8,664,663,1,2,1,0
0,0,0,0,0,0,0,0,0
0,0,0,0,0,0,0,0,0
0,0,0,0,0,0,0,0,0
0,0,0,0,0,0,0,0,0
93396,537,7,107,78,29,7,1,0
0,0,0,0,0,0,0,0,0
95897,1148,10,40,17,23,15,0,0
0,0,0,0,0,0,0,0,0
0,0,0,0,0,0,0,0,0
1062333,3691,3,393,179,214,20,1,0
107308,260,4,41,31,10,5,1,0
0,0,0,0,0,0,0,0,0
190627,1110,10,244,230,14,11,1,0
0,0,0,0,0,0,0,0,0
0,0,0,0,0,0,0,0,0
0,0,0,0,0,0,0,0,0
585432,2975,4,294,232,62,23,1,0
66250,459,2,70,68,2,10,1,0
282743,785,6,105,69,36,17,1,0
33128,303,7,32,4,28,5,1,0
0,0,0,0,0,0,0,0,0
98461,723,9,49,47,2,3,0,0
223541,708,5,108,72,36,5,0,0
0,0,0,0,0,0,0,0,0
232251,1385,8,221,188,33,23,1,0
0,0,0,0,0,0,0,0,0
0,0,0,0,0,0,0,0,0
219560,202,7,13,11,2,7,1,0
0,0,0,0,0,0,0,0,0
3748073,2036,1,84,81,3,0,1,0
69147,330,2,17,12,5,2,1,0
131676,1401,3,113,107,6,9,0,0
238508,1153,3,112,101,11,5,1,0
1052568,3975,1,215,190,25,0,1,0
0,0,0,0,0,0,0,0,0
0,0,0,0,0,0,0,0,0
8759,70,6,3,2,1,0,0,0
43047,334,4,39,38,1,0,0,0
0,0,0,0,0,0,0,0,0
104948,1808,2,428,414,14,37,1,0
0,0,0,0,0,0,0,0,0
461767,2512,14,452,350,102,32,1,0
0,0,0,0,0,0,0,0,0
40362,491,5,77,74,3,9,1,0
27028,453,4,6,0,6,2,0,0
405360,1759,7,162,141,21,37,1,0
405358,1758,7,162,141,21,37,1,0
0,0,0,0,0,0,0,0,0
0,0,0,0,0,0,0,0,0
230000,828,12,55,37,18,14,1,0
78099,1446,1,319,227,92,0,0,0
44932,96,4,6,4,2,3,0,0
437491,4685,5,460,194,266,19,1,0
0,0,0,0,0,0,0,0,0
0,0,0,0,0,0,0,0,0
28339,45,0,4,1,3,0,0,0
0,0,0,0,0,0,0,0,0
0,0,0,0,0,0,0,0,0
158629,1312,10,224,200,24,12,1,0
177914,1275,7,101,99,2,26,1,0
64059,476,7,75,70,5,0,1,0
0,0,0,0,0,0,0,0,0
0,0,0,0,0,0,0,0,0
141301,1147,6,209,195,14,5,1,0
29896,299,6,49,39,10,1,1,0
50244,596,11,93,58,35,5,1,0
0,0,0,0,0,0,0,0,0
0,0,0,0,0,0,0,0,0
0,0,0,0,0,0,0,0,0
4121069,32214,8,3326,1808,1518,7,0,0
107944,724,14,132,111,21,4,1,0
0,0,0,0,0,0,0,0,0
0,0,0,0,0,0,0,0,0
242829,922,0,186,146,40,3,1,0
0,0,0,0,0,0,0,0,0
171871,803,10,71,37,34,5,1,0
219570,1423,11,156,147,9,16,1,0
0,0,0,0,0,0,0,0,0
0,0,0,0,0,0,0,0,0
592702,11028,8,1781,1472,309,9,1,0
34117,402,8,21,15,6,0,1,0
0,0,0,0,0,0,0,0,0
0,0,0,0,0,0,0,0,0
648438,2856,5,180,168,12,1,1,0
48266,696,8,76,48,28,6,1,0
0,0,0,0,0,0,0,0,0
408458,1373,4,210,158,52,6,1,0
0,0,0,0,0,0,0,0,0
588118,400,2,68,67,1,3,1,0
0,0,0,0,0,0,0,0,0
0,0,0,0,0,0,0,0,0
226309,1457,5,596,594,2,13,1,0
183499,621,3,84,29,55,19,1,0
0,0,0,0,0,0,0,0,0
0,0,0,0,0,0,0,0,0
49612,307,3,23,23,0,16,1,0
25388,344,3,86,83,3,7,1,0
0,0,0,0,0,0,0,0,0
126545,1201,8,382,360,22,13,1,0
74483,304,3,24,24,0,16,1,0
0,0,0,0,0,0,0,0,0
296084,2611,7,569,451,118,1,1,0
6871,63,6,4,4,0,2,0,0
53169,637,4,166,135,31,0,0,0
248411,372,5,42,36,6,59,1,0
257989,389,6,33,27,6,61,1,0
0,0,0,0,0,0,0,0,0
0,0,0,0,0,0,0,0,0
167708,383,7,79,59,20,9,1,0
122152,1367,3,232,20,212,0,1,0
84659,107,1,3,3,0,0,0,0
136387,433,3,43,39,4,0,1,0
24991,168,7,44,30,14,3,1,0
182106,2555,6,567,493,74,17,1,0
37068,533,5,109,103,6,0,1,0
255694,824,0,227,214,13,0,0,0
0,0,0,0,0,0,0,0,0
112022,459,4,80,71,9,1,1,0
1175624,5051,15,294,288,6,5,1,0
3785,73,0,13,10,3,0,1,0
203736,797,7,10,4,6,5,1,0
0,0,0,0,0,0,0,0,0
55564,738,7,217,193,24,0,1,0
424795,2809,9,467,436,31,60,1,0
182458,1096,7,182,164,18,13,1,0
59641,685,2,179,161,18,0,0,0
382880,2742,9,173,48,125,4,1,0
337799,2092,8,168,158,10,0,1,0
0,0,0,0,0,0,0,0,0
376359,3284,7,222,99,123,4,1,0
0,0,0,0,0,0,0,0,0
0,0,0,0,0,0,0,0,0
0,0,0,0,0,0,0,0,0
616195,3537,5,361,311,50,90,1,0
0,0,0,0,0,0,0,0,0
0,0,0,0,0,0,0,0,0
0,0,0,0,0,0,0,0,0
123626,824,10,43,1,42,1,0,0
0,0,0,0,0,0,0,0,0
22996,37,0,2,1,1,0,1,0
0,0,0,0,0,0,0,0,0
0,0,0,0,0,0,0,0,0
0,0,0,0,0,0,0,0,0
107445,943,5,173,31,142,2,1,0
89407,257,0,48,24,24,0,1,1
256824,1594,14,397,387,10,7,1,1
79263,1034,4,180,150,30,7,1,0
37682,419,4,102,95,7,7,1,0
4974796,37771,9,3368,1870,1498,15,1,0
47106,132,8,3,0,3,0,1,0
25859,392,4,75,11,64,0,1,0
18109,325,4,75,71,4,0,1,0
36956,277,4,9,6,3,0,1,0
0,0,0,0,0,0,0,0,0
0,0,0,0,0,0,0,0,0
0,0,0,0,0,0,0,0,0
10315,185,0,21,21,0,0,1,0
5237,120,0,19,19,0,0,1,0
416749,2748,2,97,88,9,0,1,0
0,0,0,0,0,0,0,0,0
0,0,0,0,0,0,0,0,0
0,0,0,0,0,0,0,0,0
34460,51,3,7,5,2,0,1,0
37333,713,3,280,280,0,6,1,0
0,0,0,0,0,0,0,0,0
0,0,0,0,0,0,0,0,0
0,0,0,0,0,0,0,0,0
275603,1375,12,318,306,12,11,1,0
378533,1383,8,213,185,28,14,1,0
0,0,0,0,0,0,0,0,0
0,0,0,0,0,0,0,0,0
286280,993,5,113,104,9,12,1,0
170257,1223,11,99,96,3,12,1,0
431913,1839,14,185,174,11,8,1,0
374813,1808,9,102,23,79,52,1,0
0,0,0,0,0,0,0,0,0
706982,1250,13,130,91,39,4,1,0
0,0,0,0,0,0,0,0,0
0,0,0,0,0,0,0,0,0
210466,1790,12,288,150,138,7,0,0
384576,831,10,83,72,11,14,1,0
21778,33,0,1,1,0,0,1,0
54385,1055,1,238,233,5,8,0,0
0,0,0,0,0,0,0,0,0
0,0,0,0,0,0,0,0,0
87913,380,11,20,20,0,3,1,0
28716,368,6,10,10,0,22,0,0
20623,195,4,16,10,6,3,0,0
0,0,0,0,0,0,0,0,0
286891,521,1,19,13,6,1,1,0
128918,835,6,138,133,5,13,1,0
0,0,0,0,0,0,0,0,0
0,0,0,0,0,0,0,0,0
0,0,0,0,0,0,0,0,0
0,0,0,0,0,0,0,0,0
204163,1057,6,269,263,6,19,1,1
429179,2973,6,601,590,11,8,1,0
22816,37,0,2,1,1,0,1,0
191511,1071,4,158,130,28,5,1,0
0,0,0,0,0,0,0,0,0
0,0,0,0,0,0,0,0,0
0,0,0,0,0,0,0,0,0
0,0,0,0,0,0,0,0,0
0,0,0,0,0,0,0,0,0
215731,419,7,65,7,58,4,1,0
0,0,0,0,0,0,0,0,0
0,0,0,0,0,0,0,0,0
0,0,0,0,0,0,0,0,0
83177,925,6,120,108,12,2,1,0
17595,118,4,5,5,0,3,0,0
20576,345,4,69,68,1,0,0,0
0,0,0,0,0,0,0,0,0
22330,476,0,141,141,0,5,1,0
9871,173,0,28,28,0,6,1,0
0,0,0,0,0,0,0,0,0
33825,394,6,106,94,12,3,1,0
24195,37,0,2,1,1,0,1,0
480295,2569,10,398,199,199,21,1,0
454502,1573,17,273,252,21,19,1,0
158658,1665,11,126,118,8,5,1,0
0,0,0,0,0,0,0,0,0
92467,1041,2,60,33,27,2,1,0
0,0,0,0,0,0,0,0,0
0,0,0,0,0,0,0,0,0
0,0,0,0,0,0,0,0,0
0,0,0,0,0,0,0,0,0
502303,945,8,24,3,21,4,1,0
0,0,0,0,0,0,0,0,0
0,0,0,0,0,0,0,0,0
119699,418,3,111,107,4,11,1,0
0,0,0,0,0,0,0,0,0
101251,696,8,210,201,9,9,1,0
78020,669,11,85,9,76,4,1,0
11820,141,6,24,18,6,2,1,0
100262,565,10,142,135,7,7,0,0
257907,1051,4,65,42,23,3,1,0
0,0,0,0,0,0,0,0,0
0,0,0,0,0,0,0,0,0
59237,583,4,126,126,0,22,1,0
0,0,0,0,0,0,0,0,0
272095,2375,5,493,488,5,4,1,0
376400,1352,8,138,138,0,9,1,0
128229,998,6,128,113,15,11,0,0
325985,3871,19,928,905,23,19,1,0
0,0,0,0,0,0,0,0,0
0,0,0,0,0,0,0,0,0
97366,413,2,73,63,10,12,1,0
133653,431,7,58,48,10,0,1,0
0,0,0,0,0,0,0,0,0
161816,1214,4,236,197,39,11,1,0
180057,1873,2,266,252,14,8,1,0
329178,1183,7,216,204,12,8,1,0
0,0,0,0,0,0,0,0,0
198224,855,4,76,67,9,21,1,0
52017,619,10,23,20,3,7,0,0
0,0,0,0,0,0,0,0,0
0,0,0,0,0,0,0,0,0
0,0,0,0,0,0,0,0,0
243239,2181,9,427,411,16,6,1,0
349919,4731,13,122,114,8,7,1,0
348780,4718,13,122,114,8,7,1,0
0,0,0,0,0,0,0,0,0
0,0,0,0,0,0,0,0,0
84272,1544,3,645,639,6,7,1,0
12354,219,2,42,42,0,0,1,0
23020,36,0,2,1,1,0,1,0
486335,1895,5,82,74,8,9,1,0
400454,3052,4,392,348,44,22,1,0
436275,1665,8,120,118,2,33,1,0
45360,294,9,46,44,2,0,0,0
147827,679,6,139,135,4,6,1,0
0,0,0,0,0,0,0,0,0
0,0,0,0,0,0,0,0,0
143446,1548,13,239,230,9,0,1,0
0,0,0,0,0,0,0,0,0
0,0,0,0,0,0,0,0,0
213068,1992,9,252,217,35,38,1,0
193017,960,4,220,212,8,10,0,0
1451121,1207,2,152,14,138,5,1,0
383342,93,0,3,3,0,0,1,0
0,0,0,0,0,0,0,0,0
37454,542,0,161,154,7,2,1,0
88688,686,9,138,125,13,3,1,0
0,0,0,0,0,0,0,0,0
0,0,0,0,0,0,0,0,0
118910,1286,8,188,178,10,0,1,0
71954,372,7,96,86,10,0,1,0
56535,369,8,24,24,0,3,1,0
72855,711,2,229,156,73,0,1,0
306642,1143,8,176,155,21,2,1,0
491570,631,9,138,124,14,4,1,0
0,0,0,0,0,0,0,0,0
515982,4412,15,771,666,105,7,1,0
0,0,0,0,0,0,0,0,0
0,0,0,0,0,0,0,0,0
0,0,0,0,0,0,0,0,0
0,0,0,0,0,0,0,0,0
0,0,0,0,0,0,0,0,0
124887,598,11,42,29,13,4,1,0
589045,2913,7,702,376,326,9,1,0
0,0,0,0,0,0,0,0,0
7190,93,5,1,0,1,5,0,0
492697,4112,7,528,519,9,11,1,0
0,0,0,0,0,0,0,0,0
96273,1956,2,225,201,24,11,1,0
7772,87,6,2,1,1,3,0,0
369049,6839,1,1158,1048,110,0,0,0
0,0,0,0,0,0,0,0,0
364376,2664,11,529,509,20,17,1,1
101819,800,11,122,120,2,7,1,0
87792,630,8,101,99,2,3,1,0
274789,1512,5,151,134,17,12,1,0
0,0,0,0,0,0,0,0,0
192809,1444,4,204,188,16,0,0,0
267997,1033,3,74,49,25,16,1,0
53039,225,2,43,33,10,0,1,0
1099869,4920,18,457,441,16,21,1,0
664618,2817,14,347,334,13,19,1,0
21866,142,4,8,7,1,6,1,0
0,0,0,0,0,0,0,0,0
320381,2097,0,444,430,14,0,1,0
16575,358,1,95,85,10,0,1,0
12229,284,1,90,82,8,0,1,0
0,0,0,0,0,0,0,0,0
0,0,0,0,0,0,0,0,0
107184,800,4,119,45,74,0,1,0
259900,1995,9,484,478,6,8,1,0
81707,604,6,98,80,18,1,1,0
127943,2070,3,397,396,1,0,0,0
0,0,0,0,0,0,0,0,0
40037,686,5,123,118,5,24,1,0
0,0,0,0,0,0,0,0,0
0,0,0,0,0,0,0,0,0
0,0,0,0,0,0,0,0,0
0,0,0,0,0,0,0,0,0
0,0,0,0,0,0,0,0,0
0,0,0,0,0,0,0,0,0
100267,557,10,87,18,69,5,1,0
0,0,0,0,0,0,0,0,0
373335,3884,2,17,16,1,3,1,0
0,0,0,0,0,0,0,0,0
0,0,0,0,0,0,0,0,0
50104,481,6,116,116,0,6,1,0
25773,503,2,129,118,11,0,1,0
0,0,0,0,0,0,0,0,0
902366,2647,10,296,223,73,22,1,0
55167,487,3,130,125,5,2,1,0
38041,324,3,87,82,5,3,1,0
743256,2785,5,222,215,7,22,1,0
0,0,0,0,0,0,0,0,0
0,0,0,0,0,0,0,0,0
0,0,0,0,0,0,0,0,0
0,0,0,0,0,0,0,0,0
156951,521,1,96,74,22,10,0,0
74181,493,8,66,65,1,2,0,0
0,0,0,0,0,0,0,0,0
0,0,0,0,0,0,0,0,0
0,0,0,0,0,0,0,0,0
4353,55,0,4,0,4,0,0,0
0,0,0,0,0,0,0,0,0
0,0,0,0,0,0,0,0,0
551966,2278,10,354,204,150,119,1,0
258314,1566,5,96,92,4,3,1,0
56338,756,5,200,192,8,1,1,0
0,0,0,0,0,0,0,0,0
0,0,0,0,0,0,0,0,0
37031,488,6,128,121,7,0,1,0
659192,4982,17,505,496,9,24,1,0
155590,427,14,11,10,1,10,0,0
506542,5078,6,1539,967,572,9,1,0
9400,85,2,6,6,0,0,0,0
45584,652,2,118,105,13,6,1,0
114378,923,5,138,116,22,1,1,0
59038,625,8,100,16,84,2,1,0
173571,923,7,162,156,6,3,1,0
142031,548,6,41,35,6,0,1,0
0,0,0,0,0,0,0,0,0
219882,933,8,434,104,330,14,1,0
28066,581,6,137,129,8,9,1,0
48733,548,8,78,62,16,7,1,0
0,0,0,0,0,0,0,0,0
0,0,0,0,0,0,0,0,0
92430,1041,2,60,33,27,2,1,0
1906234,2021,15,309,276,33,19,1,0
393214,455,4,33,30,3,1,1,0
0,0,0,0,0,0,0,0,0
0,0,0,0,0,0,0,0,0
131256,516,12,64,60,4,48,0,0
0,0,0,0,0,0,0,0,0
70458,543,8,103,96,7,13,1,0
47202,247,8,45,40,5,11,1,0
237758,1746,8,326,326,0,8,1,0
346689,683,2,35,25,10,0,1,0
0,0,0,0,0,0,0,0,0
42459,567,4,165,164,1,0,1,0
0,0,0,0,0,0,0,0,0
22857,292,0,84,62,22,0,1,0
205184,1157,12,208,198,10,3,1,0
0,0,0,0,0,0,0,0,0
642452,1034,1,134,116,18,3,0,0
430068,2357,5,173,165,8,121,1,0
151698,1072,0,69,65,4,1,0,0
21972,35,0,1,1,0,0,1,0
365430,3075,10,994,989,5,505,1,0
0,0,0,0,0,0,0,0,0
0,0,0,0,0,0,0,0,0
0,0,0,0,0,0,0,0,0
94876,414,6,76,74,2,1,1,0
0,0,0,0,0,0,0,0,0
0,0,0,0,0,0,0,0,0
58861,299,2,23,12,11,5,1,0
0,0,0,0,0,0,0,0,0
0,0,0,0,0,0,0,0,0
468069,368,4,79,62,17,2,1,0
34029,400,7,71,18,53,4,1,0
187401,1990,7,373,362,11,0,0,0
0,0,0,0,0,0,0,0,0
200269,967,4,117,103,14,12,1,0
0,0,0,0,0,0,0,0,0
21230,271,4,53,22,31,0,1,0
0,0,0,0,0,0,0,0,0
200162,1185,6,134,127,7,1,0,0
0,0,0,0,0,0,0,0,0
0,0,0,0,0,0,0,0,0
0,0,0,0,0,0,0,0,0
87008,811,8,248,245,3,8,1,0
5223,25,3,5,5,0,0,0,0
5357,79,1,6,6,0,0,0,0
0,0,0,0,0,0,0,0,0
448584,909,2,37,3,34,7,0,0
0,0,0,0,0,0,0,0,0
722252,5331,2,1202,1124,78,0,1,0
24335,205,0,5,5,0,0,1,0
12106,177,5,27,18,9,0,1,0
0,0,0,0,0,0,0,0,0
0,0,0,0,0,0,0,0,0
0,0,0,0,0,0,0,0,0
218394,1111,6,304,285,19,4,1,0
79339,338,8,63,61,2,0,1,0
0,0,0,0,0,0,0,0,0
110134,1344,4,221,186,35,7,1,0
186603,814,2,68,22,46,0,1,0
27622,42,0,2,1,1,0,0,0
35596,655,4,178,148,30,0,1,0
0,0,0,0,0,0,0,0,0
455971,1223,8,152,148,4,8,0,0
0,0,0,0,0,0,0,0,0
124515,1628,6,215,206,9,2,1,0
2884,41,4,3,3,0,0,1,0
124875,976,2,128,125,3,11,1,1
140889,689,11,76,72,4,10,1,0
77556,324,11,56,53,3,1,1,0
3613,19,1,0,0,0,0,0,0
411630,2459,4,296,259,37,11,0,0
275880,1573,4,237,203,34,2,0,0
321764,2053,8,194,178,16,13,1,0
1087082,797,6,11,2,9,3,1,0
63332,526,10,89,67,22,0,0,0
141540,1243,6,206,138,68,10,0,0
17497,168,5,52,50,2,2,0,0
0,0,0,0,0,0,0,0,0
53028,756,2,168,158,10,10,0,0
0,0,0,0,0,0,0,0,0
0,0,0,0,0,0,0,0,0
0,0,0,0,0,0,0,0,0
163317,1555,10,472,454,18,16,0,0
125216,922,9,385,370,15,3,0,0
70851,1065,7,242,208,34,0,1,1
0,0,0,0,0,0,0,0,0
665032,2048,7,167,149,18,13,1,0
47854,402,2,30,9,21,20,1,0
0,0,0,0,0,0,0,0,0
0,0,0,0,0,0,0,0,0
294307,963,8,87,86,1,6,1,0
0,0,0,0,0,0,0,0,0
0,0,0,0,0,0,0,0,0
0,0,0,0,0,0,0,0,0
0,0,0,0,0,0,0,0,0
0,0,0,0,0,0,0,0,0
0,0,0,0,0,0,0,0,0
0,0,0,0,0,0,0,0,0
45198,496,8,118,117,1,12,1,0
8530,143,2,27,27,0,2,1,0
0,0,0,0,0,0,0,0,0
106321,899,8,166,122,44,0,1,0
181618,794,8,121,110,11,10,1,0
0,0,0,0,0,0,0,0,0
81060,806,2,295,286,9,4,1,0
336755,1242,6,67,61,6,20,1,0
46996,192,6,43,43,0,8,1,0
28332,379,6,102,79,23,0,1,0
339045,1110,0,110,98,12,52,1,0
102723,803,11,154,146,8,10,0,0
3688,45,5,3,2,1,0,0,0
269256,1347,10,171,155,16,9,1,0
0,0,0,0,0,0,0,0,0
0,0,0,0,0,0,0,0,0
172376,934,7,247,239,8,4,0,0
119408,3590,3,1207,1205,2,0,1,0
15368,257,0,60,53,7,0,1,0
0,0,0,0,0,0,0,0,0
87781,1296,7,218,211,7,14,1,0
22555,217,4,19,16,3,1,1,0
0,0,0,0,0,0,0,0,0
11196,134,1,11,6,5,1,1,0
0,0,0,0,0,0,0,0,0
45706,475,3,111,110,1,1,1,0
0,0,0,0,0,0,0,0,0
174547,913,4,118,92,26,1,1,0
0,0,0,0,0,0,0,0,0
282458,508,8,58,53,5,10,1,0
67066,510,10,108,106,2,2,1,0
6349,62,6,3,2,1,0,0,0
0,0,0,0,0,0,0,0,0
0,0,0,0,0,0,0,0,0
0,0,0,0,0,0,0,0,0
884361,2643,5,577,568,9,1,0,0
834481,2221,3,221,211,10,2,1,0
31865,249,3,22,21,1,9,1,0
0,0,0,0,0,0,0,0,0
0,0,0,0,0,0,0,0,0
21078,230,3,38,36,2,0,0,0
89302,566,4,124,120,4,2,1,0
8653,30,1,0,0,0,0,0,0
0,0,0,0,0,0,0,0,0
238247,1473,4,326,320,6,6,1,0
0,0,0,0,0,0,0,0,0
289034,4755,1,884,148,736,10,1,0
198380,958,9,141,116,25,1,0,0
7864,75,6,4,3,1,0,0,0
0,0,0,0,0,0,0,0,0
2422,60,0,7,4,3,0,0,0
463639,1621,10,285,217,68,7,1,0
56949,736,4,115,105,10,1,1,0
0,0,0,0,0,0,0,0,0
0,0,0,0,0,0,0,0,0
0,0,0,0,0,0,0,0,0
1098655,8755,5,3268,3255,13,7,1,0
0,0,0,0,0,0,0,0,0
34355,108,5,5,3,2,0,0,0
0,0,0,0,0,0,0,0,0
0,0,0,0,0,0,0,0,0
0,0,0,0,0,0,0,0,0
0,0,0,0,0,0,0,0,0
12076,362,1,92,92,0,1,1,0
0,0,0,0,0,0,0,0,0
79570,537,5,107,105,2,10,1,0
13127,196,4,61,59,2,2,1,0
0,0,0,0,0,0,0,0,0
0,0,0,0,0,0,0,0,0
550254,1790,3,265,133,132,32,1,0
78228,101,1,9,6,3,2,0,0
27961,213,6,19,17,2,2,1,0
0,0,0,0,0,0,0,0,0
466437,1529,8,146,146,0,8,1,0
0,0,0,0,0,0,0,0,0
305815,1344,7,464,458,6,2,1,0
0,0,0,0,0,0,0,0,0
0,0,0,0,0,0,0,0,0
0,0,0,0,0,0,0,0,0
0,0,0,0,0,0,0,0,0
58322,797,1,149,119,30,12,1,0
0,0,0,0,0,0,0,0,0
122639,1698,5,344,321,23,4,0,0
0,0,0,0,0,0,0,0,0
0,0,0,0,0,0,0,0,0
0,0,0,0,0,0,0,0,0
117995,1402,5,346,346,0,1,0,0
9586,117,5,10,10,0,1,0,0
0,0,0,0,0,0,0,0,0
245385,319,3,36,33,3,0,1,0
155195,747,0,97,82,15,4,1,0
0,0,0,0,0,0,0,0,0
0,0,0,0,0,0,0,0,0
177258,1448,7,360,353,7,2,1,0
61246,649,8,117,102,15,3,1,0
42537,382,10,81,79,2,2,1,0
587487,1997,6,356,337,19,50,1,0
206480,1184,12,232,223,9,29,0,0
3738,75,2,8,8,0,0,1,0
0,0,0,0,0,0,0,0,0
0,0,0,0,0,0,0,0,0
13084,186,3,32,32,0,0,0,0
970621,4352,5,849,761,88,30,1,0
0,0,0,0,0,0,0,0,0
131976,1514,9,100,94,6,5,0,0
169751,999,9,244,237,7,17,1,0
0,0,0,0,0,0,0,0,0
0,0,0,0,0,0,0,0,0
104372,380,8,44,31,13,1,1,0
0,0,0,0,0,0,0,0,0
0,0,0,0,0,0,0,0,0
0,0,0,0,0,0,0,0,0
753845,1575,6,253,231,22,3,1,0
0,0,0,0,0,0,0,0,0
0,0,0,0,0,0,0,0,0
0,0,0,0,0,0,0,0,0
853558,4334,7,613,606,7,10,1,0
0,0,0,0,0,0,0,0,0
611,10,0,1,0,1,0,0,0
12390,150,3,21,15,6,0,0,0
0,0,0,0,0,0,0,0,0
160595,1696,8,282,246,36,12,1,0
80004,512,8,67,49,18,11,1,0
0,0,0,0,0,0,0,0,0
0,0,0,0,0,0,0,0,0
90172,665,6,126,121,5,3,1,0
39096,173,6,22,17,5,1,1,0
0,0,0,0,0,0,0,0,0
27955,42,0,2,1,1,0,0,0
2650312,13879,13,2737,2462,275,207,1,0
1417911,6458,13,2311,2236,75,12,1,0
0,0,0,0,0,0,0,0,0
96048,1104,2,464,405,59,0,0,0
35428,341,3,44,37,7,1,1,0
0,0,0,0,0,0,0,0,0
891469,4497,2,403,372,31,7,1,0
200879,641,15,73,69,4,3,1,0
0,0,0,0,0,0,0,0,0
110009,1507,6,335,192,143,48,1,0
95080,44,2,4,0,4,0,1,0
0,0,0,0,0,0,0,0,0
347882,1685,12,163,123,40,0,1,0
3272817,4540,8,392,378,14,40,1,0
1204517,959,11,87,82,5,74,1,0
1254883,1062,0,40,16,24,4,1,0
66388,245,0,46,39,7,0,1,1
129898,3126,2,1062,1060,2,24,1,0
0,0,0,0,0,0,0,0,0
732409,4213,6,142,113,29,126,1,0
5891,58,1,4,4,0,0,0,0
0,0,0,0,0,0,0,0,0
25368,237,0,88,88,0,2,1,0
0,0,0,0,0,0,0,0,0
0,0,0,0,0,0,0,0,0
198290,1771,12,358,197,161,61,1,0
0,0,0,0,0,0,0,0,0
0,0,0,0,0,0,0,0,0
154039,1643,6,325,232,93,2,1,0
0,0,0,0,0,0,0,0,0
0,0,0,0,0,0,0,0,0
144198,1924,2,366,304,62,3,1,0
44989,723,2,81,49,32,3,1,0
13851,109,1,12,11,1,3,0,0
0,0,0,0,0,0,0,0,0
263171,1768,8,83,78,5,1,1,0
22780,356,2,52,46,6,4,1,0
0,0,0,0,0,0,0,0,0
0,0,0,0,0,0,0,0,0
105918,367,7,47,36,11,0,1,0
88466,287,7,39,30,9,1,1,0
0,0,0,0,0,0,0,0,0
21946,35,0,1,1,0,0,1,0
242368,931,12,46,39,7,0,1,0
59916,621,9,142,136,6,0,0,0
13762,233,9,59,53,6,0,0,0
8717,80,1,32,31,1,0,1,0
0,0,0,0,0,0,0,0,0
370051,422,4,51,42,9,1,1,0
0,0,0,0,0,0,0,0,0
69859,680,3,97,94,3,8,1,0
0,0,0,0,0,0,0,0,0
55288,678,4,177,175,2,7,1,0
12666,87,2,4,4,0,0,1,0
0,0,0,0,0,0,0,0,0
1671471,1171,6,97,89,8,12,1,0
0,0,0,0,0,0,0,0,0
0,0,0,0,0,0,0,0,0
4481,119,0,5,5,0,0,1,0
0,0,0,0,0,0,0,0,0
0,0,0,0,0,0,0,0,0
187700,920,3,138,131,7,7,1,0
0,0,0,0,0,0,0,0,0
0,0,0,0,0,0,0,0,0
135223,1008,12,226,216,10,12,1,0
22385,33,0,1,1,0,0,1,0
0,0,0,0,0,0,0,0,0
89666,1001,13,203,190,13,13,1,0
0,0,0,0,0,0,0,0,0
0,0,0,0,0,0,0,0,0
0,0,0,0,0,0,0,0,0
0,0,0,0,0,0,0,0,0
237132,1819,2,218,215,3,9,1,0
58397,485,5,130,109,21,1,1,0
115720,1595,7,312,306,6,2,1,0
19589,357,9,69,67,2,2,1,0
17069,274,10,64,63,1,4,1,0
50272,329,7,30,21,9,0,1,0
793669,1604,3,148,130,18,2,1,0
24342,331,5,48,32,16,1,0,0
191816,1563,6,347,317,30,18,0,0
193374,1566,6,347,317,30,17,0,0
414318,3844,6,301,300,1,1,1,0
133743,956,6,83,82,1,0,1,0
0,0,0,0,0,0,0,0,0
123717,751,7,118,110,8,36,1,0
123681,751,7,118,111,7,36,1,0
0,0,0,0,0,0,0,0,0
50330,263,7,32,16,16,3,1,0
0,0,0,0,0,0,0,0,0
43042,337,2,57,0,57,10,0,0
217959,2671,8,394,363,31,0,0,0
101160,961,6,153,136,17,5,1,0
52296,504,5,65,54,11,6,1,0
139231,637,9,104,93,11,9,1,0
0,0,0,0,0,0,0,0,0
0,0,0,0,0,0,0,0,0
92319,984,8,199,198,1,9,0,0
177844,582,9,68,60,8,32,0,0
10475,123,2,17,6,11,1,1,0
323766,1174,8,114,105,9,2,1,0
0,0,0,0,0,0,0,0,0
0,0,0,0,0,0,0,0,0
0,0,0,0,0,0,0,0,0
1023552,635,7,126,118,8,6,1,0
978937,363,7,99,95,4,4,1,0
0,0,0,0,0,0,0,0,0
167858,1015,1,273,265,8,0,0,0
104351,551,6,105,99,6,9,1,0
0,0,0,0,0,0,0,0,0
104123,1054,11,240,231,9,11,1,0
66180,806,11,178,172,6,11,1,0
153840,1120,9,178,161,17,2,1,0
0,0,0,0,0,0,0,0,0
0,0,0,0,0,0,0,0,0
0,0,0,0,0,0,0,0,0
70226,491,12,107,101,6,6,0,0
23953,177,3,38,38,0,3,1,0
0,0,0,0,0,0,0,0,0
184759,2950,8,584,580,4,20,1,0
72831,1272,6,430,424,6,16,1,0
346299,4613,13,897,675,222,9,1,0
305889,4846,6,1431,1240,191,5,0,0
139997,4313,7,1553,1540,13,6,0,0
723259,4113,6,775,765,10,13,1,0
511813,1280,4,225,215,10,11,1,0
0,0,0,0,0,0,0,0,0
0,0,0,0,0,0,0,0,0
0,0,0,0,0,0,0,0,0
0,0,0,0,0,0,0,0,0
0,0,0,0,0,0,0,0,0
301024,2811,13,309,302,7,11,1,0
0,0,0,0,0,0,0,0,0
37276,542,2,110,107,3,1,0,0
117255,1400,7,438,418,20,2,1,0
0,0,0,0,0,0,0,0,0
119343,1388,2,30,19,11,3,1,0
310184,2122,9,354,325,29,112,1,0
273414,1167,8,168,160,8,5,1,0
195756,1517,12,373,30,343,12,1,0
153034,2330,10,146,133,13,2,1,0
23281,286,1,6,4,2,0,1,0
190045,686,10,81,56,25,15,0,0
0,0,0,0,0,0,0,0,0
135831,1709,14,258,249,9,6,0,0
0,0,0,0,0,0,0,0,0
444079,2876,12,520,486,34,33,1,0
0,0,0,0,0,0,0,0,0
0,0,0,0,0,0,0,0,0
380761,5991,2,709,709,0,0,1,0
0,0,0,0,0,0,0,0,0
86761,221,8,11,10,1,0,1,0
57442,467,10,162,162,0,0,1,0
0,0,0,0,0,0,0,0,0
20355,438,4,153,142,11,0,1,0
0,0,0,0,0,0,0,0,0
0,0,0,0,0,0,0,0,0
30421,269,7,29,22,7,1,1,0
14763,76,8,1,1,0,1,0,0
0,0,0,0,0,0,0,0,0
159620,575,4,95,95,0,2,0,0
0,0,0,0,0,0,0,0,0
0,0,0,0,0,0,0,0,0
0,0,0,0,0,0,0,0,0
0,0,0,0,0,0,0,0,0
32220,360,5,68,60,8,3,1,0
223233,1765,11,238,207,31,0,1,0
6098,70,0,5,0,5,1,0,0
0,0,0,0,0,0,0,0,0
0,0,0,0,0,0,0,0,0
142286,1689,6,422,420,2,3,1,0
0,0,0,0,0,0,0,0,0
0,0,0,0,0,0,0,0,0
522875,2199,10,178,105,73,23,1,0
68526,690,0,83,77,6,9,1,0
27876,42,0,2,1,1,0,0,0
437860,1549,16,218,189,29,10,1,0
1634,11,0,1,1,0,0,0,0
0,0,0,0,0,0,0,0,0
0,0,0,0,0,0,0,0,0
0,0,0,0,0,0,0,0,0
0,0,0,0,0,0,0,0,0
0,0,0,0,0,0,0,0,0
0,0,0,0,0,0,0,0,0
456094,1826,14,223,209,14,13,1,0
0,0,0,0,0,0,0,0,0
0,0,0,0,0,0,0,0,0
0,0,0,0,0,0,0,0,0
0,0,0,0,0,0,0,0,0
2015,39,0,11,6,5,0,1,0
630285,2210,17,257,233,24,29,1,0
221394,1059,14,148,130,18,9,1,0
0,0,0,0,0,0,0,0,0
51847,322,5,78,75,3,0,0,0
195236,1758,8,300,279,21,11,1,0
0,0,0,0,0,0,0,0,0
174484,276,7,38,37,1,8,1,0
144733,1753,6,135,130,5,9,1,0
15583,99,7,2,2,0,3,1,0
0,0,0,0,0,0,0,0,0
0,0,0,0,0,0,0,0,0
0,0,0,0,0,0,0,0,0
0,0,0,0,0,0,0,0,0
326323,1287,11,222,215,7,10,1,0
184876,1398,6,323,296,27,12,0,0
0,0,0,0,0,0,0,0,0
0,0,0,0,0,0,0,0,0
0,0,0,0,0,0,0,0,0
226265,1807,7,149,148,1,4,1,0
25235,153,2,5,2,3,2,0,0
125963,627,13,21,18,3,4,1,0
0,0,0,0,0,0,0,0,0
15249,198,4,33,32,1,1,1,0
4287,73,0,5,4,1,0,0,0
6082,131,0,5,4,1,1,0,0
575077,1690,10,138,57,81,40,0,0
0,0,0,0,0,0,0,0,0
0,0,0,0,0,0,0,0,0
0,0,0,0,0,0,0,0,0
0,0,0,0,0,0,0,0,0
0,0,0,0,0,0,0,0,0
0,0,0,0,0,0,0,0,0
137367,1949,3,353,350,3,6,1,0
0,0,0,0,0,0,0,0,0
6938,124,2,19,19,0,0,0,0
0,0,0,0,0,0,0,0,0
0,0,0,0,0,0,0,0,0
34486,396,7,145,145,0,0,1,0
114312,715,7,92,6,86,14,1,0
0,0,0,0,0,0,0,0,0
126567,550,10,76,67,9,7,1,0
376509,1802,5,212,189,23,3,1,0
376508,1802,5,212,193,19,3,1,0
0,0,0,0,0,0,0,0,0
0,0,0,0,0,0,0,0,0
0,0,0,0,0,0,0,0,0
0,0,0,0,0,0,0,0,0
105695,804,8,108,94,14,6,0,0
48218,461,8,29,25,4,8,1,0
0,0,0,0,0,0,0,0,0
484577,1052,0,136,117,19,3,0,0
222203,2524,4,560,408,152,10,0,0
0,0,0,0,0,0,0,0,0
0,0,0,0,0,0,0,0,0
105521,678,4,7,6,1,0,0,0
23038,40,0,3,1,2,0,1,0
67344,395,8,125,108,17,3,1,0
0,0,0,0,0,0,0,0,0
36743,144,1,21,9,12,3,1,0
276443,779,1,153,124,29,0,1,0
210960,88,1,3,3,0,0,1,0
0,0,0,0,0,0,0,0,0
4704,74,2,12,12,0,0,0,0
0,0,0,0,0,0,0,0,0
0,0,0,0,0,0,0,0,0
75010,1035,4,180,162,18,1,1,0
867401,924,8,200,182,18,3,1,0
0,0,0,0,0,0,0,0,0
197285,1680,5,368,332,36,0,1,0
64906,562,6,115,113,2,23,1,0
108230,414,4,45,45,0,10,1,0
211244,1306,4,120,113,7,1,1,0
116060,366,7,40,25,15,6,1,0
0,0,0,0,0,0,0,0,0
89065,67,0,9,4,5,5,0,0
48245,422,7,59,45,14,4,1,0
98634,759,8,113,103,10,0,1,0
7096,146,1,48,24,24,0,1,0
128609,1046,15,202,139,63,11,1,0
0,0,0,0,0,0,0,0,0
166179,1206,9,191,180,11,34,1,0
168417,1215,9,191,180,11,34,1,0
0,0,0,0,0,0,0,0,0
25313,40,0,3,2,1,0,1,0
284325,2676,8,321,299,22,24,1,0
0,0,0,0,0,0,0,0,0
383483,4138,16,1048,1020,28,12,1,0
222950,2296,12,668,653,15,15,1,0
0,0,0,0,0,0,0,0,0
0,0,0,0,0,0,0,0,0
0,0,0,0,0,0,0,0,0
23529,38,0,2,1,1,0,1,0
169988,2056,10,617,595,22,2,1,0
172963,2297,11,510,463,47,1,1,0
79971,1037,6,188,160,28,20,1,0
42566,575,6,87,61,26,0,1,0
106528,1315,9,303,271,32,4,1,0
400918,808,4,108,93,15,0,1,0
0,0,0,0,0,0,0,0,0
0,0,0,0,0,0,0,0,0
169999,475,8,17,11,6,0,0,0
0,0,0,0,0,0,0,0,0
199650,809,4,124,113,11,3,1,0
0,0,0,0,0,0,0,0,0
86086,416,8,45,19,26,9,1,0
229733,1227,6,250,183,67,17,1,0
0,0,0,0,0,0,0,0,0
0,0,0,0,0,0,0,0,0
0,0,0,0,0,0,0,0,0
290883,3067,12,449,367,82,16,1,0
0,0,0,0,0,0,0,0,0
356930,3154,11,593,592,1,0,1,0
355710,3171,12,577,576,1,10,1,0
184790,1215,8,199,8,191,36,1,0
0,0,0,0,0,0,0,0,0
0,0,0,0,0,0,0,0,0
63162,482,8,94,23,71,2,1,0
0,0,0,0,0,0,0,0,0
0,0,0,0,0,0,0,0,0
65128,798,5,220,6,214,5,1,0
249806,274,10,27,23,4,20,1,0
19585,254,5,34,34,0,1,1,0
14722,189,5,35,35,0,1,1,0
0,0,0,0,0,0,0,0,0
26249,494,3,110,103,7,0,0,0
10632,143,3,24,24,0,0,0,0
0,0,0,0,0,0,0,0,0
251186,1799,6,310,271,39,15,0,0
80789,905,2,294,288,6,0,1,0
17640,239,2,75,73,2,0,1,0
0,0,0,0,0,0,0,0,0
0,0,0,0,0,0,0,0,0
343755,2407,17,527,36,491,31,1,0
20322,404,3,4,2,2,2,1,0
0,0,0,0,0,0,0,0,0
88823,1495,3,342,341,1,5,1,0
575798,2194,8,159,143,16,8,1,0
28774,597,2,298,294,4,0,0,0
251673,1132,15,154,130,24,5,1,0
104922,651,0,29,18,11,0,1,0
0,0,0,0,0,0,0,0,0
4859,48,3,1,1,0,0,0,0
41717,276,1,16,15,1,8,1,0
0,0,0,0,0,0,0,0,0
208549,1256,13,91,76,15,6,1,0
242905,1295,7,156,146,10,32,0,0
36202,522,1,180,179,1,0,1,0
6130,69,1,8,8,0,1,1,0
643551,1876,7,83,82,1,11,1,0
270781,1320,9,259,246,13,25,1,0
18456,299,1,33,29,4,0,0,0
64437,702,5,139,126,13,15,1,0
0,0,0,0,0,0,0,0,0
0,0,0,0,0,0,0,0,0
9532,78,3,7,0,7,2,0,0
0,0,0,0,0,0,0,0,0
0,0,0,0,0,0,0,0,0
443881,3047,8,312,291,21,9,1,0
58294,130,5,3,1,2,3,0,0
36385,168,8,6,6,0,8,0,0
9342,57,0,12,6,6,0,0,0
100353,745,5,132,27,105,1,1,0
0,0,0,0,0,0,0,0,0
77322,1378,1,267,266,1,0,1,0
0,0,0,0,0,0,0,0,0
169977,1030,3,50,50,0,82,1,0
184783,762,18,67,58,9,5,1,0
242160,1516,8,298,276,22,9,1,0
59287,793,3,171,140,31,0,1,0
116695,1150,7,157,155,2,1,1,0
27151,262,6,25,23,2,1,1,0
0,0,0,0,0,0,0,0,0
0,0,0,0,0,0,0,0,0
86242,972,2,241,239,2,1,1,0
0,0,0,0,0,0,0,0,0
680667,1314,11,171,152,19,23,1,0
0,0,0,0,0,0,0,0,0
0,0,0,0,0,0,0,0,0
22297,33,0,1,1,0,0,1,0
97338,817,12,55,39,16,5,1,0
164452,489,8,67,39,28,3,0,0
0,0,0,0,0,0,0,0,0
0,0,0,0,0,0,0,0,0
491623,919,14,157,142,15,9,0,0
5326,88,4,15,15,0,0,0,0
13344,253,1,27,24,3,0,0,0
0,0,0,0,0,0,0,0,0
222789,1387,10,238,222,16,2,1,0
0,0,0,0,0,0,0,0,0
413999,859,5,64,48,16,64,1,0
172624,1402,6,110,99,11,9,1,0
77998,469,8,56,48,8,9,1,0
422929,4558,7,431,412,19,5,1,0
75278,594,11,127,122,5,10,1,0
306026,615,7,106,79,27,1,1,0
182246,2020,3,203,178,25,10,0,0
359567,3765,8,860,856,4,63,1,0
157963,1804,8,679,675,4,2,1,0
10461,215,2,18,12,6,0,0,0
0,0,0,0,0,0,0,0,0
128411,800,9,170,4,166,0,1,0
0,0,0,0,0,0,0,0,0
816620,4006,6,474,437,37,11,1,0
177376,1761,3,237,202,35,11,1,0
69065,139,1,5,5,0,5,0,0
0,0,0,0,0,0,0,0,0
224649,1196,12,52,48,4,13,1,0
8131,73,2,10,7,3,0,0,0
114572,615,8,72,71,1,8,1,0
84410,1105,3,121,121,0,6,0,0
36961,600,0,62,60,2,1,0,0
198016,1034,10,193,174,19,12,1,0
154445,819,10,178,161,17,11,1,0
251833,2981,8,415,380,35,7,1,0
0,0,0,0,0,0,0,0,0
53195,282,4,21,19,2,4,1,0
0,0,0,0,0,0,0,0,0
376172,2130,16,245,240,5,14,1,0
32566,208,5,2,2,0,6,0,0
183635,775,6,137,132,5,11,1,0
23962,181,0,20,20,0,0,0,0
0,0,0,0,0,0,0,0,0
1556112,5567,6,274,262,12,3,1,0
407914,3609,4,128,124,4,2,1,0
0,0,0,0,0,0,0,0,0
211008,1646,7,384,265,119,3,1,0
448599,5242,3,1163,1108,55,18,1,0
123160,231,6,8,7,1,7,1,0
0,0,0,0,0,0,0,0,0
155137,713,11,73,73,0,6,0,0
96073,1197,3,242,240,2,0,1,0
0,0,0,0,0,0,0,0,0
454605,826,6,108,84,24,6,1,0
0,0,0,0,0,0,0,0,0
0,0,0,0,0,0,0,0,0
503406,4348,16,1132,1102,30,2,1,0
451272,3808,16,1106,1084,22,2,1,0
210271,666,12,77,75,2,25,1,0
0,0,0,0,0,0,0,0,0
0,0,0,0,0,0,0,0,0
13606,378,0,67,67,0,0,1,0
190409,1414,8,684,684,0,8,1,0
248242,945,3,111,109,2,6,1,0
34294,218,11,9,5,4,0,1,0
0,0,0,0,0,0,0,0,0
0,0,0,0,0,0,0,0,0
145037,1689,6,353,342,11,0,1,0
0,0,0,0,0,0,0,0,0
0,0,0,0,0,0,0,0,0
0,0,0,0,0,0,0,0,0
263795,2172,1,310,275,35,23,0,0
134978,1229,2,151,100,51,24,0,0
67112,399,2,113,113,0,0,1,0
7285,125,4,20,13,7,0,0,0
0,0,0,0,0,0,0,0,0
130083,1756,10,305,303,2,0,0,0
66721,672,9,174,172,2,4,0,0
219623,13374,8,298,298,0,1,1,0
0,0,0,0,0,0,0,0,0
0,0,0,0,0,0,0,0,0
27603,42,0,2,1,1,0,0,0
41130,270,1,49,49,0,0,0,0
36560,758,5,283,280,3,0,1,0
0,0,0,0,0,0,0,0,0
326672,2008,11,281,253,28,13,1,0
536002,4296,5,772,681,91,10,0,0
193635,966,4,105,90,15,0,1,0
165715,2003,8,332,262,70,6,1,0
0,0,0,0,0,0,0,0,0
63840,737,5,164,154,10,3,1,0
0,0,0,0,0,0,0,0,0
579595,2645,1,782,683,99,14,1,0
163401,330,1,74,24,50,0,1,0
0,0,0,0,0,0,0,0,0
0,0,0,0,0,0,0,0,0
105854,711,8,142,121,21,12,1,0
233986,3302,13,484,468,16,69,1,0
0,0,0,0,0,0,0,0,0
18594,228,9,55,52,3,0,1,0
74647,551,9,111,111,0,7,1,0
44160,229,9,29,29,0,4,1,0
0,0,0,0,0,0,0,0,0
0,0,0,0,0,0,0,0,0
84883,249,6,28,26,2,7,1,0
25109,325,4,61,44,17,0,1,0
74889,738,2,47,21,26,9,1,0
0,0,0,0,0,0,0,0,0
181061,5886,2,265,194,71,32,1,0
0,0,0,0,0,0,0,0,0
0,0,0,0,0,0,0,0,0
264498,670,15,22,9,13,6,1,0
189698,715,13,143,128,15,4,1,0
0,0,0,0,0,0,0,0,0
213659,4372,2,732,725,7,31,1,0
0,0,0,0,0,0,0,0,0
105831,1079,4,99,50,49,0,1,0
0,0,0,0,0,0,0,0,0
252853,1062,6,127,112,15,23,1,0
0,0,0,0,0,0,0,0,0
6871,68,4,6,5,1,0,1,0
572335,1077,9,194,183,11,13,1,0
140971,1327,6,201,187,14,5,1,0
0,0,0,0,0,0,0,0,0
0,0,0,0,0,0,0,0,0
0,0,0,0,0,0,0,0,0
242661,1548,2,241,229,12,3,1,0
374124,3223,7,700,634,66,32,1,0
85871,491,10,33,28,5,12,0,0
83210,682,8,76,72,4,5,1,0
21854,33,0,1,1,0,0,1,0
46832,380,4,39,33,6,4,1,0
121943,401,10,40,13,27,2,1,0
0,0,0,0,0,0,0,0,0
0,0,0,0,0,0,0,0,0
0,0,0,0,0,0,0,0,0
0,0,0,0,0,0,0,0,0
0,0,0,0,0,0,0,0,0
0,0,0,0,0,0,0,0,0
0,0,0,0,0,0,0,0,0
0,0,0,0,0,0,0,0,0
124464,1093,11,294,284,10,17,1,0
28182,564,2,253,228,25,0,1,0
78132,938,2,174,148,26,2,1,0
107015,76,2,2,2,0,0,0,0
0,0,0,0,0,0,0,0,0
134958,1444,7,186,173,13,5,1,0
0,0,0,0,0,0,0,0,0
0,0,0,0,0,0,0,0,0
402551,3729,11,332,252,80,6,0,0
53473,530,3,30,29,1,11,1,0
0,0,0,0,0,0,0,0,0
0,0,0,0,0,0,0,0,0
0,0,0,0,0,0,0,0,0
127293,1661,7,293,285,8,1,1,0
12123,166,4,30,24,6,0,0,0
4785,24,0,2,2,0,0,0,0
0,0,0,0,0,0,0,0,0
33192,182,1,57,57,0,1,1,0
32576,128,1,9,9,0,1,1,0
0,0,0,0,0,0,0,0,0
449271,3267,5,525,508,17,13,1,0
0,0,0,0,0,0,0,0,0
461496,1959,3,167,143,24,3,1,0
0,0,0,0,0,0,0,0,0
0,0,0,0,0,0,0,0,0
278551,997,8,149,118,31,3,0,0
17392,107,4,5,2,3,3,0,0
0,0,0,0,0,0,0,0,0
0,0,0,0,0,0,0,0,0
0,0,0,0,0,0,0,0,0
372511,1894,10,462,442,20,6,1,0
37428,541,2,71,65,6,0,1,0
18234,196,4,14,13,1,3,1,0
0,0,0,0,0,0,0,0,0
0,0,0,0,0,0,0,0,0
191998,1436,15,82,73,9,2,1,0
99331,379,14,36,31,5,0,1,0
197835,2236,7,390,333,57,12,1,0
32239,229,8,13,13,0,11,1,0
510180,2676,11,201,190,11,3,1,0
0,0,0,0,0,0,0,0,0
52219,143,2,108,107,1,0,0,0
0,0,0,0,0,0,0,0,0
37558,396,3,34,14,20,0,0,0
0,0,0,0,0,0,0,0,0
0,0,0,0,0,0,0,0,0
0,0,0,0,0,0,0,0,0
186915,2652,6,339,311,28,1,1,0
0,0,0,0,0,0,0,0,0
527963,2814,2,4,2,2,2,1,0
100351,673,7,144,116,28,2,0,0
63960,216,7,48,42,6,2,0,0
0,0,0,0,0,0,0,0,0
0,0,0,0,0,0,0,0,0
0,0,0,0,0,0,0,0,0
158115,834,9,306,304,2,0,1,0
161666,783,9,294,292,2,1,1,0
139755,996,11,128,118,10,5,1,0
84534,200,1,10,7,3,1,1,0
126970,1827,5,208,198,10,1,1,0
0,0,0,0,0,0,0,0,0
0,0,0,0,0,0,0,0,0
366785,2047,10,573,566,7,23,1,0
321622,2862,6,220,172,48,4,1,0
136774,1683,7,354,78,276,2,0,0
0,0,0,0,0,0,0,0,0
0,0,0,0,0,0,0,0,0
0,0,0,0,0,0,0,0,0
17914,201,1,3,0,3,0,0,0
4596,53,1,6,6,0,2,1,0
22323,39,0,3,1,2,0,1,0
0,0,0,0,0,0,0,0,0
0,0,0,0,0,0,0,0,0
0,0,0,0,0,0,0,0,0
194845,918,7,157,147,10,12,1,0
194894,918,7,157,148,9,12,1,0
32845,297,1,124,122,2,8,1,0
980496,978,6,167,158,9,8,1,0
22004,194,2,28,28,0,0,0,0
4476,73,2,7,7,0,0,0,0
266307,2269,7,579,557,22,27,1,0
216574,2384,7,534,518,16,30,1,0
74858,228,4,30,2,28,0,1,0
553,9,0,1,1,0,0,0,0
391308,469,10,48,41,7,0,0,0
0,0,0,0,0,0,0,0,0
787425,1243,3,226,183,43,3,1,0
121248,154,3,7,6,1,2,0,0
102404,598,11,96,3,93,9,1,0
0,0,0,0,0,0,0,0,0
0,0,0,0,0,0,0,0,0
75330,353,11,33,33,0,2,1,0
91588,2020,7,305,300,5,1,1,0
22631,483,7,53,48,5,1,1,0
258189,1601,10,332,308,24,59,1,0
0,0,0,0,0,0,0,0,0
18640,301,5,146,144,2,0,1,0
254524,2063,1,478,471,7,6,1,0
69497,513,3,67,55,12,6,1,0
39947,445,5,118,108,10,11,1,0
54862,497,9,117,108,9,0,1,0
0,0,0,0,0,0,0,0,0
608027,7183,16,1492,1478,14,39,0,0
0,0,0,0,0,0,0,0,0
0,0,0,0,0,0,0,0,0
146697,2085,13,488,462,26,31,1,0
65698,738,13,138,128,10,26,1,0
40220,1133,2,87,83,4,6,1,0
0,0,0,0,0,0,0,0,0
110900,437,10,53,52,1,3,0,0
0,0,0,0,0,0,0,0,0
83952,578,8,64,54,10,20,0,0
35285,408,1,43,38,5,17,1,0
328483,1309,13,180,166,14,4,1,0
275468,1161,12,178,158,20,4,1,0
0,0,0,0,0,0,0,0,0
32889,597,2,124,121,3,0,1,0
0,0,0,0,0,0,0,0,0
0,0,0,0,0,0,0,0,0
116622,1588,7,462,460,2,10,1,0
0,0,0,0,0,0,0,0,0
0,0,0,0,0,0,0,0,0
72551,647,5,92,91,1,6,1,0
68687,340,6,30,27,3,1,1,0
558854,2955,8,524,264,260,3,1,0
126930,178,0,6,3,3,0,1,0
317785,1727,4,117,113,4,212,1,0
79441,171,5,6,5,1,9,0,0
962918,1777,5,89,79,10,12,1,0
44016,615,8,124,120,4,4,0,0
0,0,0,0,0,0,0,0,0
22042,35,0,1,1,0,0,1,0
0,0,0,0,0,0,0,0,0
79461,412,13,68,51,17,4,0,0
0,0,0,0,0,0,0,0,0
296035,1532,9,287,271,16,22,0,0
0,0,0,0,0,0,0,0,0
76372,706,12,43,43,0,3,1,0
844964,426,6,84,75,9,5,1,0
0,0,0,0,0,0,0,0,0
130139,684,5,101,78,23,1,0,0
0,0,0,0,0,0,0,0,0
0,0,0,0,0,0,0,0,0
164808,2313,3,414,358,56,0,1,0
0,0,0,0,0,0,0,0,0
113086,785,10,127,117,10,180,1,0
43535,645,5,106,83,23,1,1,0
1571595,16391,3,829,486,343,16,1,1
18643,222,5,24,23,1,0,1,0
10118,48,4,4,4,0,0,0,0
22530,37,0,2,1,1,0,1,0
0,0,0,0,0,0,0,0,0
0,0,0,0,0,0,0,0,0
0,0,0,0,0,0,0,0,0
0,0,0,0,0,0,0,0,0
0,0,0,0,0,0,0,0,0
65819,624,4,82,45,37,5,0,0
0,0,0,0,0,0,0,0,0
0,0,0,0,0,0,0,0,0
100922,846,3,134,119,15,6,1,0
498865,1052,6,102,86,16,8,1,0
559179,1063,8,110,100,10,12,0,0
0,0,0,0,0,0,0,0,0
0,0,0,0,0,0,0,0,0
0,0,0,0,0,0,0,0,0
34399,467,1,67,66,1,0,1,0
34399,467,1,67,67,0,0,1,0
0,0,0,0,0,0,0,0,0
516177,2876,4,341,326,15,4,1,0
220109,1807,5,223,216,7,6,1,0
184852,619,2,99,86,13,9,1,0
9165,111,1,19,17,2,1,0,0
235805,2240,7,359,332,27,4,1,0
0,0,0,0,0,0,0,0,0
0,0,0,0,0,0,0,0,0
168763,1354,3,87,78,9,3,1,0
0,0,0,0,0,0,0,0,0
0,0,0,0,0,0,0,0,0
41722,495,2,63,40,23,0,1,0
27563,486,2,132,129,3,0,0,0
6150,113,2,15,15,0,0,0,0
0,0,0,0,0,0,0,0,0
40882,284,8,44,37,7,1,1,0
6610,103,6,9,7,2,1,0,0
0,0,0,0,0,0,0,0,0
232147,2506,8,333,61,272,15,1,0
282786,839,5,76,55,21,7,1,0
43172,362,3,104,102,2,0,1,0
0,0,0,0,0,0,0,0,0
37381,305,2,43,25,18,2,1,0
11742,83,1,8,5,3,1,1,0
0,0,0,0,0,0,0,0,0
129078,1149,3,195,187,8,127,1,0
104554,808,3,184,178,6,127,1,0
0,0,0,0,0,0,0,0,0
0,0,0,0,0,0,0,0,0
0,0,0,0,0,0,0,0,0
279987,1501,16,229,216,13,3,1,0
25775,381,5,72,70,2,0,0,0
13858,204,6,27,27,0,3,0,0
0,0,0,0,0,0,0,0,0
594451,1629,10,178,163,15,2,1,0
0,0,0,0,0,0,0,0,0
9466,96,5,26,20,6,0,0,0
0,0,0,0,0,0,0,0,0
206285,656,1,45,35,10,0,1,0
14605,121,6,8,6,2,0,0,0
69038,906,1,268,243,25,1,0,0
593327,2282,5,314,300,14,23,1,0
72705,522,10,65,60,5,2,1,0
0,0,0,0,0,0,0,0,0
0,0,0,0,0,0,0,0,0
112272,1160,7,313,299,14,8,1,0
223824,1000,9,119,114,5,11,1,0
0,0,0,0,0,0,0,0,0
189992,966,10,156,145,11,5,1,0
0,0,0,0,0,0,0,0,0
71976,393,6,69,69,0,0,1,0
0,0,0,0,0,0,0,0,0
119972,470,11,99,99,0,9,1,0
0,0,0,0,0,0,0,0,0
180490,1136,9,183,177,6,10,1,0
126635,267,9,6,1,5,3,0,0
296804,2370,5,264,262,2,18,1,0
238263,1421,3,234,222,12,1,1,0
0,0,0,0,0,0,0,0,0
198364,2296,6,313,285,28,0,1,0
634180,2880,5,429,368,61,16,1,0
198009,1077,5,168,132,36,6,0,0
469932,926,10,51,36,15,18,0,0
211385,2671,12,339,328,11,2,1,0
25042,526,7,21,18,3,1,1,0
27170,382,3,42,38,4,1,1,0
60657,579,9,116,43,73,0,1,0
135750,935,11,198,161,37,2,1,0
52809,412,10,35,31,4,4,1,0
88470,259,11,4,4,0,4,1,0
0,0,0,0,0,0,0,0,0
0,0,0,0,0,0,0,0,0
0,0,0,0,0,0,0,0,0
145000,1379,13,345,341,4,4,1,0
0,0,0,0,0,0,0,0,0
0,0,0,0,0,0,0,0,0
301470,1903,9,410,38,372,14,1,0
485134,1788,8,348,319,29,23,1,0
41449,533,5,132,132,0,1,1,0
651558,3282,11,256,252,4,8,1,0
0,0,0,0,0,0,0,0,0
0,0,0,0,0,0,0,0,0
0,0,0,0,0,0,0,0,0
0,0,0,0,0,0,0,0,0
48390,533,5,27,16,11,0,1,0
0,0,0,0,0,0,0,0,0
0,0,0,0,0,0,0,0,0
23594,128,2,4,2,2,1,0,0
29428,206,2,7,2,5,1,0,0
0,0,0,0,0,0,0,0,0
85592,465,11,116,83,33,1,1,0
0,0,0,0,0,0,0,0,0
0,0,0,0,0,0,0,0,0
73346,278,2,30,11,19,1,1,0
70245,258,2,30,11,19,1,1,0
2845026,4402,3,150,122,28,0,1,0
19608,371,3,106,94,12,0,1,0
11096,243,2,70,60,10,0,1,0
0,0,0,0,0,0,0,0,0
0,0,0,0,0,0,0,0,0
71954,542,10,59,56,3,6,1,0
2702,54,0,12,6,6,0,0,0
0,0,0,0,0,0,0,0,0
75879,722,7,90,82,8,0,1,0
13817,150,6,22,15,7,0,1,0
490814,906,3,111,43,68,2,1,0
0,0,0,0,0,0,0,0,0
645041,1630,4,236,210,26,2,1,0
125658,700,16,79,64,15,2,1,0
10456,83,8,6,5,1,0,0,0
37217,478,0,27,27,0,1,1,0
0,0,0,0,0,0,0,0,0
97139,1350,2,155,132,23,3,0,0
42530,460,2,80,74,6,1,0,0
0,0,0,0,0,0,0,0,0
0,0,0,0,0,0,0,0,0
0,0,0,0,0,0,0,0,0
0,0,0,0,0,0,0,0,0
0,0,0,0,0,0,0,0,0
0,0,0,0,0,0,0,0,0
28425,45,0,4,1,3,0,0,0
0,0,0,0,0,0,0,0,0
0,0,0,0,0,0,0,0,0
73387,532,4,148,143,5,15,1,0
103120,787,9,210,198,12,13,1,0
0,0,0,0,0,0,0,0,0
6865,104,3,17,16,1,2,0,0
5929,100,3,15,14,1,2,0,0
26890,255,6,30,24,6,0,0,1
269190,583,1,49,2,47,0,0,0
23281,286,1,6,4,2,0,1,0
0,0,0,0,0,0,0,0,0
0,0,0,0,0,0,0,0,0
52877,373,2,50,48,2,4,1,0
127098,1036,4,192,129,63,16,0,0
0,0,0,0,0,0,0,0,0
161767,3058,2,907,901,6,10,1,0
73722,998,3,92,66,26,33,0,0
0,0,0,0,0,0,0,0,0
0,0,0,0,0,0,0,0,0
115329,908,11,158,144,14,2,1,0
74371,204,6,13,10,3,6,1,0
0,0,0,0,0,0,0,0,0
0,0,0,0,0,0,0,0,0
0,0,0,0,0,0,0,0,0
118997,1478,5,306,296,10,2,1,0
14543,242,0,57,36,21,0,1,0
0,0,0,0,0,0,0,0,0
0,0,0,0,0,0,0,0,0
0,0,0,0,0,0,0,0,0
0,0,0,0,0,0,0,0,0
44351,596,5,242,233,9,0,1,0
13858,196,4,46,35,11,0,1,0
23701,217,5,30,25,5,0,1,0
0,0,0,0,0,0,0,0,0
52414,92,3,8,6,2,0,0,0
0,0,0,0,0,0,0,0,0
1113476,2054,8,89,78,11,1,1,0
0,0,0,0,0,0,0,0,0
5553,99,0,24,24,0,0,1,0
25511,355,0,74,70,4,1,1,0
12166,174,2,32,29,3,4,1,0
0,0,0,0,0,0,0,0,0
0,0,0,0,0,0,0,0,0
0,0,0,0,0,0,0,0,0
83427,551,7,141,129,12,3,1,0
0,0,0,0,0,0,0,0,0
496003,3090,3,526,506,20,4,1,0
170366,1289,5,206,196,10,21,0,0
33062,734,3,243,239,4,3,1,0
146358,1371,9,191,178,13,19,1,0
1024631,2768,2,394,390,4,35,1,0
195265,1151,3,237,233,4,28,1,0
0,0,0,0,0,0,0,0,0
152034,486,1,40,28,12,11,0,0
5042,46,3,4,2,2,0,0,0
0,0,0,0,0,0,0,0,0
0,0,0,0,0,0,0,0,0
0,0,0,0,0,0,0,0,0
360053,2018,11,514,431,83,17,0,0
0,0,0,0,0,0,0,0,0
0,0,0,0,0,0,0,0,0
177569,1506,5,421,414,7,5,1,0
0,0,0,0,0,0,0,0,0
0,0,0,0,0,0,0,0,0
17046,285,0,18,15,3,1,1,0
303722,2811,12,632,615,17,45,0,0
146264,116,6,4,4,0,0,0,0
0,0,0,0,0,0,0,0,0
37683,471,9,74,58,16,4,0,0
190233,1520,10,335,171,164,9,1,0
0,0,0,0,0,0,0,0,0
290605,2006,7,177,145,32,25,1,0
46944,263,1,12,12,0,39,0,0
74806,613,6,51,1,50,1,1,0
0,0,0,0,0,0,0,0,0
11726,212,4,58,58,0,1,1,0
7733,88,4,9,9,0,1,1,0
241506,1529,13,230,170,60,10,1,0
504437,1218,0,111,106,5,8,1,0
90878,80,4,3,3,0,2,0,0
58831,473,5,63,59,4,1,1,0
45900,413,11,45,37,8,0,1,0
89838,2041,2,801,800,1,0,1,0
0,0,0,0,0,0,0,0,0
0,0,0,0,0,0,0,0,0
54598,662,8,64,60,4,0,1,0
145730,469,8,44,29,15,3,1,0
72040,471,2,91,89,2,10,1,0
0,0,0,0,0,0,0,0,0
0,0,0,0,0,0,0,0,0
226240,418,4,73,68,5,6,1,0
1006755,1609,11,414,388,26,3,0,0
0,0,0,0,0,0,0,0,0
277666,840,8,109,102,7,4,0,0
0,0,0,0,0,0,0,0,0
101700,880,8,133,128,5,0,1,0
15975,140,6,3,2,1,12,0,0
85824,1161,10,177,168,9,5,1,0
0,0,0,0,0,0,0,0,0
116881,1748,6,254,197,57,7,1,0
104765,914,5,284,281,3,123,1,0
234488,1149,11,134,119,15,6,1,0
49779,380,5,34,34,0,13,1,0
88011,1241,9,169,165,4,13,1,0
45224,1038,5,230,223,7,0,1,0
0,0,0,0,0,0,0,0,0
198987,1072,8,151,143,8,5,1,0
51021,202,3,28,28,0,3,1,0
83231,563,13,57,55,2,4,1,0
48687,361,4,57,47,10,0,1,0
77405,918,3,237,228,9,5,1,0
0,0,0,0,0,0,0,0,0
92551,701,3,173,132,41,22,1,0
47890,519,3,111,103,8,2,1,0
4675,45,0,1,1,0,0,0,0
183283,2080,3,372,336,36,1,1,0
0,0,0,0,0,0,0,0,0
49686,514,0,150,150,0,9,1,0
0,0,0,0,0,0,0,0,0
94264,711,11,52,34,18,0,1,0
4640,76,0,3,2,1,0,0,0
0,0,0,0,0,0,0,0,0
0,0,0,0,0,0,0,0,0
0,0,0,0,0,0,0,0,0
19402,218,8,24,24,0,4,1,0
582966,2749,10,88,68,20,4,1,0
71947,971,4,171,146,25,73,1,0
0,0,0,0,0,0,0,0,0
149228,990,3,81,55,26,13,1,0
149086,989,3,81,55,26,13,1,0
151440,791,5,179,0,179,8,0,0
0,0,0,0,0,0,0,0,0
173754,1148,9,128,104,24,11,1,0
23593,203,3,39,33,6,0,1,0
0,0,0,0,0,0,0,0,0
0,0,0,0,0,0,0,0,0
5663,85,2,19,19,0,0,0,0
75968,499,5,113,85,28,2,1,0
220771,3823,3,265,257,8,10,1,0
67578,1094,3,52,44,8,6,1,0
156250,960,14,175,162,13,12,0,0
66738,547,9,136,120,16,0,1,0
8536,68,6,3,2,1,0,0,0
0,0,0,0,0,0,0,0,0
0,0,0,0,0,0,0,0,0
0,0,0,0,0,0,0,0,0
0,0,0,0,0,0,0,0,0
97174,645,3,41,27,14,6,1,0
52727,401,2,39,35,4,0,1,0
321557,1296,8,214,197,17,68,1,0
448558,1789,9,108,102,6,67,1,0
0,0,0,0,0,0,0,0,0
0,0,0,0,0,0,0,0,0
0,0,0,0,0,0,0,0,0
6113,147,0,65,65,0,0,0,0
175176,1583,11,316,305,11,14,1,0
700612,1420,10,100,85,15,34,1,0
0,0,0,0,0,0,0,0,0
18703,86,7,9,9,0,0,0,0
138897,408,8,54,46,8,1,1,0
498224,748,5,10,8,2,2,1,0
0,0,0,0,0,0,0,0,0
0,0,0,0,0,0,0,0,0
83037,591,5,50,46,4,9,0,0
0,0,0,0,0,0,0,0,0
0,0,0,0,0,0,0,0,0
0,0,0,0,0,0,0,0,0
114864,807,1,122,115,7,16,1,0
32773,118,2,16,10,6,4,1,0
162503,2163,13,334,302,32,30,0,0
53471,505,11,114,96,18,7,0,0
0,0,0,0,0,0,0,0,0
405333,4868,6,335,324,11,48,1,0
392954,4861,6,282,268,14,37,1,0
395037,6161,5,585,560,25,464,1,0
227382,1297,1,329,323,6,16,1,0
0,0,0,0,0,0,0,0,0
0,0,0,0,0,0,0,0,0
0,0,0,0,0,0,0,0,0
370927,7722,7,1986,1972,14,13,0,0
217751,1856,14,243,233,10,6,1,0
0,0,0,0,0,0,0,0,0
0,0,0,0,0,0,0,0,0
1458,15,1,0,0,0,0,0,0
101516,1256,10,391,386,5,6,1,0
49597,734,8,189,184,5,6,1,0
0,0,0,0,0,0,0,0,0
171500,2513,8,252,220,32,4,0,0
345413,4763,6,975,958,17,4,1,0
128277,705,6,131,125,6,3,1,0
0,0,0,0,0,0,0,0,0
208709,1204,10,204,170,34,5,1,0
1109359,2484,7,320,293,27,3,1,0
0,0,0,0,0,0,0,0,0
57817,573,1,112,89,23,0,1,0
16315,207,1,38,32,6,0,1,0
357375,2288,3,719,714,5,1,1,0
32484,93,1,0,0,0,0,0,0
0,0,0,0,0,0,0,0,0
137869,808,7,115,100,15,1,1,0
58950,766,3,146,120,26,2,1,0
22810,285,4,74,70,4,0,1,0
22362,293,12,31,30,1,7,1,0
0,0,0,0,0,0,0,0,0
34939,248,5,47,4,43,5,1,0
32587,229,5,45,22,23,5,1,0
0,0,0,0,0,0,0,0,0
347636,2298,15,409,401,8,71,1,0
347409,2298,15,409,401,8,71,1,0
0,0,0,0,0,0,0,0,0
92430,1041,2,60,33,27,2,1,0
323534,2401,18,373,352,21,16,1,0
211908,1480,16,211,190,21,18,1,0
191830,918,9,162,150,12,9,1,0
0,0,0,0,0,0,0,0,0
60958,466,14,53,38,15,1,1,0
0,0,0,0,0,0,0,0,0
217391,489,8,26,20,6,7,1,0
0,0,0,0,0,0,0,0,0
0,0,0,0,0,0,0,0,0
522467,1781,11,336,291,45,28,1,0
0,0,0,0,0,0,0,0,0
33029,154,8,10,6,4,3,1,0
53567,728,4,176,176,0,0,1,0
1826,40,0,1,1,0,0,0,0
293988,769,12,98,95,3,1,1,0
429457,1488,5,128,117,11,2,0,0
39333,106,1,5,5,0,3,0,0
464195,4155,9,668,632,36,14,1,0
322417,1891,15,251,238,13,8,1,0
0,0,0,0,0,0,0,0,0
0,0,0,0,0,0,0,0,0
416923,1057,11,136,125,11,11,1,0
43244,433,4,92,90,2,8,1,0
22062,35,0,1,1,0,0,1,0
1910926,1871,13,503,404,99,31,1,0
0,0,0,0,0,0,0,0,0
538530,1582,12,252,245,7,0,1,0
57868,1412,3,303,296,7,0,1,0
368095,1596,4,140,95,45,4,1,0
101423,352,2,48,32,16,0,1,0
72179,220,2,31,25,6,0,1,0
0,0,0,0,0,0,0,0,0
73827,666,5,131,126,5,3,1,0
0,0,0,0,0,0,0,0,0
0,0,0,0,0,0,0,0,0
67550,523,2,111,110,1,2,1,0
62348,401,2,97,96,1,2,1,0
0,0,0,0,0,0,0,0,0
0,0,0,0,0,0,0,0,0
114293,645,12,59,55,4,3,0,0
19477,217,8,53,51,2,0,0,0
287048,4072,7,1598,1285,313,3,1,0
0,0,0,0,0,0,0,0,0
224375,1902,10,152,116,36,9,1,0
0,0,0,0,0,0,0,0,0
127738,3063,1,933,916,17,0,1,0
451960,1051,12,148,128,20,15,1,0
63653,1102,2,279,268,11,6,0,0
56011,989,2,263,256,7,6,0,0
0,0,0,0,0,0,0,0,0
304211,1151,5,66,64,2,2,1,0
0,0,0,0,0,0,0,0,0
80969,1041,9,218,213,5,18,1,0
56609,777,8,184,182,2,20,1,0
0,0,0,0,0,0,0,0,0
0,0,0,0,0,0,0,0,0
22043,35,0,1,1,0,0,1,0
30555,192,12,12,10,2,0,1,0
561509,2269,11,458,449,9,1,0,0
0,0,0,0,0,0,0,0,0
111187,302,10,39,0,39,19,1,0
0,0,0,0,0,0,0,0,0
114897,391,1,19,17,2,0,1,0
0,0,0,0,0,0,0,0,0
132441,3430,0,1078,1077,1,0,0,0
397708,1038,2,78,74,4,1,1,0
0,0,0,0,0,0,0,0,0
0,0,0,0,0,0,0,0,0
0,0,0,0,0,0,0,0,0
173,7,0,0,0,0,0,0,0
369924,1122,9,53,51,2,0,1,0
0,0,0,0,0,0,0,0,0
168213,932,7,76,63,13,1,0,0
0,0,0,0,0,0,0,0,0
0,0,0,0,0,0,0,0,0
85747,558,10,101,101,0,1,0,0
0,0,0,0,0,0,0,0,0
0,0,0,0,0,0,0,0,0
0,0,0,0,0,0,0,0,0
395203,1364,7,216,199,17,12,1,0
0,0,0,0,0,0,0,0,0
241368,1853,7,310,268,42,8,1,0
0,0,0,0,0,0,0,0,0
244661,2311,2,399,383,16,6,1,0
236346,4386,1,490,471,19,5,0,0
261207,1672,9,318,161,157,56,1,0
76960,620,13,137,80,57,2,0,0
43810,263,5,22,19,3,0,0,0
5237,21,0,5,5,0,0,0,0
0,0,0,0,0,0,0,0,0
0,0,0,0,0,0,0,0,0
285444,1468,2,204,128,76,18,1,0
169753,382,6,36,26,10,1,1,0
257917,2903,5,111,67,44,18,1,0
377468,1402,14,135,120,15,19,1,0
0,0,0,0,0,0,0,0,0
0,0,0,0,0,0,0,0,0
358021,1741,7,408,368,40,12,1,0
0,0,0,0,0,0,0,0,0
0,0,0,0,0,0,0,0,0
16706,197,0,43,37,6,0,1,0
0,0,0,0,0,0,0,0,0
0,0,0,0,0,0,0,0,0
144843,479,3,26,25,1,0,1,0
631837,1513,18,144,133,11,5,1,0
631837,1513,18,144,133,11,5,1,0
0,0,0,0,0,0,0,0,0
0,0,0,0,0,0,0,0,0
226033,1550,1,232,231,1,9,1,0
143617,693,1,124,123,1,9,1,0
0,0,0,0,0,0,0,0,0
0,0,0,0,0,0,0,0,0
0,0,0,0,0,0,0,0,0
40160,566,6,133,125,8,4,1,0
12971,151,6,24,24,0,1,1,0
52527,509,6,36,33,3,10,1,0
0,0,0,0,0,0,0,0,0
187550,789,10,91,80,11,2,1,0
0,0,0,0,0,0,0,0,0
0,0,0,0,0,0,0,0,0
108852,799,1,177,154,23,2,0,0
19398,470,0,116,115,1,12,1,0
10821,188,0,36,35,1,6,1,0
27899,368,3,150,61,89,0,0,0
0,0,0,0,0,0,0,0,0
0,0,0,0,0,0,0,0,0
0,0,0,0,0,0,0,0,0
0,0,0,0,0,0,0,0,0
265168,1276,7,147,116,31,6,1,0
0,0,0,0,0,0,0,0,0
0,0,0,0,0,0,0,0,0
8160,36,0,3,3,0,0,1,0
108063,3197,3,1567,1539,28,0,1,0
352672,2068,9,285,274,11,1,1,0
248687,1223,8,168,157,11,9,1,0
0,0,0,0,0,0,0,0,0
108529,945,7,143,138,5,2,0,0
6692,71,6,3,2,1,0,0,0
257762,2779,6,648,643,5,23,1,0
31375,306,5,30,28,2,4,1,0
464755,1710,4,159,114,45,17,1,0
0,0,0,0,0,0,0,0,0
0,0,0,0,0,0,0,0,0
107831,873,4,130,123,7,6,1,0
0,0,0,0,0,0,0,0,0
162876,1052,10,114,110,4,4,1,0
0,0,0,0,0,0,0,0,0
156846,1944,11,315,299,16,4,1,0
156845,1944,11,315,299,16,4,1,0
208174,1763,6,295,256,39,19,0,0
63761,535,10,94,81,13,12,0,0
21914,35,0,1,1,0,0,1,0
141402,1214,4,294,0,294,3,0,0
51776,219,4,38,29,9,2,0,0
324132,1782,1,357,352,5,4,1,0
163400,330,1,74,24,50,0,1,0
0,0,0,0,0,0,0,0,0
0,0,0,0,0,0,0,0,0
297756,695,7,114,106,8,8,0,0
12589,121,5,11,4,7,1,1,0
0,0,0,0,0,0,0,0,0
0,0,0,0,0,0,0,0,0
136933,1448,10,319,289,30,11,1,0
31444,430,5,74,70,4,3,1,0
103266,576,0,94,0,94,72,1,0
644415,1716,3,70,59,11,5,1,0
214031,1755,9,277,276,1,2,1,0
0,0,0,0,0,0,0,0,0
120306,471,1,42,29,13,1,1,0
0,0,0,0,0,0,0,0,0
703765,433,9,15,8,7,0,1,0
0,0,0,0,0,0,0,0,0
3016783,11099,6,850,629,221,63,1,0
29632,126,3,10,3,7,2,1,0
129288,1236,10,275,274,1,3,1,0
0,0,0,0,0,0,0,0,0
0,0,0,0,0,0,0,0,0
382578,1384,15,230,184,46,11,1,0
264982,2880,4,546,507,39,15,0,0
0,0,0,0,0,0,0,0,0
35047,248,5,47,4,43,5,1,0
32592,229,5,45,22,23,5,1,0
0,0,0,0,0,0,0,0,0
132833,903,2,182,0,182,0,1,0
244711,2708,1,201,179,22,2,1,0
53453,544,2,149,142,7,0,1,0
32354,448,2,142,142,0,0,1,0
0,0,0,0,0,0,0,0,0
0,0,0,0,0,0,0,0,0
29997,313,1,32,32,0,6,1,0
30234,201,1,14,4,10,25,1,0
458044,1107,2,142,121,21,2,1,0
82940,887,2,263,9,254,0,1,0
159140,863,12,153,150,3,0,1,0
61683,703,8,93,86,7,11,1,0
1118614,3415,17,373,316,57,34,1,0
178515,923,12,150,106,44,4,1,0
263922,2695,11,171,146,25,3,1,0
192267,967,13,67,12,55,7,1,0
15305,94,7,6,6,0,2,0,0
2999810,591,4,44,3,41,0,0,0
0,0,0,0,0,0,0,0,0
934,27,0,3,3,0,0,1,0
559953,1910,11,268,253,15,13,0,1
0,0,0,0,0,0,0,0,0
523858,3075,12,462,452,10,13,1,0
0,0,0,0,0,0,0,0,0
2199915,2843,10,199,141,58,39,1,0
10386,49,1,0,0,0,0,0,0
0,0,0,0,0,0,0,0,0
0,0,0,0,0,0,0,0,0
19272,306,0,79,79,0,0,1,0
0,0,0,0,0,0,0,0,0
96679,1033,2,299,298,1,3,1,0
0,0,0,0,0,0,0,0,0
0,0,0,0,0,0,0,0,0
265857,1711,16,102,90,12,11,1,0
33217,140,9,14,14,0,2,0,0
0,0,0,0,0,0,0,0,0
0,0,0,0,0,0,0,0,0
0,0,0,0,0,0,0,0,0
0,0,0,0,0,0,0,0,0
78177,490,5,102,99,3,10,1,0
224450,1346,7,173,161,12,5,1,0
123655,2393,4,499,472,27,6,1,0
3880,58,6,3,3,0,0,0,0
280304,486,10,55,25,30,0,1,0
2852,50,0,6,6,0,0,1,0
0,0,0,0,0,0,0,0,0
0,0,0,0,0,0,0,0,0
0,0,0,0,0,0,0,0,0
616356,1844,8,204,184,20,43,1,0
29544,123,8,11,11,0,2,0,0
68273,934,3,255,254,1,5,0,0
0,0,0,0,0,0,0,0,0
0,0,0,0,0,0,0,0,0
26299,481,6,144,144,0,2,1,0
38958,419,7,65,56,9,11,0,0
67024,979,3,133,116,17,2,1,0
215295,1562,8,299,286,13,23,0,0
47279,306,7,52,48,4,1,0,0
0,0,0,0,0,0,0,0,0
92133,564,3,145,135,10,2,1,0
0,0,0,0,0,0,0,0,0
0,0,0,0,0,0,0,0,0
14492,219,1,41,39,2,2,1,0
348711,1670,4,203,173,30,0,0,0
0,0,0,0,0,0,0,0,0
77940,1061,3,191,183,8,14,1,0
41313,607,3,126,126,0,10,1,0
0,0,0,0,0,0,0,0,0
0,0,0,0,0,0,0,0,0
61145,659,9,66,32,34,0,1,0
61104,659,9,66,40,26,0,1,0
0,0,0,0,0,0,0,0,0
7690,99,2,4,4,0,2,0,0
389481,3977,11,718,712,6,11,0,0
55719,371,11,75,67,8,2,1,0
0,0,0,0,0,0,0,0,0
0,0,0,0,0,0,0,0,0
258331,282,4,32,24,8,0,1,0
251021,195,4,28,20,8,0,1,0
0,0,0,0,0,0,0,0,0
83027,772,14,105,100,5,12,1,0
0,0,0,0,0,0,0,0,0
604513,4444,8,756,731,25,3,0,0
48249,516,6,70,69,1,2,1,0
2653,34,2,0,0,0,0,0,0
0,0,0,0,0,0,0,0,0
0,0,0,0,0,0,0,0,0
87700,923,5,118,115,3,0,1,0
0,0,0,0,0,0,0,0,0
492733,1262,5,307,303,4,16,1,0
0,0,0,0,0,0,0,0,0
715183,5142,20,553,524,29,21,1,0
301937,796,3,34,27,7,2,1,0
270329,3691,1,1029,902,127,129,1,0
49028,357,0,91,85,6,1,1,0
645760,4986,2,428,396,32,20,1,0
0,0,0,0,0,0,0,0,0
0,0,0,0,0,0,0,0,0
21999,32,0,1,1,0,0,1,0
0,0,0,0,0,0,0,0,0
199835,1059,13,205,191,14,3,1,0
307436,1536,5,235,207,28,25,1,0
195754,1603,1,240,238,2,46,0,0
23164,36,0,2,1,1,0,1,0
0,0,0,0,0,0,0,0,0
49257,412,4,60,58,2,7,1,0
369588,5109,9,656,642,14,166,0,0
37051,519,3,120,120,0,0,1,0
322133,971,15,182,127,55,6,1,0
0,0,0,0,0,0,0,0,0
0,0,0,0,0,0,0,0,0
499388,1474,6,260,254,6,4,1,0
286357,2483,4,238,217,21,5,1,0
573826,1345,12,238,220,18,4,1,0
545331,2371,3,140,122,18,3,0,0
240361,1055,5,46,33,13,3,0,0
0,0,0,0,0,0,0,0,0
157863,431,16,60,60,0,3,1,0
0,0,0,0,0,0,0,0,0
357708,722,5,33,26,7,14,1,0
0,0,0,0,0,0,0,0,0
51626,680,2,136,132,4,0,1,0
145389,884,10,139,135,4,12,1,0
501221,2559,4,279,273,6,18,1,0
0,0,0,0,0,0,0,0,0
0,0,0,0,0,0,0,0,0
0,0,0,0,0,0,0,0,0
0,0,0,0,0,0,0,0,0
74998,1208,1,303,303,0,1,1,0
0,0,0,0,0,0,0,0,0
0,0,0,0,0,0,0,0,0
300731,1812,13,68,64,4,12,1,0
294469,4409,0,255,254,1,0,1,0
132717,2518,0,732,726,6,5,1,0
34272,481,4,77,74,3,0,1,0
0,0,0,0,0,0,0,0,0
0,0,0,0,0,0,0,0,0
0,0,0,0,0,0,0,0,0
0,0,0,0,0,0,0,0,0
307180,1959,12,629,543,86,3,1,0
0,0,0,0,0,0,0,0,0
0,0,0,0,0,0,0,0,0
397315,1964,8,404,374,30,10,1,0
0,0,0,0,0,0,0,0,0
1022035,1954,11,288,271,17,3,1,0
103787,1362,5,315,301,14,3,1,0
189617,204,1,11,8,3,1,1,0
38939,129,2,4,3,1,1,1,0
45180,207,2,7,3,4,1,1,0
0,0,0,0,0,0,0,0,0
16258,211,5,15,13,2,2,1,0
16035,175,4,20,13,7,0,1,0
133811,813,6,190,180,10,11,1,0
203970,699,9,120,117,3,10,0,0
0,0,0,0,0,0,0,0,0
115453,1374,6,228,178,50,34,1,0
22749,262,2,39,37,2,6,1,0
0,0,0,0,0,0,0,0,0
212914,3325,5,560,550,10,2,1,0
22365,230,4,37,35,2,4,1,0
549661,1531,1,87,65,22,6,1,0
69504,169,2,15,13,2,0,1,0
432770,1818,14,436,418,18,18,1,0
8860,113,5,14,10,4,1,1,0
0,0,0,0,0,0,0,0,0
49874,241,3,29,4,25,0,1,0
3444,35,2,0,0,0,0,0,0
0,0,0,0,0,0,0,0,0
0,0,0,0,0,0,0,0,0
0,0,0,0,0,0,0,0,0
0,0,0,0,0,0,0,0,0
24093,37,0,2,1,1,0,1,0
0,0,0,0,0,0,0,0,0
0,0,0,0,0,0,0,0,0
604030,2205,7,422,379,43,31,1,1
0,0,0,0,0,0,0,0,0
0,0,0,0,0,0,0,0,0
0,0,0,0,0,0,0,0,0
141325,1556,5,226,183,43,0,1,0
19002,54,1,1,1,0,1,0,0
0,0,0,0,0,0,0,0,0
92430,1041,2,60,33,27,2,1,0
307068,2641,9,333,316,17,5,1,0
113475,1259,4,234,233,1,0,1,0
0,0,0,0,0,0,0,0,0
0,0,0,0,0,0,0,0,0
159978,1492,5,123,121,2,8,1,0
93925,241,6,32,31,1,6,1,0
137546,1400,9,235,234,1,11,0,0
47300,798,5,82,82,0,0,1,0
0,0,0,0,0,0,0,0,0
276634,1517,14,348,342,6,1,1,0
0,0,0,0,0,0,0,0,0
40630,368,1,17,12,5,1,1,0
165432,998,4,109,106,3,12,0,0
0,0,0,0,0,0,0,0,0
75046,451,4,53,31,22,1,0,0
340261,2205,3,275,272,3,7,0,0
376866,789,2,67,63,4,0,1,0
325531,150,2,18,11,7,0,1,0
14929,171,3,12,11,1,0,1,0
0,0,0,0,0,0,0,0,0
137137,2098,10,433,380,53,6,1,0
0,0,0,0,0,0,0,0,0
1562384,1585,4,114,107,7,1,1,0
32568,467,7,81,74,7,5,1,0
0,0,0,0,0,0,0,0,0
135887,1334,6,307,185,122,1,1,0
0,0,0,0,0,0,0,0,0
171945,1626,13,503,494,9,16,1,0
185096,1898,13,610,601,9,19,1,0
1421173,2312,7,63,63,0,4,1,0
418531,1731,14,150,139,11,0,1,0
459098,1048,11,118,106,12,4,1,0
890697,2812,16,423,299,124,1,1,0
198996,763,5,102,95,7,5,1,0
0,0,0,0,0,0,0,0,0
47400,543,5,104,95,9,20,1,0
35879,746,2,185,161,24,0,1,0
98705,1862,4,129,115,14,3,0,0
150405,1353,8,215,185,30,3,1,0
7760,76,1,5,5,0,0,0,0
0,0,0,0,0,0,0,0,0
0,0,0,0,0,0,0,0,0
205532,1383,8,121,107,14,29,1,0
139385,758,10,121,115,6,33,1,0
0,0,0,0,0,0,0,0,0
0,0,0,0,0,0,0,0,0
2418444,3441,14,433,432,1,100,1,0
324139,1324,14,170,169,1,28,1,0
0,0,0,0,0,0,0,0,0
137156,711,16,84,60,24,5,1,0
1568,31,0,3,1,2,0,0,0
304399,729,4,115,4,111,0,1,0
0,0,0,0,0,0,0,0,0
0,0,0,0,0,0,0,0,0
0,0,0,0,0,0,0,0,0
16162,313,3,54,37,17,0,0,0
77204,671,15,99,86,13,10,1,0
54251,416,10,97,87,10,8,1,0
428676,1960,10,329,329,0,20,1,0
101525,545,4,77,58,19,8,1,0
258624,982,5,146,123,23,9,1,0
159340,258,5,28,15,13,2,1,0
143697,73,5,5,5,0,2,1,0
0,0,0,0,0,0,0,0,0
44434,245,8,43,38,5,4,1,0
79420,833,7,138,133,5,4,1,0
0,0,0,0,0,0,0,0,0
149627,1198,7,264,239,25,7,1,0
0,0,0,0,0,0,0,0,0
0,0,0,0,0,0,0,0,0
610906,986,6,182,129,53,0,1,0
61293,157,4,5,3,2,1,1,0
25650,380,3,130,120,10,0,0,0
452558,1394,5,356,345,11,9,1,0
0,0,0,0,0,0,0,0,0
11313,140,2,21,19,2,0,0,0
0,0,0,0,0,0,0,0,0
0,0,0,0,0,0,0,0,0
7763455,1073,2,236,59,177,2,0,0
65740,697,9,125,103,22,2,1,0
0,0,0,0,0,0,0,0,0
293813,1746,9,167,137,30,24,1,0
0,0,0,0,0,0,0,0,0
0,0,0,0,0,0,0,0,0
198894,1891,10,287,252,35,12,1,0
505413,387,3,32,9,23,0,1,0
171064,1001,2,325,302,23,1,1,0
61197,1456,4,133,128,5,0,1,0
27085,129,5,5,4,1,8,1,0
0,0,0,0,0,0,0,0,0
441574,1546,4,204,169,35,5,0,0
0,0,0,0,0,0,0,0,0
0,0,0,0,0,0,0,0,0
0,0,0,0,0,0,0,0,0
282574,779,5,136,128,8,1,0,0
665424,30,1,1,1,0,0,0,0
0,0,0,0,0,0,0,0,0
568874,5994,9,916,847,69,12,1,0
18191,216,2,44,44,0,1,1,0
239126,1444,8,274,237,37,6,1,0
177731,608,5,88,78,10,3,0,0
0,0,0,0,0,0,0,0,0
291376,1262,8,199,167,32,14,1,0
0,0,0,0,0,0,0,0,0
213689,2285,4,444,369,75,12,1,0
137050,1748,6,269,197,72,13,1,0
0,0,0,0,0,0,0,0,0
295380,1388,8,269,254,15,7,1,0
238249,2188,7,344,344,0,205,1,0
133040,450,7,136,136,0,15,1,0
187920,1246,6,251,235,16,7,1,0
2342,29,1,0,0,0,0,0,0
30272,222,1,18,18,0,6,1,0
1283710,2162,20,395,288,107,33,1,0
0,0,0,0,0,0,0,0,0
82445,238,3,20,17,3,0,0,0
3953680,2012,1,79,78,1,1,1,0
75940,319,2,12,9,3,2,1,0
417579,1954,5,285,270,15,2,1,0
329361,1451,5,241,226,15,2,1,0
0,0,0,0,0,0,0,0,0
142180,1120,9,217,186,31,4,1,0
12126,80,0,6,3,3,0,1,0
63036,504,9,79,76,3,3,1,0
0,0,0,0,0,0,0,0,0
38139,734,2,175,172,3,2,1,0
13851,282,2,38,34,4,7,1,0
0,0,0,0,0,0,0,0,0
0,0,0,0,0,0,0,0,0
0,0,0,0,0,0,0,0,0
0,0,0,0,0,0,0,0,0
3202,40,3,5,5,0,0,1,0
0,0,0,0,0,0,0,0,0
0,0,0,0,0,0,0,0,0
0,0,0,0,0,0,0,0,0
248639,1772,2,252,252,0,0,1,0
135506,906,2,176,176,0,0,1,0
325005,2843,5,406,391,15,24,1,0
177050,1242,5,267,256,11,9,1,0
68164,725,6,101,94,7,10,1,0
26131,307,6,63,58,5,8,1,0
0,0,0,0,0,0,0,0,0
904218,12409,8,2297,2245,52,12,1,0
29577,217,8,27,25,2,3,0,0
0,0,0,0,0,0,0,0,0
856481,7125,9,412,288,124,37,0,0
0,0,0,0,0,0,0,0,0
3307519,1133,3,168,97,71,8,1,0
0,0,0,0,0,0,0,0,0
210968,729,5,168,159,9,6,1,0
0,0,0,0,0,0,0,0,0
135251,244,5,25,23,2,2,0,0
114454,208,5,26,23,3,2,0,0
0,0,0,0,0,0,0,0,0
0,0,0,0,0,0,0,0,0
0,0,0,0,0,0,0,0,0
645114,6236,7,118,110,8,1,1,0
166528,1658,8,399,377,22,13,1,0
185986,2514,3,673,554,119,1,1,0
71607,1095,1,333,333,0,0,1,0
21947,35,0,1,1,0,0,1,0
0,0,0,0,0,0,0,0,0
27687,42,0,2,1,1,0,0,0
152702,1044,4,196,180,16,21,1,0
386790,1310,12,259,250,9,1,1,0
5925,63,6,4,3,1,0,0,0
57126,494,11,113,104,9,2,0,0
10417,73,6,3,2,1,0,0,0
356549,1038,0,109,106,3,1,1,0
137376,1269,17,215,192,23,11,1,0
150171,1070,3,113,98,15,1,1,0
0,0,0,0,0,0,0,0,0
0,0,0,0,0,0,0,0,0
541757,3596,6,393,302,91,13,1,0
0,0,0,0,0,0,0,0,0
0,0,0,0,0,0,0,0,0
81557,679,3,124,120,4,0,1,0
0,0,0,0,0,0,0,0,0
102719,988,8,276,264,12,10,1,0
0,0,0,0,0,0,0,0,0
136916,1224,16,90,84,6,4,1,0
214942,1764,6,499,489,10,13,1,0
0,0,0,0,0,0,0,0,0
969765,3199,13,665,567,98,23,1,1
21371,170,4,4,0,4,3,1,0
159941,1270,6,296,265,31,10,1,0
0,0,0,0,0,0,0,0,0
0,0,0,0,0,0,0,0,0
169778,1180,6,163,155,8,9,1,0
177835,1146,6,167,164,3,5,1,0
40592,426,5,121,118,3,8,0,0
40759,1053,1,368,364,4,3,1,0
37427,205,9,17,16,1,20,1,0
0,0,0,0,0,0,0,0,0
9259,103,3,14,8,6,1,0,0
745150,5917,7,854,837,17,23,0,0
312389,4909,9,203,191,12,17,0,0
16129,187,4,15,14,1,0,1,0
0,0,0,0,0,0,0,0,0
0,0,0,0,0,0,0,0,0
0,0,0,0,0,0,0,0,0
490938,714,6,15,15,0,0,1,0
5434,65,6,2,2,0,0,1,0
0,0,0,0,0,0,0,0,0
0,0,0,0,0,0,0,0,0
47012,569,6,143,142,1,7,1,0
166721,392,8,31,21,10,28,0,0
43393,376,4,80,77,3,3,1,0
0,0,0,0,0,0,0,0,0
69698,329,2,51,38,13,1,1,0
0,0,0,0,0,0,0,0,0
65360,489,5,59,57,2,0,1,0
22023,253,2,36,36,0,0,1,0
143383,919,9,166,120,46,8,1,0
453993,4762,7,796,781,15,29,1,0
0,0,0,0,0,0,0,0,0
0,0,0,0,0,0,0,0,0
237793,1497,3,171,168,3,4,0,0
498493,776,3,59,56,3,4,0,0
73395,814,8,235,229,6,9,1,0
41528,550,8,121,115,6,8,1,0
918023,3125,6,670,18,652,17,1,0
324425,603,6,117,81,36,13,1,0
0,0,0,0,0,0,0,0,0
23157,407,0,106,104,2,2,1,0
0,0,0,0,0,0,0,0,0
415895,2430,5,253,253,0,6,1,0
0,0,0,0,0,0,0,0,0
282363,1076,8,140,136,4,0,1,0
0,0,0,0,0,0,0,0,0
117385,1219,8,200,174,26,15,1,0
53567,613,5,193,193,0,7,1,0
0,0,0,0,0,0,0,0,0
0,0,0,0,0,0,0,0,0
307764,776,2,113,111,2,1,1,0
0,0,0,0,0,0,0,0,0
0,0,0,0,0,0,0,0,0
38390,132,7,7,1,6,0,0,0
62990,377,11,43,31,12,7,1,0
417279,3669,2,135,106,29,4,1,0
237898,2814,8,585,569,16,1,1,0
92779,1503,3,358,355,3,0,1,0
0,0,0,0,0,0,0,0,0
119787,857,9,72,67,5,11,1,0
124350,861,9,72,67,5,13,1,0
0,0,0,0,0,0,0,0,0
509336,460,10,43,40,3,2,1,0
113809,1344,7,199,172,27,0,1,0
260325,2737,4,190,132,58,4,0,0
0,0,0,0,0,0,0,0,0
0,0,0,0,0,0,0,0,0
0,0,0,0,0,0,0,0,0
1153,16,1,0,0,0,0,0,0
0,0,0,0,0,0,0,0,0
10929,63,2,1,1,0,1,1,0
0,0,0,0,0,0,0,0,0
100180,77,2,5,3,2,0,1,0
0,0,0,0,0,0,0,0,0
71844,616,9,54,51,3,3,1,0
0,0,0,0,0,0,0,0,0
22652,34,0,1,1,0,0,1,0
185138,711,9,102,23,79,6,1,0
203888,808,11,103,92,11,7,1,0
31993,546,7,25,24,1,6,0,0
0,0,0,0,0,0,0,0,0
34430,368,10,49,46,3,5,1,0
147660,1049,5,79,65,14,72,1,0
0,0,0,0,0,0,0,0,0
0,0,0,0,0,0,0,0,0
0,0,0,0,0,0,0,0,0
18587,251,10,39,34,5,0,1,0
0,0,0,0,0,0,0,0,0
0,0,0,0,0,0,0,0,0
317567,1808,9,306,254,52,9,1,0
31430,373,5,12,11,1,3,0,0
51517,445,2,3,3,0,4,0,0
133783,1345,3,232,227,5,6,1,0
371009,1189,9,141,118,23,13,1,0
550737,2465,6,285,89,196,5,1,0
91913,932,6,192,188,4,7,1,0
0,0,0,0,0,0,0,0,0
0,0,0,0,0,0,0,0,0
0,0,0,0,0,0,0,0,0
0,0,0,0,0,0,0,0,0
506378,3716,10,625,621,4,0,1,0
895,11,0,2,0,2,0,0,0
0,0,0,0,0,0,0,0,0
87786,720,7,121,110,11,8,1,0
159161,281,6,12,7,5,10,0,0
0,0,0,0,0,0,0,0,0
299528,3118,4,654,650,4,112,1,0
146540,1624,4,483,480,3,32,1,0
0,0,0,0,0,0,0,0,0
88448,1846,3,411,397,14,7,1,0
954868,4670,6,1054,1041,13,13,1,0
67729,839,8,143,139,4,0,1,0
229393,2168,3,83,50,33,62,1,0
2882,55,1,6,6,0,0,0,0
0,0,0,0,0,0,0,0,0
0,0,0,0,0,0,0,0,0
147110,780,14,160,139,21,10,1,0
61845,740,9,138,97,41,9,0,0
0,0,0,0,0,0,0,0,0
0,0,0,0,0,0,0,0,0
181893,1483,11,281,217,64,9,1,0
83283,624,3,80,65,15,1,1,0
0,0,0,0,0,0,0,0,0
0,0,0,0,0,0,0,0,0
162037,695,12,118,116,2,35,1,0
350502,497,2,20,19,1,6,1,0
351832,343,4,17,16,1,4,1,0
229944,626,6,117,115,2,0,1,0
255035,1380,5,182,161,21,13,1,0
11757,78,3,3,3,0,5,0,0
96936,676,4,171,167,4,12,1,0
69541,356,4,36,32,4,12,1,0
230185,2718,7,259,248,11,6,0,0
0,0,0,0,0,0,0,0,0
233497,1186,9,95,86,9,32,1,0
54946,537,0,63,55,8,5,0,0
60248,487,7,76,67,9,0,1,0
197027,1415,9,165,154,11,2,1,0
158387,812,7,199,197,2,6,1,0
117251,572,7,167,165,2,7,1,0
392477,3425,4,584,571,13,1,0,0
0,0,0,0,0,0,0,0,0
54952,602,4,103,96,7,2,1,0
58231,459,2,40,40,0,0,0,0
0,0,0,0,0,0,0,0,0
0,0,0,0,0,0,0,0,0
0,0,0,0,0,0,0,0,0
19478,253,5,70,64,6,0,0,0
61248,313,3,41,0,41,0,0,0
226136,1124,4,154,135,19,2,0,0
46732,765,5,144,47,97,2,1,0
24738,421,5,61,52,9,2,1,0
0,0,0,0,0,0,0,0,0
351148,472,8,48,41,7,59,1,0
319111,265,8,21,17,4,57,1,0
0,0,0,0,0,0,0,0,0
0,0,0,0,0,0,0,0,0
0,0,0,0,0,0,0,0,0
286058,1595,6,256,239,17,20,1,0
78046,479,7,99,94,5,2,0,0
0,0,0,0,0,0,0,0,0
142294,1246,13,141,132,9,3,1,0
78949,696,4,65,63,2,3,1,0
0,0,0,0,0,0,0,0,0
319560,1345,2,241,232,9,12,1,0
0,0,0,0,0,0,0,0,0
149778,891,5,173,170,3,4,1,0
90939,1577,4,273,271,2,0,0,0
84241,631,6,69,39,30,0,1,0
306002,3042,7,499,440,59,51,1,0
65835,753,1,236,203,33,1,1,0
0,0,0,0,0,0,0,0,0
0,0,0,0,0,0,0,0,0
0,0,0,0,0,0,0,0,0
268660,3854,6,561,517,44,1,1,0
149057,608,8,99,94,5,19,1,0
0,0,0,0,0,0,0,0,0
235060,807,13,27,20,7,9,0,0
162083,279,3,9,5,4,0,0,0
0,0,0,0,0,0,0,0,0
136435,1245,5,102,95,7,1,1,0
320913,2134,9,336,225,111,28,1,0
0,0,0,0,0,0,0,0,0
0,0,0,0,0,0,0,0,0
324617,3023,9,433,379,54,51,1,0
0,0,0,0,0,0,0,0,0
118497,1909,9,434,425,9,2,0,0
26372,217,12,4,4,0,1,0,0
0,0,0,0,0,0,0,0,0
0,0,0,0,0,0,0,0,0
0,0,0,0,0,0,0,0,0
8499,100,0,0,0,0,0,1,0
0,0,0,0,0,0,0,0,0
121848,1004,0,77,70,7,25,0,0
0,0,0,0,0,0,0,0,0
0,0,0,0,0,0,0,0,0
187417,540,6,29,29,0,7,1,0
172672,2127,5,387,383,4,9,0,0
0,0,0,0,0,0,0,0,0
0,0,0,0,0,0,0,0,0
0,0,0,0,0,0,0,0,0
0,0,0,0,0,0,0,0,0
54228,574,2,60,40,20,3,1,0
0,0,0,0,0,0,0,0,0
96441,583,5,168,161,7,4,1,0
135319,331,5,47,41,6,2,1,0
90025,864,2,148,99,49,0,1,0
75253,621,6,25,24,1,3,1,0
645170,1543,9,84,83,1,30,0,0
38871,202,3,7,7,0,0,1,0
45451,508,3,153,149,4,10,1,0
715942,1782,11,172,133,39,71,1,0
93533,1492,2,373,372,1,2,1,0
0,0,0,0,0,0,0,0,0
0,0,0,0,0,0,0,0,0
0,0,0,0,0,0,0,0,0
14056,121,3,21,11,10,0,1,0
331435,2009,6,302,221,81,14,1,0
175779,365,6,32,24,8,1,1,0
34187,723,4,85,79,6,2,1,0
0,0,0,0,0,0,0,0,0
335512,1820,2,234,222,12,6,0,0
60709,696,1,1,0,1,0,0,0
45558,417,6,30,23,7,3,1,0
278990,1720,7,147,131,16,11,1,0
162818,904,6,128,117,11,1,1,0
43573,339,6,49,26,23,0,0,0
0,0,0,0,0,0,0,0,0
0,0,0,0,0,0,0,0,0
21997,35,0,1,1,0,0,1,0
924485,4073,5,423,360,63,16,1,0
1095285,1957,7,301,261,40,38,1,0
66304,87,4,13,11,2,0,0,0
413370,3546,10,751,716,35,14,1,0
0,0,0,0,0,0,0,0,0
175067,2766,4,88,88,0,3,1,0
0,0,0,0,0,0,0,0,0
61352,763,4,176,131,45,14,1,0
73644,764,14,138,136,2,7,0,0
61032,354,10,81,79,2,5,0,0
171223,1610,7,330,325,5,8,1,0
71111,1131,2,180,139,41,4,1,0
114993,744,13,75,70,5,5,1,0
4578,58,1,6,6,0,0,1,0
61685,390,7,79,75,4,7,0,0
119201,1770,4,473,357,116,0,1,0
203589,1370,6,220,194,26,93,1,0
0,0,0,0,0,0,0,0,0
87385,543,11,70,59,11,0,1,0
61311,230,10,38,35,3,0,1,0
0,0,0,0,0,0,0,0,0
0,0,0,0,0,0,0,0,0
0,0,0,0,0,0,0,0,0
0,0,0,0,0,0,0,0,0
95080,491,9,88,81,7,8,1,0
81923,477,10,92,85,7,8,1,0
54331,948,7,117,37,80,11,1,0
0,0,0,0,0,0,0,0,0
118120,1764,10,359,330,29,21,1,0
241428,2772,11,603,578,25,12,1,0
1226233,6369,10,1377,8,1369,41,1,0
0,0,0,0,0,0,0,0,0
372070,2056,9,409,396,13,25,1,0
0,0,0,0,0,0,0,0,0
17663,199,1,72,64,8,0,1,0
0,0,0,0,0,0,0,0,0
0,0,0,0,0,0,0,0,0
240968,3042,9,567,432,135,4,0,0
0,0,0,0,0,0,0,0,0
381997,7284,5,487,472,15,16,1,0
15299,318,2,129,128,1,0,1,0
14489,128,3,9,9,0,4,1,0
56573,766,5,166,161,5,0,1,0
32732,446,6,98,94,4,0,1,0
0,0,0,0,0,0,0,0,0
193639,2107,10,414,389,25,22,1,0
576616,2829,12,417,397,20,5,1,0
576605,2829,12,417,397,20,5,1,0
0,0,0,0,0,0,0,0,0
0,0,0,0,0,0,0,0,0
0,0,0,0,0,0,0,0,0
0,0,0,0,0,0,0,0,0
218320,641,0,80,38,42,0,1,0
0,0,0,0,0,0,0,0,0
9552,137,7,26,26,0,1,1,0
257025,1791,8,310,268,42,18,1,0
248526,2046,8,287,264,23,18,1,0
0,0,0,0,0,0,0,0,0
260451,1347,4,129,83,46,1,1,0
173819,889,8,113,64,49,5,1,0
0,0,0,0,0,0,0,0,0
0,0,0,0,0,0,0,0,0
74100,357,2,39,37,2,3,1,0
1569453,854,9,35,17,18,7,1,0
632016,1095,4,163,163,0,8,0,0
226565,1621,2,94,66,28,5,1,0
0,0,0,0,0,0,0,0,0
286473,753,9,120,101,19,5,1,0
0,0,0,0,0,0,0,0,0
128656,298,10,31,22,9,0,1,0
55261,639,3,90,77,13,7,1,0
221054,2199,10,376,356,20,17,1,0
2331,34,1,2,2,0,0,0,0
0,0,0,0,0,0,0,0,0
0,0,0,0,0,0,0,0,0
261522,1254,8,137,117,20,14,1,0
21634,71,1,5,5,0,0,0,0
0,0,0,0,0,0,0,0,0
33066,685,2,262,262,0,0,1,0
45630,849,0,214,184,30,0,1,0
8942,232,0,74,49,25,0,1,0
654792,2789,5,223,204,19,7,1,0
0,0,0,0,0,0,0,0,0
0,0,0,0,0,0,0,0,0
76053,1932,2,568,568,0,1,1,0
0,0,0,0,0,0,0,0,0
823295,7344,11,2076,2004,72,18,1,0
473839,5115,10,1691,1678,13,17,1,0
91396,1274,2,305,289,16,1,1,0
29819,134,2,5,5,0,1,1,0
0,0,0,0,0,0,0,0,0
0,0,0,0,0,0,0,0,0
365892,1508,6,108,101,7,30,0,0
53006,144,5,8,8,0,4,0,0
0,0,0,0,0,0,0,0,0
0,0,0,0,0,0,0,0,0
0,0,0,0,0,0,0,0,0
0,0,0,0,0,0,0,0,0
120511,284,9,30,26,4,2,1,0
0,0,0,0,0,0,0,0,0
0,0,0,0,0,0,0,0,0
0,0,0,0,0,0,0,0,0
0,0,0,0,0,0,0,0,0
0,0,0,0,0,0,0,0,0
0,0,0,0,0,0,0,0,0
0,0,0,0,0,0,0,0,0
0,0,0,0,0,0,0,0,0
0,0,0,0,0,0,0,0,0
0,0,0,0,0,0,0,0,0
0,0,0,0,0,0,0,0,0
0,0,0,0,0,0,0,0,0
0,0,0,0,0,0,0,0,0
0,0,0,0,0,0,0,0,0
0,0,0,0,0,0,0,0,0
0,0,0,0,0,0,0,0,0
0,0,0,0,0,0,0,0,0
0,0,0,0,0,0,0,0,0
0,0,0,0,0,0,0,0,0
0,0,0,0,0,0,0,0,0
0,0,0,0,0,0,0,0,0
0,0,0,0,0,0,0,0,0
0,0,0,0,0,0,0,0,0
0,0,0,0,0,0,0,0,0
0,0,0,0,0,0,0,0,0
0,0,0,0,0,0,0,0,0
0,0,0,0,0,0,0,0,0
0,0,0,0,0,0,0,0,0
0,0,0,0,0,0,0,0,0
0,0,0,0,0,0,0,0,0
0,0,0,0,0,0,0,0,0
0,0,0,0,0,0,0,0,0
0,0,0,0,0,0,0,0,0
0,0,0,0,0,0,0,0,0
0,0,0,0,0,0,0,0,0
0,0,0,0,0,0,0,0,0
0,0,0,0,0,0,0,0,0
0,0,0,0,0,0,0,0,0
0,0,0,0,0,0,0,0,0
0,0,0,0,0,0,0,0,0
0,0,0,0,0,0,0,0,0
0,0,0,0,0,0,0,0,0
0,0,0,0,0,0,0,0,0
0,0,0,0,0,0,0,0,0
0,0,0,0,0,0,0,0,0
0,0,0,0,0,0,0,0,0
0,0,0,0,0,0,0,0,0
0,0,0,0,0,0,0,0,0
0,0,0,0,0,0,0,0,0
0,0,0,0,0,0,0,0,0
0,0,0,0,0,0,0,0,0
0,0,0,0,0,0,0,0,0
0,0,0,0,0,0,0,0,0
0,0,0,0,0,0,0,0,0
0,0,0,0,0,0,0,0,0
0,0,0,0,0,0,0,0,0
0,0,0,0,0,0,0,0,0
0,0,0,0,0,0,0,0,0
0,0,0,0,0,0,0,0,0
0,0,0,0,0,0,0,0,0
0,0,0,0,0,0,0,0,0
0,0,0,0,0,0,0,0,0
0,0,0,0,0,0,0,0,0
0,0,0,0,0,0,0,0,0
0,0,0,0,0,0,0,0,0
0,0,0,0,0,0,0,0,0
0,0,0,0,0,0,0,0,0
0,0,0,0,0,0,0,0,0
0,0,0,0,0,0,0,0,0
0,0,0,0,0,0,0,0,0
0,0,0,0,0,0,0,0,0
0,0,0,0,0,0,0,0,0
0,0,0,0,0,0,0,0,0
0,0,0,0,0,0,0,0,0
0,0,0,0,0,0,0,0,0
0,0,0,0,0,0,0,0,0
0,0,0,0,0,0,0,0,0
0,0,0,0,0,0,0,0,0
0,0,0,0,0,0,0,0,0
0,0,0,0,0,0,0,0,0
0,0,0,0,0,0,0,0,0
0,0,0,0,0,0,0,0,0
0,0,0,0,0,0,0,0,0
0,0,0,0,0,0,0,0,0
0,0,0,0,0,0,0,0,0
0,0,0,0,0,0,0,0,0
0,0,0,0,0,0,0,0,0
0,0,0,0,0,0,0,0,0
0,0,0,0,0,0,0,0,0
0,0,0,0,0,0,0,0,0
0,0,0,0,0,0,0,0,0
0,0,0,0,0,0,0,0,0
0,0,0,0,0,0,0,0,0
0,0,0,0,0,0,0,0,0
0,0,0,0,0,0,0,0,0
0,0,0,0,0,0,0,0,0
0,0,0,0,0,0,0,0,0
0,0,0,0,0,0,0,0,0
0,0,0,0,0,0,0,0,0
0,0,0,0,0,0,0,0,0
0,0,0,0,0,0,0,0,0
0,0,0,0,0,0,0,0,0
0,0,0,0,0,0,0,0,0
0,0,0,0,0,0,0,0,0
0,0,0,0,0,0,0,0,0
0,0,0,0,0,0,0,0,0
0,0,0,0,0,0,0,0,0
0,0,0,0,0,0,0,0,0
0,0,0,0,0,0,0,0,0
0,0,0,0,0,0,0,0,0
0,0,0,0,0,0,0,0,0
0,0,0,0,0,0,0,0,0
0,0,0,0,0,0,0,0,0
0,0,0,0,0,0,0,0,0
0,0,0,0,0,0,0,0,0
0,0,0,0,0,0,0,0,0
0,0,0,0,0,0,0,0,0
0,0,0,0,0,0,0,0,0
0,0,0,0,0,0,0,0,0
0,0,0,0,0,0,0,0,0
0,0,0,0,0,0,0,0,0
0,0,0,0,0,0,0,0,0
0,0,0,0,0,0,0,0,0
0,0,0,0,0,0,0,0,0
0,0,0,0,0,0,0,0,0
0,0,0,0,0,0,0,0,0
0,0,0,0,0,0,0,0,0
0,0,0,0,0,0,0,0,0
0,0,0,0,0,0,0,0,0
0,0,0,0,0,0,0,0,0
0,0,0,0,0,0,0,0,0
0,0,0,0,0,0,0,0,0
0,0,0,0,0,0,0,0,0
0,0,0,0,0,0,0,0,0
0,0,0,0,0,0,0,0,0
0,0,0,0,0,0,0,0,0
0,0,0,0,0,0,0,0,0
0,0,0,0,0,0,0,0,0
0,0,0,0,0,0,0,0,0
0,0,0,0,0,0,0,0,0
0,0,0,0,0,0,0,0,0
0,0,0,0,0,0,0,0,0
0,0,0,0,0,0,0,0,0
0,0,0,0,0,0,0,0,0
0,0,0,0,0,0,0,0,0
0,0,0,0,0,0,0,0,0
0,0,0,0,0,0,0,0,0
0,0,0,0,0,0,0,0,0
0,0,0,0,0,0,0,0,0
0,0,0,0,0,0,0,0,0
0,0,0,0,0,0,0,0,0
0,0,0,0,0,0,0,0,0
0,0,0,0,0,0,0,0,0
0,0,0,0,0,0,0,0,0
0,0,0,0,0,0,0,0,0
0,0,0,0,0,0,0,0,0
0,0,0,0,0,0,0,0,0
0,0,0,0,0,0,0,0,0
0,0,0,0,0,0,0,0,0
0,0,0,0,0,0,0,0,0
0,0,0,0,0,0,0,0,0
0,0,0,0,0,0,0,0,0
0,0,0,0,0,0,0,0,0
0,0,0,0,0,0,0,0,0
0,0,0,0,0,0,0,0,0
0,0,0,0,0,0,0,0,0
0,0,0,0,0,0,0,0,0
0,0,0,0,0,0,0,0,0
0,0,0,0,0,0,0,0,0
0,0,0,0,0,0,0,0,0
0,0,0,0,0,0,0,0,0
0,0,0,0,0,0,0,0,0
0,0,0,0,0,0,0,0,0
0,0,0,0,0,0,0,0,0
0,0,0,0,0,0,0,0,0
0,0,0,0,0,0,0,0,0
0,0,0,0,0,0,0,0,0
0,0,0,0,0,0,0,0,0
0,0,0,0,0,0,0,0,0
0,0,0,0,0,0,0,0,0
0,0,0,0,0,0,0,0,0
0,0,0,0,0,0,0,0,0
0,0,0,0,0,0,0,0,0
0,0,0,0,0,0,0,0,0
0,0,0,0,0,0,0,0,0
0,0,0,0,0,0,0,0,0
0,0,0,0,0,0,0,0,0
0,0,0,0,0,0,0,0,0
0,0,0,0,0,0,0,0,0
0,0,0,0,0,0,0,0,0
0,0,0,0,0,0,0,0,0
0,0,0,0,0,0,0,0,0
0,0,0,0,0,0,0,0,0
0,0,0,0,0,0,0,0,0
0,0,0,0,0,0,0,0,0
0,0,0,0,0,0,0,0,0
0,0,0,0,0,0,0,0,0
0,0,0,0,0,0,0,0,0
0,0,0,0,0,0,0,0,0
0,0,0,0,0,0,0,0,0
0,0,0,0,0,0,0,0,0
0,0,0,0,0,0,0,0,0
0,0,0,0,0,0,0,0,0
0,0,0,0,0,0,0,0,0
0,0,0,0,0,0,0,0,0
0,0,0,0,0,0,0,0,0
0,0,0,0,0,0,0,0,0
0,0,0,0,0,0,0,0,0
0,0,0,0,0,0,0,0,0
0,0,0,0,0,0,0,0,0
0,0,0,0,0,0,0,0,0
0,0,0,0,0,0,0,0,0
0,0,0,0,0,0,0,0,0
62501,491,4,63,30,33,5,1,0
28669,179,5,5,5,0,5,1,0
3274,54,2,2,0,2,0,0,0
19196,294,4,23,18,5,2,0,0
293206,1792,2,313,308,5,4,1,0
35085,329,0,15,14,1,1,1,0
0,0,0,0,0,0,0,0,0
134026,2524,7,63,61,2,11,1,0
0,0,0,0,0,0,0,0,0
0,0,0,0,0,0,0,0,0
268668,1869,3,442,18,424,6,1,0
0,0,0,0,0,0,0,0,0
0,0,0,0,0,0,0,0,0
0,0,0,0,0,0,0,0,0
9973,126,7,22,14,8,0,1,0
7732,118,6,23,15,8,0,1,0
0,0,0,0,0,0,0,0,0
97336,758,5,133,122,11,17,0,0
280822,1045,7,45,18,27,8,1,0
0,0,0,0,0,0,0,0,0
0,0,0,0,0,0,0,0,0
0,0,0,0,0,0,0,0,0
201840,1127,16,207,185,22,7,1,0
0,0,0,0,0,0,0,0,0
0,0,0,0,0,0,0,0,0
6596,61,0,1,1,0,0,1,0
446168,1127,7,163,87,76,11,1,0
0,0,0,0,0,0,0,0,0
0,0,0,0,0,0,0,0,0
0,0,0,0,0,0,0,0,0
0,0,0,0,0,0,0,0,0
0,0,0,0,0,0,0,0,0
102855,1096,8,193,186,7,2,1,0
123263,1392,6,193,187,6,3,0,0
472243,4227,5,877,866,11,5,1,0
0,0,0,0,0,0,0,0,0
173347,567,10,106,106,0,11,0,0
54987,917,4,178,173,5,1,0,0
31673,507,8,151,135,16,0,1,0
44756,428,8,46,33,13,6,0,0
27421,178,7,37,30,7,1,0,0
0,0,0,0,0,0,0,0,0
0,0,0,0,0,0,0,0,0
182824,355,7,28,26,2,13,1,0
84064,648,5,131,122,9,9,0,0
0,0,0,0,0,0,0,0,0
0,0,0,0,0,0,0,0,0
165305,844,3,162,154,8,9,1,0
78235,259,3,52,46,6,8,1,0
0,0,0,0,0,0,0,0,0
0,0,0,0,0,0,0,0,0
102918,746,11,105,60,45,9,1,0
9597,120,1,27,18,9,1,1,0
152486,1814,13,330,307,23,8,1,0
46321,500,11,129,116,13,1,1,0
30822,313,2,5,2,3,7,1,0
227623,1486,14,311,304,7,50,1,0
284764,2566,14,338,329,9,58,1,0
133605,1083,3,233,76,157,3,1,0
62270,485,3,48,35,13,4,1,0
63025,861,2,114,77,37,6,1,0
68732,404,8,40,39,1,0,1,0
36649,242,0,37,30,7,2,1,0
0,0,0,0,0,0,0,0,0
0,0,0,0,0,0,0,0,0
21451,183,4,40,39,1,1,1,0
39290,626,0,119,108,11,0,1,0
0,0,0,0,0,0,0,0,0
0,0,0,0,0,0,0,0,0
21865,33,0,1,1,0,0,1,0
712222,2647,8,233,162,71,15,1,0
184364,1385,10,306,95,211,33,1,0
0,0,0,0,0,0,0,0,0
366679,734,3,44,36,8,9,1,0
350314,1744,2,332,199,133,127,1,0
170703,1070,7,254,246,8,4,1,0
128637,1187,5,228,222,6,80,1,0
610821,3235,2,126,107,19,2,1,0
34189,418,4,76,52,24,5,1,0
36703,437,7,108,106,2,2,1,0
189464,1160,7,203,190,13,15,1,0
122897,1004,6,179,164,15,13,1,0
261477,1890,13,269,255,14,19,0,0
0,0,0,0,0,0,0,0,0
0,0,0,0,0,0,0,0,0
27687,42,0,2,1,1,0,0,0
0,0,0,0,0,0,0,0,0
319639,3444,15,607,497,110,13,0,0
0,0,0,0,0,0,0,0,0
413954,3137,19,195,171,24,23,1,0
59391,310,6,29,21,8,1,0,0
0,0,0,0,0,0,0,0,0
2262,41,1,2,0,2,0,0,0
0,0,0,0,0,0,0,0,0
0,0,0,0,0,0,0,0,0
656483,2119,9,224,162,62,14,1,0
0,0,0,0,0,0,0,0,0
0,0,0,0,0,0,0,0,0
0,0,0,0,0,0,0,0,0
0,0,0,0,0,0,0,0,0
22720,37,0,2,1,1,0,1,0
0,0,0,0,0,0,0,0,0
336711,794,11,88,86,2,3,1,0
59786,908,3,208,185,23,6,0,0
0,0,0,0,0,0,0,0,0
0,0,0,0,0,0,0,0,0
57314,1397,7,207,203,4,1,0,0
198884,647,11,85,70,15,26,1,0
0,0,0,0,0,0,0,0,0
1184124,11890,4,380,371,9,3,1,0
254885,1179,11,220,214,6,17,1,0
80728,547,2,55,48,7,0,1,0
41317,256,3,18,18,0,2,1,0
1676299,1445,15,189,157,32,21,1,0
0,0,0,0,0,0,0,0,0
22821,33,0,1,1,0,0,1,0
135042,608,13,47,6,41,7,0,0
0,0,0,0,0,0,0,0,0
99742,1605,4,403,400,3,0,1,0
0,0,0,0,0,0,0,0,0
108822,325,9,51,51,0,2,1,0
0,0,0,0,0,0,0,0,0
113346,1205,10,234,211,23,36,1,0
66198,459,7,71,67,4,29,1,0
0,0,0,0,0,0,0,0,0
79976,754,11,158,132,26,9,1,0
56694,596,1,114,110,4,0,1,0
25497,284,1,74,71,3,2,1,0
175454,1248,10,252,230,22,3,1,0
15257,177,3,107,105,2,1,1,0
180393,4000,1,2669,2666,3,4,1,0
13301,190,1,34,33,1,3,1,0
0,0,0,0,0,0,0,0,0
0,0,0,0,0,0,0,0,0
0,0,0,0,0,0,0,0,0
58483,580,3,120,107,13,2,1,0
198735,764,11,108,104,4,10,1,0
172962,371,9,73,70,3,0,1,0
0,0,0,0,0,0,0,0,0
0,0,0,0,0,0,0,0,0
0,0,0,0,0,0,0,0,0
268298,701,6,89,78,11,0,1,0
0,0,0,0,0,0,0,0,0
181401,1231,5,210,180,30,0,1,0
38040,440,9,91,88,3,2,1,0
24553,281,9,58,54,4,1,1,0
235363,1796,15,324,56,268,16,0,0
199832,1440,15,252,236,16,16,0,0
248790,2073,6,203,203,0,78,1,0
0,0,0,0,0,0,0,0,0
48566,243,0,10,8,2,1,0,0
0,0,0,0,0,0,0,0,0
114035,1186,9,276,273,3,3,0,0
68410,574,9,137,134,3,3,0,0
521316,1388,5,328,309,19,13,1,0
15565,271,2,32,32,0,0,0,0
7052,147,2,27,27,0,1,0,0
539601,149,4,20,20,0,0,1,0
544150,155,5,11,11,0,0,1,0
0,0,0,0,0,0,0,0,0
63739,672,10,99,91,8,1,1,0
293541,370,4,53,52,1,3,1,0
33162,400,1,82,82,0,4,1,0
3524,72,0,21,21,0,0,1,0
452529,3100,6,215,78,137,0,1,0
142279,1132,10,213,203,10,3,1,0
64508,567,4,131,123,8,11,1,0
0,0,0,0,0,0,0,0,0
316934,2237,9,273,236,37,23,1,0
108359,715,9,156,152,4,0,1,0
39682,501,4,0,0,0,1,1,0
0,0,0,0,0,0,0,0,0
0,0,0,0,0,0,0,0,0
0,0,0,0,0,0,0,0,0
0,0,0,0,0,0,0,0,0
422845,2622,14,286,265,21,3,1,0
383693,2370,14,274,257,17,3,1,0
0,0,0,0,0,0,0,0,0
0,0,0,0,0,0,0,0,0
164769,1208,10,213,192,21,8,1,0
0,0,0,0,0,0,0,0,0
31560,140,8,10,9,1,0,1,0
52598,381,2,48,44,4,6,0,0
243644,1428,0,218,203,15,40,1,0
0,0,0,0,0,0,0,0,0
0,0,0,0,0,0,0,0,0
0,0,0,0,0,0,0,0,0
189260,684,8,66,26,40,3,1,0
312584,1412,3,170,166,4,5,1,0
0,0,0,0,0,0,0,0,0
0,0,0,0,0,0,0,0,0
0,0,0,0,0,0,0,0,0
0,0,0,0,0,0,0,0,0
0,0,0,0,0,0,0,0,0
0,0,0,0,0,0,0,0,0
74804,792,3,135,135,0,0,0,0
74804,792,3,135,135,0,0,0,0
21767,33,0,1,1,0,0,1,0
448246,2793,6,699,478,221,6,0,0
0,0,0,0,0,0,0,0,0
968055,2780,15,473,384,89,10,1,0
781830,2107,14,380,314,66,10,1,0
125420,708,11,128,52,76,2,1,0
13150,153,3,16,16,0,2,1,0
10539,115,3,13,13,0,2,1,0
24332,159,6,13,10,3,0,1,0
0,0,0,0,0,0,0,0,0
261597,747,11,83,42,41,35,1,0
23738,109,6,15,10,5,1,1,0
0,0,0,0,0,0,0,0,0
167890,1749,5,380,339,41,14,1,0
22741,37,0,2,1,1,0,1,0
0,0,0,0,0,0,0,0,0
79107,305,3,11,11,0,11,1,0
37874,352,4,35,32,3,2,0,0
199981,679,4,119,107,12,8,1,0
188295,539,4,79,67,12,8,1,0
0,0,0,0,0,0,0,0,0
615802,1981,14,284,238,46,16,0,0
894303,2972,2,373,326,47,10,1,0
0,0,0,0,0,0,0,0,0
456281,1459,6,134,131,3,7,1,0
22023,35,0,1,1,0,0,1,0
22267,332,7,85,62,23,0,0,0
1038373,2926,7,395,231,164,39,1,0
27168,349,5,60,50,10,0,1,0
0,0,0,0,0,0,0,0,0
73086,670,8,178,172,6,14,1,0
173680,782,14,177,173,4,9,1,0
6250,65,2,8,7,1,0,0,0
0,0,0,0,0,0,0,0,0
0,0,0,0,0,0,0,0,0
53479,1112,1,171,151,20,1,1,0
0,0,0,0,0,0,0,0,0
0,0,0,0,0,0,0,0,0
294226,2754,6,182,136,46,8,1,0
61001,330,10,41,37,4,2,1,0
0,0,0,0,0,0,0,0,0
293087,1117,10,156,125,31,7,1,0
0,0,0,0,0,0,0,0,0
0,0,0,0,0,0,0,0,0
86508,835,4,86,65,21,8,1,0
2839,56,0,1,1,0,0,0,0
87319,796,5,137,103,34,0,1,0
782767,3110,2,248,189,59,6,1,0
310666,1221,2,190,142,48,6,1,0
113319,469,0,48,45,3,9,1,0
0,0,0,0,0,0,0,0,0
0,0,0,0,0,0,0,0,0
777654,2878,12,365,312,53,26,1,0
192674,1157,10,195,143,52,4,1,0
99248,722,9,127,114,13,3,1,0
0,0,0,0,0,0,0,0,0
105097,369,7,50,49,1,1,1,0
89639,753,1,129,128,1,0,0,0
15923,282,2,38,38,0,0,0,0
26914,337,6,52,52,0,2,1,0
0,0,0,0,0,0,0,0,0
0,0,0,0,0,0,0,0,0
159871,936,10,201,200,1,3,0,0
2313107,2279,3,302,243,59,30,1,0
0,0,0,0,0,0,0,0,0
56528,451,5,125,118,7,22,1,0
0,0,0,0,0,0,0,0,0
15583,274,1,29,23,6,1,1,0
12480,76,2,11,11,0,0,1,0
46398,684,5,135,129,6,7,1,0
531239,1568,11,68,67,1,40,1,0
1219765,3766,16,401,383,18,14,1,0
773446,1973,14,265,258,7,15,1,0
478284,1308,1,97,94,3,0,1,0
0,0,0,0,0,0,0,0,0
77096,673,9,104,91,13,0,1,0
0,0,0,0,0,0,0,0,0
0,0,0,0,0,0,0,0,0
230888,1750,10,194,181,13,13,0,0
121400,1086,6,175,168,7,0,1,0
90095,98,0,12,5,7,0,1,0
118145,2572,2,326,322,4,18,1,0
0,0,0,0,0,0,0,0,0
0,0,0,0,0,0,0,0,0
1160596,1152,10,102,92,10,17,1,0
0,0,0,0,0,0,0,0,0
0,0,0,0,0,0,0,0,0
68248,1173,3,302,288,14,6,0,0
56404,1034,2,281,274,7,6,0,0
174506,1512,11,246,237,9,17,1,0
237189,1755,4,433,431,2,7,0,0
144771,1739,0,81,77,4,1,0,0
332847,2142,4,194,194,0,1,1,0
5312,51,3,8,1,7,0,1,0
0,0,0,0,0,0,0,0,0
0,0,0,0,0,0,0,0,0
0,0,0,0,0,0,0,0,0
1098767,349,6,7,2,5,2,1,0
26553,36,0,3,1,2,0,0,0
330856,2113,18,345,314,31,67,1,0
0,0,0,0,0,0,0,0,0
0,0,0,0,0,0,0,0,0
179302,1199,8,338,319,19,57,1,0
552378,1405,10,273,222,51,19,1,0
363276,2109,12,394,378,16,16,1,0
137265,611,6,72,53,19,0,1,0
0,0,0,0,0,0,0,0,0
634616,3614,9,1037,1032,5,158,0,0
68299,225,8,14,14,0,20,0,0
1049,12,1,0,0,0,0,0,0
0,0,0,0,0,0,0,0,0
0,0,0,0,0,0,0,0,0
453102,3161,2,286,277,9,11,1,0
117577,731,12,49,43,6,7,1,0
164114,1321,2,147,95,52,35,1,0
0,0,0,0,0,0,0,0,0
141938,2393,1,462,461,1,2,1,0
17253,215,1,32,32,0,1,1,0
61272,400,7,30,30,0,18,1,0
0,0,0,0,0,0,0,0,0
0,0,0,0,0,0,0,0,0
0,0,0,0,0,0,0,0,0
36412,284,8,32,14,18,11,1,0
12779,257,5,54,53,1,0,0,0
1064486,2245,10,384,340,44,40,1,0
1203722,1534,10,191,148,43,38,1,0
44776,569,8,67,67,0,0,1,0
828810,7398,6,186,157,29,89,1,0
51456,517,3,97,90,7,1,1,0
199693,1131,3,351,348,3,16,1,0
138946,316,1,85,85,0,0,1,0
0,0,0,0,0,0,0,0,0
0,0,0,0,0,0,0,0,0
338280,2643,7,538,523,15,8,1,0
108881,1479,3,341,335,6,0,1,0
0,0,0,0,0,0,0,0,0
138647,297,5,47,47,0,0,1,0
208102,701,15,91,78,13,1,0,0
1279426,4416,2,298,172,126,0,1,0
220818,328,4,35,34,1,3,1,0
82879,330,1,40,8,32,6,1,0
79469,151,5,11,1,10,0,1,0
167161,770,2,223,211,12,3,1,0
60357,801,5,168,153,15,13,1,0
0,0,0,0,0,0,0,0,0
0,0,0,0,0,0,0,0,0
0,0,0,0,0,0,0,0,0
554846,1936,9,403,393,10,6,1,0
130750,893,4,145,131,14,2,1,0
0,0,0,0,0,0,0,0,0
0,0,0,0,0,0,0,0,0
0,0,0,0,0,0,0,0,0
0,0,0,0,0,0,0,0,0
631660,3105,17,287,279,8,17,1,0
371396,939,17,144,136,8,16,1,0
0,0,0,0,0,0,0,0,0
650710,2420,8,519,515,4,11,1,0
369581,2367,1,406,15,391,1,1,0
9989,122,3,10,10,0,1,1,0
0,0,0,0,0,0,0,0,0
438238,1191,16,135,126,9,5,1,0
0,0,0,0,0,0,0,0,0
0,0,0,0,0,0,0,0,0
0,0,0,0,0,0,0,0,0
113988,595,1,78,66,12,0,1,0
37514,148,2,2,2,0,0,1,0
56882,623,5,137,129,8,12,1,0
0,0,0,0,0,0,0,0,0
26088,311,4,55,49,6,4,1,0
14633,190,2,37,33,4,5,1,0
624394,2562,16,242,224,18,6,0,0
0,0,0,0,0,0,0,0,0
22038,36,0,1,1,0,0,1,0
0,0,0,0,0,0,0,0,0
46737,204,3,32,32,0,3,1,0
0,0,0,0,0,0,0,0,0
431200,2721,13,318,200,118,10,1,0
178036,794,14,108,104,4,8,0,0
0,0,0,0,0,0,0,0,0
778,31,0,6,6,0,0,0,0
0,0,0,0,0,0,0,0,0
1302,18,0,0,0,0,0,0,0
215259,1894,2,323,313,10,3,1,0
3570,63,1,5,5,0,0,1,0
0,0,0,0,0,0,0,0,0
0,0,0,0,0,0,0,0,0
121603,473,2,66,53,13,0,0,0
670100,2275,15,353,339,14,18,1,0
105105,1060,7,284,268,16,6,1,0
821485,4156,6,326,255,71,9,1,0
237760,1105,7,172,166,6,11,1,0
0,0,0,0,0,0,0,0,0
138311,430,7,65,61,4,4,1,0
138103,451,7,67,63,4,4,1,0
0,0,0,0,0,0,0,0,0
631637,3192,1,273,268,5,33,1,0
0,0,0,0,0,0,0,0,0
3676163,31400,7,3218,1730,1488,26,0,0
47106,132,8,3,0,3,0,1,0
0,0,0,0,0,0,0,0,0
0,0,0,0,0,0,0,0,0
1984,33,0,3,3,0,0,0,0
0,0,0,0,0,0,0,0,0
288751,4321,2,1281,1271,10,129,0,0
423955,1658,12,298,298,0,15,1,0
122576,1670,1,204,196,8,36,0,0
3350,50,4,1,1,0,0,0,0
0,0,0,0,0,0,0,0,0
21018,294,5,56,50,6,0,1,0
39924,623,3,163,160,3,0,0,0
23422,240,1,38,14,24,0,0,0
22759,319,5,90,88,2,1,1,0
0,0,0,0,0,0,0,0,0
92823,1210,13,245,241,4,3,0,0
168284,876,4,64,40,24,18,1,0
0,0,0,0,0,0,0,0,0
464828,2859,12,579,572,7,6,1,0
376022,2545,12,540,533,7,6,1,0
0,0,0,0,0,0,0,0,0
93207,927,4,202,202,0,3,1,0
0,0,0,0,0,0,0,0,0
51308,282,7,54,53,1,0,0,0
0,0,0,0,0,0,0,0,0
447840,850,6,178,173,5,7,1,0
453636,423,11,50,34,16,3,1,0
0,0,0,0,0,0,0,0,0
11308,344,2,29,27,2,7,1,0
4439,96,2,17,17,0,0,1,0
233417,2656,8,338,333,5,5,1,0
25719,410,8,74,69,5,0,1,0
43215,581,2,140,139,1,4,1,0
10970,90,8,9,5,4,1,0,0
0,0,0,0,0,0,0,0,0
538774,1745,8,172,154,18,24,1,0
1748930,12147,7,342,332,10,66,1,0
1556433,10246,7,166,154,12,65,1,0
1104305,1477,3,146,129,17,4,1,0
163853,332,2,6,2,4,0,0,0
0,0,0,0,0,0,0,0,0
0,0,0,0,0,0,0,0,0
0,0,0,0,0,0,0,0,0
0,0,0,0,0,0,0,0,0
550128,3659,9,153,124,29,10,1,0
66091,344,4,51,41,10,0,1,0
0,0,0,0,0,0,0,0,0
584366,3145,9,180,102,78,58,0,0
719741,536,0,4,0,4,2,1,1
914131,3760,4,452,367,85,5,1,0
0,0,0,0,0,0,0,0,0
0,0,0,0,0,0,0,0,0
50105,639,3,53,52,1,4,1,0
23445,135,1,11,11,0,0,0,0
104544,735,9,212,188,24,13,0,0
3006,50,0,2,2,0,0,0,0
86468,967,4,83,83,0,10,0,0
0,0,0,0,0,0,0,0,0
167543,996,13,107,20,87,10,1,0
176388,1130,8,246,235,11,11,1,0
500091,7139,3,435,415,20,13,1,0
44067,687,5,135,135,0,1,1,0
43346,687,5,135,135,0,1,1,0
475799,3679,14,671,633,38,14,1,0
462219,147,3,7,6,1,0,0,0
0,0,0,0,0,0,0,0,0
0,0,0,0,0,0,0,0,0
37395,320,7,33,11,22,1,1,0
8893,107,8,14,11,3,0,1,0
0,0,0,0,0,0,0,0,0
0,0,0,0,0,0,0,0,0
3746,75,2,8,8,0,0,1,0
0,0,0,0,0,0,0,0,0
0,0,0,0,0,0,0,0,0
195236,1574,8,205,198,7,12,1,0
103981,835,7,123,90,33,20,1,0
38454,315,6,57,51,6,0,1,0
333000,4472,10,691,684,7,3,1,0
94963,1446,11,452,448,4,5,1,0
449610,2715,8,393,351,42,22,1,0
254471,1248,7,115,82,33,8,1,0
119259,448,2,39,30,9,1,1,0
1148158,11014,7,112,99,13,2,0,0
0,0,0,0,0,0,0,0,0
0,0,0,0,0,0,0,0,0
319971,2672,8,274,263,11,17,1,0
212770,986,6,79,64,15,1,1,0
148515,431,7,41,34,7,5,1,0
0,0,0,0,0,0,0,0,0
88146,644,9,106,105,1,1,1,0
0,0,0,0,0,0,0,0,0
0,0,0,0,0,0,0,0,0
92467,1041,2,60,33,27,2,1,0
91143,921,4,58,36,22,28,1,0
313387,962,4,138,129,9,10,1,0
26320,404,1,25,21,4,0,1,0
0,0,0,0,0,0,0,0,0
290102,3958,4,518,503,15,0,1,0
0,0,0,0,0,0,0,0,0
27777,272,4,32,27,5,2,0,0
46861,883,4,191,189,2,6,1,0
0,0,0,0,0,0,0,0,0
0,0,0,0,0,0,0,0,0
107506,1117,5,314,314,0,7,1,0
0,0,0,0,0,0,0,0,0
142570,1796,2,450,445,5,3,0,0
454574,335,2,18,8,10,2,0,0
53010,675,5,144,135,9,8,1,0
79459,471,3,51,41,10,0,1,0
9054,110,0,16,14,2,2,1,0
0,0,0,0,0,0,0,0,0
0,0,0,0,0,0,0,0,0
0,0,0,0,0,0,0,0,0
309369,2300,5,253,243,10,4,0,0
139547,1249,5,165,155,10,4,0,0
0,0,0,0,0,0,0,0,0
85539,744,2,315,315,0,4,1,0
209433,1840,10,342,218,124,35,1,0
306817,1693,20,429,420,9,6,1,0
87540,510,8,15,9,6,1,1,0
0,0,0,0,0,0,0,0,0
0,0,0,0,0,0,0,0,0
8796,42,0,0,0,0,0,0,0
1044703,1751,12,520,506,14,7,1,0
84171,998,2,85,75,10,2,1,0
0,0,0,0,0,0,0,0,0
84509,696,6,112,111,1,4,1,0
50009,330,4,22,21,1,3,1,0
377900,4017,10,305,295,10,14,1,0
622550,4692,8,671,631,40,4,1,0
495248,3791,8,569,529,40,4,1,0
0,0,0,0,0,0,0,0,0
231892,1097,7,99,84,15,6,1,1
127966,199,7,8,8,0,2,0,0
21365,230,4,38,32,6,1,1,0
16300,162,4,25,19,6,1,1,0
563516,2112,7,273,265,8,62,1,0
488882,1479,7,203,197,6,14,1,0
0,0,0,0,0,0,0,0,0
0,0,0,0,0,0,0,0,0
0,0,0,0,0,0,0,0,0
0,0,0,0,0,0,0,0,0
24025,129,8,24,23,1,0,1,0
0,0,0,0,0,0,0,0,0
112832,624,8,237,229,8,14,1,0
15327,276,4,59,50,9,0,1,0
64270,738,3,99,53,46,2,1,0
0,0,0,0,0,0,0,0,0
0,0,0,0,0,0,0,0,0
479086,467,18,95,89,6,1,1,0
0,0,0,0,0,0,0,0,0
0,0,0,0,0,0,0,0,0
0,0,0,0,0,0,0,0,0
1078182,1077,5,193,176,17,3,1,0
373105,2178,7,207,198,9,5,1,0
0,0,0,0,0,0,0,0,0
142934,2854,0,360,289,71,1,1,0
16257,289,0,35,34,1,0,1,0
0,0,0,0,0,0,0,0,0
29742,402,3,79,66,13,2,1,0
44872,385,7,55,21,34,0,1,0
52002,242,6,39,30,9,0,1,0
36236,55,7,2,2,0,0,0,0
0,0,0,0,0,0,0,0,0
0,0,0,0,0,0,0,0,0
73167,517,8,66,59,7,3,1,0
8057,73,6,3,2,1,0,0,0
0,0,0,0,0,0,0,0,0
273097,2174,9,206,198,8,3,1,0
132191,774,9,107,100,7,3,1,0
0,0,0,0,0,0,0,0,0
0,0,0,0,0,0,0,0,0
0,0,0,0,0,0,0,0,0
0,0,0,0,0,0,0,0,0
55322,407,1,89,80,9,0,1,0
0,0,0,0,0,0,0,0,0
0,0,0,0,0,0,0,0,0
0,0,0,0,0,0,0,0,0
323579,2247,16,178,163,15,0,1,0
42853,249,5,5,4,1,2,1,0
23684,35,0,2,1,1,0,1,0
0,0,0,0,0,0,0,0,0
0,0,0,0,0,0,0,0,0
8095,93,2,39,38,1,1,1,0
0,0,0,0,0,0,0,0,0
0,0,0,0,0,0,0,0,0
0,0,0,0,0,0,0,0,0
607619,2556,5,378,342,36,3,1,0
150723,1070,14,223,210,13,70,0,0
59974,416,9,81,74,7,6,1,0
99809,370,4,86,67,19,10,0,0
20636,253,3,56,38,18,6,0,0
640024,2512,16,301,277,24,52,1,0
160894,1072,13,152,137,15,8,1,0
45377,456,12,56,52,4,1,0,0
280258,1821,13,472,466,6,18,1,0
342003,1725,8,241,133,108,21,1,0
0,0,0,0,0,0,0,0,0
0,0,0,0,0,0,0,0,0
60363,449,7,61,57,4,4,1,0
292682,1097,1,183,181,2,39,1,0
0,0,0,0,0,0,0,0,0
0,0,0,0,0,0,0,0,0
742906,1224,1,97,78,19,0,1,0
7085,106,3,3,3,0,1,0,0
175607,3980,5,884,856,28,15,1,0
56359,667,13,58,29,29,2,1,0
74236,521,5,65,59,6,15,1,0
27365,197,5,21,18,3,3,1,0
0,0,0,0,0,0,0,0,0
0,0,0,0,0,0,0,0,0
58825,732,6,108,103,5,1,0,0
44633,458,7,95,91,4,1,1,0
490514,1071,12,182,162,20,4,1,0
28202,46,0,4,1,3,0,0,0
176243,1289,5,97,74,23,6,1,0
67028,544,1,185,177,8,16,1,0
17816,72,0,5,2,3,0,1,0
0,0,0,0,0,0,0,0,0
0,0,0,0,0,0,0,0,0
0,0,0,0,0,0,0,0,0
15717,206,2,30,19,11,0,0,0
64392,417,13,70,70,0,2,1,0
0,0,0,0,0,0,0,0,0
52393,461,2,108,106,2,10,1,0
81874,855,8,214,202,12,11,1,0
64362,630,6,134,134,0,14,1,1
86802,1360,6,129,122,7,6,1,0
11437,182,4,26,22,4,0,1,0
0,0,0,0,0,0,0,0,0
11705,120,1,13,12,1,0,1,0
0,0,0,0,0,0,0,0,0
0,0,0,0,0,0,0,0,0
0,0,0,0,0,0,0,0,0
948561,2687,3,461,452,9,3,1,0
678311,544,4,11,8,3,3,1,0
69993,1075,1,215,213,2,10,1,0
391528,2217,7,112,98,14,2,1,0
63280,40,0,4,4,0,0,0,0
239721,1162,17,206,190,16,9,1,0
0,0,0,0,0,0,0,0,0
189334,2288,2,44,43,1,24,1,0
0,0,0,0,0,0,0,0,0
518793,1379,11,155,133,22,24,1,0
0,0,0,0,0,0,0,0,0
171332,748,7,62,59,3,13,1,0
0,0,0,0,0,0,0,0,0
115135,1381,4,319,299,20,0,1,0
0,0,0,0,0,0,0,0,0
260845,1958,4,730,684,46,13,1,0
203809,1675,4,591,547,44,12,1,0
0,0,0,0,0,0,0,0,0
0,0,0,0,0,0,0,0,0
0,0,0,0,0,0,0,0,0
0,0,0,0,0,0,0,0,0
0,0,0,0,0,0,0,0,0
0,0,0,0,0,0,0,0,0
0,0,0,0,0,0,0,0,0
0,0,0,0,0,0,0,0,0
274137,1983,7,428,414,14,3,1,1
0,0,0,0,0,0,0,0,0
198526,1334,9,265,252,13,13,1,0
493562,1615,19,46,45,1,36,1,0
151675,494,16,60,50,10,1,1,0
17060,80,12,4,4,0,2,0,0
123820,1181,8,146,124,22,2,1,0
2027,30,1,1,0,1,0,0,0
0,0,0,0,0,0,0,0,0
0,0,0,0,0,0,0,0,0
113521,465,5,66,47,19,5,1,0
0,0,0,0,0,0,0,0,0
87337,1073,9,131,124,7,4,1,0
326804,1996,12,288,263,25,20,1,0
613635,3413,9,395,382,13,7,0,0
312064,2024,4,212,184,28,28,0,0
26851,135,4,10,8,2,1,1,0
448412,2969,5,467,402,65,5,0,0
381750,2427,5,422,357,65,5,0,0
0,0,0,0,0,0,0,0,0
26908,473,3,127,89,38,0,1,0
394477,204,4,40,35,5,4,1,0
87159,389,8,23,20,3,8,1,0
1031905,4067,7,108,100,8,10,1,0
0,0,0,0,0,0,0,0,0
0,0,0,0,0,0,0,0,0
86501,570,7,82,77,5,4,1,0
59540,183,9,2,1,1,6,0,0
0,0,0,0,0,0,0,0,0
380958,1592,8,275,166,109,33,1,0
0,0,0,0,0,0,0,0,0
0,0,0,0,0,0,0,0,0
0,0,0,0,0,0,0,0,0
0,0,0,0,0,0,0,0,0
0,0,0,0,0,0,0,0,0
1821,31,0,0,0,0,0,0,0
1480316,2221,9,337,325,12,19,1,0
0,0,0,0,0,0,0,0,0
0,0,0,0,0,0,0,0,0
0,0,0,0,0,0,0,0,0
372044,2501,10,416,360,56,61,1,0
59297,581,11,74,61,13,9,1,0
0,0,0,0,0,0,0,0,0
112458,1740,9,32,26,6,5,1,0
31721,239,2,42,41,1,4,1,0
0,0,0,0,0,0,0,0,0
0,0,0,0,0,0,0,0,0
119528,1066,0,293,293,0,24,1,0
0,0,0,0,0,0,0,0,0
157163,653,4,98,91,7,2,1,0
0,0,0,0,0,0,0,0,0
0,0,0,0,0,0,0,0,0
167762,515,0,62,62,0,9,0,0
0,0,0,0,0,0,0,0,0
0,0,0,0,0,0,0,0,0
0,0,0,0,0,0,0,0,0
0,0,0,0,0,0,0,0,0
455017,2503,9,606,595,11,10,1,0
228785,567,8,98,92,6,10,1,0
28643,463,6,162,162,0,2,1,0
0,0,0,0,0,0,0,0,0
0,0,0,0,0,0,0,0,0
0,0,0,0,0,0,0,0,0
149450,1357,9,207,197,10,10,1,0
454599,5542,0,505,505,0,0,0,0
89298,1475,8,199,132,67,1,1,0
0,0,0,0,0,0,0,0,0
0,0,0,0,0,0,0,0,0
23026,37,0,2,1,1,0,1,0
323053,1262,6,176,149,27,1,1,0
230272,1654,9,301,271,30,2,1,0
524716,3934,6,1120,1110,10,8,1,0
397337,3034,6,992,982,10,8,1,0
96293,939,6,223,223,0,2,0,0
369915,2115,8,108,69,39,1,1,0
205600,1326,3,328,312,16,23,0,0
63230,500,0,90,84,6,1,1,0
90522,732,6,77,68,9,0,0,0
52430,604,6,115,108,7,8,1,0
5039,183,0,89,83,6,0,0,0
100078,2349,1,989,988,1,0,0,0
177847,369,7,46,45,1,0,1,0
407648,3031,18,202,34,168,69,0,0
317254,1107,11,199,189,10,6,1,0
262739,1867,8,334,322,12,16,1,1
656328,2479,6,401,396,5,0,1,0
0,0,0,0,0,0,0,0,0
52134,731,4,145,138,7,1,1,0
149217,1080,6,142,135,7,4,0,0
81637,446,11,26,20,6,2,1,0
121347,355,6,57,57,0,19,1,0
0,0,0,0,0,0,0,0,0
0,0,0,0,0,0,0,0,0
71769,528,8,142,22,120,0,0,0
0,0,0,0,0,0,0,0,0
173645,1901,6,223,217,6,5,1,0
129919,907,10,213,183,30,11,1,0
0,0,0,0,0,0,0,0,0
82722,239,3,20,17,3,0,0,0
0,0,0,0,0,0,0,0,0
1860561,10424,5,502,436,66,247,1,0
418864,1752,6,152,146,6,34,1,0
0,0,0,0,0,0,0,0,0
0,0,0,0,0,0,0,0,0
0,0,0,0,0,0,0,0,0
117695,753,11,154,135,19,16,1,0
0,0,0,0,0,0,0,0,0
265283,1593,6,238,224,14,4,1,0
264252,770,12,100,87,13,6,1,0
17807,232,5,59,51,8,0,1,0
17807,232,5,59,51,8,0,1,0
0,0,0,0,0,0,0,0,0
94488,554,13,66,61,5,3,1,0
0,0,0,0,0,0,0,0,0
0,0,0,0,0,0,0,0,0
0,0,0,0,0,0,0,0,0
35215,365,4,58,50,8,0,1,0
19818,169,4,33,29,4,2,1,0
438134,2710,7,453,254,199,25,1,0
0,0,0,0,0,0,0,0,0
0,0,0,0,0,0,0,0,0
257365,3149,12,962,932,30,25,1,0
9646,118,1,17,17,0,0,1,0
23939,40,0,2,2,0,0,0,0
47886,304,6,76,51,25,0,1,0
95531,1295,7,270,254,16,10,1,0
42931,257,5,22,8,14,3,1,0
0,0,0,0,0,0,0,0,0
2576,44,1,7,4,3,0,1,0
0,0,0,0,0,0,0,0,0
0,0,0,0,0,0,0,0,0
186086,547,6,68,62,6,9,1,0
35944,193,2,11,5,6,5,1,0
0,0,0,0,0,0,0,0,0
2086,27,3,1,1,0,0,0,0
0,0,0,0,0,0,0,0,0
16345,58,3,5,5,0,0,0,0
0,0,0,0,0,0,0,0,0
0,0,0,0,0,0,0,0,0
127788,1097,2,88,67,21,5,1,0
0,0,0,0,0,0,0,0,0
201713,3493,2,970,967,3,0,0,0
16190,76,0,1,1,0,0,0,0
417803,2785,4,609,570,39,49,1,0
1567565,8221,10,631,143,488,9,1,0
0,0,0,0,0,0,0,0,0
0,0,0,0,0,0,0,0,0
0,0,0,0,0,0,0,0,0
0,0,0,0,0,0,0,0,0
0,0,0,0,0,0,0,0,0
87199,1810,2,565,509,56,23,0,0
0,0,0,0,0,0,0,0,0
3906464,33570,12,3769,2188,1581,23,1,0
47106,132,8,3,0,3,0,1,0
0,0,0,0,0,0,0,0,0
141645,1253,6,195,143,52,7,1,0
947734,3785,6,458,128,330,24,1,0
947676,3785,6,458,128,330,24,1,0
136733,305,10,44,33,11,1,1,0
409227,2877,11,598,593,5,1,1,0
0,0,0,0,0,0,0,0,0
228582,1269,4,130,120,10,2,1,0
350258,404,3,11,3,8,1,1,0
563937,5686,4,456,441,15,76,1,0
0,0,0,0,0,0,0,0,0
230182,1567,3,258,244,14,2,0,0
35760,457,2,71,69,2,7,1,0
28382,342,2,57,52,5,7,1,0
42640,370,3,82,76,6,0,1,0
27379,162,2,29,24,5,4,1,0
190774,1318,10,264,251,13,9,1,0
61815,1464,3,381,349,32,4,1,0
0,0,0,0,0,0,0,0,0
0,0,0,0,0,0,0,0,0
0,0,0,0,0,0,0,0,0
156017,1940,6,518,504,14,28,0,0
0,0,0,0,0,0,0,0,0
453408,3065,5,488,427,61,5,0,0
378597,2427,5,434,373,61,5,0,0
55110,968,4,302,277,25,4,0,0
22855,36,0,2,1,1,0,1,0
235174,1167,8,151,4,147,1,1,0
30597,567,1,105,81,24,3,1,0
0,0,0,0,0,0,0,0,0
22825,502,0,87,43,44,0,1,0
0,0,0,0,0,0,0,0,0
0,0,0,0,0,0,0,0,0
0,0,0,0,0,0,0,0,0
683790,3439,8,294,276,18,139,1,0
7171,103,1,14,12,2,1,0,0
150361,691,2,18,16,2,14,1,0
0,0,0,0,0,0,0,0,0
84880,362,6,44,42,2,10,1,0
0,0,0,0,0,0,0,0,0
52865,779,3,104,100,4,1,1,0
249662,2175,4,662,649,13,12,0,0
179849,1532,5,509,497,12,3,0,0
2940,26,0,2,1,1,0,0,0
65686,418,2,38,34,4,1,1,0
77961,211,2,38,34,4,1,1,0
0,0,0,0,0,0,0,0,0
255593,1336,5,172,168,4,14,1,0
44758,240,3,24,24,0,7,0,0
199018,519,5,36,36,0,0,1,0
0,0,0,0,0,0,0,0,0
0,0,0,0,0,0,0,0,0
112890,237,6,16,12,4,0,1,0
0,0,0,0,0,0,0,0,0
50293,611,4,131,131,0,4,1,0
44996,385,7,55,19,36,0,1,0
108203,1077,4,129,126,3,0,0,0
0,0,0,0,0,0,0,0,0
0,0,0,0,0,0,0,0,0
0,0,0,0,0,0,0,0,0
448919,697,5,48,39,9,5,1,0
0,0,0,0,0,0,0,0,0
0,0,0,0,0,0,0,0,0
0,0,0,0,0,0,0,0,0
0,0,0,0,0,0,0,0,0
0,0,0,0,0,0,0,0,0
41814,312,5,45,44,1,10,1,0
0,0,0,0,0,0,0,0,0
61014,827,1,253,214,39,4,0,0
124070,1994,5,322,283,39,10,1,0
78744,137,0,1,1,0,9,0,0
153525,691,9,60,55,5,1,0,0
0,0,0,0,0,0,0,0,0
0,0,0,0,0,0,0,0,0
360710,985,4,82,72,10,4,1,0
0,0,0,0,0,0,0,0,0
189013,1558,11,205,154,51,10,0,0
16606,333,4,99,93,6,4,0,0
47561,321,5,72,43,29,8,0,0
534476,7630,9,2104,1941,163,29,1,0
36475,655,7,164,162,2,5,1,0
103854,451,10,68,68,0,3,1,0
334793,1458,3,134,122,12,2,1,0
0,0,0,0,0,0,0,0,0
32716,332,8,24,13,11,45,1,0
23956,398,3,74,70,4,0,1,0
474457,862,9,85,77,8,18,1,0
0,0,0,0,0,0,0,0,0
0,0,0,0,0,0,0,0,0
46182,665,4,185,183,2,13,1,0
145238,1204,9,155,119,36,3,1,0
585263,6543,7,1070,1056,14,12,1,0
80515,561,13,61,58,3,1,1,0
57547,340,12,35,32,3,1,1,0
904455,2960,5,539,523,16,12,1,0
10441,147,0,8,7,1,1,0,0
0,0,0,0,0,0,0,0,0
0,0,0,0,0,0,0,0,0
0,0,0,0,0,0,0,0,0
0,0,0,0,0,0,0,0,0
29942,367,1,65,61,4,4,1,0
34037,524,7,91,56,35,0,1,0
34036,499,2,184,167,17,0,1,0
23376,240,3,68,66,2,0,1,0
31902,284,2,66,65,1,0,1,0
0,0,0,0,0,0,0,0,0
0,0,0,0,0,0,0,0,0
14519,206,1,58,53,5,0,1,0
0,0,0,0,0,0,0,0,0
0,0,0,0,0,0,0,0,0
70240,742,8,119,100,19,6,1,0
183643,881,14,140,121,19,2,1,0
0,0,0,0,0,0,0,0,0
0,0,0,0,0,0,0,0,0
218509,1173,5,300,293,7,0,1,0
0,0,0,0,0,0,0,0,0
0,0,0,0,0,0,0,0,0
531705,1038,9,103,92,11,3,1,0
0,0,0,0,0,0,0,0,0
79728,592,11,108,69,39,3,1,0
48090,163,4,4,4,0,3,0,0
349871,839,8,101,92,9,18,1,0
148278,1903,0,312,262,50,1,1,0
0,0,0,0,0,0,0,0,0
102576,2088,1,517,517,0,0,0,0
187397,1567,9,413,409,4,1,1,0
0,0,0,0,0,0,0,0,0
92467,1041,2,60,33,27,2,1,0
69394,482,8,48,44,4,2,1,0
69396,482,8,48,44,4,2,1,0
193620,1697,6,260,254,6,4,0,0
0,0,0,0,0,0,0,0,0
47414,449,5,56,56,0,8,1,0
26326,164,5,21,21,0,8,1,0
35351,448,6,110,71,39,0,1,0
13441,229,3,33,26,7,1,0,0
35669,448,6,79,44,35,0,1,0
16931,197,7,37,29,8,0,1,0
80838,744,8,213,192,21,0,1,0
0,0,0,0,0,0,0,0,0
0,0,0,0,0,0,0,0,0
0,0,0,0,0,0,0,0,0
131567,1024,5,90,87,3,1,1,0
867953,3224,3,882,869,13,1,1,0
179638,526,8,93,82,11,6,1,0
9360,111,3,12,12,0,0,1,0
0,0,0,0,0,0,0,0,0
160607,690,4,139,132,7,1,1,0
0,0,0,0,0,0,0,0,0
0,0,0,0,0,0,0,0,0
9090,190,3,24,19,5,0,1,0
0,0,0,0,0,0,0,0,0
0,0,0,0,0,0,0,0,0
723942,2664,11,798,751,47,14,0,0
99192,799,11,140,131,9,0,0,0
0,0,0,0,0,0,0,0,0
0,0,0,0,0,0,0,0,0
19356,48,3,6,1,5,0,1,0
0,0,0,0,0,0,0,0,0
0,0,0,0,0,0,0,0,0
84750,557,8,159,149,10,5,0,0
0,0,0,0,0,0,0,0,0
0,0,0,0,0,0,0,0,0
22863,37,0,2,1,1,0,1,0
695166,7568,7,2866,2862,4,4,1,0
0,0,0,0,0,0,0,0,0
51689,731,2,139,111,28,7,1,0
102789,904,8,205,197,8,12,1,0
192244,2739,1,410,399,11,1,1,0
102965,134,3,17,17,0,0,1,0
180731,692,2,96,69,27,1,1,0
44864,134,3,2,2,0,1,0,0
0,0,0,0,0,0,0,0,0
91094,790,9,58,39,19,0,1,0
0,0,0,0,0,0,0,0,0
0,0,0,0,0,0,0,0,0
1905467,13057,12,1757,1698,59,96,1,0
1640235,5781,11,131,116,15,19,1,0
0,0,0,0,0,0,0,0,0
1825,39,1,3,3,0,0,1,0
0,0,0,0,0,0,0,0,0
500392,2084,16,251,231,20,28,1,0
153401,1081,12,157,143,14,8,1,0
25626,337,6,63,63,0,2,1,0
23674,319,5,59,59,0,0,1,0
45216,214,4,36,26,10,1,0,0
0,0,0,0,0,0,0,0,0
36318,687,5,83,80,3,0,1,0
0,0,0,0,0,0,0,0,0
0,0,0,0,0,0,0,0,0
59622,360,9,72,69,3,0,1,0
0,0,0,0,0,0,0,0,0
2570861,9631,10,626,619,7,14,1,0
33415,578,1,168,168,0,3,1,0
0,0,0,0,0,0,0,0,0
91777,1071,15,82,74,8,19,1,0
77897,706,7,112,96,16,29,1,0
41257,355,6,85,85,0,3,1,0
513377,2801,7,310,208,102,75,1,0
97436,703,11,41,36,5,4,1,0
48328,377,7,59,35,24,12,1,0
0,0,0,0,0,0,0,0,0
0,0,0,0,0,0,0,0,0
57012,501,7,96,84,12,1,1,0
67987,528,3,115,0,115,0,1,0
0,0,0,0,0,0,0,0,0
72486,1032,2,195,166,29,0,1,0
20167,150,2,5,4,1,0,1,0
0,0,0,0,0,0,0,0,0
0,0,0,0,0,0,0,0,0
0,0,0,0,0,0,0,0,0
566586,4670,5,156,147,9,17,1,0
70430,415,5,44,37,7,5,1,0
63645,716,2,202,199,3,5,1,0
31173,335,1,49,49,0,5,1,0
0,0,0,0,0,0,0,0,0
0,0,0,0,0,0,0,0,0
198156,1173,8,166,150,16,10,1,0
174646,800,8,143,124,19,5,1,0
0,0,0,0,0,0,0,0,0
0,0,0,0,0,0,0,0,0
0,0,0,0,0,0,0,0,0
0,0,0,0,0,0,0,0,0
234983,730,6,147,144,3,21,1,0
80109,644,3,397,395,2,0,0,0
0,0,0,0,0,0,0,0,0
1054161,14124,8,1314,1288,26,120,1,0
168815,575,1,8,6,2,10,1,0
84629,486,11,52,33,19,4,1,0
0,0,0,0,0,0,0,0,0
161153,447,4,67,65,2,1,1,0
182050,1275,4,246,235,11,2,1,0
109806,1385,5,199,188,11,6,1,0
0,0,0,0,0,0,0,0,0
207323,432,9,82,71,11,3,1,0
16091,187,1,33,29,4,0,0,0
195,7,0,1,1,0,0,0,0
270114,3665,1,1024,899,125,129,1,0
34979,290,2,64,63,1,3,0,0
60081,531,4,37,37,0,0,1,0
12651,140,3,0,0,0,3,0,0
524141,1712,14,79,77,2,26,1,0
58820,474,2,89,86,3,1,1,0
0,0,0,0,0,0,0,0,0
71419,505,5,101,92,9,0,1,0
1244418,11704,2,2759,2698,61,23,1,0
97828,684,2,99,89,10,11,1,0
0,0,0,0,0,0,0,0,0
33645,357,6,47,46,1,0,1,0
0,0,0,0,0,0,0,0,0
0,0,0,0,0,0,0,0,0
0,0,0,0,0,0,0,0,0
32067,99,1,0,0,0,1,1,0
59762,826,1,43,33,10,0,1,0
13210,140,2,20,18,2,0,1,0
329176,3366,1,578,553,25,3,1,0
14473,275,3,58,57,1,1,1,0
0,0,0,0,0,0,0,0,0
27782,42,0,2,1,1,0,0,0
33645,139,8,18,10,8,1,1,0
33645,139,8,18,9,9,1,1,0
114437,741,2,166,160,6,12,1,0
0,0,0,0,0,0,0,0,0
0,0,0,0,0,0,0,0,0
61279,884,9,118,118,0,4,1,0
0,0,0,0,0,0,0,0,0
1123971,5611,14,427,351,76,12,1,0
144376,976,12,226,219,7,5,1,0
91330,991,4,244,238,6,0,0,0
30125,248,4,42,38,4,0,0,0
0,0,0,0,0,0,0,0,0
0,0,0,0,0,0,0,0,0
0,0,0,0,0,0,0,0,0
0,0,0,0,0,0,0,0,0
0,0,0,0,0,0,0,0,0
0,0,0,0,0,0,0,0,0
0,0,0,0,0,0,0,0,0
176166,104,0,2,2,0,2,1,0
0,0,0,0,0,0,0,0,0
127821,865,7,181,181,0,0,0,0
178731,1277,6,381,340,41,0,0,0
38920,342,5,25,14,11,0,1,0
0,0,0,0,0,0,0,0,0
467503,937,6,24,9,15,0,1,0
187781,551,6,57,53,4,0,0,0
0,0,0,0,0,0,0,0,0
0,0,0,0,0,0,0,0,0
31637,183,5,33,33,0,0,1,0
0,0,0,0,0,0,0,0,0
0,0,0,0,0,0,0,0,0
0,0,0,0,0,0,0,0,0
0,0,0,0,0,0,0,0,0
0,0,0,0,0,0,0,0,0
156604,1037,11,19,17,2,0,1,0
507927,3506,6,316,295,21,30,1,0
110909,558,6,82,67,15,0,1,0
0,0,0,0,0,0,0,0,0
57256,440,5,75,75,0,0,0,0
0,0,0,0,0,0,0,0,0
461404,4393,5,384,373,11,0,1,0
301208,365,0,17,13,4,2,1,0
0,0,0,0,0,0,0,0,0
0,0,0,0,0,0,0,0,0
0,0,0,0,0,0,0,0,0
93059,1295,7,166,147,19,7,1,0
60476,402,11,64,62,2,7,1,0
64504,1064,3,264,259,5,6,0,0
77866,553,11,103,100,3,4,1,0
842919,1253,5,116,111,5,8,1,0
411869,2830,12,600,572,28,50,1,0
0,0,0,0,0,0,0,0,0
0,0,0,0,0,0,0,0,0
175010,141,0,5,5,0,0,0,0
244001,1665,6,210,203,7,6,1,0
104567,709,3,156,155,1,9,1,0
12224,314,1,73,71,2,0,1,0
0,0,0,0,0,0,0,0,0
0,0,0,0,0,0,0,0,0
50175,264,4,47,36,11,0,1,0
0,0,0,0,0,0,0,0,0
0,0,0,0,0,0,0,0,0
0,0,0,0,0,0,0,0,0
0,0,0,0,0,0,0,0,0
315711,2993,7,405,292,113,8,1,0
259716,1265,7,184,168,16,8,1,0
177907,1025,7,58,57,1,0,1,0
0,0,0,0,0,0,0,0,0
17762,303,4,65,10,55,3,0,0
69185,390,0,76,34,42,0,1,0
61588,417,3,58,56,2,10,0,0
109472,198,4,22,16,6,3,0,0
0,0,0,0,0,0,0,0,0
18893,70,3,9,9,0,0,1,0
230448,987,8,156,130,26,11,0,0
101662,923,11,157,143,14,5,1,0
24659,328,8,63,54,9,2,1,0
169314,972,4,211,207,4,1,0,0
73081,1928,2,567,567,0,1,1,0
242289,1023,4,245,241,4,0,1,0
326215,2342,13,370,351,19,12,0,0
0,0,0,0,0,0,0,0,0
242876,1152,8,141,124,17,1,1,0
0,0,0,0,0,0,0,0,0
47547,381,5,21,13,8,0,1,0
395719,2285,5,396,364,32,22,1,0
0,0,0,0,0,0,0,0,0
159003,753,7,105,73,32,6,0,0
110042,221,5,47,41,6,0,1,0
260234,1070,6,135,119,16,3,1,0
0,0,0,0,0,0,0,0,0
269107,719,2,95,78,17,1,1,0
236828,483,2,84,69,15,0,1,0
0,0,0,0,0,0,0,0,0
0,0,0,0,0,0,0,0,0
175416,875,11,111,0,111,10,1,0
66515,947,1,197,188,9,2,1,0
0,0,0,0,0,0,0,0,0
1092549,2361,7,488,419,69,17,1,0
699076,544,7,80,57,23,13,1,0
67848,978,6,285,211,74,9,1,0
0,0,0,0,0,0,0,0,0
224328,3003,4,786,745,41,1,0,0
45945,454,4,36,17,19,1,0,0
379154,2816,11,208,205,3,45,1,0
222528,1203,11,126,123,3,3,1,0
78334,531,12,122,122,0,4,1,0
0,0,0,0,0,0,0,0,0
163724,1845,8,255,230,25,4,0,0
138086,743,10,121,18,103,5,1,0
0,0,0,0,0,0,0,0,0
0,0,0,0,0,0,0,0,0
58747,821,7,145,98,47,9,1,0
3707,36,3,2,0,2,0,0,0
14014,109,2,10,9,1,0,0,0
0,0,0,0,0,0,0,0,0
48259,355,3,52,43,9,0,1,0
6914,45,0,3,3,0,0,0,0
0,0,0,0,0,0,0,0,0
0,0,0,0,0,0,0,0,0
0,0,0,0,0,0,0,0,0
0,0,0,0,0,0,0,0,0
1690147,1358,3,105,103,2,2,1,0
194429,553,2,83,72,11,1,0,0
245515,994,7,44,40,4,0,1,0
54465,565,8,122,84,38,5,0,0
0,0,0,0,0,0,0,0,0
0,0,0,0,0,0,0,0,0
37375,458,4,43,42,1,2,1,0
1817,35,0,1,1,0,0,1,0
259288,384,6,10,6,4,0,1,0
0,0,0,0,0,0,0,0,0
82215,1486,3,235,175,60,0,1,0
21389,180,3,48,48,0,0,0,0
872112,2089,12,246,213,33,3,1,0
16208,125,8,8,7,1,0,1,0
288437,1493,11,224,68,156,6,1,0
95530,1514,3,367,362,5,7,0,0
0,0,0,0,0,0,0,0,0
319427,1139,2,303,273,30,3,1,0
0,0,0,0,0,0,0,0,0
0,0,0,0,0,0,0,0,0
971578,2349,1,131,126,5,3,0,0
0,0,0,0,0,0,0,0,0
0,0,0,0,0,0,0,0,0
0,0,0,0,0,0,0,0,0
160934,1749,11,427,412,15,24,1,0
180142,1843,9,237,214,23,7,1,0
0,0,0,0,0,0,0,0,0
0,0,0,0,0,0,0,0,0
170029,936,5,62,56,6,6,0,0
79424,498,11,128,121,7,9,1,0
104579,491,12,80,67,13,11,1,0
45603,792,3,323,321,2,0,1,0
6362,120,2,23,22,1,0,1,0
0,0,0,0,0,0,0,0,0
0,0,0,0,0,0,0,0,0
60278,441,6,38,36,2,15,1,0
253600,1158,5,248,242,6,9,1,1
0,0,0,0,0,0,0,0,0
583229,7184,1,2057,2047,10,26,0,0
34784,402,3,70,43,27,4,1,0
87228,664,3,115,106,9,14,1,0
0,0,0,0,0,0,0,0,0
83110,518,9,50,39,11,5,1,0
506775,2156,4,192,179,13,42,1,0
0,0,0,0,0,0,0,0,0
833307,13831,13,1405,1392,13,7,1,0
54641,358,8,55,55,0,2,0,0
79723,455,8,58,53,5,2,0,0
0,0,0,0,0,0,0,0,0
0,0,0,0,0,0,0,0,0
0,0,0,0,0,0,0,0,0
0,0,0,0,0,0,0,0,0
295306,999,8,262,254,8,10,1,0
213829,1194,9,135,104,31,17,1,0
49141,78,5,2,2,0,0,0,0
0,0,0,0,0,0,0,0,0
34515,347,7,29,29,0,2,0,0
0,0,0,0,0,0,0,0,0
0,0,0,0,0,0,0,0,0
54789,446,6,112,110,2,0,1,0
0,0,0,0,0,0,0,0,0
743984,3540,9,218,94,124,3,1,0
453173,3705,14,762,734,28,43,1,0
0,0,0,0,0,0,0,0,0
0,0,0,0,0,0,0,0,0
0,0,0,0,0,0,0,0,0
0,0,0,0,0,0,0,0,0
298999,1654,19,155,148,7,23,1,0
194399,2376,5,143,68,75,0,0,0
10914,89,5,5,5,0,1,0,0
125495,2181,8,586,510,76,48,1,0
64785,1546,5,534,468,66,46,1,0
0,0,0,0,0,0,0,0,0
186256,1497,5,412,407,5,0,1,0
56201,370,6,62,62,0,7,1,0
0,0,0,0,0,0,0,0,0
0,0,0,0,0,0,0,0,0
0,0,0,0,0,0,0,0,0
0,0,0,0,0,0,0,0,0
11502,174,1,46,45,1,1,0,0
0,0,0,0,0,0,0,0,0
0,0,0,0,0,0,0,0,0
69586,1291,6,291,290,1,1,1,0
0,0,0,0,0,0,0,0,0
0,0,0,0,0,0,0,0,0
0,0,0,0,0,0,0,0,0
155115,1374,11,188,182,6,5,1,0
8098,68,6,3,2,1,0,0,0
148972,1539,12,351,343,8,74,1,0
0,0,0,0,0,0,0,0,0
28928,45,0,4,1,3,0,0,0
1226984,3390,8,242,230,12,24,1,0
827417,3934,13,952,933,19,70,1,0
0,0,0,0,0,0,0,0,0
288172,1631,14,259,243,16,8,1,0
35666,536,2,34,31,3,0,1,0
300797,3410,7,345,338,7,38,1,0
553386,4460,10,634,610,24,49,1,0
0,0,0,0,0,0,0,0,0
601520,1845,7,126,99,27,35,1,0
134478,1112,10,10,6,4,4,0,0
3024390,8898,6,459,38,421,0,1,0
160275,665,4,45,38,7,22,1,0
0,0,0,0,0,0,0,0,0
0,0,0,0,0,0,0,0,0
0,0,0,0,0,0,0,0,0
145,5,0,0,0,0,0,0,0
0,0,0,0,0,0,0,0,0
159523,1246,19,218,188,30,6,1,0
50731,292,4,55,3,52,5,1,0
0,0,0,0,0,0,0,0,0
95611,696,5,95,93,2,0,1,0
271485,2687,11,554,542,12,9,1,0
0,0,0,0,0,0,0,0,0
153099,1726,5,249,238,11,15,1,0
121358,1360,5,427,418,9,10,1,0
53789,692,4,204,191,13,6,1,0
22098,33,0,1,1,0,0,1,0
0,0,0,0,0,0,0,0,0
0,0,0,0,0,0,0,0,0
261115,2216,5,101,95,6,4,1,0
22099,35,0,1,1,0,0,1,0
46181,692,4,249,247,2,2,1,0
298885,599,4,80,58,22,0,1,0
0,0,0,0,0,0,0,0,0
86721,793,8,188,176,12,5,1,0
55482,668,8,165,155,10,6,1,0
0,0,0,0,0,0,0,0,0
583578,5714,10,92,82,10,9,1,0
0,0,0,0,0,0,0,0,0
64802,583,6,35,18,17,10,1,0
217259,748,1,230,120,110,1,1,0
1864522,272,6,21,15,6,4,1,0
0,0,0,0,0,0,0,0,0
395988,2090,9,157,146,11,5,0,0
0,0,0,0,0,0,0,0,0
428369,2821,10,348,319,29,27,1,0
0,0,0,0,0,0,0,0,0
756684,2232,2,104,85,19,1,1,0
0,0,0,0,0,0,0,0,0
232004,1460,11,96,74,22,1,1,0
563334,3084,13,979,973,6,7,1,0
0,0,0,0,0,0,0,0,0
0,0,0,0,0,0,0,0,0
107329,1779,4,238,219,19,18,1,0
0,0,0,0,0,0,0,0,0
0,0,0,0,0,0,0,0,0
5018,101,1,15,11,4,0,1,0
0,0,0,0,0,0,0,0,0
0,0,0,0,0,0,0,0,0
4856,35,4,3,1,2,0,1,0
226244,1145,7,271,262,9,10,1,0
339762,4047,12,1291,1269,22,10,0,0
346250,917,0,226,225,1,1,1,0
178794,74,6,4,4,0,0,1,0
0,0,0,0,0,0,0,0,0
277687,1137,5,195,190,5,0,1,0
164377,904,12,126,120,6,10,1,0
0,0,0,0,0,0,0,0,0
0,0,0,0,0,0,0,0,0
0,0,0,0,0,0,0,0,0
0,0,0,0,0,0,0,0,0
0,0,0,0,0,0,0,0,0
769920,457,6,12,9,3,0,1,0
326691,1861,20,287,228,59,24,1,0
0,0,0,0,0,0,0,0,0
92967,1537,2,511,494,17,0,1,0
21655,361,2,153,147,6,0,1,0
515955,3633,7,132,112,20,3,1,0
223406,180,0,47,37,10,1,1,0
271406,76,0,5,0,5,0,0,0
21944,33,0,1,1,0,0,1,0
440108,647,4,22,18,4,4,1,0
441332,497,6,19,15,4,2,1,0
0,0,0,0,0,0,0,0,0
0,0,0,0,0,0,0,0,0
91048,459,1,14,12,2,11,1,0
0,0,0,0,0,0,0,0,0
1345221,1065,15,141,108,33,6,1,0
5162,33,1,0,0,0,0,0,0
67053,1170,3,281,266,15,6,0,0
0,0,0,0,0,0,0,0,0
211387,2707,8,416,398,18,2,0,0
70021,617,9,125,122,3,3,0,0
0,0,0,0,0,0,0,0,0
108972,455,8,106,102,4,10,1,0
0,0,0,0,0,0,0,0,0
526531,2289,9,158,139,19,77,1,0
0,0,0,0,0,0,0,0,0
0,0,0,0,0,0,0,0,0
113853,647,7,117,109,8,7,1,0
129052,1212,0,101,95,6,2,0,1
168793,1310,8,278,243,35,5,1,0
47676,609,4,137,137,0,3,0,0
0,0,0,0,0,0,0,0,0
0,0,0,0,0,0,0,0,0
0,0,0,0,0,0,0,0,0
35345,812,2,118,88,30,49,0,0
0,0,0,0,0,0,0,0,0
0,0,0,0,0,0,0,0,0
44726,533,2,174,148,26,1,0,0
0,0,0,0,0,0,0,0,0
217717,1056,11,107,105,2,4,1,0
0,0,0,0,0,0,0,0,0
0,0,0,0,0,0,0,0,0
67453,571,4,54,54,0,26,0,0
81648,820,4,123,110,13,5,1,1
0,0,0,0,0,0,0,0,0
205943,436,7,48,46,2,8,1,0
200288,282,7,38,37,1,7,1,0
477018,1680,1,99,80,19,4,1,0
373837,688,1,20,14,6,1,1,0
0,0,0,0,0,0,0,0,0
11227,58,0,3,3,0,0,0,0
0,0,0,0,0,0,0,0,0
133672,795,12,84,22,62,3,0,0
316590,1094,8,138,131,7,6,1,0
0,0,0,0,0,0,0,0,0
373055,2698,11,119,111,8,2,1,0
0,0,0,0,0,0,0,0,0
0,0,0,0,0,0,0,0,0
581877,2918,6,409,383,26,61,1,0
317194,1852,6,382,372,10,45,1,0
25046,526,5,153,147,6,0,1,0
0,0,0,0,0,0,0,0,0
0,0,0,0,0,0,0,0,0
0,0,0,0,0,0,0,0,0
0,0,0,0,0,0,0,0,0
0,0,0,0,0,0,0,0,0
0,0,0,0,0,0,0,0,0
239894,1296,9,219,179,40,8,1,0
0,0,0,0,0,0,0,0,0
156777,1526,2,296,255,41,1,1,0
103201,700,6,82,65,17,1,0,0
835728,6787,5,3045,3029,16,0,0,0
815837,6637,5,3009,2999,10,2,0,0
57310,239,3,23,23,0,8,0,0
0,0,0,0,0,0,0,0,0
0,0,0,0,0,0,0,0,0
0,0,0,0,0,0,0,0,0
0,0,0,0,0,0,0,0,0
100365,1855,8,65,31,34,17,0,1
0,0,0,0,0,0,0,0,0
0,0,0,0,0,0,0,0,0
64441,770,2,154,96,58,2,1,0
0,0,0,0,0,0,0,0,0
138978,874,5,72,59,13,82,1,0
157383,1152,5,253,253,0,76,1,0
410199,2872,11,436,70,366,46,1,0
314100,1851,5,257,236,21,16,1,0
0,0,0,0,0,0,0,0,0
164316,687,11,107,103,4,1,1,0
0,0,0,0,0,0,0,0,0
82037,1626,8,351,339,12,0,1,0
60660,1196,9,304,294,10,2,1,0
57222,386,6,144,19,125,0,0,0
58737,612,6,135,127,8,0,0,0
0,0,0,0,0,0,0,0,0
0,0,0,0,0,0,0,0,0
125964,515,12,50,46,4,6,1,0
0,0,0,0,0,0,0,0,0
58937,818,7,80,78,2,5,0,0
22468,266,7,42,42,0,4,0,0
0,0,0,0,0,0,0,0,0
0,0,0,0,0,0,0,0,0
203331,1087,3,210,201,9,2,1,0
51108,508,7,44,8,36,4,1,0
306094,1004,9,178,157,21,8,1,0
0,0,0,0,0,0,0,0,0
249906,2340,7,328,324,4,957,0,0
272665,349,10,38,2,36,1,1,0
259469,344,12,43,38,5,2,1,0
23281,286,1,6,4,2,0,1,0
0,0,0,0,0,0,0,0,0
500443,16177,6,7751,7750,1,7,1,0
11376,70,4,3,3,0,1,0,0
0,0,0,0,0,0,0,0,0
174449,2126,3,459,450,9,9,0,0
28780,228,3,46,45,1,10,0,0
0,0,0,0,0,0,0,0,0
48035,924,2,159,149,10,5,0,0
8689,78,6,7,7,0,0,0,0
298093,2916,9,327,302,25,31,0,0
0,0,0,0,0,0,0,0,0
0,0,0,0,0,0,0,0,0
945922,1458,10,148,135,13,7,1,0
0,0,0,0,0,0,0,0,0
768968,4885,5,608,531,77,151,1,0
262836,1908,5,285,280,5,45,1,0
77281,1062,13,236,188,48,1,1,0
125080,969,17,126,100,26,30,1,0
241153,878,1,161,156,5,4,1,0
163400,330,1,74,24,50,0,1,0
0,0,0,0,0,0,0,0,0
0,0,0,0,0,0,0,0,0
222968,1631,7,530,478,52,10,1,1
2407130,26926,12,6316,6290,26,35,1,0
0,0,0,0,0,0,0,0,0
37114,441,3,47,35,12,3,0,0
52632,529,6,54,44,10,6,1,0
13271,306,0,89,43,46,0,1,0
3897,105,0,25,25,0,0,1,0
49717,221,5,28,15,13,0,1,0
0,0,0,0,0,0,0,0,0
0,0,0,0,0,0,0,0,0
202279,2884,8,1051,1033,18,13,1,0
29646,410,5,12,12,0,3,1,0
105405,427,0,57,2,55,2,1,0
0,0,0,0,0,0,0,0,0
0,0,0,0,0,0,0,0,0
0,0,0,0,0,0,0,0,0
0,0,0,0,0,0,0,0,0
638506,5033,8,470,454,16,1,1,0
73022,738,9,174,173,1,0,0,0
0,0,0,0,0,0,0,0,0
0,0,0,0,0,0,0,0,0
50590,381,11,60,40,20,15,1,0
119229,2002,3,400,387,13,0,0,0
20623,459,3,148,134,14,2,1,0
3367,43,2,2,2,0,0,0,0
0,0,0,0,0,0,0,0,0
183601,662,14,70,63,7,1,1,0
26837,34,0,2,1,1,0,0,0
0,0,0,0,0,0,0,0,0
0,0,0,0,0,0,0,0,0
0,0,0,0,0,0,0,0,0
83848,398,3,29,4,25,0,1,0
271579,554,1,69,64,5,8,1,0
0,0,0,0,0,0,0,0,0
0,0,0,0,0,0,0,0,0
0,0,0,0,0,0,0,0,0
40999,307,8,37,31,6,3,1,0
154489,1344,7,208,202,6,4,1,0
0,0,0,0,0,0,0,0,0
0,0,0,0,0,0,0,0,0
676528,556,0,4,0,4,2,1,1
1115133,767,2,49,39,10,5,1,0
0,0,0,0,0,0,0,0,0
189403,583,6,13,11,2,2,1,0
1205273,6184,12,806,773,33,88,1,0
342544,1849,12,350,343,7,10,1,0
67615,1051,5,274,251,23,7,1,0
3510,73,0,4,4,0,0,1,0
42321,955,4,62,61,1,3,0,0
422439,4237,9,1034,963,71,3,1,0
0,0,0,0,0,0,0,0,0
870600,1567,7,198,181,17,0,1,0
148249,333,2,10,7,3,0,1,0
0,0,0,0,0,0,0,0,0
0,0,0,0,0,0,0,0,0
22937,265,5,51,44,7,16,1,1
302303,1358,12,119,116,3,21,1,0
0,0,0,0,0,0,0,0,0
132762,640,9,150,146,4,12,1,0
0,0,0,0,0,0,0,0,0
24687,467,3,87,69,18,2,1,0
67987,628,10,142,136,6,13,1,0
0,0,0,0,0,0,0,0,0
0,0,0,0,0,0,0,0,0
0,0,0,0,0,0,0,0,0
85148,638,8,168,164,4,1,1,0
950591,8710,14,133,126,7,8,1,0
900892,8267,13,120,112,8,8,1,0
67983,469,15,48,13,35,4,1,0
0,0,0,0,0,0,0,0,0
22157,35,0,1,1,0,0,1,0
13614,203,0,28,22,6,0,1,0
0,0,0,0,0,0,0,0,0
0,0,0,0,0,0,0,0,0
189041,2511,6,799,792,7,4,1,0
0,0,0,0,0,0,0,0,0
4277,56,3,7,7,0,1,0,0
0,0,0,0,0,0,0,0,0
0,0,0,0,0,0,0,0,0
18878,44,0,1,0,1,2,0,1
38367,677,3,121,115,6,1,1,0
4013,44,2,3,2,1,0,0,0
61431,737,4,185,184,1,5,1,0
23955,123,4,3,3,0,5,0,0
0,0,0,0,0,0,0,0,0
0,0,0,0,0,0,0,0,0
0,0,0,0,0,0,0,0,0
201469,1355,5,208,187,21,18,1,0
318116,2392,3,481,451,30,7,1,0
38761,492,2,68,67,1,2,1,0
21709,292,2,37,36,1,1,1,0
0,0,0,0,0,0,0,0,0
0,0,0,0,0,0,0,0,0
232192,1148,6,103,92,11,14,1,0
7715,40,4,0,0,0,0,0,0
348155,849,5,85,84,1,0,1,0
220865,2551,6,820,812,8,0,1,0
303092,1343,7,44,31,13,17,0,0
127209,1332,3,408,340,68,6,1,0
133182,783,9,202,155,47,8,1,0
32972,353,7,55,45,10,8,1,0
14379,221,5,23,23,0,15,1,0
41835,364,9,79,76,3,6,1,0
35783,317,9,69,66,3,3,1,0
0,0,0,0,0,0,0,0,0
0,0,0,0,0,0,0,0,0
41196,388,6,50,43,7,4,0,0
0,0,0,0,0,0,0,0,0
138371,931,8,100,98,2,0,1,0
8504,140,6,24,19,5,0,0,0
0,0,0,0,0,0,0,0,0
0,0,0,0,0,0,0,0,0
119770,1484,7,239,235,4,1,1,0
0,0,0,0,0,0,0,0,0
120005,752,7,209,208,1,8,0,0
306185,2217,15,141,106,35,20,1,0
227545,1022,7,266,228,38,3,1,0
1082753,1890,9,239,211,28,12,1,0
562087,5234,14,972,961,11,52,1,0
377384,3430,13,821,811,10,37,1,0
0,0,0,0,0,0,0,0,0
205534,2471,7,607,584,23,0,1,0
0,0,0,0,0,0,0,0,0
0,0,0,0,0,0,0,0,0
0,0,0,0,0,0,0,0,0
0,0,0,0,0,0,0,0,0
307473,2677,10,371,320,51,9,0,0
285709,1443,12,221,198,23,55,1,0
113360,594,9,86,81,5,11,1,0
86921,335,8,52,47,5,4,1,0
72494,573,9,58,43,15,1,0,0
459423,3513,8,606,595,11,9,1,0
0,0,0,0,0,0,0,0,0
273250,1202,6,102,69,33,15,1,0
485028,2612,11,230,191,39,17,1,0
0,0,0,0,0,0,0,0,0
0,0,0,0,0,0,0,0,0
35002,557,2,198,189,9,0,0,0
0,0,0,0,0,0,0,0,0
46814,798,3,165,158,7,6,1,0
2213572,11367,2,379,371,8,10,1,0
12954,171,0,15,6,9,0,1,0
43129,253,4,35,25,10,0,1,0
0,0,0,0,0,0,0,0,0
171671,674,8,106,86,20,11,1,0
1117218,4816,4,479,454,25,143,1,0
258536,134,3,6,3,3,7,0,0
0,0,0,0,0,0,0,0,0
0,0,0,0,0,0,0,0,0
68591,542,9,93,84,9,3,1,0
0,0,0,0,0,0,0,0,0
159335,1117,6,223,219,4,4,1,0
24300,216,7,39,36,3,4,1,0
7830,89,4,23,23,0,0,1,0
0,0,0,0,0,0,0,0,0
90636,388,10,46,46,0,1,1,0
0,0,0,0,0,0,0,0,0
16063,242,4,26,26,0,3,0,0
0,0,0,0,0,0,0,0,0
0,0,0,0,0,0,0,0,0
0,0,0,0,0,0,0,0,0
161571,1981,11,139,82,57,14,1,0
0,0,0,0,0,0,0,0,0
68339,271,9,3,1,2,9,1,0
39859,729,3,251,251,0,0,1,0
661740,4525,18,420,388,32,86,1,0
397561,1862,16,316,303,13,47,1,0
161787,1457,7,122,113,9,1,1,0
57046,562,6,105,99,6,0,0,0
0,0,0,0,0,0,0,0,0
0,0,0,0,0,0,0,0,0
0,0,0,0,0,0,0,0,0
23272,294,3,66,37,29,0,1,0
92324,850,12,70,60,10,12,0,0
0,0,0,0,0,0,0,0,0
125745,2094,6,351,327,24,7,1,0
247986,1100,4,151,137,14,4,1,0
58076,91,4,2,2,0,1,0,0
736643,8117,9,1222,1215,7,91,1,0
0,0,0,0,0,0,0,0,0
0,0,0,0,0,0,0,0,0
73000,666,8,109,81,28,5,1,0
11309,63,4,2,2,0,0,0,0
196633,1354,9,416,399,17,4,0,0
4300,90,1,36,32,4,0,0,0
2755,68,2,11,11,0,0,0,0
0,0,0,0,0,0,0,0,0
297039,1527,8,104,103,1,16,1,0
413474,4086,1,833,832,1,2,1,0
0,0,0,0,0,0,0,0,0
48849,542,9,90,85,5,0,0,0
28280,199,9,32,28,4,0,0,0
592578,14486,6,3188,3174,14,7,1,0
0,0,0,0,0,0,0,0,0
100434,836,9,257,244,13,12,1,0
28269,42,0,2,1,1,0,0,0
8759,33,1,0,0,0,1,0,0
0,0,0,0,0,0,0,0,0
0,0,0,0,0,0,0,0,0
0,0,0,0,0,0,0,0,0
158488,699,8,151,145,6,0,1,0
0,0,0,0,0,0,0,0,0
754192,3651,11,887,880,7,4,1,0
277302,3153,8,414,410,4,10,0,0
0,0,0,0,0,0,0,0,0
0,0,0,0,0,0,0,0,0
1757001,6134,9,514,498,16,12,1,0
1068815,4526,17,690,622,68,34,1,1
0,0,0,0,0,0,0,0,0
0,0,0,0,0,0,0,0,0
325246,1295,10,262,231,31,20,1,0
146794,1009,6,206,178,28,29,1,0
48812,873,1,154,148,6,1,1,0
150430,943,11,168,146,22,4,1,0
36090,436,10,80,70,10,1,1,0
0,0,0,0,0,0,0,0,0
85225,1203,0,275,244,31,4,0,0
134067,932,11,237,231,6,2,1,0
62807,763,0,195,192,3,6,1,1
0,0,0,0,0,0,0,0,0
103403,1315,2,247,244,3,1,0,0
0,0,0,0,0,0,0,0,0
120701,1507,8,231,189,42,1,0,0
147443,2047,7,321,311,10,23,1,0
7329,126,1,11,9,2,0,1,0
83421,734,6,155,139,16,10,0,0
2801,41,4,3,3,0,0,1,0
155075,1273,1,223,200,23,1,1,0
71091,909,3,142,137,5,1,1,0
0,0,0,0,0,0,0,0,0
58376,494,1,20,19,1,1,1,0
154212,2278,7,21,18,3,28,0,0
0,0,0,0,0,0,0,0,0
15614,280,0,35,30,5,0,1,0
188185,2330,4,510,506,4,1,1,0
89787,1054,3,312,308,4,0,1,0
179384,1775,6,178,168,10,96,1,0
2136126,8554,0,147,132,15,298,1,0
35738,416,0,71,67,4,0,1,0
239633,481,6,62,61,1,7,1,0
0,0,0,0,0,0,0,0,0
198039,1650,1,198,197,1,2,1,0
0,0,0,0,0,0,0,0,0
0,0,0,0,0,0,0,0,0
30239,408,6,114,110,4,7,1,0
85024,1285,8,171,164,7,11,1,0
0,0,0,0,0,0,0,0,0
149332,774,12,163,141,22,7,1,0
0,0,0,0,0,0,0,0,0
14825,188,6,11,11,0,0,0,1
14825,188,6,11,11,0,0,0,1
0,0,0,0,0,0,0,0,0
1399,15,0,1,0,1,0,0,0
236318,591,6,43,39,4,0,1,0
96061,954,3,77,48,29,9,0,0
0,0,0,0,0,0,0,0,0
183489,2037,6,462,462,0,7,0,0
129587,1353,3,201,192,9,0,1,0
38329,305,5,4,4,0,1,0,0
782157,5484,5,440,399,41,168,1,0
14438,221,2,58,57,1,10,1,0
9584,111,3,23,22,1,3,1,0
0,0,0,0,0,0,0,0,0
56300,265,1,20,20,0,11,1,0
0,0,0,0,0,0,0,0,0
0,0,0,0,0,0,0,0,0
0,0,0,0,0,0,0,0,0
57335,694,4,59,47,12,2,1,0
0,0,0,0,0,0,0,0,0
208340,1870,3,262,214,48,6,1,0
28344,303,4,65,55,10,5,1,0
11855,130,4,21,12,9,1,1,0
9937,70,0,3,2,1,0,0,0
0,0,0,0,0,0,0,0,0
0,0,0,0,0,0,0,0,0
25534,166,6,25,21,4,0,1,0
0,0,0,0,0,0,0,0,0
30707,296,4,33,30,3,3,1,0
9004,82,3,4,3,1,1,0,0
611083,610,7,107,95,12,4,1,0
27773,173,6,23,14,9,3,0,0
189293,2211,0,49,49,0,0,1,0
86960,277,0,39,39,0,0,1,0
256776,1463,5,175,140,35,1,1,0
267606,2749,8,1030,1029,1,17,1,0
58857,1242,6,22,20,2,3,0,0
0,0,0,0,0,0,0,0,0
62188,888,1,124,112,12,0,1,0
15552,193,1,52,47,5,1,1,0
294791,4027,2,696,694,2,1,1,0
127337,1491,9,220,141,79,6,0,0
5057,71,2,5,4,1,0,0,0
0,0,0,0,0,0,0,0,0
0,0,0,0,0,0,0,0,0
0,0,0,0,0,0,0,0,0
0,0,0,0,0,0,0,0,0
102938,473,6,81,58,23,2,1,0
127419,1494,13,214,209,5,1,1,0
0,0,0,0,0,0,0,0,0
345997,1424,8,155,146,9,31,1,0
137088,603,7,68,61,7,4,0,0
115993,328,4,36,18,18,0,1,0
85532,1148,11,101,93,8,0,1,0
31193,292,9,61,55,6,0,1,0
365804,1629,5,85,68,17,4,1,0
132706,683,5,117,1,116,28,1,0
130353,169,8,3,2,1,7,0,0
532257,4791,9,1159,1128,31,90,1,0
0,0,0,0,0,0,0,0,0
205110,665,9,90,88,2,8,1,0
0,0,0,0,0,0,0,0,0
240798,1298,8,135,130,5,16,1,0
130711,692,8,98,93,5,4,1,0
128624,611,3,85,7,78,2,1,0
22047,33,0,1,1,0,0,1,0
55186,520,5,33,14,19,0,1,0
261776,2533,2,205,192,13,3,1,0
182484,1207,11,287,270,17,19,1,0
48702,163,4,4,2,2,3,0,0
110909,879,7,152,151,1,10,1,0
0,0,0,0,0,0,0,0,0
186090,1568,3,361,354,7,1,1,0
29605,349,3,60,56,4,0,1,0
19109,235,4,33,33,0,1,1,0
734857,2586,11,267,222,45,12,1,0
0,0,0,0,0,0,0,0,0
35880,457,4,53,48,5,1,1,0
46545,340,4,25,15,10,0,1,0
0,0,0,0,0,0,0,0,0
0,0,0,0,0,0,0,0,0
1063710,1665,8,392,392,0,27,1,0
1028012,1264,9,200,199,1,27,1,0
0,0,0,0,0,0,0,0,0
0,0,0,0,0,0,0,0,0
0,0,0,0,0,0,0,0,0
0,0,0,0,0,0,0,0,0
298737,2700,12,212,164,48,2,1,0
81558,523,8,52,44,8,8,1,0
136690,796,7,67,58,9,23,1,0
452268,1597,15,179,148,31,108,1,0
92467,1041,2,60,33,27,2,1,0
0,0,0,0,0,0,0,0,0
259289,384,6,10,6,4,0,1,0
128526,775,9,106,96,10,7,1,0
189336,2605,6,477,408,69,5,1,0
0,0,0,0,0,0,0,0,0
0,0,0,0,0,0,0,0,0
0,0,0,0,0,0,0,0,0
220749,893,11,70,65,5,8,1,0
0,0,0,0,0,0,0,0,0
237321,1446,13,222,199,23,3,1,0
96857,828,3,153,151,2,2,1,0
0,0,0,0,0,0,0,0,0
198226,1127,7,190,181,9,13,0,0
0,0,0,0,0,0,0,0,0
0,0,0,0,0,0,0,0,0
31867,497,8,147,122,25,0,1,0
418048,384,7,10,4,6,0,1,0
17593,337,3,144,144,0,4,0,0
39915,705,5,168,139,29,2,1,0
1017992,4386,7,125,100,25,11,1,0
12823,163,5,20,19,1,0,1,0
3605,31,3,2,2,0,0,0,0
0,0,0,0,0,0,0,0,0
0,0,0,0,0,0,0,0,0
75560,562,4,101,66,35,26,1,1
0,0,0,0,0,0,0,0,0
337102,600,10,45,27,18,15,1,0
302940,1800,5,357,315,42,16,0,0
59491,637,5,160,155,5,16,1,0
0,0,0,0,0,0,0,0,0
0,0,0,0,0,0,0,0,0
22051,419,2,118,92,26,1,1,0
0,0,0,0,0,0,0,0,0
144293,1384,5,129,129,0,2,1,0
0,0,0,0,0,0,0,0,0
153135,1265,4,148,147,1,10,1,0
68708,515,4,93,93,0,10,1,0
10756,144,1,4,4,0,0,0,0
0,0,0,0,0,0,0,0,0
144956,1154,6,411,399,12,3,1,0
0,0,0,0,0,0,0,0,0
0,0,0,0,0,0,0,0,0
0,0,0,0,0,0,0,0,0
0,0,0,0,0,0,0,0,0
0,0,0,0,0,0,0,0,0
59151,708,1,152,150,2,8,1,0
0,0,0,0,0,0,0,0,0
51335,716,5,133,133,0,0,0,0
14558,153,7,28,28,0,0,0,0
0,0,0,0,0,0,0,0,0
0,0,0,0,0,0,0,0,0
368365,665,4,105,99,6,9,1,0
31566,619,2,168,157,11,0,1,0
36755,903,4,96,92,4,3,1,0
2464,34,0,1,1,0,0,0,0
0,0,0,0,0,0,0,0,0
364921,1352,8,233,223,10,38,1,0
66584,803,5,161,158,3,13,1,0
85694,586,9,77,11,66,3,0,0
4738,46,1,3,2,1,0,0,0
652650,3505,7,209,191,18,5,1,0
23215,268,3,55,40,15,0,1,0
41453,563,8,4,4,0,4,0,0
0,0,0,0,0,0,0,0,0
14202,192,7,42,33,9,0,0,0
0,0,0,0,0,0,0,0,0
29840,299,0,61,61,0,1,0,0
28303,42,0,2,1,1,0,0,0
16590,250,3,22,21,1,0,1,0
178101,494,0,21,7,14,73,0,0
0,0,0,0,0,0,0,0,0
88307,725,7,108,93,15,11,1,0
0,0,0,0,0,0,0,0,0
0,0,0,0,0,0,0,0,0
0,0,0,0,0,0,0,0,0
0,0,0,0,0,0,0,0,0
0,0,0,0,0,0,0,0,0
369129,1797,7,293,263,30,0,1,0
7830,33,0,2,2,0,0,1,0
0,0,0,0,0,0,0,0,0
0,0,0,0,0,0,0,0,0
266008,3634,1,1014,891,123,125,1,0
97427,1236,5,295,262,33,10,1,0
38499,403,7,22,22,0,11,0,0
1047522,5400,14,325,308,17,53,1,0
411202,1461,14,198,182,16,18,1,0
6551,114,3,12,0,12,0,1,0
0,0,0,0,0,0,0,0,0
307504,2680,14,374,150,224,3,1,0
345818,895,10,197,8,189,3,1,0
111663,1001,7,258,247,11,6,1,0
0,0,0,0,0,0,0,0,0
286046,1572,11,131,120,11,5,1,0
874426,103,5,2,1,1,0,1,0
89662,781,10,111,90,21,9,1,0
443425,3127,3,215,184,31,1,0,0
238291,1372,4,63,63,0,7,0,0
70088,994,1,223,223,0,0,1,0
731640,2937,6,252,188,64,9,1,0
0,0,0,0,0,0,0,0,0
0,0,0,0,0,0,0,0,0
784083,1290,3,114,95,19,5,1,0
860833,3868,7,514,404,110,85,1,0
111977,1793,7,221,207,14,4,1,0
18729,233,4,19,15,4,2,1,0
0,0,0,0,0,0,0,0,0
371658,3516,2,207,183,24,74,1,0
0,0,0,0,0,0,0,0,0
0,0,0,0,0,0,0,0,0
134326,940,4,18,15,3,3,1,0
0,0,0,0,0,0,0,0,0
3741,41,0,4,3,1,0,1,0
22915,37,0,2,1,1,0,1,0
120002,683,8,33,28,5,7,1,0
0,0,0,0,0,0,0,0,0
0,0,0,0,0,0,0,0,0
115962,1203,7,161,151,10,0,1,0
0,0,0,0,0,0,0,0,0
1284277,8512,2,271,253,18,9,1,0
0,0,0,0,0,0,0,0,0
0,0,0,0,0,0,0,0,0
582227,2059,22,115,93,22,40,1,0
0,0,0,0,0,0,0,0,0
93564,688,5,141,111,30,2,0,0
0,0,0,0,0,0,0,0,0
728929,4297,9,132,127,5,0,1,0
266423,1546,8,232,225,7,7,1,1
158162,2987,4,423,413,10,16,1,0
0,0,0,0,0,0,0,0,0
0,0,0,0,0,0,0,0,0
0,0,0,0,0,0,0,0,0
414312,2311,7,367,273,94,25,1,0
818367,2573,14,163,160,3,40,1,0
0,0,0,0,0,0,0,0,0
526959,1551,9,101,97,4,4,1,0
143386,817,8,117,113,4,6,1,0
6580,65,6,3,2,1,0,0,0
0,0,0,0,0,0,0,0,0
0,0,0,0,0,0,0,0,0
0,0,0,0,0,0,0,0,0
2183148,15738,8,3533,3509,24,22,1,0
0,0,0,0,0,0,0,0,0
327810,1610,5,209,115,94,10,1,0
106199,1032,3,311,8,303,3,1,0
385833,3615,10,838,477,361,18,1,0
0,0,0,0,0,0,0,0,0
85234,613,2,176,157,19,11,1,0
57844,661,6,93,85,8,0,0,0
0,0,0,0,0,0,0,0,0
391369,3752,9,1061,1048,13,18,1,0
111363,588,12,81,72,9,11,1,0
23281,286,1,6,4,2,0,1,0
55530,755,10,136,87,49,15,1,0
206771,574,7,105,5,100,0,1,0
231279,1461,14,252,223,29,8,1,0
0,0,0,0,0,0,0,0,0
290433,2497,12,294,285,9,73,1,0
8758,33,1,0,0,0,1,0,0
260384,1538,9,264,216,48,30,1,0
19586,482,1,129,129,0,1,1,0
6481,64,4,6,5,1,0,0,0
21958,35,0,1,1,0,0,1,0
0,0,0,0,0,0,0,0,0
16842,361,1,83,83,0,0,1,0
0,0,0,0,0,0,0,0,0
37644,149,4,2,2,0,1,1,0
0,0,0,0,0,0,0,0,0
135955,767,7,70,2,68,5,1,0
135769,1037,5,232,226,6,1,1,0
8131,73,2,10,7,3,0,0,0
2180051,3707,13,379,341,38,15,1,0
169239,1819,11,338,329,9,16,1,0
876395,4739,12,785,782,3,17,1,0
572191,3826,12,714,712,2,7,1,0
143855,2086,1,307,299,8,6,0,0
168448,1294,10,204,157,47,4,1,0
1988502,6291,4,296,241,55,117,0,0
132775,1104,10,244,222,22,13,1,0
142145,1861,9,332,325,7,69,1,0
48767,296,11,69,66,3,13,1,0
38024,330,5,30,25,5,0,1,0
38024,330,5,30,25,5,0,1,0
359612,2546,5,256,223,33,5,1,0
0,0,0,0,0,0,0,0,0
23246,33,0,1,1,0,0,1,0
0,0,0,0,0,0,0,0,0
0,0,0,0,0,0,0,0,0
665010,1293,4,229,217,12,10,1,0
183687,554,4,20,13,7,1,1,0
0,0,0,0,0,0,0,0,0
20690,191,5,4,4,0,5,0,0
0,0,0,0,0,0,0,0,0
0,0,0,0,0,0,0,0,0
365470,1085,7,142,3,139,13,1,0
651681,3473,5,646,21,625,7,1,0
0,0,0,0,0,0,0,0,0
267983,779,5,99,91,8,12,1,0
109218,799,7,147,136,11,0,1,0
327990,1466,13,221,195,26,8,1,0
8851,72,6,3,2,1,0,0,0
0,0,0,0,0,0,0,0,0
0,0,0,0,0,0,0,0,0
0,0,0,0,0,0,0,0,0
145364,487,11,46,46,0,0,1,0
52644,301,2,72,72,0,9,0,0
13310,211,3,48,46,2,3,0,0
7331,50,3,3,3,0,2,0,0
100078,894,9,259,255,4,9,1,0
0,0,0,0,0,0,0,0,0
213454,1269,5,270,260,10,1,1,0
2783,62,1,12,12,0,0,1,0
0,0,0,0,0,0,0,0,0
0,0,0,0,0,0,0,0,0
0,0,0,0,0,0,0,0,0
488130,1118,2,50,42,8,2,0,0
0,0,0,0,0,0,0,0,0
18096,87,1,6,2,4,0,1,0
1192732,3434,12,918,854,64,71,1,0
38029,89,1,2,1,1,0,0,0
194318,1249,14,197,156,41,2,0,0
0,0,0,0,0,0,0,0,0
0,0,0,0,0,0,0,0,0
0,0,0,0,0,0,0,0,0
252991,2571,8,454,440,14,4,1,0
0,0,0,0,0,0,0,0,0
0,0,0,0,0,0,0,0,0
1110464,9659,12,1763,1744,19,10,1,0
3956,70,7,9,9,0,0,1,0
0,0,0,0,0,0,0,0,0
0,0,0,0,0,0,0,0,0
0,0,0,0,0,0,0,0,0
0,0,0,0,0,0,0,0,0
0,0,0,0,0,0,0,0,0
74415,793,1,231,228,3,1,1,0
999462,2941,9,88,72,16,54,1,0
92430,1041,2,60,33,27,2,1,0
0,0,0,0,0,0,0,0,0
9179,74,5,0,0,0,0,0,0
0,0,0,0,0,0,0,0,0
0,0,0,0,0,0,0,0,0
232405,2233,4,247,148,99,0,0,0
166907,1499,5,259,247,12,7,0,0
0,0,0,0,0,0,0,0,0
180513,1674,0,280,280,0,11,1,0
13314,250,5,23,17,6,1,1,0
5403,65,3,11,11,0,0,1,0
93927,720,6,117,40,77,1,1,0
0,0,0,0,0,0,0,0,0
2070252,755,16,76,58,18,5,1,0
10465,74,7,3,2,1,0,0,0
0,0,0,0,0,0,0,0,0
0,0,0,0,0,0,0,0,0
207076,636,8,47,36,11,1,1,0
0,0,0,0,0,0,0,0,0
15497,161,3,32,29,3,1,1,0
211191,902,11,183,179,4,4,1,1
0,0,0,0,0,0,0,0,0
21936,33,0,1,1,0,0,1,0
42037,1231,2,478,477,1,7,1,0
0,0,0,0,0,0,0,0,0
265697,558,5,54,51,3,14,1,0
0,0,0,0,0,0,0,0,0
0,0,0,0,0,0,0,0,0
0,0,0,0,0,0,0,0,0
352223,1158,9,199,87,112,0,1,0
147210,984,7,167,152,15,1,1,0
0,0,0,0,0,0,0,0,0
0,0,0,0,0,0,0,0,0
506116,2499,11,129,98,31,19,1,0
18592,216,5,38,33,5,3,0,0
273878,1229,20,213,201,12,26,1,0
264079,628,9,39,24,15,15,1,0
0,0,0,0,0,0,0,0,0
573072,3452,10,343,319,24,8,1,0
12611,196,1,21,10,11,0,0,0
20177,351,0,130,122,8,0,1,0
8172,113,0,8,8,0,0,1,0
0,0,0,0,0,0,0,0,0
420858,1214,13,185,161,24,3,1,0
0,0,0,0,0,0,0,0,0
0,0,0,0,0,0,0,0,0
350187,858,6,192,155,37,7,1,0
302324,239,7,5,4,1,7,0,0
1314970,4393,3,173,170,3,0,1,0
0,0,0,0,0,0,0,0,0
137600,573,1,15,13,2,8,1,0
189683,1151,0,77,72,5,3,1,0
0,0,0,0,0,0,0,0,0
72351,780,7,123,114,9,2,0,0
0,0,0,0,0,0,0,0,0
0,0,0,0,0,0,0,0,0
0,0,0,0,0,0,0,0,0
0,0,0,0,0,0,0,0,0
360372,1722,6,297,224,73,5,1,0
183315,450,11,71,46,25,5,1,0
37497,410,5,74,61,13,11,1,0
22809,246,5,44,39,5,7,1,0
1077656,2979,7,609,571,38,0,1,0
87260,1087,5,175,171,4,3,1,0
13787,136,1,6,5,1,2,0,0
0,0,0,0,0,0,0,0,0
0,0,0,0,0,0,0,0,0
0,0,0,0,0,0,0,0,0
442203,1597,14,274,223,51,29,1,0
31226,298,8,40,29,11,3,0,0
526581,993,7,191,165,26,3,1,0
40257,531,7,95,89,6,1,0,0
660116,2027,19,243,194,49,12,1,0
14788,259,3,37,37,0,0,1,0
7711,125,3,19,19,0,0,1,0
153826,1105,8,46,39,7,0,1,0
11377,70,6,4,4,0,0,0,0
166339,529,3,67,63,4,1,1,0
496511,3819,10,639,639,0,1,1,0
57487,218,1,11,11,0,1,0,0
34578,88,3,4,2,2,0,0,0
350453,730,16,99,86,13,2,1,0
0,0,0,0,0,0,0,0,0
410173,1380,10,238,236,2,12,1,0
519822,1690,6,206,204,2,8,1,0
23175,326,2,52,17,35,0,0,0
95659,306,1,78,15,63,2,0,0
180564,1436,9,261,245,16,4,1,0
285212,1361,12,194,189,5,9,1,0
218599,1250,7,103,92,11,3,1,0
78557,501,5,130,125,5,7,1,0
205131,1468,2,317,294,23,0,0,0
0,0,0,0,0,0,0,0,0
258834,2644,5,635,590,45,4,0,0
77957,741,7,138,118,20,3,1,0
0,0,0,0,0,0,0,0,0
119667,1387,2,201,197,4,8,1,0
119869,163,2,18,15,3,0,1,0
1121107,2141,2,481,455,26,8,1,0
943060,6848,2,1113,1059,54,10,0,0
0,0,0,0,0,0,0,0,0
0,0,0,0,0,0,0,0,0
291089,4381,6,917,879,38,8,1,0
371156,1297,13,141,131,10,20,1,0
316143,1071,13,124,114,10,20,1,0
0,0,0,0,0,0,0,0,0
0,0,0,0,0,0,0,0,0
136567,1508,10,146,137,9,10,1,0
406996,1065,14,194,181,13,20,1,0
0,0,0,0,0,0,0,0,0
106290,743,9,103,86,17,14,1,0
1411,29,0,0,0,0,0,0,0
164487,837,5,95,88,7,15,1,0
0,0,0,0,0,0,0,0,0
114207,1227,6,157,146,11,13,1,0
0,0,0,0,0,0,0,0,0
401941,1577,11,264,245,19,23,1,0
0,0,0,0,0,0,0,0,0
270860,3479,3,369,335,34,1,1,0
44476,777,3,190,180,10,0,1,0
0,0,0,0,0,0,0,0,0
88428,523,12,140,124,16,8,1,0
0,0,0,0,0,0,0,0,0
103487,1189,7,130,114,16,33,0,0
0,0,0,0,0,0,0,0,0
0,0,0,0,0,0,0,0,0
0,0,0,0,0,0,0,0,0
311404,1399,3,112,82,30,1,1,0
0,0,0,0,0,0,0,0,0
3508220,2463,5,106,95,11,1,1,0
36473,75,1,3,2,1,0,0,0
0,0,0,0,0,0,0,0,0
0,0,0,0,0,0,0,0,0
0,0,0,0,0,0,0,0,0
25767,279,8,20,16,4,0,1,0
64169,1041,4,322,282,40,3,1,0
0,0,0,0,0,0,0,0,0
0,0,0,0,0,0,0,0,0
25237,520,0,93,51,42,0,1,0
0,0,0,0,0,0,0,0,0
132877,1387,3,307,297,10,18,0,0
79698,402,11,144,144,0,8,1,0
177761,777,6,144,13,131,3,1,0
892156,1482,1,125,103,22,23,1,0
0,0,0,0,0,0,0,0,0
0,0,0,0,0,0,0,0,0
0,0,0,0,0,0,0,0,0
405922,1380,2,41,30,11,1,1,0
0,0,0,0,0,0,0,0,0
0,0,0,0,0,0,0,0,0
0,0,0,0,0,0,0,0,0
0,0,0,0,0,0,0,0,0
70734,505,7,76,57,19,1,1,0
0,0,0,0,0,0,0,0,0
120213,602,13,55,47,8,16,0,0
2721847,811,4,87,86,1,5,1,0
0,0,0,0,0,0,0,0,0
0,0,0,0,0,0,0,0,0
0,0,0,0,0,0,0,0,0
148648,1301,10,137,128,9,7,1,0
0,0,0,0,0,0,0,0,0
0,0,0,0,0,0,0,0,0
190717,1255,10,235,222,13,23,1,0
0,0,0,0,0,0,0,0,0
50552,864,6,102,100,2,2,0,0
0,0,0,0,0,0,0,0,0
0,0,0,0,0,0,0,0,0
0,0,0,0,0,0,0,0,0
0,0,0,0,0,0,0,0,0
107485,1898,1,351,342,9,1,1,0
0,0,0,0,0,0,0,0,0
66121,339,4,93,93,0,4,1,0
182920,839,3,177,132,45,2,1,0
0,0,0,0,0,0,0,0,0
519042,3930,1,681,533,148,23,1,0
35826,566,1,145,144,1,9,1,0
436,6,0,0,0,0,0,0,0
0,0,0,0,0,0,0,0,0
79738,983,5,88,81,7,2,1,0
43471,363,6,129,122,7,1,1,0
0,0,0,0,0,0,0,0,0
0,0,0,0,0,0,0,0,0
0,0,0,0,0,0,0,0,0
0,0,0,0,0,0,0,0,0
154367,1450,8,227,202,25,10,1,0
0,0,0,0,0,0,0,0,0
0,0,0,0,0,0,0,0,0
0,0,0,0,0,0,0,0,0
566928,1776,10,274,262,12,14,1,0
0,0,0,0,0,0,0,0,0
123177,1289,3,268,264,4,0,0,0
26833,359,5,61,53,8,6,1,0
0,0,0,0,0,0,0,0,0
19111,308,1,76,75,1,0,1,0
37378,478,5,83,82,1,6,1,0
22914,211,2,60,57,3,3,0,0
0,0,0,0,0,0,0,0,0
1067174,667,5,71,13,58,2,1,0
0,0,0,0,0,0,0,0,0
0,0,0,0,0,0,0,0,0
105419,407,10,51,51,0,1,1,0
240959,2842,7,400,285,115,15,1,0
214972,844,12,65,51,14,2,1,0
0,0,0,0,0,0,0,0,0
110119,1709,3,400,400,0,0,1,0
503659,2557,6,381,313,68,16,1,0
356404,1359,5,162,152,10,0,1,0
0,0,0,0,0,0,0,0,0
683249,2677,18,294,278,16,12,1,0
74414,1929,2,568,567,1,1,1,0
0,0,0,0,0,0,0,0,0
0,0,0,0,0,0,0,0,0
77490,796,6,95,80,15,3,1,0
0,0,0,0,0,0,0,0,0
0,0,0,0,0,0,0,0,0
123085,261,5,8,8,0,0,1,0
0,0,0,0,0,0,0,0,0
0,0,0,0,0,0,0,0,0
0,0,0,0,0,0,0,0,0
94245,481,2,27,3,24,11,1,0
0,0,0,0,0,0,0,0,0
114096,606,3,48,39,9,2,1,0
103781,1128,1,136,127,9,0,1,0
0,0,0,0,0,0,0,0,0
691870,4725,10,1155,1127,28,17,1,0
163434,1265,7,328,327,1,12,1,0
439009,1551,4,165,163,2,13,0,0
29269,429,3,163,159,4,0,0,0
16341,103,4,6,3,3,0,0,0
75759,1080,3,307,297,10,9,1,0
0,0,0,0,0,0,0,0,0
0,0,0,0,0,0,0,0,0
0,0,0,0,0,0,0,0,0
0,0,0,0,0,0,0,0,0
0,0,0,0,0,0,0,0,0
0,0,0,0,0,0,0,0,0
30618,500,5,337,337,0,0,1,0
18133,127,4,18,17,1,0,1,0
0,0,0,0,0,0,0,0,0
0,0,0,0,0,0,0,0,0
0,0,0,0,0,0,0,0,0
75311,1323,6,258,217,41,0,1,0
0,0,0,0,0,0,0,0,0
0,0,0,0,0,0,0,0,0
0,0,0,0,0,0,0,0,0
0,0,0,0,0,0,0,0,0
92467,1041,2,60,33,27,2,1,0
0,0,0,0,0,0,0,0,0
157347,887,2,101,76,25,8,0,0
199713,3545,1,1841,1840,1,12,0,0
0,0,0,0,0,0,0,0,0
116613,809,10,135,134,1,1,1,0
213405,1787,11,285,269,16,7,1,0
0,0,0,0,0,0,0,0,0
23589,37,0,2,1,1,0,1,0
199718,1899,10,290,209,81,12,1,0
128181,113,0,6,3,3,2,1,0
70079,1173,4,149,68,81,5,1,0
0,0,0,0,0,0,0,0,0
0,0,0,0,0,0,0,0,0
0,0,0,0,0,0,0,0,0
61430,416,5,67,66,1,7,1,0
144376,803,3,111,33,78,0,1,0
148236,903,4,77,76,1,8,1,0
100786,534,4,61,60,1,2,1,0
0,0,0,0,0,0,0,0,0
166617,849,11,92,83,9,12,1,0
84122,175,7,18,17,1,5,1,0
0,0,0,0,0,0,0,0,0
0,0,0,0,0,0,0,0,0
320661,756,9,112,91,21,11,1,0
170073,193,7,28,24,4,1,1,0
0,0,0,0,0,0,0,0,0
0,0,0,0,0,0,0,0,0
0,0,0,0,0,0,0,0,0
871983,2755,10,351,336,15,29,1,0
59320,530,10,140,137,3,0,0,0
435811,1563,3,228,186,42,1,1,0
0,0,0,0,0,0,0,0,0
81939,973,10,194,173,21,5,1,0
0,0,0,0,0,0,0,0,0
0,0,0,0,0,0,0,0,0
125568,926,1,47,41,6,2,1,0
67138,533,9,78,71,7,5,0,0
160173,700,12,88,71,17,8,1,0
0,0,0,0,0,0,0,0,0
123475,617,6,100,99,1,2,1,0
0,0,0,0,0,0,0,0,0
0,0,0,0,0,0,0,0,0
0,0,0,0,0,0,0,0,0
209895,1316,5,275,245,30,13,0,0
118388,610,6,139,139,0,6,0,0
0,0,0,0,0,0,0,0,0
0,0,0,0,0,0,0,0,0
9151,160,6,16,13,3,0,1,0
7209,116,6,19,16,3,0,1,0
0,0,0,0,0,0,0,0,0
50948,606,2,134,115,19,19,1,0
53362,537,8,104,62,42,9,0,0
211997,1496,9,292,268,24,9,1,0
66646,517,10,107,103,4,14,1,0
0,0,0,0,0,0,0,0,0
55314,522,0,86,80,6,0,1,0
90195,1057,8,194,73,121,5,1,0
196303,1718,13,282,274,8,12,1,0
0,0,0,0,0,0,0,0,0
115285,800,0,49,37,12,0,0,0
22877,37,0,2,1,1,0,1,0
6181,121,1,41,37,4,0,0,0
0,0,0,0,0,0,0,0,0
0,0,0,0,0,0,0,0,0
33991,908,1,132,132,0,0,1,0
0,0,0,0,0,0,0,0,0
43106,435,3,47,42,5,1,1,0
0,0,0,0,0,0,0,0,0
185689,933,8,130,124,6,5,1,0
0,0,0,0,0,0,0,0,0
109239,1092,10,166,75,91,1,1,0
210170,766,8,63,1,62,0,1,0
188966,563,8,64,57,7,0,1,0
179981,1904,2,532,495,37,6,1,0
0,0,0,0,0,0,0,0,0
131029,434,10,67,59,8,3,1,0
1124156,381,2,33,28,5,8,1,0
151948,1628,8,217,205,12,1,1,0
0,0,0,0,0,0,0,0,0
0,0,0,0,0,0,0,0,0
0,0,0,0,0,0,0,0,0
36756,191,7,18,17,1,0,0,0
8129,67,6,3,2,1,0,0,0
0,0,0,0,0,0,0,0,0
212241,323,5,34,23,11,7,1,0
1192417,11432,13,746,721,25,11,1,0
28670,426,4,101,92,9,2,1,0
0,0,0,0,0,0,0,0,0
209363,527,6,73,61,12,9,1,0
205281,541,6,85,56,29,9,1,0
0,0,0,0,0,0,0,0,0
397049,1132,5,69,56,13,3,1,0
32841,142,3,2,1,1,3,0,0
0,0,0,0,0,0,0,0,0
166559,760,4,162,151,11,4,1,0
0,0,0,0,0,0,0,0,0
0,0,0,0,0,0,0,0,0
81200,1011,5,274,273,1,0,1,0
183671,615,6,93,86,7,9,1,0
599464,3064,9,224,164,60,26,1,0
0,0,0,0,0,0,0,0,0
200438,2134,8,408,398,10,4,1,0
812386,5519,5,75,16,59,134,1,0
59213,220,7,38,28,10,3,1,0
20839,302,4,43,37,6,2,1,0
134241,715,15,72,71,1,52,1,0
253768,4817,5,2678,2612,66,1,0,0
54790,200,6,41,41,0,10,0,0
440689,3856,6,419,254,165,26,1,0
112323,800,6,88,85,3,3,1,0
0,0,0,0,0,0,0,0,0
0,0,0,0,0,0,0,0,0
38693,416,3,53,50,3,9,1,0
56810,741,4,172,166,6,5,0,0
32089,325,4,57,51,6,5,0,0
233743,341,0,16,3,13,0,1,0
0,0,0,0,0,0,0,0,0
0,0,0,0,0,0,0,0,0
382459,4568,10,1262,1253,9,0,1,0
105023,1613,10,478,470,8,1,1,0
0,0,0,0,0,0,0,0,0
88493,1032,11,193,174,19,6,1,0
19541,248,6,34,25,9,2,0,0
10438,123,6,21,20,1,0,0,0
0,0,0,0,0,0,0,0,0
58969,546,8,92,82,10,1,1,0
86480,515,4,44,37,7,18,1,0
60284,293,6,29,23,6,0,1,0
237405,1389,3,169,147,22,29,1,0
170793,1077,5,7,5,2,26,0,0
0,0,0,0,0,0,0,0,0
138092,1470,6,319,280,39,1,0,0
0,0,0,0,0,0,0,0,0
174307,1294,9,333,324,9,5,1,0
0,0,0,0,0,0,0,0,0
139017,930,11,222,185,37,8,1,0
0,0,0,0,0,0,0,0,0
48253,612,2,135,104,31,1,0,0
0,0,0,0,0,0,0,0,0
146096,1450,7,116,103,13,5,1,0
320925,2975,14,730,646,84,6,1,0
193120,2187,15,496,434,62,11,1,0
267562,1388,8,230,177,53,0,1,0
397319,1980,6,250,165,85,4,1,0
0,0,0,0,0,0,0,0,0
0,0,0,0,0,0,0,0,0
202934,4127,3,1634,1389,245,5,0,0
0,0,0,0,0,0,0,0,0
0,0,0,0,0,0,0,0,0
246716,1167,4,120,111,9,0,1,0
327044,1625,8,455,450,5,6,1,0
67241,420,8,111,106,5,5,1,0
139052,902,5,194,178,16,1,1,0
151763,1517,5,211,123,88,1,0,0
0,0,0,0,0,0,0,0,0
0,0,0,0,0,0,0,0,0
259825,3253,6,314,304,10,30,1,0
927146,5635,13,783,655,128,38,1,0
0,0,0,0,0,0,0,0,0
0,0,0,0,0,0,0,0,0
60149,426,4,79,76,3,18,1,0
4865,49,0,5,5,0,0,0,0
1321020,12886,2,365,341,24,9,0,0
92636,279,2,16,14,2,3,0,0
0,0,0,0,0,0,0,0,0
0,0,0,0,0,0,0,0,0
92467,1041,2,60,33,27,2,1,0
117876,1214,2,355,349,6,26,1,0
0,0,0,0,0,0,0,0,0
164702,495,7,50,41,9,2,1,0
28995,183,10,15,15,0,4,0,0
0,0,0,0,0,0,0,0,0
159114,2140,7,122,100,22,4,1,0
73468,689,12,173,166,7,18,0,0
0,0,0,0,0,0,0,0,0
68705,769,0,195,181,14,26,0,0
251785,656,10,100,90,10,10,1,0
233880,650,5,73,73,0,0,1,0
0,0,0,0,0,0,0,0,0
557436,2507,8,197,172,25,31,1,0
156579,353,6,26,22,4,4,1,0
0,0,0,0,0,0,0,0,0
20038,261,4,42,31,11,0,1,0
149529,1730,8,700,686,14,3,1,0
264909,1875,10,568,552,16,18,1,0
393704,682,5,83,72,11,9,1,0
277977,430,5,59,48,11,8,1,0
0,0,0,0,0,0,0,0,0
396752,1057,7,40,33,7,7,1,0
0,0,0,0,0,0,0,0,0
628614,4182,13,312,307,5,4,1,0
0,0,0,0,0,0,0,0,0
97698,1314,2,232,63,169,0,1,0
54519,530,8,104,76,28,8,0,0
123081,173,5,29,25,4,1,1,0
122928,163,5,25,21,4,1,1,0
0,0,0,0,0,0,0,0,0
0,0,0,0,0,0,0,0,0
0,0,0,0,0,0,0,0,0
138712,2115,2,627,626,1,69,1,0
41808,408,5,75,69,6,0,1,0
92802,676,6,145,127,18,1,1,0
0,0,0,0,0,0,0,0,0
316909,1420,8,121,30,91,6,1,0
0,0,0,0,0,0,0,0,0
40566,593,2,46,45,1,0,1,0
264125,1186,8,136,127,9,7,0,0
0,0,0,0,0,0,0,0,0
228054,1380,9,212,170,42,6,1,0
4780,69,2,12,5,7,0,1,0
48167,934,2,234,233,1,1,1,0
13843,146,3,18,17,1,4,1,0
42178,400,2,40,26,14,1,1,0
18560,173,2,17,16,1,1,1,0
0,0,0,0,0,0,0,0,0
0,0,0,0,0,0,0,0,0
66146,749,9,29,29,0,0,0,0
8504,69,6,3,2,1,0,0,0
93710,1567,3,371,325,46,0,1,0
0,0,0,0,0,0,0,0,0
0,0,0,0,0,0,0,0,0
63214,624,10,132,120,12,2,1,0
18837,247,2,28,28,0,0,1,0
14673,197,2,29,29,0,0,1,0
327957,1177,4,108,96,12,8,1,0
164900,570,4,9,6,3,10,1,0
0,0,0,0,0,0,0,0,0
52470,251,7,27,17,10,0,1,0
466320,4718,16,767,763,4,17,1,0
56373,743,5,148,135,13,4,1,0
0,0,0,0,0,0,0,0,0
155539,2553,3,291,287,4,5,0,0
917058,3269,3,278,269,9,0,1,0
636865,1718,3,206,197,9,0,1,0
25810,238,2,18,6,12,1,0,0
26572,241,2,10,8,2,1,0,0
0,0,0,0,0,0,0,0,0
98332,1178,6,63,48,15,18,1,0
0,0,0,0,0,0,0,0,0
0,0,0,0,0,0,0,0,0
13534,121,0,14,7,7,0,1,0
534565,780,8,47,40,7,0,1,0
60975,353,5,20,17,3,4,0,0
0,0,0,0,0,0,0,0,0
199137,464,4,70,58,12,1,1,0
14893,86,5,16,10,6,0,1,0
0,0,0,0,0,0,0,0,0
0,0,0,0,0,0,0,0,0
14226,168,8,15,15,0,2,1,0
167795,857,13,154,147,7,39,1,0
0,0,0,0,0,0,0,0,0
0,0,0,0,0,0,0,0,0
105879,343,4,29,29,0,0,0,0
314842,3250,1,628,603,25,5,1,0
0,0,0,0,0,0,0,0,0
0,0,0,0,0,0,0,0,0
133156,371,5,29,26,3,0,1,0
57480,314,3,57,36,21,3,1,0
704476,190,5,14,13,1,2,0,0
208996,1282,10,250,220,30,10,1,0
0,0,0,0,0,0,0,0,0
101720,1151,6,299,269,30,5,1,0
364537,3012,4,327,110,217,0,1,0
9347074,126,3,2,2,0,1,1,0
58692,1004,4,201,197,4,4,1,0
17341,299,4,79,75,4,4,1,0
648407,3319,6,208,161,47,130,1,0
363298,1235,6,44,41,3,12,1,0
0,0,0,0,0,0,0,0,0
22484,299,4,39,29,10,1,0,0
0,0,0,0,0,0,0,0,0
66387,586,5,97,93,4,4,1,0
31581,198,5,20,19,1,3,1,0
0,0,0,0,0,0,0,0,0
394297,1187,8,232,201,31,8,1,0
0,0,0,0,0,0,0,0,0
0,0,0,0,0,0,0,0,0
0,0,0,0,0,0,0,0,0
176022,656,5,76,76,0,20,1,0
405180,1431,3,132,114,18,0,1,0
109707,666,9,139,138,1,35,1,0
0,0,0,0,0,0,0,0,0
105596,1015,10,271,267,4,4,1,0
43990,256,10,43,39,4,1,1,0
181362,943,18,155,145,10,40,1,1
191069,968,18,155,145,10,53,1,1
31317,493,1,63,63,0,9,1,0
9995,65,0,3,3,0,0,0,0
74002,1176,8,169,144,25,0,1,0
0,0,0,0,0,0,0,0,0
0,0,0,0,0,0,0,0,0
0,0,0,0,0,0,0,0,0
411586,3611,13,599,586,13,40,1,0
0,0,0,0,0,0,0,0,0
0,0,0,0,0,0,0,0,0
0,0,0,0,0,0,0,0,0
65490,555,9,101,90,11,13,1,0
0,0,0,0,0,0,0,0,0
0,0,0,0,0,0,0,0,0
197092,2255,6,294,222,72,17,0,0
214262,1885,13,293,284,9,6,1,0
0,0,0,0,0,0,0,0,0
43453,470,7,67,65,2,0,0,0
103716,789,7,49,47,2,5,0,0
133443,913,4,221,211,10,9,1,0
0,0,0,0,0,0,0,0,0
0,0,0,0,0,0,0,0,0
290693,1475,4,196,164,32,9,1,0
0,0,0,0,0,0,0,0,0
202543,2625,6,505,462,43,3,1,0
68192,494,5,70,49,21,2,1,0
59535,258,2,23,11,12,48,1,0
41614,731,4,143,133,10,0,1,0
480128,2598,18,483,479,4,18,1,0
290585,839,8,197,178,19,7,0,0
51080,315,3,24,24,0,16,1,0
17631,379,3,103,87,16,2,0,0
0,0,0,0,0,0,0,0,0
35476,67,2,11,10,1,0,1,0
38940,168,2,18,17,1,0,1,0
0,0,0,0,0,0,0,0,0
0,0,0,0,0,0,0,0,0
114296,989,9,384,367,17,3,1,0
78343,656,8,313,307,6,2,1,0
1299199,1148,11,156,136,20,13,1,0
148027,916,5,111,98,13,41,0,0
195782,1182,4,156,133,23,22,1,0
86259,369,4,2,2,0,16,1,0
64569,503,4,63,53,10,4,0,0
108380,766,7,83,18,65,11,1,0
15326,352,0,24,24,0,0,1,0
8714,189,0,20,20,0,0,1,0
0,0,0,0,0,0,0,0,0
0,0,0,0,0,0,0,0,0
0,0,0,0,0,0,0,0,0
0,0,0,0,0,0,0,0,0
0,0,0,0,0,0,0,0,0
0,0,0,0,0,0,0,0,0
82511,386,2,61,55,6,13,1,0
174213,549,0,67,56,11,1,1,0
67589,582,8,98,86,12,7,1,0
0,0,0,0,0,0,0,0,0
273500,2451,11,579,564,15,9,1,0
15485,239,0,47,42,5,1,0,0
19248,262,1,39,32,7,4,0,0
132851,1199,14,204,168,36,1,0,0
0,0,0,0,0,0,0,0,0
0,0,0,0,0,0,0,0,0
8639,98,2,9,6,3,0,0,0
0,0,0,0,0,0,0,0,0
129002,1562,12,186,47,139,2,0,0
860009,1995,7,0,0,0,20,0,0
50811,553,8,60,27,33,0,0,0
29427,478,5,127,111,16,6,1,0
0,0,0,0,0,0,0,0,0
35539,293,0,104,102,2,0,1,0
485878,2360,3,242,130,112,7,1,0
152093,431,3,15,15,0,4,0,0
0,0,0,0,0,0,0,0,0
0,0,0,0,0,0,0,0,0
12169,204,4,31,24,7,0,1,0
15423,225,4,36,26,10,2,1,0
95507,348,5,43,35,8,6,0,0
38277,238,1,17,17,0,5,0,0
0,0,0,0,0,0,0,0,0
260559,1739,13,343,295,48,17,0,0
0,0,0,0,0,0,0,0,0
0,0,0,0,0,0,0,0,0
0,0,0,0,0,0,0,0,0
231257,2182,6,351,340,11,13,1,0
0,0,0,0,0,0,0,0,0
95659,1356,5,254,236,18,3,0,0
49300,554,5,73,73,0,3,0,0
0,0,0,0,0,0,0,0,0
396007,1278,9,172,172,0,76,1,0
259287,384,6,10,6,4,0,1,0
0,0,0,0,0,0,0,0,0
780837,2192,15,182,173,9,35,1,0
660525,1930,15,169,160,9,38,1,0
15647,226,5,10,10,0,3,0,0
13599,171,5,9,9,0,1,0,0
307849,2294,4,277,259,18,8,0,0
0,0,0,0,0,0,0,0,0
0,0,0,0,0,0,0,0,0
0,0,0,0,0,0,0,0,0
68329,483,6,146,137,9,8,0,0
0,0,0,0,0,0,0,0,0
401813,2790,9,447,433,14,4,1,0
0,0,0,0,0,0,0,0,0
36601,170,10,22,21,1,0,0,0
172528,1114,3,253,245,8,23,0,0
352298,823,1,59,57,2,0,1,0
76514,843,2,151,151,0,1,1,0
368833,1547,4,279,243,36,8,1,0
0,0,0,0,0,0,0,0,0
319612,683,7,66,61,5,17,1,0
104689,417,7,59,55,4,8,0,0
51630,660,6,162,162,0,9,1,0
33981,383,6,103,103,0,8,1,0
0,0,0,0,0,0,0,0,0
90909,656,17,36,20,16,5,0,0
5471,42,2,3,1,2,2,0,0
1219835,1193,2,136,108,28,6,1,0
331940,710,1,98,94,4,0,1,0
0,0,0,0,0,0,0,0,0
0,0,0,0,0,0,0,0,0
1440046,1037,9,174,161,13,17,1,0
315865,1712,5,591,582,9,31,0,0
0,0,0,0,0,0,0,0,0
180122,395,6,56,52,4,0,0,0
165507,1779,6,304,293,11,4,0,0
513209,1408,16,248,243,5,8,1,0
309455,3236,15,622,608,14,42,1,0
0,0,0,0,0,0,0,0,0
59922,695,7,175,154,21,3,1,0
34864,472,6,141,120,21,2,1,0
29084,345,4,41,35,6,3,1,0
59134,772,2,195,111,84,5,0,0
34241,382,2,107,54,53,2,0,0
0,0,0,0,0,0,0,0,0
443928,3550,8,849,829,20,18,0,0
18525,228,2,94,93,1,8,0,0
66564,364,7,66,66,0,7,1,0
321265,1756,4,120,96,24,6,1,0
703363,3301,7,801,731,70,96,1,0
368429,1893,8,583,577,6,7,1,0
0,0,0,0,0,0,0,0,0
0,0,0,0,0,0,0,0,0
78035,303,6,2,2,0,2,0,0
78035,303,6,2,2,0,2,0,0
0,0,0,0,0,0,0,0,0
95135,766,3,137,133,4,13,1,0
0,0,0,0,0,0,0,0,0
112737,1346,1,359,359,0,5,0,0
2076875,998,5,59,40,19,1,1,0
143087,328,4,65,47,18,0,1,0
0,0,0,0,0,0,0,0,0
0,0,0,0,0,0,0,0,0
0,0,0,0,0,0,0,0,0
0,0,0,0,0,0,0,0,0
0,0,0,0,0,0,0,0,0
0,0,0,0,0,0,0,0,0
0,0,0,0,0,0,0,0,0
0,0,0,0,0,0,0,0,0
52192,287,3,9,7,2,0,1,0
9724,52,3,3,3,0,0,0,0
31019,444,3,127,120,7,1,1,0
208350,608,8,106,96,10,8,1,0
0,0,0,0,0,0,0,0,0
0,0,0,0,0,0,0,0,0
353206,1049,5,31,26,5,2,0,0
0,0,0,0,0,0,0,0,0
257975,2262,3,343,282,61,3,1,0
213678,2691,5,206,196,10,0,0,0
0,0,0,0,0,0,0,0,0
0,0,0,0,0,0,0,0,0
455446,4150,5,950,894,56,0,1,0
2355344,12745,17,2748,2681,67,92,1,0
0,0,0,0,0,0,0,0,0
70983,599,9,116,115,1,0,0,0
132710,1064,6,243,232,11,3,0,0
0,0,0,0,0,0,0,0,0
394499,1087,4,61,56,5,0,0,0
602037,1660,4,202,156,46,1,1,0
0,0,0,0,0,0,0,0,0
0,0,0,0,0,0,0,0,0
249012,1018,9,122,88,34,0,0,0
0,0,0,0,0,0,0,0,0
0,0,0,0,0,0,0,0,0
0,0,0,0,0,0,0,0,0
24416,37,0,2,1,1,0,1,0
23585,37,0,2,1,1,0,1,0
1658452,466,8,28,23,5,9,1,0
11111,116,0,5,4,1,4,1,0
52314,632,3,35,21,14,2,1,0
7764,115,3,18,18,0,0,1,0
0,0,0,0,0,0,0,0,0
42321,214,9,47,47,0,0,1,0
13867,168,3,21,18,3,1,0,0
219600,1330,10,190,185,5,1,1,0
180335,789,9,74,62,12,5,1,0
162831,699,9,62,52,10,5,1,0
127405,1670,6,103,103,0,19,1,0
21141,263,4,17,15,2,2,1,0
12086,93,5,6,6,0,2,1,0
294768,1321,6,243,236,7,0,1,0
127065,1141,8,144,142,2,3,1,0
0,0,0,0,0,0,0,0,0
88113,846,9,156,71,85,0,1,0
0,0,0,0,0,0,0,0,0
28384,245,4,31,29,2,4,1,0
668021,4807,2,281,185,96,0,0,0
0,0,0,0,0,0,0,0,0
0,0,0,0,0,0,0,0,0
706110,3331,5,229,210,19,6,1,0
0,0,0,0,0,0,0,0,0
0,0,0,0,0,0,0,0,0
0,0,0,0,0,0,0,0,0
0,0,0,0,0,0,0,0,0
0,0,0,0,0,0,0,0,0
527127,2134,10,170,125,45,24,1,0
339584,928,2,117,95,22,1,1,0
587201,1830,17,337,331,6,27,1,0
1043330,1308,6,176,161,15,2,1,0
0,0,0,0,0,0,0,0,0
97167,849,7,159,29,130,3,1,0
105704,588,3,78,58,20,24,1,0
41117,474,5,122,110,12,8,1,0
44819,503,5,131,108,23,11,1,0
0,0,0,0,0,0,0,0,0
62030,494,11,50,43,7,2,1,0
0,0,0,0,0,0,0,0,0
172310,1950,7,498,478,20,88,0,0
44842,395,5,91,91,0,9,1,0
22504,138,6,29,26,3,0,1,0
1046249,4192,7,326,323,3,16,1,0
0,0,0,0,0,0,0,0,0
698485,2595,10,116,103,13,11,1,0
190347,1251,11,172,158,14,5,1,0
0,0,0,0,0,0,0,0,0
29511,321,8,59,48,11,8,1,0
34890,521,3,130,126,4,1,0,0
123142,511,6,142,138,4,1,1,0
0,0,0,0,0,0,0,0,0
0,0,0,0,0,0,0,0,0
0,0,0,0,0,0,0,0,0
665588,1230,10,16,14,2,13,1,0
732389,8404,17,335,280,55,60,1,0
34290,224,5,3,1,2,17,0,0
0,0,0,0,0,0,0,0,0
0,0,0,0,0,0,0,0,0
162510,800,7,138,123,15,4,1,0
102186,178,6,10,4,6,2,1,0
81335,1007,5,136,124,12,1,1,0
59362,742,4,77,73,4,1,1,0
25884,294,4,64,60,4,1,1,0
0,0,0,0,0,0,0,0,0
0,0,0,0,0,0,0,0,0
75021,948,6,241,147,94,18,1,0
0,0,0,0,0,0,0,0,0
0,0,0,0,0,0,0,0,0
0,0,0,0,0,0,0,0,0
175512,359,3,1,0,1,0,1,0
0,0,0,0,0,0,0,0,0
0,0,0,0,0,0,0,0,0
479622,1138,18,180,177,3,10,1,0
568782,2360,5,112,106,6,8,1,0
547041,2076,5,93,81,12,3,1,0
0,0,0,0,0,0,0,0,0
0,0,0,0,0,0,0,0,0
0,0,0,0,0,0,0,0,0
71335,978,7,144,125,19,3,1,0
0,0,0,0,0,0,0,0,0
0,0,0,0,0,0,0,0,0
0,0,0,0,0,0,0,0,0
133476,807,13,62,41,21,2,1,0
0,0,0,0,0,0,0,0,0
0,0,0,0,0,0,0,0,0
0,0,0,0,0,0,0,0,0
385017,2526,20,381,358,23,43,1,0
221006,1120,19,168,159,9,42,1,0
1331142,12480,9,106,102,4,1,1,0
103138,88,0,14,14,0,6,0,0
0,0,0,0,0,0,0,0,0
177574,1302,4,325,319,6,4,1,0
1551643,10360,5,593,568,25,24,0,0
0,0,0,0,0,0,0,0,0
46940,565,2,40,29,11,1,0,0
224746,4034,7,1242,1221,21,6,1,0
113838,220,8,16,10,6,0,1,0
245653,1297,7,271,267,4,8,1,0
120045,1194,7,242,234,8,10,1,0
0,0,0,0,0,0,0,0,0
241603,1093,13,266,242,24,9,1,0
100445,272,1,25,6,19,14,1,1
594924,2993,7,461,445,16,61,1,0
0,0,0,0,0,0,0,0,0
0,0,0,0,0,0,0,0,0
444547,823,6,91,80,11,21,1,0
0,0,0,0,0,0,0,0,0
31396,487,4,214,214,0,0,1,0
81779,296,5,71,39,32,1,1,0
0,0,0,0,0,0,0,0,0
0,0,0,0,0,0,0,0,0
0,0,0,0,0,0,0,0,0
18833,288,3,12,8,4,4,0,0
346672,2250,3,279,227,52,4,0,0
278458,1697,3,231,179,52,4,0,0
0,0,0,0,0,0,0,0,0
121532,860,10,186,146,40,3,0,0
117318,1114,9,119,112,7,4,1,0
160338,1168,9,312,302,10,1,1,0
0,0,0,0,0,0,0,0,0
103253,1068,10,243,240,3,4,1,0
97661,712,10,230,223,7,7,1,0
112841,943,5,169,159,10,0,1,0
23048,217,2,33,33,0,1,1,0
0,0,0,0,0,0,0,0,0
243536,788,10,170,167,3,0,0,0
57875,210,9,22,13,9,0,1,0
420576,1444,4,5,4,1,2,0,0
0,0,0,0,0,0,0,0,0
0,0,0,0,0,0,0,0,0
0,0,0,0,0,0,0,0,0
12208,160,4,57,57,0,0,1,0
554269,2550,6,499,426,73,5,1,0
853980,2579,10,390,380,10,14,1,0
79646,844,6,107,91,16,7,1,0
65359,576,9,57,49,8,8,1,0
319949,1975,12,324,317,7,5,0,0
3523,44,3,3,3,0,0,0,0
89847,1879,4,604,511,93,15,1,0
0,0,0,0,0,0,0,0,0
0,0,0,0,0,0,0,0,0
52113,143,2,108,107,1,0,0,0
2000891,3619,5,218,164,54,8,1,0
366404,1359,5,191,168,23,8,1,0
0,0,0,0,0,0,0,0,0
1640,11,0,1,1,0,0,0,0
1077076,2679,7,279,264,15,11,1,0
632397,1441,9,231,205,26,15,1,0
0,0,0,0,0,0,0,0,0
174802,1673,10,456,423,33,6,1,0
33088,634,8,51,47,4,3,1,0
0,0,0,0,0,0,0,0,0
3030,29,3,3,1,2,0,0,0
39704,1271,2,211,207,4,0,1,0
0,0,0,0,0,0,0,0,0
141383,381,7,24,13,11,0,1,0
137353,125,3,0,0,0,0,0,0
133508,1563,8,312,277,35,7,1,0
0,0,0,0,0,0,0,0,0
837479,6361,7,480,480,0,127,1,0
363718,1445,7,267,267,0,4,1,0
0,0,0,0,0,0,0,0,0
75805,830,7,159,158,1,8,1,0
0,0,0,0,0,0,0,0,0
701240,1320,6,111,97,14,25,1,0
29545,191,5,4,3,1,11,1,0
0,0,0,0,0,0,0,0,0
47875,573,2,143,139,4,0,1,0
70778,1310,8,378,67,311,5,1,0
0,0,0,0,0,0,0,0,0
0,0,0,0,0,0,0,0,0
209021,3379,5,980,958,22,5,1,0
0,0,0,0,0,0,0,0,0
106078,933,6,209,192,17,10,1,0
3028,41,4,3,3,0,0,1,0
241046,1999,11,240,219,21,13,1,0
196569,669,4,46,21,25,7,1,0
129273,161,6,8,6,2,1,0,0
46987,830,2,180,163,17,0,1,0
69170,522,3,62,62,0,15,1,0
660,14,0,0,0,0,0,1,0
165577,1024,10,151,151,0,10,1,1
40004,266,1,37,35,2,3,1,0
253366,1956,14,584,577,7,0,1,0
147073,856,8,171,166,5,1,1,0
444239,1901,5,273,239,34,5,1,0
87464,774,2,70,64,6,0,1,0
76082,839,2,135,134,1,8,1,0
16865,285,0,29,28,1,4,1,0
89378,762,6,177,17,160,19,1,0
0,0,0,0,0,0,0,0,0
912632,2614,8,351,190,161,34,1,0
320445,1035,3,146,130,16,1,1,0
0,0,0,0,0,0,0,0,0
0,0,0,0,0,0,0,0,0
246177,2249,15,466,32,434,8,1,0
0,0,0,0,0,0,0,0,0
0,0,0,0,0,0,0,0,0
67357,514,2,65,59,6,0,1,0
135222,2552,2,672,672,0,1,1,0
570746,1916,16,403,338,65,18,1,0
131021,1268,6,402,377,25,4,1,0
102870,599,10,116,91,25,18,1,0
29917,507,6,145,129,16,1,1,0
18576,282,6,57,41,16,1,1,0
1252470,3690,8,283,233,50,24,1,0
417078,1201,8,203,191,12,21,1,0
90430,569,11,44,35,9,1,1,0
43692,130,5,2,2,0,6,0,0
312445,2782,9,548,519,29,8,1,0
226009,1083,12,381,370,11,5,1,0
0,0,0,0,0,0,0,0,0
0,0,0,0,0,0,0,0,0
0,0,0,0,0,0,0,0,0
83531,621,10,168,167,1,6,1,0
0,0,0,0,0,0,0,0,0
52486,154,2,12,0,12,0,1,0
23429,191,3,41,31,10,0,0,0
261935,563,6,138,136,2,8,1,0
141316,1281,2,188,165,23,1,1,0
703227,6685,6,68,62,6,8,1,0
395481,3607,7,54,48,6,10,1,0
0,0,0,0,0,0,0,0,0
993757,2663,11,219,207,12,14,1,0
165927,1526,5,404,399,5,13,1,0
0,0,0,0,0,0,0,0,0
294855,2303,7,206,58,148,1,1,0
197078,1375,16,103,93,10,2,1,0
0,0,0,0,0,0,0,0,0
163917,1535,4,372,275,97,8,0,0
248586,4707,3,1804,1803,1,0,1,0
108246,1349,5,161,150,11,29,1,0
143665,541,9,81,68,13,13,0,0
223267,706,6,150,130,20,0,1,0
0,0,0,0,0,0,0,0,0
476381,1687,11,249,199,50,11,1,0
18144,68,8,5,5,0,2,1,0
46263,883,0,88,80,8,0,1,0
6468,82,0,1,1,0,0,0,0
100609,57,4,1,1,0,4,0,0
0,0,0,0,0,0,0,0,0
3805,75,2,8,8,0,0,1,0
430450,4189,2,1644,1636,8,1,1,0
165092,3114,3,1252,1242,10,4,1,0
127339,959,8,122,118,4,6,1,1
118514,1944,8,236,221,15,5,1,0
206159,1553,10,266,266,0,2,1,0
0,0,0,0,0,0,0,0,0
33673,323,1,40,33,7,3,1,0
0,0,0,0,0,0,0,0,0
0,0,0,0,0,0,0,0,0
1191,20,1,0,0,0,0,0,0
81615,616,8,93,12,81,0,1,0
195403,1064,4,77,26,51,30,1,0
3211918,562,8,118,101,17,12,1,0
0,0,0,0,0,0,0,0,0
111346,1438,8,340,332,8,10,1,0
41676,737,9,239,235,4,0,1,0
0,0,0,0,0,0,0,0,0
241561,1394,3,317,207,110,2,1,0
0,0,0,0,0,0,0,0,0
0,0,0,0,0,0,0,0,0
91101,845,8,128,106,22,15,1,0
9698,228,1,31,25,6,0,1,0
0,0,0,0,0,0,0,0,0
0,0,0,0,0,0,0,0,0
0,0,0,0,0,0,0,0,0
11862,234,0,22,22,0,0,1,0
0,0,0,0,0,0,0,0,0
0,0,0,0,0,0,0,0,0
213741,786,8,61,56,5,3,0,0
742988,3073,20,394,385,9,13,1,0
0,0,0,0,0,0,0,0,0
58889,830,2,143,140,3,4,1,0
13191,112,4,18,2,16,1,1,0
0,0,0,0,0,0,0,0,0
0,0,0,0,0,0,0,0,0
120659,1257,10,255,237,18,3,1,0
29920,548,6,71,21,50,0,1,0
0,0,0,0,0,0,0,0,0
174974,1188,5,320,305,15,19,1,0
268346,1647,5,336,59,277,17,1,0
249634,1546,5,327,319,8,17,1,0
75372,804,3,96,94,2,35,1,0
409,7,0,0,0,0,0,0,0
0,0,0,0,0,0,0,0,0
77827,706,6,15,13,2,10,1,0
46291,204,8,20,17,3,12,1,0
222174,2017,14,382,358,24,24,1,0
0,0,0,0,0,0,0,0,0
0,0,0,0,0,0,0,0,0
0,0,0,0,0,0,0,0,0
98779,1196,4,107,97,10,11,1,0
57952,861,4,76,66,10,4,1,0
23550,37,0,2,1,1,0,1,0
0,0,0,0,0,0,0,0,0
0,0,0,0,0,0,0,0,0
0,0,0,0,0,0,0,0,0
0,0,0,0,0,0,0,0,0
573271,1318,14,192,182,10,6,1,0
20139,216,6,61,48,13,0,1,0
653227,5027,10,346,173,173,26,0,0
52379,608,8,119,109,10,0,1,0
1107182,2800,12,628,588,40,13,1,0
161529,1825,6,375,312,63,4,1,0
469312,2196,7,596,533,63,8,1,0
23181,256,5,32,20,12,2,1,0
326844,1429,13,267,231,36,16,1,0
114396,1581,6,463,462,1,0,1,0
79753,881,6,212,187,25,1,1,0
508581,1782,7,45,41,4,15,1,0
0,0,0,0,0,0,0,0,0
237683,999,4,341,325,16,10,1,0
0,0,0,0,0,0,0,0,0
0,0,0,0,0,0,0,0,0
0,0,0,0,0,0,0,0,0
0,0,0,0,0,0,0,0,0
125189,1142,9,146,146,0,1,1,0
152054,272,6,31,31,0,8,1,0
110502,616,4,86,85,1,3,1,0
249447,973,0,119,100,19,3,1,0
27613,39,0,2,1,1,0,0,0
0,0,0,0,0,0,0,0,0
0,0,0,0,0,0,0,0,0
227569,2186,6,165,56,109,65,1,0
0,0,0,0,0,0,0,0,0
356030,1877,7,92,72,20,2,1,0
0,0,0,0,0,0,0,0,0
40399,393,7,78,76,2,0,1,0
17801,397,2,124,106,18,0,1,0
16360,192,3,42,41,1,0,1,0
69777,445,8,104,99,5,2,1,0
56912,195,7,42,37,5,5,1,0
0,0,0,0,0,0,0,0,0
109315,163,5,19,19,0,5,1,0
0,0,0,0,0,0,0,0,0
306262,1057,6,140,136,4,3,0,0
0,0,0,0,0,0,0,0,0
247615,229,1,12,5,7,3,1,0
26009,160,1,7,7,0,2,0,0
0,0,0,0,0,0,0,0,0
28288,42,0,2,1,1,0,0,0
0,0,0,0,0,0,0,0,0
0,0,0,0,0,0,0,0,0
1433034,8874,15,839,767,72,685,1,0
474403,1731,12,262,172,90,6,1,0
234686,1511,2,213,206,7,1,1,0
31472,517,8,73,16,57,0,1,0
0,0,0,0,0,0,0,0,0
117969,800,8,156,153,3,18,0,0
0,0,0,0,0,0,0,0,0
68650,538,10,120,117,3,7,1,0
5799,61,6,3,2,1,0,0,0
0,0,0,0,0,0,0,0,0
20734,192,8,55,27,28,3,0,0
28419,73,3,3,1,2,9,1,0
80732,822,3,128,126,2,10,1,0
534470,1713,1,257,119,138,14,1,0
81287,112,1,10,10,0,2,0,0
313956,1909,6,221,125,96,7,1,0
0,0,0,0,0,0,0,0,0
0,0,0,0,0,0,0,0,0
0,0,0,0,0,0,0,0,0
198641,1237,8,265,256,9,9,1,0
64045,1166,2,208,176,32,1,1,0
0,0,0,0,0,0,0,0,0
518945,2001,5,93,63,30,38,1,0
0,0,0,0,0,0,0,0,0
0,0,0,0,0,0,0,0,0
236110,1592,11,351,329,22,10,1,0
393466,4668,0,1193,935,258,13,0,0
195762,252,6,13,12,1,3,1,1
267929,2304,6,567,561,6,2,1,0
29520,592,4,193,178,15,10,1,0
165784,891,8,87,82,5,1,1,0
0,0,0,0,0,0,0,0,0
797787,635,12,83,76,7,37,1,0
305661,1868,4,223,223,0,2,0,0
208603,1506,4,90,71,19,1,1,0
22804,216,1,25,23,2,3,1,0
0,0,0,0,0,0,0,0,0
0,0,0,0,0,0,0,0,0
252424,2855,4,335,333,2,6,0,0
0,0,0,0,0,0,0,0,0
33360,407,12,114,92,22,3,1,0
0,0,0,0,0,0,0,0,0
414285,1203,2,166,136,30,1,1,1
0,0,0,0,0,0,0,0,0
1065764,8771,12,269,257,12,15,1,0
4494,70,1,7,4,3,0,1,0
160544,1058,7,78,70,8,4,1,0
0,0,0,0,0,0,0,0,0
187324,676,13,74,66,8,1,1,0
180443,768,11,61,58,3,7,1,0
0,0,0,0,0,0,0,0,0
0,0,0,0,0,0,0,0,0
245931,1583,13,309,99,210,10,1,0
116431,193,2,1,1,0,10,0,0
0,0,0,0,0,0,0,0,0
0,0,0,0,0,0,0,0,0
1488445,4347,3,58,50,8,1,1,0
236373,2020,6,473,435,38,10,1,0
393095,576,12,62,54,8,37,1,0
74416,896,8,107,94,13,6,1,0
34592,220,2,44,43,1,8,1,0
83735,476,5,48,35,13,1,1,0
0,0,0,0,0,0,0,0,0
74009,1026,5,145,131,14,10,1,0
0,0,0,0,0,0,0,0,0
0,0,0,0,0,0,0,0,0
0,0,0,0,0,0,0,0,0
0,0,0,0,0,0,0,0,0
0,0,0,0,0,0,0,0,0
0,0,0,0,0,0,0,0,0
53674,308,1,51,45,6,0,1,0
53023,751,4,194,188,6,3,1,0
23066,36,0,2,1,1,0,1,0
0,0,0,0,0,0,0,0,0
13482,259,3,49,40,9,0,1,0
0,0,0,0,0,0,0,0,0
0,0,0,0,0,0,0,0,0
0,0,0,0,0,0,0,0,0
0,0,0,0,0,0,0,0,0
13514,179,1,76,39,37,1,0,0
76325,435,5,93,91,2,20,1,0
0,0,0,0,0,0,0,0,0
311281,3296,4,319,301,18,6,1,0
176582,1181,9,178,170,8,16,1,0
95309,607,9,98,91,7,12,1,0
22938,666,3,270,232,38,0,1,0
85466,1028,8,274,273,1,2,1,0
7419,72,0,12,10,2,0,0,0
1222161,6269,9,1063,1058,5,31,1,0
2323,14,0,1,0,1,0,0,0
143564,771,12,155,111,44,8,0,0
0,0,0,0,0,0,0,0,0
73560,512,7,73,70,3,6,1,0
485438,883,7,162,149,13,6,1,0
388000,3298,3,873,868,5,14,1,0
332426,2743,2,838,833,5,14,1,0
0,0,0,0,0,0,0,0,0
48173,305,9,30,22,8,0,1,0
50424,593,6,69,55,14,3,1,0
98043,1020,7,205,118,87,4,1,0
197285,1643,7,168,153,15,6,1,0
77238,763,7,87,73,14,4,1,0
1334243,1487,4,233,211,22,1,1,0
26231,133,8,3,1,2,1,0,0
0,0,0,0,0,0,0,0,0
9824,180,1,13,10,3,0,1,0
354108,2378,16,184,50,134,4,1,0
0,0,0,0,0,0,0,0,0
331375,1210,8,122,111,11,1,0,0
99824,1972,2,1697,1682,15,0,1,0
46344,954,4,187,147,40,2,0,0
23877,297,4,71,60,11,2,0,0
92467,1041,2,60,33,27,2,1,0
408439,1436,9,220,218,2,19,1,0
0,0,0,0,0,0,0,0,0
6678,75,3,4,3,1,4,0,0
7310,81,3,1,1,0,4,0,0
153477,530,7,117,105,12,7,1,0
206624,1713,4,488,475,13,3,1,0
543002,4478,10,666,532,134,26,1,0
47903,327,7,46,46,0,0,1,0
0,0,0,0,0,0,0,0,0
0,0,0,0,0,0,0,0,0
5586,56,2,10,10,0,0,0,0
389323,1845,5,268,252,16,12,1,0
2889,44,0,9,9,0,3,0,0
163560,699,5,142,139,3,7,1,0
22056,33,0,1,1,0,0,1,0
21443,239,5,39,30,9,6,1,0
0,0,0,0,0,0,0,0,0
0,0,0,0,0,0,0,0,0
0,0,0,0,0,0,0,0,0
12824,338,2,106,87,19,0,0,0
2910,19,0,0,0,0,0,0,0
158945,702,8,74,48,26,6,1,0
129729,748,9,151,143,8,1,1,0
0,0,0,0,0,0,0,0,0
1592860,1739,18,337,329,8,20,1,0
1554138,1504,18,310,302,8,20,1,0
41399,438,0,128,128,0,2,0,0
34702,374,0,113,113,0,0,0,0
37517,180,4,25,21,4,0,1,0
38306,966,1,342,337,5,0,0,0
29514,433,2,125,122,3,0,0,0
0,0,0,0,0,0,0,0,0
0,0,0,0,0,0,0,0,0
0,0,0,0,0,0,0,0,0
148315,810,8,105,100,5,6,1,0
575034,2226,0,475,11,464,0,0,0
0,0,0,0,0,0,0,0,0
13162,135,0,13,9,4,4,0,0
48521,355,1,61,54,7,0,1,0
473797,3764,8,125,94,31,73,1,0
0,0,0,0,0,0,0,0,0
0,0,0,0,0,0,0,0,0
0,0,0,0,0,0,0,0,0
0,0,0,0,0,0,0,0,0
0,0,0,0,0,0,0,0,0
144797,1647,3,225,196,29,12,1,0
353939,1715,4,259,212,47,40,1,0
55906,114,2,8,1,7,0,0,0
0,0,0,0,0,0,0,0,0
38822,266,6,28,27,1,0,1,0
13635,164,4,14,12,2,3,0,0
43433,519,6,64,54,10,2,1,0
0,0,0,0,0,0,0,0,0
0,0,0,0,0,0,0,0,0
0,0,0,0,0,0,0,0,0
126848,771,6,189,185,4,52,1,0
275211,991,9,248,241,7,8,1,0
0,0,0,0,0,0,0,0,0
256137,1466,11,382,318,64,2,1,0
129605,990,10,153,129,24,0,1,0
291430,3598,7,1063,1046,17,3,1,0
152196,731,1,169,142,27,9,0,0
98699,519,12,111,84,27,8,0,0
29345,308,8,58,58,0,0,1,0
0,0,0,0,0,0,0,0,0
167502,945,9,65,55,10,14,1,0
0,0,0,0,0,0,0,0,0
0,0,0,0,0,0,0,0,0
0,0,0,0,0,0,0,0,0
0,0,0,0,0,0,0,0,0
0,0,0,0,0,0,0,0,0
230828,453,2,41,40,1,12,1,0
238151,657,4,6,4,2,2,0,0
0,0,0,0,0,0,0,0,0
0,0,0,0,0,0,0,0,0
418676,1841,14,223,134,89,8,1,0
254854,1708,12,291,283,8,9,1,0
60980,693,17,140,136,4,1,1,0
55894,654,3,29,7,22,23,1,0
22061,35,0,1,1,0,0,1,0
273931,782,7,188,177,11,3,1,0
106024,1494,5,226,207,19,1,0,0
85372,642,9,40,35,5,5,1,0
155629,898,4,90,84,6,4,1,0
100027,197,3,43,43,0,0,1,0
0,0,0,0,0,0,0,0,0
79111,717,9,141,129,12,8,1,0
385102,631,1,73,63,10,18,0,0
99512,378,8,47,42,5,2,0,0
189480,647,15,118,58,60,12,1,0
22077,35,0,1,1,0,0,1,0
80902,451,3,12,11,1,0,0,0
0,0,0,0,0,0,0,0,0
0,0,0,0,0,0,0,0,0
65897,984,5,238,217,21,1,0,0
0,0,0,0,0,0,0,0,0
764725,1752,12,251,229,22,5,1,0
66957,219,2,23,0,23,0,1,0
0,0,0,0,0,0,0,0,0
0,0,0,0,0,0,0,0,0
0,0,0,0,0,0,0,0,0
0,0,0,0,0,0,0,0,0
2352,37,2,2,2,0,0,1,0
39285,294,9,29,29,0,3,1,0
389788,2344,17,567,551,16,11,1,0
300256,1639,3,246,237,9,5,1,0
802877,6002,5,928,549,379,4,1,0
109904,161,3,12,8,4,2,1,0
0,0,0,0,0,0,0,0,0
111872,1730,3,630,616,14,22,1,0
110566,1726,3,630,616,14,21,1,0
0,0,0,0,0,0,0,0,0
26775,36,0,3,1,2,0,0,0
0,0,0,0,0,0,0,0,0
0,0,0,0,0,0,0,0,0
344201,2796,6,303,243,60,5,1,0
244369,1859,11,134,91,43,5,1,0
263112,4535,2,1479,1479,0,2,1,0
696890,4120,4,159,137,22,81,1,0
146173,2071,5,334,302,32,1,1,0
0,0,0,0,0,0,0,0,0
261580,2102,12,100,7,93,3,1,0
203439,1524,14,194,194,0,3,1,0
0,0,0,0,0,0,0,0,0
170867,1090,8,225,213,12,1,1,0
0,0,0,0,0,0,0,0,0
0,0,0,0,0,0,0,0,0
0,0,0,0,0,0,0,0,0
144701,1311,7,295,290,5,3,1,0
0,0,0,0,0,0,0,0,0
0,0,0,0,0,0,0,0,0
41488,472,5,87,85,2,10,1,0
212471,1022,6,135,90,45,9,0,0
82785,1675,2,379,342,37,2,1,0
421558,1139,5,304,298,6,13,1,0
150775,1408,8,266,212,54,0,1,0
0,0,0,0,0,0,0,0,0
0,0,0,0,0,0,0,0,0
22576,241,7,4,1,3,0,1,0
539853,1869,12,111,75,36,18,1,0
181481,1582,13,214,213,1,7,1,0
0,0,0,0,0,0,0,0,0
83001,721,2,97,93,4,0,0,0
531842,1780,9,185,152,33,31,1,0
100122,663,9,123,120,3,0,1,0
242534,1382,6,127,123,4,1,1,0
45745,232,4,29,27,2,1,1,0
0,0,0,0,0,0,0,0,0
464181,1999,18,254,227,27,19,1,0
42420,288,4,35,28,7,4,1,0
227446,1426,14,134,124,10,7,1,0
3063322,895,3,73,38,35,3,0,0
34274,605,2,252,252,0,1,0,0
33600,593,2,253,253,0,1,0,0
1118002,3394,7,406,385,21,67,1,0
1298706,1077,3,112,90,22,1,1,0
0,0,0,0,0,0,0,0,0
44240,408,2,18,17,1,4,0,0
140139,940,13,192,108,84,8,1,0
22122,35,0,1,1,0,0,1,0
0,0,0,0,0,0,0,0,0
1690266,1144,3,118,101,17,0,1,0
310034,1828,5,343,306,37,6,1,0
0,0,0,0,0,0,0,0,0
489146,4238,8,1616,1607,9,13,0,0
0,0,0,0,0,0,0,0,0
0,0,0,0,0,0,0,0,0
305449,1225,10,162,148,14,10,1,0
225745,1674,5,352,320,32,4,1,0
0,0,0,0,0,0,0,0,0
0,0,0,0,0,0,0,0,0
243231,2577,10,137,121,16,61,1,0
130067,1114,5,204,200,4,14,1,0
0,0,0,0,0,0,0,0,0
432205,2368,13,492,475,17,94,1,0
8169,88,4,4,4,0,1,1,0
61238,589,8,112,107,5,1,1,0
56210,332,6,41,41,0,0,0,0
101477,1433,2,237,235,2,0,1,0
99010,548,10,51,0,51,3,1,0
0,0,0,0,0,0,0,0,0
89564,896,8,51,51,0,0,1,0
52507,258,8,17,17,0,2,1,0
93198,1342,6,193,171,22,11,1,0
269960,1072,10,194,188,6,46,1,0
257612,1002,11,190,183,7,48,1,0
0,0,0,0,0,0,0,0,0
21385,331,2,91,90,1,9,1,0
0,0,0,0,0,0,0,0,0
0,0,0,0,0,0,0,0,0
105258,1015,6,226,222,4,6,1,0
0,0,0,0,0,0,0,0,0
13078,231,2,42,40,2,3,1,0
9588,154,1,24,22,2,1,1,0
0,0,0,0,0,0,0,0,0
196116,766,17,97,86,11,5,1,0
1211,15,1,0,0,0,0,0,0
10654,184,0,15,15,0,0,0,0
0,0,0,0,0,0,0,0,0
370883,2228,10,457,430,27,30,1,0
859348,4271,13,403,365,38,245,0,0
755575,3632,13,361,323,38,91,0,0
0,0,0,0,0,0,0,0,0
362936,1655,4,353,135,218,3,1,0
0,0,0,0,0,0,0,0,0
0,0,0,0,0,0,0,0,0
77001,2052,2,570,569,1,1,1,0
69635,684,5,137,133,4,0,1,0
80775,193,9,3,2,1,0,1,0
0,0,0,0,0,0,0,0,0
58712,376,3,66,66,0,0,1,0
902789,1748,5,238,238,0,2,1,0
823216,937,5,121,121,0,2,1,0
0,0,0,0,0,0,0,0,0
0,0,0,0,0,0,0,0,0
646147,2519,18,413,347,66,22,1,0
645881,2518,18,413,347,66,21,1,0
0,0,0,0,0,0,0,0,0
22058,35,0,1,1,0,0,1,0
23948,203,2,53,48,5,7,1,0
315383,1872,2,118,111,7,3,1,0
247794,1850,3,448,421,27,7,1,0
91316,580,3,124,115,9,7,1,0
0,0,0,0,0,0,0,0,0
0,0,0,0,0,0,0,0,0
88183,244,5,19,19,0,8,1,0
0,0,0,0,0,0,0,0,0
706507,2670,4,235,231,4,20,1,0
368690,1383,10,198,73,125,12,1,0
59401,302,8,14,14,0,0,1,0
279437,1649,15,178,14,164,7,1,0
0,0,0,0,0,0,0,0,0
0,0,0,0,0,0,0,0,0
0,0,0,0,0,0,0,0,0
0,0,0,0,0,0,0,0,0
42687,341,9,63,24,39,0,1,0
174140,1502,8,282,272,10,1,1,0
7822,275,1,128,128,0,0,0,0
0,0,0,0,0,0,0,0,0
94618,785,9,114,102,12,0,1,0
260709,3206,11,919,879,40,6,1,0
66582,313,10,56,54,2,8,1,0
196460,1838,9,164,151,13,139,1,0
59863,392,10,21,16,5,7,1,0
327965,2972,4,286,181,105,4,1,0
62514,487,5,121,98,23,0,0,0
0,0,0,0,0,0,0,0,0
0,0,0,0,0,0,0,0,0
23087,37,0,2,1,1,0,1,0
40974,419,8,53,47,6,4,1,0
73666,603,5,99,96,3,0,1,0
42856,85,3,5,5,0,0,0,0
163626,1706,3,184,170,14,7,1,0
193681,1510,9,103,88,15,2,1,0
864782,19386,1,102,102,0,0,1,0
67897,332,7,62,55,7,7,1,0
0,0,0,0,0,0,0,0,0
0,0,0,0,0,0,0,0,0
0,0,0,0,0,0,0,0,0
3655,91,1,6,6,0,0,1,0
331033,1501,8,140,108,32,5,1,0
170962,973,5,231,209,22,19,1,0
93693,1446,9,175,168,7,1,1,0
192708,1624,3,208,151,57,3,1,0
70829,661,1,57,44,13,10,1,0
141182,1933,3,423,420,3,1,1,0
447929,692,7,81,60,21,24,0,0
0,0,0,0,0,0,0,0,0
47534,503,4,40,32,8,0,1,0
28224,45,0,4,1,3,0,0,0
0,0,0,0,0,0,0,0,0
0,0,0,0,0,0,0,0,0
114631,1474,6,210,206,4,17,1,0
92467,1041,2,60,33,27,2,1,0
0,0,0,0,0,0,0,0,0
0,0,0,0,0,0,0,0,0
30631,556,0,86,84,2,0,0,0
21286,361,0,44,41,3,0,0,0
0,0,0,0,0,0,0,0,0
27926,274,7,47,34,13,33,0,0
0,0,0,0,0,0,0,0,0
0,0,0,0,0,0,0,0,0
0,0,0,0,0,0,0,0,0
31708,63,2,3,2,1,1,1,0
4559,41,1,2,2,0,0,1,0
529102,1078,12,135,118,17,5,1,0
0,0,0,0,0,0,0,0,0
153356,1188,7,264,240,24,8,1,0
270916,744,7,121,119,2,7,1,0
131598,1239,7,119,85,34,0,1,0
37299,170,6,22,13,9,0,0,0
23079,38,0,2,1,1,0,1,0
18924,287,1,33,30,3,0,1,0
303521,1103,3,185,184,1,42,1,0
81518,254,4,10,9,1,45,1,0
39545,332,4,23,15,8,0,1,0
103054,1071,3,212,207,5,14,1,0
20684,226,1,53,49,4,0,1,0
0,0,0,0,0,0,0,0,0
0,0,0,0,0,0,0,0,0
28320,225,5,40,29,11,6,0,0
50444,501,5,33,13,20,0,1,0
0,0,0,0,0,0,0,0,0
69938,1143,1,244,232,12,1,0,0
0,0,0,0,0,0,0,0,0
68980,828,5,76,70,6,4,1,0
0,0,0,0,0,0,0,0,0
21659,33,0,1,1,0,0,1,0
0,0,0,0,0,0,0,0,0
86432,947,3,65,62,3,1,0,0
0,0,0,0,0,0,0,0,0
0,0,0,0,0,0,0,0,0
0,0,0,0,0,0,0,0,0
214981,1604,5,190,169,21,258,1,0
127619,588,14,25,19,6,1,1,0
0,0,0,0,0,0,0,0,0
298565,1251,7,283,281,2,14,1,0
0,0,0,0,0,0,0,0,0
0,0,0,0,0,0,0,0,0
0,0,0,0,0,0,0,0,0
28595,45,0,4,1,3,0,0,0
67970,871,7,109,97,12,6,0,0
38284,522,7,66,57,9,6,0,0
179501,951,5,141,138,3,4,1,0
776038,2406,13,429,231,198,16,1,0
0,0,0,0,0,0,0,0,0
305627,1242,15,134,125,9,14,1,0
0,0,0,0,0,0,0,0,0
21122,59,1,0,0,0,1,0,0
426078,1828,1,125,79,46,2,1,0
360852,1585,8,117,15,102,5,1,0
40099,412,5,96,83,13,7,1,0
35551,238,6,36,18,18,7,1,0
84018,226,7,10,9,1,0,1,0
232583,1476,8,183,166,17,6,1,0
177150,934,8,132,126,6,5,1,0
390824,1696,18,103,1,102,4,0,0
280499,707,19,20,19,1,4,0,0
0,0,0,0,0,0,0,0,0
0,0,0,0,0,0,0,0,0
340415,4796,8,737,729,8,0,0,0
150309,333,9,25,22,3,0,0,0
0,0,0,0,0,0,0,0,0
15648,138,4,32,29,3,2,1,0
38755,327,8,56,51,5,7,1,0
0,0,0,0,0,0,0,0,0
58856,841,3,92,87,5,8,1,0
30849,280,2,57,53,4,4,1,0
170141,435,5,44,40,4,2,0,0
232365,907,8,168,156,12,30,1,0
7632,88,4,3,3,0,1,0,0
386247,1025,6,173,172,1,8,1,0
3726,75,2,8,8,0,0,1,0
0,0,0,0,0,0,0,0,0
30753,533,3,74,70,4,2,1,0
190177,1638,9,279,255,24,13,1,0
124292,940,9,117,108,9,15,1,0
64942,528,5,91,84,7,0,1,0
0,0,0,0,0,0,0,0,0
463852,1135,7,181,19,162,17,1,0
0,0,0,0,0,0,0,0,0
0,0,0,0,0,0,0,0,0
91698,601,2,116,114,2,6,1,0
517710,1893,19,172,164,8,51,0,0
18481,202,3,36,35,1,3,1,0
0,0,0,0,0,0,0,0,0
150576,1107,10,191,188,3,10,1,0
2994,35,3,3,3,0,0,0,0
263240,1268,10,242,229,13,23,1,0
261275,918,9,220,216,4,11,1,0
0,0,0,0,0,0,0,0,0
0,0,0,0,0,0,0,0,0
98274,1004,5,164,164,0,4,0,0
46086,518,6,56,48,8,1,1,0
230048,1243,6,230,216,14,9,1,0
0,0,0,0,0,0,0,0,0
23353,258,2,66,66,0,4,1,0
0,0,0,0,0,0,0,0,0
0,0,0,0,0,0,0,0,0
0,0,0,0,0,0,0,0,0
128293,854,7,222,214,8,6,1,0
0,0,0,0,0,0,0,0,0
330135,1418,4,108,98,10,11,1,0
201597,750,4,81,73,8,12,1,0
0,0,0,0,0,0,0,0,0
0,0,0,0,0,0,0,0,0
71995,749,8,90,84,6,20,1,0
45590,393,8,43,38,5,18,1,0
8633,117,0,11,3,8,0,1,0
190464,909,13,182,173,9,17,1,0
30340,142,3,12,11,1,2,1,0
66339,885,7,254,236,18,2,1,0
25084,344,10,56,52,4,4,0,0
0,0,0,0,0,0,0,0,0
0,0,0,0,0,0,0,0,0
725156,8224,12,1466,1455,11,27,1,0
166659,1871,1,750,746,4,7,1,0
0,0,0,0,0,0,0,0,0
0,0,0,0,0,0,0,0,0
0,0,0,0,0,0,0,0,0
408904,1869,13,651,22,629,12,1,0
273714,571,5,22,21,1,6,0,0
684849,143,1,4,2,2,3,1,0
684849,143,1,4,2,2,3,1,0
85667,1192,3,392,392,0,1,1,0
277887,663,5,50,39,11,3,1,0
165175,2289,6,465,455,10,0,1,0
0,0,0,0,0,0,0,0,0
0,0,0,0,0,0,0,0,0
28910,413,4,61,48,13,3,1,0
111794,1161,8,280,273,7,12,1,0
106960,1254,6,281,280,1,16,0,0
272293,1570,14,336,277,59,32,1,0
0,0,0,0,0,0,0,0,0
0,0,0,0,0,0,0,0,0
146663,360,5,22,17,5,6,1,0
15277,248,1,80,77,3,0,1,0
13242,233,1,56,53,3,0,1,0
0,0,0,0,0,0,0,0,0
0,0,0,0,0,0,0,0,0
180836,1006,10,153,147,6,3,1,0
55680,494,9,65,58,7,12,1,0
0,0,0,0,0,0,0,0,0
4797174,36477,10,3356,1838,1518,7,0,0
47106,132,8,3,0,3,0,1,0
84940,674,1,103,88,15,5,1,0
23585,233,0,46,37,9,5,1,0
0,0,0,0,0,0,0,0,0
936665,896,5,84,34,50,3,1,0
0,0,0,0,0,0,0,0,0
0,0,0,0,0,0,0,0,0
118121,1312,7,114,52,62,9,0,0
52894,849,3,211,201,10,0,1,0
0,0,0,0,0,0,0,0,0
438080,4500,10,775,134,641,32,1,0
320978,1524,1,327,322,5,5,1,0
163818,332,1,74,24,50,0,1,0
37048,496,6,72,60,12,0,1,0
0,0,0,0,0,0,0,0,0
40825,330,3,42,37,5,0,0,0
99154,1025,8,255,221,34,20,1,0
0,0,0,0,0,0,0,0,0
77098,753,5,138,116,22,12,1,1
0,0,0,0,0,0,0,0,0
12403,106,2,12,9,3,0,1,0
114087,249,9,24,17,7,4,0,0
114089,249,9,24,17,7,4,0,0
0,0,0,0,0,0,0,0,0
0,0,0,0,0,0,0,0,0
566331,4960,2,178,172,6,8,1,0
21962,33,0,1,1,0,0,1,0
0,0,0,0,0,0,0,0,0
147647,1195,10,190,186,4,3,1,0
21651,244,9,45,42,3,3,1,0
68381,561,4,82,79,3,4,0,0
164399,1236,10,415,407,8,1,1,0
92417,319,10,47,40,7,1,1,0
0,0,0,0,0,0,0,0,0
0,0,0,0,0,0,0,0,0
0,0,0,0,0,0,0,0,0
0,0,0,0,0,0,0,0,0
27634,153,0,27,25,2,1,0,0
470670,1260,8,148,141,7,6,1,0
224058,1120,0,253,163,90,0,0,0
56679,1013,2,251,241,10,6,0,0
22106,35,0,1,1,0,0,1,0
0,0,0,0,0,0,0,0,0
508228,2209,15,576,19,557,6,1,0
109272,768,4,90,84,6,15,1,0
425430,3961,6,186,174,12,68,1,0
134457,733,6,90,78,12,4,1,0
0,0,0,0,0,0,0,0,0
60097,356,12,28,22,6,4,0,0
0,0,0,0,0,0,0,0,0
268474,2091,8,391,362,29,2,1,0
0,0,0,0,0,0,0,0,0
0,0,0,0,0,0,0,0,0
854,15,0,2,1,1,0,0,0
25292,220,1,1,1,0,8,0,0
112938,1170,1,146,8,138,0,1,0
0,0,0,0,0,0,0,0,0
0,0,0,0,0,0,0,0,0
16236,152,7,5,5,0,0,1,0
0,0,0,0,0,0,0,0,0
177088,1789,5,195,187,8,102,1,0
449007,2065,9,370,315,55,21,1,0
0,0,0,0,0,0,0,0,0
26090,590,0,228,140,88,0,1,0
0,0,0,0,0,0,0,0,0
188613,1421,12,221,209,12,18,1,1
186797,1549,13,163,162,1,16,1,0
16357,115,10,5,0,5,2,0,0
87501,464,1,83,83,0,0,0,0
0,0,0,0,0,0,0,0,0
1437,33,0,8,1,7,0,0,0
25147,619,1,72,70,2,1,1,0
0,0,0,0,0,0,0,0,0
0,0,0,0,0,0,0,0,0
39225,49,0,8,4,4,0,0,0
0,0,0,0,0,0,0,0,0
61732,662,2,113,89,24,1,1,0
0,0,0,0,0,0,0,0,0
108671,1426,2,350,346,4,10,0,0
128221,663,16,46,34,12,4,1,0
46495,787,2,4,3,1,0,0,0
281661,2453,9,645,628,17,6,1,0
252728,2464,10,648,640,8,9,1,0
0,0,0,0,0,0,0,0,0
0,0,0,0,0,0,0,0,0
2287,32,1,2,2,0,0,1,0
0,0,0,0,0,0,0,0,0
8160,85,5,3,2,1,3,1,0
133023,933,7,112,102,10,0,0,1
0,0,0,0,0,0,0,0,0
0,0,0,0,0,0,0,0,0
36009,458,6,72,66,6,4,0,0
36651,411,7,63,49,14,1,0,0
0,0,0,0,0,0,0,0,0
185968,1213,2,218,198,20,7,1,0
4135,57,0,4,3,1,0,0,0
6123,84,3,4,3,1,0,1,0
12639,72,4,6,6,0,0,1,0
0,0,0,0,0,0,0,0,0
25753,179,2,23,23,0,12,1,0
455074,2953,4,267,254,13,0,1,0
0,0,0,0,0,0,0,0,0
24429,450,2,36,36,0,2,1,0
0,0,0,0,0,0,0,0,0
46841,399,6,106,103,3,10,1,0
0,0,0,0,0,0,0,0,0
52568,558,6,141,136,5,8,1,0
102151,489,1,31,14,17,0,1,0
37109,104,8,0,0,0,2,0,0
183874,867,10,162,146,16,7,1,0
194091,2561,6,397,378,19,11,1,0
199131,2146,5,390,385,5,39,1,0
0,0,0,0,0,0,0,0,0
373793,4479,3,1614,1108,506,5,1,0
242647,2724,2,1394,891,503,5,1,0
15091,168,1,1,1,0,0,1,0
582633,1502,13,273,221,52,6,1,0
0,0,0,0,0,0,0,0,0
22902,36,0,2,1,1,0,1,0
234832,2164,3,259,241,18,11,1,0
6282,62,2,7,6,1,0,1,0
104038,1123,6,193,193,0,14,1,0
184746,1950,7,12,11,1,167,1,0
0,0,0,0,0,0,0,0,0
0,0,0,0,0,0,0,0,0
0,0,0,0,0,0,0,0,0
22760,37,0,2,1,1,0,1,0
0,0,0,0,0,0,0,0,0
0,0,0,0,0,0,0,0,0
123456,1385,2,592,558,34,32,0,0
0,0,0,0,0,0,0,0,0
0,0,0,0,0,0,0,0,0
822979,1159,9,94,86,8,2,1,0
695391,566,7,45,42,3,2,1,0
0,0,0,0,0,0,0,0,0
714122,2871,5,434,429,5,5,1,0
394631,1788,22,212,187,25,10,1,0
331276,1838,1,339,334,5,5,1,0
163400,330,1,74,24,50,0,1,0
930568,7114,20,714,678,36,13,1,0
0,0,0,0,0,0,0,0,0
0,0,0,0,0,0,0,0,0
0,0,0,0,0,0,0,0,0
100654,1178,6,306,285,21,4,1,0
49672,613,6,169,149,20,4,1,0
129425,821,5,130,108,22,8,1,0
0,0,0,0,0,0,0,0,0
376780,467,12,21,16,5,4,1,0
223421,1496,16,265,250,15,38,1,0
146635,1505,8,291,257,34,6,1,1
100395,916,2,34,22,12,3,0,0
600167,2627,12,200,178,22,18,1,0
198590,1253,5,266,260,6,13,1,0
189338,1280,5,137,108,29,9,1,0
21702,121,11,11,10,1,7,0,0
0,0,0,0,0,0,0,0,0
40041,810,2,477,208,269,2,1,0
2893,52,1,7,5,2,0,1,0
0,0,0,0,0,0,0,0,0
257145,616,8,113,112,1,12,1,0
858469,1159,10,131,99,32,17,1,0
64511,658,4,131,119,12,2,1,0
316654,1670,6,367,342,25,2,1,0
0,0,0,0,0,0,0,0,0
4580425,3891,9,155,143,12,10,1,0
0,0,0,0,0,0,0,0,0
431348,3166,7,138,127,11,9,1,0
217512,876,7,88,78,10,9,1,0
44800,258,2,2,1,1,1,1,0
168424,994,15,173,151,22,2,1,0
0,0,0,0,0,0,0,0,0
499293,830,13,89,80,9,1,1,0
54342,60,1,5,5,0,0,1,0
75275,1155,3,343,283,60,0,1,0
0,0,0,0,0,0,0,0,0
121303,3374,0,51,10,41,47,0,0
0,0,0,0,0,0,0,0,0
0,0,0,0,0,0,0,0,0
317454,1117,10,183,177,6,7,1,0
67586,470,4,55,47,8,6,0,0
152735,1799,6,977,971,6,2,1,1
150153,851,7,86,67,19,5,0,0
6536,46,3,0,0,0,0,0,0
0,0,0,0,0,0,0,0,0
33195,436,5,101,97,4,9,0,0
0,0,0,0,0,0,0,0,0
0,0,0,0,0,0,0,0,0
133469,642,14,116,111,5,0,1,0
69698,1225,2,178,168,10,2,1,0
0,0,0,0,0,0,0,0,0
169282,1435,11,286,224,62,10,1,0
0,0,0,0,0,0,0,0,0
7939,28,3,4,0,4,0,0,0
128945,157,6,8,6,2,1,0,0
241141,1218,4,110,96,14,2,1,0
87085,422,3,28,28,0,6,1,0
0,0,0,0,0,0,0,0,0
98402,1183,7,211,205,6,3,1,0
91777,1322,7,257,243,14,10,1,0
0,0,0,0,0,0,0,0,0
0,0,0,0,0,0,0,0,0
132942,700,5,215,201,14,0,1,0
859630,5880,11,1550,1515,35,46,1,0
70737,403,6,74,73,1,1,1,0
826426,2399,7,283,276,7,3,1,0
499721,327,19,1,1,0,4,1,0
44817,470,7,60,57,3,4,1,0
30710,264,8,43,40,3,4,1,0
0,0,0,0,0,0,0,0,0
48624,320,6,48,48,0,15,0,0
97562,1069,5,214,190,24,13,1,0
0,0,0,0,0,0,0,0,0
208870,977,7,136,127,9,11,1,0
145597,616,7,104,95,9,11,1,0
0,0,0,0,0,0,0,0,0
108730,1169,7,169,140,29,5,0,0
84966,786,7,100,72,28,7,0,0
447585,5356,2,266,253,13,12,1,0
0,0,0,0,0,0,0,0,0
0,0,0,0,0,0,0,0,0
116998,449,8,49,40,9,2,1,0
0,0,0,0,0,0,0,0,0
0,0,0,0,0,0,0,0,0
177909,1328,11,306,249,57,19,1,0
0,0,0,0,0,0,0,0,0
0,0,0,0,0,0,0,0,0
163521,1009,8,49,31,18,6,1,0
0,0,0,0,0,0,0,0,0
1094588,1511,15,208,195,13,2,1,1
45065,536,5,127,114,13,4,1,0
21261,256,6,53,46,7,4,1,0
0,0,0,0,0,0,0,0,0
92430,1041,2,60,33,27,2,1,0
0,0,0,0,0,0,0,0,0
0,0,0,0,0,0,0,0,0
51331,687,6,168,148,20,1,1,0
0,0,0,0,0,0,0,0,0
292033,1691,7,338,308,30,4,1,0
0,0,0,0,0,0,0,0,0
0,0,0,0,0,0,0,0,0
148823,818,9,50,50,0,2,1,1
233958,1949,16,414,279,135,14,1,0
102481,146,2,9,8,1,1,1,0
0,0,0,0,0,0,0,0,0
111142,931,8,110,80,30,1,1,0
45425,549,4,127,119,8,5,1,0
621829,5883,20,244,232,12,6,1,0
260490,966,20,70,61,9,6,1,0
0,0,0,0,0,0,0,0,0
123782,380,8,107,105,2,4,1,0
0,0,0,0,0,0,0,0,0
47339,908,9,181,176,5,2,1,0
481250,2940,11,337,292,45,6,0,0
386297,2160,11,200,157,43,8,0,0
0,0,0,0,0,0,0,0,0
0,0,0,0,0,0,0,0,0
108450,1025,5,60,50,10,4,1,0
545527,186,6,9,6,3,2,0,0
73961,671,4,123,117,6,2,0,0
73499,666,4,118,109,9,5,0,0
0,0,0,0,0,0,0,0,0
204075,1528,5,398,381,17,0,0,0
0,0,0,0,0,0,0,0,0
230954,732,4,88,76,12,18,1,0
1766452,4634,1,916,62,854,4,1,0
674352,556,0,4,0,4,2,1,1
45329,508,4,75,74,1,0,0,0
23829,215,4,44,44,0,0,0,0
76118,605,9,83,43,40,2,1,0
0,0,0,0,0,0,0,0,0
87416,803,6,182,173,9,0,1,0
285903,233,0,4,3,1,1,1,0
47969,571,8,82,70,12,0,1,0
403582,2253,7,134,121,13,2,1,0
62807,42,0,6,6,0,0,0,0
2266954,3157,9,182,119,63,36,1,0
0,0,0,0,0,0,0,0,0
35055,248,5,47,4,43,5,1,0
32592,229,5,45,22,23,5,1,0
0,0,0,0,0,0,0,0,0
2866,56,1,8,5,3,0,1,0
63236,907,3,48,46,2,0,1,0
0,0,0,0,0,0,0,0,0
3746,51,2,7,6,1,0,1,0
0,0,0,0,0,0,0,0,0
306179,859,8,146,128,18,8,1,0
2914402,154,3,7,7,0,0,0,0
90728,686,0,133,129,4,6,1,0
0,0,0,0,0,0,0,0,0
0,0,0,0,0,0,0,0,0
121306,1568,8,505,499,6,0,1,0
295590,1157,6,133,16,117,6,1,0
0,0,0,0,0,0,0,0,0
0,0,0,0,0,0,0,0,0
94991,1204,6,225,211,14,19,1,0
37285,448,6,77,64,13,14,1,0
0,0,0,0,0,0,0,0,0
75837,460,9,103,100,3,4,1,0
75806,460,9,103,100,3,4,1,0
0,0,0,0,0,0,0,0,0
163706,845,2,222,189,33,0,1,0
61134,814,7,151,121,30,9,1,0
0,0,0,0,0,0,0,0,0
0,0,0,0,0,0,0,0,0
0,0,0,0,0,0,0,0,0
0,0,0,0,0,0,0,0,0
1808016,1113,6,165,154,11,4,1,0
47784,514,4,137,131,6,12,0,0
0,0,0,0,0,0,0,0,0
0,0,0,0,0,0,0,0,0
33607,613,3,107,104,3,0,1,0
48317,505,4,161,161,0,0,1,0
369533,332,2,72,11,61,3,1,0
0,0,0,0,0,0,0,0,0
0,0,0,0,0,0,0,0,0
0,0,0,0,0,0,0,0,0
51026,666,2,165,65,100,7,0,0
28672,423,2,52,43,9,4,0,0
150534,1638,8,203,190,13,36,1,0
0,0,0,0,0,0,0,0,0
0,0,0,0,0,0,0,0,0
8301,127,0,13,1,12,0,0,0
0,0,0,0,0,0,0,0,0
226490,2381,13,402,400,2,9,1,0
0,0,0,0,0,0,0,0,0
25708,364,2,114,109,5,22,1,0
147767,773,8,172,163,9,6,1,0
132852,677,8,148,140,8,7,1,0
638249,747,3,130,122,8,1,1,0
403538,1511,15,144,141,3,9,1,0
26971,162,3,22,22,0,0,0,0
26971,162,3,22,22,0,0,0,0
0,0,0,0,0,0,0,0,0
75749,672,5,125,109,16,6,1,0
386255,1267,5,208,155,53,48,1,0
220347,2287,7,499,372,127,10,1,0
136908,1132,8,229,223,6,22,1,0
19247,315,8,53,45,8,1,1,0
17160,211,9,33,30,3,1,1,0
464303,1674,11,229,214,15,34,1,0
42675,137,10,4,3,1,4,1,0
0,0,0,0,0,0,0,0,0
20543,108,2,20,20,0,0,0,0
0,0,0,0,0,0,0,0,0
160063,850,8,121,7,114,14,1,0
0,0,0,0,0,0,0,0,0
17844,393,0,128,128,0,8,1,0
0,0,0,0,0,0,0,0,0
0,0,0,0,0,0,0,0,0
69328,994,4,97,89,8,0,1,0
0,0,0,0,0,0,0,0,0
0,0,0,0,0,0,0,0,0
0,0,0,0,0,0,0,0,0
92467,1041,2,60,33,27,2,1,0
0,0,0,0,0,0,0,0,0
0,0,0,0,0,0,0,0,0
313237,1413,9,167,156,11,10,1,0
76785,488,6,95,80,15,3,1,0
76785,488,6,95,80,15,3,1,0
2503923,5742,14,207,192,15,6,1,0
0,0,0,0,0,0,0,0,0
165409,464,1,114,13,101,8,1,0
163082,545,6,152,149,3,10,1,0
47991,614,6,40,40,0,3,1,0
0,0,0,0,0,0,0,0,0
16748,275,5,73,72,1,1,0,0
8623,109,5,15,14,1,1,0,0
817437,4996,13,653,642,11,101,1,0
494814,2086,13,510,499,11,12,1,0
31820,419,3,63,61,2,8,1,0
173156,1153,15,225,195,30,24,1,0
0,0,0,0,0,0,0,0,0
0,0,0,0,0,0,0,0,0
35548,358,8,36,34,2,5,1,0
0,0,0,0,0,0,0,0,0
166035,1865,9,346,332,14,6,1,0
0,0,0,0,0,0,0,0,0
2058020,501,6,90,83,7,5,1,0
154070,1531,2,11,11,0,8,0,0
0,0,0,0,0,0,0,0,0
723324,2424,14,165,153,12,2,1,0
114747,806,7,119,83,36,4,1,0
710226,3029,5,387,372,15,4,1,0
430396,962,5,141,126,15,3,1,0
0,0,0,0,0,0,0,0,0
132826,1190,11,267,197,70,6,1,0
9413,173,1,10,6,4,0,1,0
159828,994,11,20,16,4,1,1,0
143177,706,10,77,58,19,0,1,0
0,0,0,0,0,0,0,0,0
20741,434,1,83,75,8,4,1,0
14000,264,1,29,27,2,10,1,0
0,0,0,0,0,0,0,0,0
47774,661,1,172,148,24,0,0,0
308168,2432,8,296,286,10,7,1,0
183845,1404,8,252,247,5,5,1,0
0,0,0,0,0,0,0,0,0
106028,786,8,235,225,10,2,1,0
103568,805,8,235,222,13,2,1,0
0,0,0,0,0,0,0,0,0
0,0,0,0,0,0,0,0,0
977274,4137,7,824,47,777,69,1,0
315,6,0,0,0,0,0,0,0
21718,33,0,1,1,0,0,1,0
79034,759,9,242,228,14,7,1,0
523529,1611,4,243,142,101,14,1,0
81130,112,1,10,7,3,2,0,0
122951,1578,3,227,218,9,41,1,0
108221,1487,3,214,203,11,41,1,0
129863,585,11,57,46,11,0,0,0
8990,97,1,1,1,0,2,0,0
28062,422,2,65,64,1,0,1,0
3435,76,3,18,18,0,0,1,0
115586,1086,8,292,277,15,4,1,0
0,0,0,0,0,0,0,0,0
268430,899,8,104,51,53,11,1,0
84945,464,8,103,98,5,1,1,0
0,0,0,0,0,0,0,0,0
0,0,0,0,0,0,0,0,0
753608,4575,9,675,658,17,7,0,0
1132509,5811,9,688,660,28,18,0,0
0,0,0,0,0,0,0,0,0
208217,490,7,42,37,5,5,1,0
11270,85,2,5,5,0,0,0,0
310392,2188,10,316,296,20,15,1,0
109310,1021,5,228,216,12,6,1,0
32775,224,4,36,33,3,2,1,0
0,0,0,0,0,0,0,0,0
0,0,0,0,0,0,0,0,0
0,0,0,0,0,0,0,0,0
67965,650,8,120,90,30,12,1,0
0,0,0,0,0,0,0,0,0
60547,832,4,284,277,7,0,1,0
32346,458,3,148,145,3,0,1,0
64808,700,4,208,206,2,7,1,0
102705,1557,6,167,156,11,1,1,0
23423,376,6,61,58,3,1,1,0
43741,646,6,110,105,5,15,1,0
0,0,0,0,0,0,0,0,0
128184,1038,4,224,223,1,7,1,0
0,0,0,0,0,0,0,0,0
0,0,0,0,0,0,0,0,0
0,0,0,0,0,0,0,0,0
0,0,0,0,0,0,0,0,0
0,0,0,0,0,0,0,0,0
86000,1049,10,194,136,58,10,1,0
132975,293,0,89,86,3,0,0,0
0,0,0,0,0,0,0,0,0
67839,688,3,118,91,27,2,1,0
34118,411,3,87,71,16,1,1,0
10029,181,3,27,26,1,0,1,0
0,0,0,0,0,0,0,0,0
92229,84,0,15,15,0,5,0,0
0,0,0,0,0,0,0,0,0
308291,1702,1,375,326,49,1,1,0
48917,657,7,160,153,7,6,1,0
7873,162,3,36,28,8,0,1,0
0,0,0,0,0,0,0,0,0
0,0,0,0,0,0,0,0,0
0,0,0,0,0,0,0,0,0
183790,2968,5,221,202,19,0,1,0
309467,1255,3,161,156,5,8,0,0
0,0,0,0,0,0,0,0,0
0,0,0,0,0,0,0,0,0
0,0,0,0,0,0,0,0,0
230345,166,6,7,1,6,0,1,0
84648,817,7,182,182,0,18,0,0
0,0,0,0,0,0,0,0,0
0,0,0,0,0,0,0,0,0
278720,1406,11,274,253,21,10,1,0
60403,1449,2,295,284,11,0,1,0
13047,166,2,41,32,9,1,1,0
0,0,0,0,0,0,0,0,0
0,0,0,0,0,0,0,0,0
0,0,0,0,0,0,0,0,0
101850,1269,7,77,45,32,9,0,0
12143,86,3,10,10,0,1,1,0
12462,87,3,10,10,0,1,1,0
180392,909,4,201,173,28,1,1,0
219079,1152,8,128,127,1,53,1,0
0,0,0,0,0,0,0,0,0
0,0,0,0,0,0,0,0,0
588617,1616,5,113,106,7,26,1,0
22956,36,0,2,1,1,0,1,0
0,0,0,0,0,0,0,0,0
123944,841,14,57,24,33,3,1,0
0,0,0,0,0,0,0,0,0
59394,934,4,296,249,47,8,1,0
2326,50,0,5,4,1,0,0,0
328326,480,8,56,37,19,1,1,0
0,0,0,0,0,0,0,0,0
69638,986,3,304,209,95,6,0,0
15563,215,3,23,20,3,5,0,0
0,0,0,0,0,0,0,0,0
144768,1678,2,314,300,14,11,0,0
57445,762,7,144,142,2,0,1,0
0,0,0,0,0,0,0,0,0
91419,443,5,119,116,3,0,1,0
527316,1431,14,129,117,12,16,1,0
77655,492,9,85,84,1,8,0,0
0,0,0,0,0,0,0,0,0
0,0,0,0,0,0,0,0,0
327082,3852,3,1058,1036,22,37,1,0
389623,4210,3,1000,979,21,34,1,0
0,0,0,0,0,0,0,0,0
465134,3247,11,927,750,177,39,0,0
171029,695,6,117,116,1,15,1,0
0,0,0,0,0,0,0,0,0
0,0,0,0,0,0,0,0,0
667103,1781,6,202,171,31,0,1,0
264710,2725,4,137,53,84,7,1,0
52677,249,7,56,53,3,0,1,0
0,0,0,0,0,0,0,0,0
0,0,0,0,0,0,0,0,0
130943,418,11,53,44,9,0,1,0
9723,111,5,12,11,1,2,0,0
112358,693,8,124,114,10,3,1,0
532579,1670,8,265,205,60,16,1,0
5416,42,5,3,2,1,0,0,0
1230628,2386,6,239,219,20,21,1,0
0,0,0,0,0,0,0,0,0
0,0,0,0,0,0,0,0,0
0,0,0,0,0,0,0,0,0
0,0,0,0,0,0,0,0,0
0,0,0,0,0,0,0,0,0
249086,1811,12,362,356,6,24,1,0
416715,3857,11,334,300,34,10,0,0
53473,530,3,30,29,1,11,1,0
0,0,0,0,0,0,0,0,0
0,0,0,0,0,0,0,0,0
265337,1537,13,172,145,27,9,1,0
169848,552,6,42,37,5,10,1,0
0,0,0,0,0,0,0,0,0
0,0,0,0,0,0,0,0,0
22685,33,0,1,1,0,0,1,0
0,0,0,0,0,0,0,0,0
0,0,0,0,0,0,0,0,0
0,0,0,0,0,0,0,0,0
83593,343,14,27,22,5,3,1,0
62614,244,13,24,19,5,2,1,0
0,0,0,0,0,0,0,0,0
0,0,0,0,0,0,0,0,0
30972,101,1,10,9,1,2,1,0
30285,82,1,11,10,1,2,1,0
0,0,0,0,0,0,0,0,0
0,0,0,0,0,0,0,0,0
0,0,0,0,0,0,0,0,0
113079,1047,8,239,226,13,46,1,0
163035,1190,3,141,130,11,7,1,0
23577,39,0,3,1,2,0,1,0
0,0,0,0,0,0,0,0,0
9627,191,1,21,21,0,0,1,0
0,0,0,0,0,0,0,0,0
117473,703,3,116,111,5,14,1,0
718782,102,4,2,2,0,2,0,0
178975,818,7,86,83,3,0,1,0
72482,853,0,151,77,74,0,1,0
0,0,0,0,0,0,0,0,0
313506,3333,2,516,512,4,1,0,0
3162294,1394,9,277,231,46,12,1,0
145981,1021,5,353,345,8,0,0,0
0,0,0,0,0,0,0,0,0
112575,1054,0,168,154,14,2,1,0
0,0,0,0,0,0,0,0,0
10893,113,3,20,17,3,4,1,0
0,0,0,0,0,0,0,0,0
71826,505,4,18,9,9,1,1,0
2973694,22532,10,3226,3101,125,10,1,0
262861,2801,2,699,692,7,2,0,0
9956,59,4,3,0,3,0,0,0
298627,2193,4,214,208,6,0,0,0
204691,1395,3,148,142,6,0,0,0
0,0,0,0,0,0,0,0,0
90077,951,5,161,159,2,1,0,0
75721,1035,4,297,132,165,0,1,0
15612,137,4,15,15,0,0,1,0
92430,1041,2,60,33,27,2,1,0
52425,165,11,14,13,1,4,0,0
0,0,0,0,0,0,0,0,0
237716,1864,2,385,373,12,0,1,0
157539,353,1,60,53,7,0,1,0
0,0,0,0,0,0,0,0,0
447806,1837,11,262,9,253,29,1,0
0,0,0,0,0,0,0,0,0
838868,460,6,97,90,7,5,1,0
848116,394,6,65,57,8,5,1,0
0,0,0,0,0,0,0,0,0
171028,731,11,105,104,1,4,1,0
170812,731,11,105,104,1,4,1,0
201578,926,2,153,150,3,4,1,0
452349,1476,13,284,276,8,3,1,0
42321,427,6,104,104,0,2,1,0
179445,695,11,90,84,6,46,1,0
92889,1261,2,291,276,15,2,1,0
146345,1572,4,207,204,3,2,1,0
45420,328,0,34,24,10,0,0,0
33656,395,7,97,92,5,0,1,0
388499,1427,13,317,265,52,8,1,0
111856,118,9,7,7,0,3,1,0
333237,1267,12,213,203,10,6,1,0
0,0,0,0,0,0,0,0,0
0,0,0,0,0,0,0,0,0
0,0,0,0,0,0,0,0,0
200879,1380,8,249,242,7,72,0,0
3558059,1523,15,364,346,18,11,1,0
46488,531,3,97,84,13,6,1,0
0,0,0,0,0,0,0,0,0
263288,938,11,153,145,8,5,1,0
0,0,0,0,0,0,0,0,0
414299,1101,8,178,14,164,3,0,0
23044,38,0,2,2,0,0,1,0
42715,150,2,5,1,4,0,0,0
0,0,0,0,0,0,0,0,0
179789,890,5,133,130,3,0,1,0
199339,1430,16,173,168,5,10,1,0
141310,1314,3,111,44,67,2,1,0
0,0,0,0,0,0,0,0,0
0,0,0,0,0,0,0,0,0
0,0,0,0,0,0,0,0,0
29759,162,3,7,3,4,3,0,0
35542,240,3,10,3,7,3,0,0
5210,60,2,4,4,0,0,0,0
28122,429,2,115,109,6,0,1,0
367825,1590,7,54,44,10,359,1,0
0,0,0,0,0,0,0,0,0
21990,33,0,1,1,0,0,1,0
221056,1097,12,163,161,2,10,1,0
183307,906,12,152,147,5,9,1,0
510454,1995,4,106,106,0,7,1,0
34943,420,6,78,48,30,0,1,0
0,0,0,0,0,0,0,0,0
168511,688,3,50,8,42,6,1,0
71360,449,3,81,57,24,61,1,0
0,0,0,0,0,0,0,0,0
52773,493,1,99,51,48,0,1,0
210947,180,0,47,32,15,1,1,0
0,0,0,0,0,0,0,0,0
89413,1238,7,149,113,36,6,1,0
0,0,0,0,0,0,0,0,0
0,0,0,0,0,0,0,0,0
80007,1161,4,142,137,5,3,1,0
0,0,0,0,0,0,0,0,0
49348,1009,1,214,213,1,7,0,0
0,0,0,0,0,0,0,0,0
0,0,0,0,0,0,0,0,0
238932,1022,11,169,160,9,21,1,0
60068,281,5,56,54,2,9,0,0
75073,717,7,121,113,8,4,1,0
0,0,0,0,0,0,0,0,0
0,0,0,0,0,0,0,0,0
43875,337,4,52,50,2,7,1,0
41577,609,3,56,51,5,0,1,0
0,0,0,0,0,0,0,0,0
70220,459,2,34,34,0,1,0,0
129617,1989,0,217,214,3,0,0,0
140504,414,4,13,13,0,6,1,0
145090,1168,6,220,208,12,1,1,0
1083019,2353,8,491,18,473,17,1,0
714129,687,7,125,92,33,13,1,0
0,0,0,0,0,0,0,0,0
0,0,0,0,0,0,0,0,0
255498,2635,8,513,504,9,15,1,0
28334,42,0,2,1,1,0,0,0
52540,604,2,71,70,1,0,1,0
178115,786,8,121,45,76,2,1,0
154258,559,7,86,83,3,8,1,0
317786,1135,1,88,81,7,1,0,0
279123,472,1,33,26,7,1,0,0
24646,409,2,116,115,1,0,1,0
104416,813,8,57,51,6,17,1,0
46513,300,7,49,42,7,5,1,0
27630,312,1,32,12,20,3,1,0
61819,147,0,9,5,4,13,1,0
0,0,0,0,0,0,0,0,0
0,0,0,0,0,0,0,0,0
108581,565,3,103,103,0,12,1,0
180019,1193,7,298,293,5,6,1,0
0,0,0,0,0,0,0,0,0
0,0,0,0,0,0,0,0,0
239902,3551,4,1125,1094,31,43,0,0
0,0,0,0,0,0,0,0,0
38959,364,10,28,7,21,1,1,0
21799,33,0,1,1,0,0,1,0
373742,1606,5,250,230,20,7,1,0
334528,1418,5,234,215,19,7,1,0
270014,1521,6,187,180,7,12,1,0
218869,1051,6,123,116,7,11,1,0
67756,277,5,28,13,15,1,1,0
0,0,0,0,0,0,0,0,0
86092,759,5,145,125,20,10,1,0
221981,2308,12,311,285,26,6,1,0
0,0,0,0,0,0,0,0,0
139446,2746,6,383,377,6,15,1,0
63502,1102,6,163,163,0,10,1,0
723267,2932,16,280,271,9,8,1,0
145530,925,6,198,147,51,0,1,0
0,0,0,0,0,0,0,0,0
433640,2363,7,446,395,51,39,1,0
348698,1844,12,229,109,120,3,1,0
382377,1659,11,340,336,4,6,1,0
231059,347,0,17,9,8,0,1,0
520954,3718,6,219,80,139,3,0,0
215608,743,3,63,53,10,3,0,0
27886,44,0,4,3,1,0,0,0
0,0,0,0,0,0,0,0,0
164391,1020,4,88,61,27,2,1,0
0,0,0,0,0,0,0,0,0
61500,263,8,22,19,3,14,1,0
30941,166,7,24,21,3,10,1,0
0,0,0,0,0,0,0,0,0
9753,114,4,27,25,2,0,1,0
0,0,0,0,0,0,0,0,0
1418754,3309,6,506,476,30,0,0,0
0,0,0,0,0,0,0,0,0
0,0,0,0,0,0,0,0,0
6974,89,3,9,2,7,0,1,0
0,0,0,0,0,0,0,0,0
334233,2226,1,416,395,21,8,1,0
5821,119,1,31,27,4,0,1,0
445982,2497,8,385,360,25,10,1,0
0,0,0,0,0,0,0,0,0
0,0,0,0,0,0,0,0,0
146088,878,0,173,159,14,5,1,0
55032,408,2,102,102,0,1,1,0
0,0,0,0,0,0,0,0,0
30215,429,0,220,206,14,0,0,0
260583,3295,12,576,511,65,29,1,0
46396,131,2,5,4,1,0,1,0
247752,1526,8,134,52,82,9,1,0
170214,1131,6,209,159,50,6,1,0
65704,637,5,114,95,19,7,1,0
86922,444,2,17,13,4,12,1,0
62803,505,2,74,65,9,0,0,0
0,0,0,0,0,0,0,0,0
40526,610,8,114,82,32,6,1,0
44865,373,3,64,60,4,6,1,0
96332,1124,6,193,188,5,5,1,0
77888,569,7,84,78,6,1,1,0
325769,401,7,58,57,1,7,1,0
0,0,0,0,0,0,0,0,0
0,0,0,0,0,0,0,0,0
0,0,0,0,0,0,0,0,0
104687,1974,4,760,760,0,0,0,0
1295827,2414,9,146,127,19,3,1,0
1338418,2292,11,5,5,0,3,1,0
0,0,0,0,0,0,0,0,0
341644,1348,3,246,87,159,8,1,0
87312,413,6,58,58,0,8,1,0
0,0,0,0,0,0,0,0,0
47275,580,3,105,105,0,7,1,0
154441,798,5,78,37,41,0,1,0
472061,5047,11,2215,2201,14,2022,1,0
201636,614,11,84,71,13,5,1,0
0,0,0,0,0,0,0,0,0
75540,1513,3,464,432,32,5,1,0
0,0,0,0,0,0,0,0,0
2419981,826,9,159,153,6,18,1,0
244781,741,8,99,99,0,5,1,0
0,0,0,0,0,0,0,0,0
0,0,0,0,0,0,0,0,0
0,0,0,0,0,0,0,0,0
0,0,0,0,0,0,0,0,0
998141,8710,9,163,157,6,9,1,0
0,0,0,0,0,0,0,0,0
171571,1180,4,257,250,7,0,1,0
0,0,0,0,0,0,0,0,0
0,0,0,0,0,0,0,0,0
100762,831,9,257,253,4,18,1,0
33433,297,3,48,46,2,4,1,0
4640,97,0,22,22,0,0,0,0
52620,408,7,66,62,4,5,0,0
280059,1053,15,186,177,9,12,1,0
255377,864,14,166,160,6,6,1,0
179178,1252,9,149,125,24,57,1,0
85350,546,2,13,9,4,4,1,0
0,0,0,0,0,0,0,0,0
0,0,0,0,0,0,0,0,0
51021,604,4,162,162,0,0,1,0
0,0,0,0,0,0,0,0,0
0,0,0,0,0,0,0,0,0
0,0,0,0,0,0,0,0,0
0,0,0,0,0,0,0,0,0
91539,1041,7,138,131,7,4,0,0
0,0,0,0,0,0,0,0,0
10201,176,0,27,22,5,0,1,0
55055,504,2,68,68,0,1,0,0
61803,1067,4,253,252,1,25,1,0
33391,583,2,127,125,2,2,1,0
75902,1070,1,207,200,7,3,1,0
26923,225,1,28,19,9,2,1,0
1199226,1673,9,199,173,26,5,1,0
308182,963,12,175,136,39,10,1,0
374345,772,4,63,35,28,7,1,0
40387,213,7,13,8,5,0,0,0
0,0,0,0,0,0,0,0,0
605776,1339,9,151,133,18,22,1,0
0,0,0,0,0,0,0,0,0
1011244,18886,7,1500,1478,22,39,0,0
204534,2144,9,727,522,205,8,1,0
89142,1063,10,403,391,12,2,1,0
105172,1587,6,199,155,44,0,1,0
573548,2722,6,159,153,6,76,0,0
264758,1223,6,116,110,6,17,0,0
0,0,0,0,0,0,0,0,0
0,0,0,0,0,0,0,0,0
0,0,0,0,0,0,0,0,0
0,0,0,0,0,0,0,0,0
7160,47,3,3,3,0,3,0,0
0,0,0,0,0,0,0,0,0
22022,33,0,1,1,0,0,1,0
22863,37,0,2,1,1,0,1,0
290599,3752,5,232,183,49,13,1,0
351735,2336,2,152,145,7,3,1,0
0,0,0,0,0,0,0,0,0
4892810,7539,7,422,406,16,4,1,0
40512,141,4,24,18,6,0,1,0
0,0,0,0,0,0,0,0,0
155811,391,12,24,20,4,1,1,0
0,0,0,0,0,0,0,0,0
0,0,0,0,0,0,0,0,0
305381,1109,10,226,206,20,6,1,0
3877,56,0,5,1,4,0,0,0
0,0,0,0,0,0,0,0,0
21792,33,0,1,1,0,0,1,0
0,0,0,0,0,0,0,0,0
117949,1096,6,262,253,9,8,1,0
99772,1572,4,235,235,0,0,0,0
14782,213,5,48,48,0,3,0,0
0,0,0,0,0,0,0,0,0
0,0,0,0,0,0,0,0,0
16511,286,6,91,76,15,0,0,0
0,0,0,0,0,0,0,0,0
2356563,2680,3,94,90,4,244,1,0
0,0,0,0,0,0,0,0,0
0,0,0,0,0,0,0,0,0
45733,455,9,80,72,8,0,1,0
0,0,0,0,0,0,0,0,0
147160,1012,8,204,204,0,0,0,0
0,0,0,0,0,0,0,0,0
0,0,0,0,0,0,0,0,0
81674,1037,9,108,89,19,3,1,0
19700,77,6,1,1,0,1,0,0
0,0,0,0,0,0,0,0,0
0,0,0,0,0,0,0,0,0
98879,952,8,212,204,8,22,1,0
144124,835,1,270,268,2,2,1,0
31540,499,0,196,189,7,0,1,0
17950,184,0,55,53,2,0,1,0
63399,553,9,116,110,6,0,1,0
95472,1126,11,90,17,73,5,1,0
57224,75,6,3,3,0,2,0,0
0,0,0,0,0,0,0,0,0
8801,42,0,0,0,0,0,0,0
0,0,0,0,0,0,0,0,0
88105,436,5,37,24,13,8,1,0
0,0,0,0,0,0,0,0,0
0,0,0,0,0,0,0,0,0
323558,4329,7,407,236,171,1,1,0
259231,2205,5,334,297,37,4,1,0
37017,337,5,60,31,29,0,1,0
0,0,0,0,0,0,0,0,0
0,0,0,0,0,0,0,0,0
47808,405,6,21,2,19,0,0,0
1623961,1487,10,61,7,54,8,1,0
0,0,0,0,0,0,0,0,0
0,0,0,0,0,0,0,0,0
235819,1758,10,385,380,5,16,1,0
5113,76,2,6,6,0,0,1,0
0,0,0,0,0,0,0,0,0
23098,538,0,191,189,2,4,1,0
7079,87,2,8,6,2,0,1,0
0,0,0,0,0,0,0,0,0
2840547,25968,9,173,160,13,0,1,0
1110,12,1,0,0,0,0,0,0
0,0,0,0,0,0,0,0,0
181918,916,11,78,75,3,2,0,0
181982,916,11,78,75,3,2,0,0
86396,724,3,144,135,9,8,1,0
174123,985,12,154,147,7,7,1,0
0,0,0,0,0,0,0,0,0
0,0,0,0,0,0,0,0,0
266803,1256,6,118,110,8,10,1,0
0,0,0,0,0,0,0,0,0
85218,786,3,65,52,13,7,0,0
187020,1817,2,411,407,4,0,0,0
28220,262,2,33,30,3,0,0,0
80543,383,7,53,45,8,22,1,0
0,0,0,0,0,0,0,0,0
0,0,0,0,0,0,0,0,0
48248,609,8,66,48,18,5,0,0
32105,398,9,48,39,9,0,0,0
0,0,0,0,0,0,0,0,0
0,0,0,0,0,0,0,0,0
231134,1431,11,211,190,21,19,1,0
255840,1293,10,280,262,18,6,1,0
178269,1838,7,286,274,12,4,1,0
716594,393,8,58,51,7,7,1,0
223370,1130,1,56,42,14,0,1,0
0,0,0,0,0,0,0,0,0
333380,1832,10,446,412,34,13,0,0
32374,118,3,8,3,5,1,1,0
28824,478,4,71,61,10,0,1,0
0,0,0,0,0,0,0,0,0
69699,1226,9,260,224,36,3,1,0
10411,152,4,26,26,0,0,1,0
83682,638,2,167,167,0,6,1,0
0,0,0,0,0,0,0,0,0
288703,1694,7,267,243,24,14,1,0
69575,122,5,2,2,0,2,0,0
14282,321,3,69,69,0,0,1,0
104451,830,13,79,71,8,15,1,0
47445,656,5,71,70,1,2,1,0
24856,273,6,48,46,2,0,1,0
29385,326,3,121,119,2,5,1,0
19692,168,2,53,9,44,0,1,0
0,0,0,0,0,0,0,0,0
85680,785,10,27,20,7,20,1,0
2629622,5754,5,311,247,64,2,1,0
324348,870,5,129,90,39,2,1,0
0,0,0,0,0,0,0,0,0
53786,831,3,198,190,8,0,0,0
56519,1042,2,171,171,0,0,1,0
107245,788,10,225,222,3,5,0,0
10929,86,7,6,5,1,0,0,0
85159,1110,5,175,171,4,55,1,0
0,0,0,0,0,0,0,0,0
136555,1280,5,313,307,6,4,0,0
285857,2041,13,338,320,18,18,0,0
0,0,0,0,0,0,0,0,0
34934,313,0,44,4,40,0,0,0
66672,235,5,30,15,15,2,1,0
555552,1761,4,103,94,9,0,1,0
0,0,0,0,0,0,0,0,0
0,0,0,0,0,0,0,0,0
336799,2094,3,262,244,18,1,1,0
0,0,0,0,0,0,0,0,0
0,0,0,0,0,0,0,0,0
173448,1615,6,368,353,15,1,1,0
32076,407,6,69,61,8,6,1,0
11668,172,6,24,19,5,6,1,0
748425,1685,6,206,205,1,17,1,1
0,0,0,0,0,0,0,0,0
236695,1415,7,329,241,88,7,1,0
60672,337,12,48,48,0,5,1,0
0,0,0,0,0,0,0,0,0
107220,859,8,152,132,20,0,1,0
339512,3451,4,641,119,522,3,1,0
31173,43,1,14,14,0,0,1,0
64543,1545,0,355,354,1,5,1,0
8799,213,0,46,45,1,3,1,0
246001,2438,13,330,223,107,13,1,0
18830,50,3,7,4,3,0,0,0
192154,742,6,49,49,0,4,1,0
117224,380,2,33,33,0,6,1,0
0,0,0,0,0,0,0,0,0
0,0,0,0,0,0,0,0,0
0,0,0,0,0,0,0,0,0
0,0,0,0,0,0,0,0,0
321042,2592,13,332,327,5,3,1,0
289917,2298,17,737,722,15,35,1,0
695880,1905,5,6,5,1,0,1,0
0,0,0,0,0,0,0,0,0
0,0,0,0,0,0,0,0,0
208848,857,13,208,191,17,0,1,0
85073,1156,4,232,191,41,0,0,0
21114,244,4,49,32,17,0,0,0
195333,923,4,293,284,9,5,1,0
103068,165,3,6,4,2,5,0,0
437444,1321,13,73,73,0,41,1,0
0,0,0,0,0,0,0,0,0
590256,610,8,89,87,2,0,1,0
414834,441,8,6,6,0,0,1,0
112326,1297,1,285,285,0,8,0,0
0,0,0,0,0,0,0,0,0
14684,199,8,23,22,1,4,1,0
60505,712,2,77,77,0,11,1,0
19431,176,3,17,17,0,9,1,0
0,0,0,0,0,0,0,0,0
0,0,0,0,0,0,0,0,0
0,0,0,0,0,0,0,0,0
0,0,0,0,0,0,0,0,0
0,0,0,0,0,0,0,0,0
301370,403,10,24,21,3,0,1,0
454117,3762,5,238,141,97,2,1,0
0,0,0,0,0,0,0,0,0
0,0,0,0,0,0,0,0,0
238216,1657,5,137,134,3,6,1,0
221445,1333,6,92,87,5,7,1,0
0,0,0,0,0,0,0,0,0
1168340,464,7,58,50,8,8,1,0
0,0,0,0,0,0,0,0,0
0,0,0,0,0,0,0,0,0
191222,2570,4,17,14,3,3,1,0
170490,1003,6,136,119,17,0,1,0
0,0,0,0,0,0,0,0,0
224561,2343,9,528,509,19,6,1,0
0,0,0,0,0,0,0,0,0
0,0,0,0,0,0,0,0,0
182762,799,12,120,100,20,9,1,0
0,0,0,0,0,0,0,0,0
484081,2494,7,375,284,91,25,1,0
71863,553,8,170,166,4,11,1,0
0,0,0,0,0,0,0,0,0
87180,1441,7,476,473,3,0,1,0
0,0,0,0,0,0,0,0,0
0,0,0,0,0,0,0,0,0
1407,32,0,4,4,0,0,0,0
19106,239,4,40,35,5,2,1,0
0,0,0,0,0,0,0,0,0
250541,485,4,28,27,1,1,0,0
0,0,0,0,0,0,0,0,0
0,0,0,0,0,0,0,0,0
42154,704,3,115,16,99,1,1,0
0,0,0,0,0,0,0,0,0
0,0,0,0,0,0,0,0,0
0,0,0,0,0,0,0,0,0
0,0,0,0,0,0,0,0,0
0,0,0,0,0,0,0,0,0
105948,479,10,189,184,5,5,1,0
10811,82,7,4,3,1,0,0,0
251428,792,11,104,74,30,5,1,0
116839,1251,2,76,76,0,2,0,0
23655,86,0,1,1,0,5,1,0
14742,261,0,14,14,0,0,1,0
11246,135,0,18,18,0,0,1,0
221544,1233,5,120,114,6,0,1,0
221543,1233,5,120,114,6,0,1,0
0,0,0,0,0,0,0,0,0
431482,1595,11,122,112,10,28,1,0
670463,3170,16,454,432,22,5,1,0
0,0,0,0,0,0,0,0,0
0,0,0,0,0,0,0,0,0
231200,347,0,17,14,3,0,1,0
24410,247,4,23,17,6,0,1,0
0,0,0,0,0,0,0,0,0
0,0,0,0,0,0,0,0,0
57756,594,6,136,94,42,4,1,0
0,0,0,0,0,0,0,0,0
0,0,0,0,0,0,0,0,0
0,0,0,0,0,0,0,0,0
0,0,0,0,0,0,0,0,0
113580,846,7,97,95,2,3,1,0
104046,788,7,80,78,2,5,1,0
0,0,0,0,0,0,0,0,0
223916,1263,7,60,51,9,11,1,0
187282,714,7,41,35,6,12,1,0
91519,849,11,67,63,4,7,1,0
55765,422,3,39,37,2,5,1,0
0,0,0,0,0,0,0,0,0
39281,402,2,105,100,5,2,1,0
17242,166,1,17,17,0,8,1,0
3620,64,0,16,16,0,0,1,0
145899,818,11,98,93,5,37,1,0
0,0,0,0,0,0,0,0,0
1284423,13528,3,2035,2015,20,13,1,0
0,0,0,0,0,0,0,0,0
211109,215,2,7,7,0,11,1,0
126840,759,5,88,74,14,4,1,0
67297,512,9,81,70,11,3,0,0
89610,929,6,208,205,3,0,1,0
131386,1387,10,366,335,31,2,1,0
123744,832,5,58,29,29,6,1,0
5234,72,0,3,2,1,0,0,0
259139,1110,9,160,155,5,5,1,0
468453,728,11,85,43,42,6,1,0
219586,180,6,5,5,0,5,0,0
193969,674,10,90,76,14,1,1,0
0,0,0,0,0,0,0,0,0
19915,295,3,81,81,0,0,0,0
0,0,0,0,0,0,0,0,0
0,0,0,0,0,0,0,0,0
0,0,0,0,0,0,0,0,0
0,0,0,0,0,0,0,0,0
0,0,0,0,0,0,0,0,0
0,0,0,0,0,0,0,0,0
0,0,0,0,0,0,0,0,0
0,0,0,0,0,0,0,0,0
0,0,0,0,0,0,0,0,0
0,0,0,0,0,0,0,0,0
0,0,0,0,0,0,0,0,0
0,0,0,0,0,0,0,0,0
0,0,0,0,0,0,0,0,0
0,0,0,0,0,0,0,0,0
0,0,0,0,0,0,0,0,0
0,0,0,0,0,0,0,0,0
0,0,0,0,0,0,0,0,0
0,0,0,0,0,0,0,0,0
0,0,0,0,0,0,0,0,0
0,0,0,0,0,0,0,0,0
0,0,0,0,0,0,0,0,0
0,0,0,0,0,0,0,0,0
0,0,0,0,0,0,0,0,0
0,0,0,0,0,0,0,0,0
0,0,0,0,0,0,0,0,0
0,0,0,0,0,0,0,0,0
0,0,0,0,0,0,0,0,0
0,0,0,0,0,0,0,0,0
0,0,0,0,0,0,0,0,0
0,0,0,0,0,0,0,0,0
0,0,0,0,0,0,0,0,0
0,0,0,0,0,0,0,0,0
0,0,0,0,0,0,0,0,0
0,0,0,0,0,0,0,0,0
0,0,0,0,0,0,0,0,0
0,0,0,0,0,0,0,0,0
0,0,0,0,0,0,0,0,0
0,0,0,0,0,0,0,0,0
0,0,0,0,0,0,0,0,0
0,0,0,0,0,0,0,0,0
0,0,0,0,0,0,0,0,0
0,0,0,0,0,0,0,0,0
0,0,0,0,0,0,0,0,0
0,0,0,0,0,0,0,0,0
0,0,0,0,0,0,0,0,0
0,0,0,0,0,0,0,0,0
0,0,0,0,0,0,0,0,0
0,0,0,0,0,0,0,0,0
0,0,0,0,0,0,0,0,0
0,0,0,0,0,0,0,0,0
0,0,0,0,0,0,0,0,0
0,0,0,0,0,0,0,0,0
0,0,0,0,0,0,0,0,0
0,0,0,0,0,0,0,0,0
0,0,0,0,0,0,0,0,0
0,0,0,0,0,0,0,0,0
0,0,0,0,0,0,0,0,0
0,0,0,0,0,0,0,0,0
0,0,0,0,0,0,0,0,0
0,0,0,0,0,0,0,0,0
0,0,0,0,0,0,0,0,0
0,0,0,0,0,0,0,0,0
0,0,0,0,0,0,0,0,0
0,0,0,0,0,0,0,0,0
0,0,0,0,0,0,0,0,0
0,0,0,0,0,0,0,0,0
0,0,0,0,0,0,0,0,0
0,0,0,0,0,0,0,0,0
0,0,0,0,0,0,0,0,0
0,0,0,0,0,0,0,0,0
0,0,0,0,0,0,0,0,0
0,0,0,0,0,0,0,0,0
0,0,0,0,0,0,0,0,0
0,0,0,0,0,0,0,0,0
0,0,0,0,0,0,0,0,0
0,0,0,0,0,0,0,0,0
0,0,0,0,0,0,0,0,0
0,0,0,0,0,0,0,0,0
0,0,0,0,0,0,0,0,0
0,0,0,0,0,0,0,0,0
0,0,0,0,0,0,0,0,0
0,0,0,0,0,0,0,0,0
0,0,0,0,0,0,0,0,0
0,0,0,0,0,0,0,0,0
0,0,0,0,0,0,0,0,0
0,0,0,0,0,0,0,0,0
0,0,0,0,0,0,0,0,0
0,0,0,0,0,0,0,0,0
0,0,0,0,0,0,0,0,0
0,0,0,0,0,0,0,0,0
0,0,0,0,0,0,0,0,0
0,0,0,0,0,0,0,0,0
0,0,0,0,0,0,0,0,0
0,0,0,0,0,0,0,0,0
0,0,0,0,0,0,0,0,0
0,0,0,0,0,0,0,0,0
0,0,0,0,0,0,0,0,0
0,0,0,0,0,0,0,0,0
0,0,0,0,0,0,0,0,0
0,0,0,0,0,0,0,0,0
0,0,0,0,0,0,0,0,0
0,0,0,0,0,0,0,0,0
0,0,0,0,0,0,0,0,0
0,0,0,0,0,0,0,0,0
0,0,0,0,0,0,0,0,0
0,0,0,0,0,0,0,0,0
0,0,0,0,0,0,0,0,0
0,0,0,0,0,0,0,0,0
0,0,0,0,0,0,0,0,0
0,0,0,0,0,0,0,0,0
0,0,0,0,0,0,0,0,0
0,0,0,0,0,0,0,0,0
0,0,0,0,0,0,0,0,0
0,0,0,0,0,0,0,0,0
0,0,0,0,0,0,0,0,0
0,0,0,0,0,0,0,0,0
0,0,0,0,0,0,0,0,0
0,0,0,0,0,0,0,0,0
0,0,0,0,0,0,0,0,0
0,0,0,0,0,0,0,0,0
0,0,0,0,0,0,0,0,0
0,0,0,0,0,0,0,0,0
0,0,0,0,0,0,0,0,0
0,0,0,0,0,0,0,0,0
0,0,0,0,0,0,0,0,0
0,0,0,0,0,0,0,0,0
0,0,0,0,0,0,0,0,0
0,0,0,0,0,0,0,0,0
0,0,0,0,0,0,0,0,0
0,0,0,0,0,0,0,0,0
0,0,0,0,0,0,0,0,0
0,0,0,0,0,0,0,0,0
0,0,0,0,0,0,0,0,0
0,0,0,0,0,0,0,0,0
0,0,0,0,0,0,0,0,0
0,0,0,0,0,0,0,0,0
0,0,0,0,0,0,0,0,0
0,0,0,0,0,0,0,0,0
0,0,0,0,0,0,0,0,0
0,0,0,0,0,0,0,0,0
0,0,0,0,0,0,0,0,0
0,0,0,0,0,0,0,0,0
0,0,0,0,0,0,0,0,0
0,0,0,0,0,0,0,0,0
0,0,0,0,0,0,0,0,0
0,0,0,0,0,0,0,0,0
0,0,0,0,0,0,0,0,0
0,0,0,0,0,0,0,0,0
0,0,0,0,0,0,0,0,0
0,0,0,0,0,0,0,0,0
0,0,0,0,0,0,0,0,0
0,0,0,0,0,0,0,0,0
0,0,0,0,0,0,0,0,0
0,0,0,0,0,0,0,0,0
0,0,0,0,0,0,0,0,0
0,0,0,0,0,0,0,0,0
0,0,0,0,0,0,0,0,0
0,0,0,0,0,0,0,0,0
0,0,0,0,0,0,0,0,0
0,0,0,0,0,0,0,0,0
0,0,0,0,0,0,0,0,0
0,0,0,0,0,0,0,0,0
0,0,0,0,0,0,0,0,0
0,0,0,0,0,0,0,0,0
0,0,0,0,0,0,0,0,0
0,0,0,0,0,0,0,0,0
0,0,0,0,0,0,0,0,0
0,0,0,0,0,0,0,0,0
0,0,0,0,0,0,0,0,0
0,0,0,0,0,0,0,0,0
0,0,0,0,0,0,0,0,0
0,0,0,0,0,0,0,0,0
0,0,0,0,0,0,0,0,0
0,0,0,0,0,0,0,0,0
0,0,0,0,0,0,0,0,0
0,0,0,0,0,0,0,0,0
0,0,0,0,0,0,0,0,0
0,0,0,0,0,0,0,0,0
0,0,0,0,0,0,0,0,0
0,0,0,0,0,0,0,0,0
0,0,0,0,0,0,0,0,0
0,0,0,0,0,0,0,0,0
0,0,0,0,0,0,0,0,0
0,0,0,0,0,0,0,0,0
0,0,0,0,0,0,0,0,0
0,0,0,0,0,0,0,0,0
0,0,0,0,0,0,0,0,0
0,0,0,0,0,0,0,0,0
0,0,0,0,0,0,0,0,0
0,0,0,0,0,0,0,0,0
0,0,0,0,0,0,0,0,0
0,0,0,0,0,0,0,0,0
0,0,0,0,0,0,0,0,0
0,0,0,0,0,0,0,0,0
0,0,0,0,0,0,0,0,0
0,0,0,0,0,0,0,0,0
0,0,0,0,0,0,0,0,0
0,0,0,0,0,0,0,0,0
0,0,0,0,0,0,0,0,0
0,0,0,0,0,0,0,0,0
0,0,0,0,0,0,0,0,0
0,0,0,0,0,0,0,0,0
0,0,0,0,0,0,0,0,0
0,0,0,0,0,0,0,0,0
0,0,0,0,0,0,0,0,0
0,0,0,0,0,0,0,0,0
0,0,0,0,0,0,0,0,0
0,0,0,0,0,0,0,0,0
0,0,0,0,0,0,0,0,0
0,0,0,0,0,0,0,0,0
0,0,0,0,0,0,0,0,0
0,0,0,0,0,0,0,0,0
0,0,0,0,0,0,0,0,0
276387,1811,11,290,254,36,15,0,0
52453,979,5,261,227,34,12,1,0
121830,421,7,51,23,28,1,1,0
15014,192,3,8,8,0,0,1,0
0,0,0,0,0,0,0,0,0
0,0,0,0,0,0,0,0,0
155642,1035,16,227,22,205,21,1,0
0,0,0,0,0,0,0,0,0
31886,96,4,15,8,7,0,0,0
0,0,0,0,0,0,0,0,0
0,0,0,0,0,0,0,0,0
0,0,0,0,0,0,0,0,0
0,0,0,0,0,0,0,0,0
155625,1765,9,180,169,11,5,1,0
0,0,0,0,0,0,0,0,0
339335,1836,9,294,281,13,17,1,0
0,0,0,0,0,0,0,0,0
0,0,0,0,0,0,0,0,0
0,0,0,0,0,0,0,0,0
0,0,0,0,0,0,0,0,0
0,0,0,0,0,0,0,0,0
0,0,0,0,0,0,0,0,0
0,0,0,0,0,0,0,0,0
13772,123,0,30,30,0,3,1,0
1001633,14997,5,160,151,9,15,1,0
55217,362,4,50,47,3,4,1,0
0,0,0,0,0,0,0,0,0
369061,1135,6,177,172,5,1,1,0
525466,4262,9,406,402,4,3,1,0
0,0,0,0,0,0,0,0,0
623306,571,2,48,47,1,5,1,0
0,0,0,0,0,0,0,0,0
0,0,0,0,0,0,0,0,0
450924,2663,2,366,209,157,15,1,0
0,0,0,0,0,0,0,0,0
273416,1810,7,401,393,8,18,1,0
266294,1487,8,172,167,5,9,1,0
235362,2389,10,299,279,20,62,0,1
0,0,0,0,0,0,0,0,0
0,0,0,0,0,0,0,0,0
43307,181,9,6,6,0,4,0,0
29000,180,4,28,14,14,6,1,0
97791,480,5,77,72,5,0,0,0
84061,296,5,34,29,5,0,0,0
0,0,0,0,0,0,0,0,0
359149,5012,3,1550,1545,5,1,0,0
131982,1261,8,332,314,18,3,1,0
134296,1188,7,259,255,4,20,1,0
51011,209,2,23,12,11,0,1,0
0,0,0,0,0,0,0,0,0
1214572,173,10,3,0,3,0,1,0
0,0,0,0,0,0,0,0,0
65560,359,3,53,51,2,0,0,0
20281,299,2,72,68,4,3,1,0
158058,1699,4,458,28,430,9,1,0
78869,1062,6,347,344,3,3,1,0
0,0,0,0,0,0,0,0,0
59877,263,12,31,28,3,2,1,0
122078,496,7,60,36,24,12,1,0
1036999,9613,8,297,252,45,11,1,0
106838,1477,3,311,263,48,13,1,0
0,0,0,0,0,0,0,0,0
24051,213,6,47,45,2,1,1,0
0,0,0,0,0,0,0,0,0
352955,5268,8,943,901,42,8,1,0
372030,3426,8,863,847,16,11,1,0
0,0,0,0,0,0,0,0,0
277124,903,8,90,87,3,1,1,0
151608,284,8,6,5,1,1,1,0
104289,547,1,15,9,6,0,0,0
0,0,0,0,0,0,0,0,0
0,0,0,0,0,0,0,0,0
0,0,0,0,0,0,0,0,0
0,0,0,0,0,0,0,0,0
0,0,0,0,0,0,0,0,0
782639,4973,2,311,299,12,3,0,0
0,0,0,0,0,0,0,0,0
0,0,0,0,0,0,0,0,0
80206,1556,5,274,268,6,13,1,0
7677,52,0,6,1,5,0,0,0
242297,1385,10,236,221,15,9,1,0
105480,1359,6,368,325,43,0,1,0
251392,476,1,10,10,0,1,1,0
135789,1569,5,283,196,87,8,1,0
0,0,0,0,0,0,0,0,0
184659,1902,4,512,478,34,9,1,0
7690,52,0,6,1,5,0,0,0
0,0,0,0,0,0,0,0,0
310158,2678,5,333,314,19,3,1,1
37832,416,2,11,5,6,11,1,0
0,0,0,0,0,0,0,0,0
244815,1760,12,376,243,133,4,0,0
8833,93,5,7,4,3,2,1,0
0,0,0,0,0,0,0,0,0
0,0,0,0,0,0,0,0,0
461330,3358,5,721,712,9,4,1,0
367065,2567,5,645,640,5,3,1,0
98910,1843,3,537,530,7,0,1,0
15584,283,1,83,78,5,1,1,0
15690,81,3,3,3,0,0,0,0
141423,488,7,41,41,0,0,1,0
0,0,0,0,0,0,0,0,0
2785898,18193,11,3903,3753,150,898,1,0
503123,3473,10,454,422,32,150,0,0
167891,681,13,168,168,0,1,1,0
0,0,0,0,0,0,0,0,0
0,0,0,0,0,0,0,0,0
0,0,0,0,0,0,0,0,0
0,0,0,0,0,0,0,0,0
0,0,0,0,0,0,0,0,0
0,0,0,0,0,0,0,0,0
3562,66,0,19,19,0,0,1,0
0,0,0,0,0,0,0,0,0
425899,3731,17,790,784,6,65,1,0
223962,2632,15,733,728,5,16,1,0
162776,354,2,17,17,0,0,1,0
0,0,0,0,0,0,0,0,0
80465,577,3,89,85,4,10,1,0
180894,1131,10,61,46,15,35,1,0
38236,897,1,162,162,0,0,1,0
179883,2064,7,474,472,2,5,1,0
0,0,0,0,0,0,0,0,0
87045,764,13,109,88,21,3,0,0
0,0,0,0,0,0,0,0,0
0,0,0,0,0,0,0,0,0
0,0,0,0,0,0,0,0,0
165921,1468,3,223,179,44,6,0,0
8799,42,0,0,0,0,0,0,0
123418,1140,9,55,43,12,2,1,0
1535643,1082,11,179,130,49,11,1,0
0,0,0,0,0,0,0,0,0
0,0,0,0,0,0,0,0,0
0,0,0,0,0,0,0,0,0
0,0,0,0,0,0,0,0,0
0,0,0,0,0,0,0,0,0
182694,1924,13,244,241,3,9,0,0
57761,463,10,90,86,4,6,0,0
91086,1402,10,173,166,7,14,1,0
0,0,0,0,0,0,0,0,0
0,0,0,0,0,0,0,0,0
0,0,0,0,0,0,0,0,0
0,0,0,0,0,0,0,0,0
0,0,0,0,0,0,0,0,0
0,0,0,0,0,0,0,0,0
0,0,0,0,0,0,0,0,0
0,0,0,0,0,0,0,0,0
0,0,0,0,0,0,0,0,0
98414,1308,1,305,300,5,1,1,0
0,0,0,0,0,0,0,0,0
2418,32,3,1,0,1,0,0,0
0,0,0,0,0,0,0,0,0
22283,132,2,10,8,2,3,1,0
0,0,0,0,0,0,0,0,0
248252,660,1,46,30,16,0,1,0
542365,1319,14,39,33,6,21,1,0
0,0,0,0,0,0,0,0,0
3368945,29156,1,569,562,7,4,1,0
120955,141,0,11,7,4,0,1,0
552454,3847,3,663,645,18,0,1,0
300189,2804,3,611,603,8,0,1,0
0,0,0,0,0,0,0,0,0
655351,2087,11,358,312,46,17,1,0
18388,147,8,9,9,0,0,0,0
0,0,0,0,0,0,0,0,0
470385,1994,3,112,98,14,3,0,0
252735,1076,5,50,43,7,3,0,0
1112192,9017,6,944,734,210,211,1,0
215188,1571,13,415,407,8,10,1,0
388011,910,4,77,53,24,0,1,0
495116,1855,19,314,293,21,19,1,0
629223,4307,3,977,967,10,6,0,0
429628,3324,3,893,883,10,9,0,0
0,0,0,0,0,0,0,0,0
126463,444,10,50,42,8,9,1,0
125,5,0,0,0,0,0,0,0
0,0,0,0,0,0,0,0,0
0,0,0,0,0,0,0,0,0
340071,1342,11,164,154,10,14,1,0
0,0,0,0,0,0,0,0,0
134187,794,11,138,134,4,11,1,0
51518,239,12,20,20,0,8,0,0
0,0,0,0,0,0,0,0,0
0,0,0,0,0,0,0,0,0
574384,3790,8,641,629,12,30,1,0
17562,332,4,99,91,8,2,1,0
13110,219,4,92,85,7,2,1,0
93952,389,0,86,85,1,0,1,0
234580,2279,17,320,298,22,11,1,0
70088,883,17,169,149,20,12,1,0
0,0,0,0,0,0,0,0,0
0,0,0,0,0,0,0,0,0
168950,810,6,149,97,52,2,1,0
360866,2799,11,112,91,21,18,1,0
476333,2006,14,546,526,20,12,1,0
100647,175,2,15,15,0,1,0,0
0,0,0,0,0,0,0,0,0
0,0,0,0,0,0,0,0,0
0,0,0,0,0,0,0,0,0
262422,2891,13,376,352,24,48,1,0
0,0,0,0,0,0,0,0,0
455736,4446,7,521,513,8,5,1,0
180091,1742,8,310,303,7,5,1,0
1847,41,0,5,3,2,0,0,0
406128,3860,4,598,587,11,12,1,0
28190,552,1,174,172,2,0,1,0
12257,253,1,36,35,1,0,1,0
0,0,0,0,0,0,0,0,0
0,0,0,0,0,0,0,0,0
76367,790,6,63,53,10,7,0,0
51901,143,2,108,107,1,0,0,0
0,0,0,0,0,0,0,0,0
571777,3525,5,308,57,251,13,0,0
900599,4274,5,1035,1019,16,24,1,0
0,0,0,0,0,0,0,0,0
203874,478,7,103,102,1,32,1,0
119804,868,9,209,208,1,9,1,0
197022,1109,5,192,187,5,21,1,0
154473,542,5,92,89,3,19,1,0
0,0,0,0,0,0,0,0,0
22939,37,0,2,2,0,0,1,0
0,0,0,0,0,0,0,0,0
0,0,0,0,0,0,0,0,0
126029,1360,6,276,58,218,9,1,0
48445,609,3,91,91,0,3,0,0
0,0,0,0,0,0,0,0,0
1946568,8454,12,161,151,10,26,1,0
101299,235,1,0,0,0,0,0,0
224133,1183,2,107,85,22,19,0,0
68370,119,3,0,0,0,11,0,0
781297,3236,7,408,403,5,12,1,0
0,0,0,0,0,0,0,0,0
122653,655,5,125,124,1,0,1,0
0,0,0,0,0,0,0,0,0
0,0,0,0,0,0,0,0,0
862102,1059,13,97,97,0,13,1,0
86360,860,6,179,174,5,8,1,0
5581,52,4,5,5,0,0,1,0
0,0,0,0,0,0,0,0,0
0,0,0,0,0,0,0,0,0
0,0,0,0,0,0,0,0,0
692513,1018,4,192,192,0,0,1,0
198972,862,13,97,92,5,6,0,0
0,0,0,0,0,0,0,0,0
50015,247,4,25,20,5,17,1,0
202715,642,8,111,101,10,1,0,0
21809,33,0,1,1,0,0,1,0
0,0,0,0,0,0,0,0,0
101225,771,7,140,134,6,1,1,0
0,0,0,0,0,0,0,0,0
0,0,0,0,0,0,0,0,0
71847,422,9,75,71,4,1,0,0
30648,347,5,59,58,1,7,1,0
186823,759,9,37,18,19,3,1,0
22600,116,7,10,10,0,0,1,0
0,0,0,0,0,0,0,0,0
0,0,0,0,0,0,0,0,0
35148,428,3,51,47,4,14,1,0
54839,663,4,186,183,3,2,1,0
671101,1580,8,221,202,19,0,0,0
5196,84,1,0,0,0,0,0,0
56992,581,9,139,139,0,4,1,0
65350,1046,3,245,242,3,3,1,0
69436,1063,2,292,292,0,3,1,0
10273,112,5,13,12,1,0,1,0
946692,720,4,142,136,6,0,1,0
0,0,0,0,0,0,0,0,0
27835,42,0,2,1,1,0,0,0
96531,369,4,40,39,1,5,0,0
228495,3650,3,480,475,5,17,1,0
38531,538,3,152,147,5,4,1,0
1268400,12697,7,107,92,15,7,1,0
47948,338,7,40,24,16,1,1,0
0,0,0,0,0,0,0,0,0
0,0,0,0,0,0,0,0,0
269314,684,12,75,57,18,4,0,0
192156,345,1,113,79,34,3,1,0
168212,168,0,73,52,21,0,1,0
0,0,0,0,0,0,0,0,0
287889,1198,5,133,113,20,1,1,0
0,0,0,0,0,0,0,0,0
239945,825,7,52,50,2,1,1,0
0,0,0,0,0,0,0,0,0
325092,2691,4,509,407,102,7,1,0
266740,1591,12,393,388,5,7,1,0
0,0,0,0,0,0,0,0,0
1356062,3117,10,446,285,161,41,1,0
0,0,0,0,0,0,0,0,0
305256,798,5,41,40,1,1,0,0
199416,315,5,5,3,2,5,0,0
34302,255,7,38,33,5,0,1,0
23141,144,7,12,12,0,0,1,0
0,0,0,0,0,0,0,0,0
522753,3068,6,710,668,42,14,1,0
259093,842,12,106,101,5,12,0,0
39177,426,7,109,89,20,4,1,0
1718430,886,9,199,186,13,2,1,0
0,0,0,0,0,0,0,0,0
257603,2515,8,606,579,27,10,1,0
0,0,0,0,0,0,0,0,0
1480507,2926,6,300,279,21,0,1,0
45388,391,4,95,89,6,6,1,0
0,0,0,0,0,0,0,0,0
0,0,0,0,0,0,0,0,0
73267,707,1,178,175,3,27,0,0
21870,32,0,1,1,0,0,1,0
0,0,0,0,0,0,0,0,0
49224,290,1,49,41,8,1,0,0
93891,1095,7,375,375,0,8,0,0
31943,291,1,58,50,8,0,1,0
0,0,0,0,0,0,0,0,0
0,0,0,0,0,0,0,0,0
8029,163,0,59,43,16,0,1,0
22186,66,0,11,1,10,0,0,0
0,0,0,0,0,0,0,0,0
203319,549,4,85,66,19,0,1,0
401049,893,8,140,125,15,8,1,0
228475,2990,6,439,411,28,7,0,0
0,0,0,0,0,0,0,0,0
0,0,0,0,0,0,0,0,0
0,0,0,0,0,0,0,0,0
0,0,0,0,0,0,0,0,0
0,0,0,0,0,0,0,0,0
0,0,0,0,0,0,0,0,0
1011092,1049,8,100,94,6,14,1,0
26199,51,1,2,2,0,1,0,0
41822,511,3,154,154,0,3,0,0
1049768,2309,5,321,236,85,36,1,0
312046,1281,4,259,252,7,4,1,0
100298,815,5,145,137,8,5,1,0
101623,2134,3,655,654,1,1,1,0
475850,642,5,24,21,3,4,1,0
478418,493,7,21,18,3,2,1,0
0,0,0,0,0,0,0,0,0
105126,641,10,138,137,1,9,1,0
33419,217,1,15,12,3,3,1,0
16097,74,5,9,1,8,1,1,0
0,0,0,0,0,0,0,0,0
200257,911,9,145,132,13,0,0,0
200257,911,9,145,132,13,0,0,0
0,0,0,0,0,0,0,0,0
0,0,0,0,0,0,0,0,0
150332,1179,13,77,71,6,10,1,0
108257,632,14,36,35,1,10,1,0
55070,220,4,19,19,0,0,1,0
0,0,0,0,0,0,0,0,0
16037,82,6,1,1,0,2,0,0
0,0,0,0,0,0,0,0,0
493341,3752,6,455,239,216,34,1,0
742617,4853,12,322,312,10,63,1,0
379038,407,14,71,62,9,3,1,0
191354,1805,4,366,357,9,3,1,0
246528,998,11,100,26,74,5,1,0
131623,871,17,158,154,4,10,1,0
0,0,0,0,0,0,0,0,0
254587,1185,9,292,272,20,13,1,0
45048,261,2,21,18,3,11,1,0
138336,1163,12,261,251,10,5,0,0
180172,1026,11,243,227,16,2,1,0
0,0,0,0,0,0,0,0,0
0,0,0,0,0,0,0,0,0
108935,1116,9,180,158,22,1,1,0
180358,571,5,100,93,7,1,0,0
92844,146,5,5,5,0,1,0,0
48427,533,5,27,16,11,0,1,0
0,0,0,0,0,0,0,0,0
41776,551,1,159,146,13,0,1,0
762826,5345,9,1605,1434,171,20,1,0
660854,4334,8,1494,1325,169,16,1,0
25026,274,7,26,11,15,0,0,0
14828,146,8,13,13,0,0,0,0
0,0,0,0,0,0,0,0,0
10628,174,1,51,51,0,0,1,0
83665,1068,4,168,111,57,4,1,0
20409,222,5,27,22,5,6,1,0
0,0,0,0,0,0,0,0,0
0,0,0,0,0,0,0,0,0
289543,2341,11,489,134,355,12,1,0
0,0,0,0,0,0,0,0,0
0,0,0,0,0,0,0,0,0
0,0,0,0,0,0,0,0,0
221642,1266,6,181,153,28,15,1,0
239311,1692,10,23,2,21,18,1,0
146766,930,8,133,128,5,8,1,0
20241,114,3,7,7,0,7,1,0
43847,716,8,170,165,5,1,1,0
792808,7293,10,869,837,32,2,1,0
410257,2395,10,511,511,0,2,1,0
267807,3658,1,1023,1016,7,127,1,0
636038,6460,4,214,203,11,5,1,0
125623,1685,9,164,155,9,2,1,0
704840,1902,2,475,340,135,8,1,0
242612,1090,5,115,103,12,5,1,0
123009,648,4,75,63,12,1,1,0
0,0,0,0,0,0,0,0,0
22997,37,0,2,1,1,0,1,0
188735,1210,12,294,292,2,6,1,0
128952,883,12,236,234,2,6,1,0
0,0,0,0,0,0,0,0,0
7379,71,4,12,10,2,3,1,0
41907,334,5,81,71,10,1,1,0
0,0,0,0,0,0,0,0,0
0,0,0,0,0,0,0,0,0
0,0,0,0,0,0,0,0,0
144528,1812,3,289,280,9,0,0,0
79355,212,5,35,33,2,0,0,0
0,0,0,0,0,0,0,0,0
0,0,0,0,0,0,0,0,0
0,0,0,0,0,0,0,0,0
27746,42,0,2,1,1,0,0,0
298507,2646,10,658,534,124,26,1,0
0,0,0,0,0,0,0,0,0
0,0,0,0,0,0,0,0,0
25348,267,4,64,64,0,3,1,0
8878,104,2,27,27,0,0,1,0
0,0,0,0,0,0,0,0,0
49861,424,4,27,15,12,0,1,0
0,0,0,0,0,0,0,0,0
0,0,0,0,0,0,0,0,0
0,0,0,0,0,0,0,0,0
173798,1693,9,195,175,20,18,1,0
122985,1410,9,107,87,20,23,1,0
121144,572,5,103,103,0,6,0,0
205304,2266,5,341,321,20,6,1,0
20853,150,3,14,10,4,2,1,0
86328,754,7,64,64,0,2,0,0
12187,58,1,0,0,0,0,0,0
129107,2104,5,274,268,6,1,1,0
333049,2774,3,480,416,64,9,0,0
0,0,0,0,0,0,0,0,0
37662,379,6,79,79,0,0,1,0
316104,2012,8,424,379,45,61,1,0
0,0,0,0,0,0,0,0,0
155621,1203,3,230,180,50,3,0,0
0,0,0,0,0,0,0,0,0
31088,535,5,181,181,0,7,0,0
51672,895,4,241,222,19,80,1,0
0,0,0,0,0,0,0,0,0
0,0,0,0,0,0,0,0,0
37314,352,1,32,26,6,31,1,0
0,0,0,0,0,0,0,0,0
663629,6805,5,1031,1026,5,311,0,0
0,0,0,0,0,0,0,0,0
0,0,0,0,0,0,0,0,0
47562,649,4,107,93,14,3,1,0
0,0,0,0,0,0,0,0,0
0,0,0,0,0,0,0,0,0
539827,1687,2,260,136,124,11,1,0
80903,112,1,10,7,3,2,0,0
0,0,0,0,0,0,0,0,0
113006,3726,8,161,161,0,1,1,0
0,0,0,0,0,0,0,0,0
0,0,0,0,0,0,0,0,0
188774,1376,1,141,118,23,0,1,0
89921,608,9,110,107,3,8,1,0
268113,1381,5,205,202,3,1,1,0
505855,914,8,93,86,7,1,1,0
861210,4638,10,282,217,65,13,1,0
756921,4244,9,247,189,58,9,1,0
32321,421,8,17,17,0,0,1,0
309083,1335,5,190,16,174,7,1,0
77233,538,0,19,12,7,17,0,0
767064,2007,7,383,96,287,1,1,0
0,0,0,0,0,0,0,0,0
0,0,0,0,0,0,0,0,0
353243,866,5,100,77,23,20,1,0
221653,4277,15,201,190,11,3,1,0
185265,995,11,178,170,8,10,1,0
0,0,0,0,0,0,0,0,0
83814,471,7,127,122,5,10,1,0
70949,664,9,93,88,5,11,1,0
0,0,0,0,0,0,0,0,0
477482,1430,12,154,113,41,32,1,0
369190,379,0,44,28,16,11,1,1
842197,8899,6,2192,2086,106,4,1,0
515731,4758,6,1538,1533,5,3,1,0
779952,7605,3,601,439,162,17,1,1
0,0,0,0,0,0,0,0,0
0,0,0,0,0,0,0,0,0
27646,42,0,2,1,1,0,0,0
348328,2393,17,226,185,41,48,0,0
3589,39,4,4,0,4,0,0,0
140144,1109,10,220,216,4,6,1,0
8944,64,5,6,6,0,0,0,0
78445,1191,2,243,218,25,7,0,0
16090,142,2,21,19,2,7,0,0
246735,6636,12,45,21,24,4,1,0
39862,420,3,113,110,3,2,1,0
505575,3302,10,436,36,400,10,1,0
0,0,0,0,0,0,0,0,0
0,0,0,0,0,0,0,0,0
5615,108,2,0,0,0,0,0,0
0,0,0,0,0,0,0,0,0
318907,1453,4,292,284,8,1,1,0
328633,1521,5,285,276,9,4,1,0
0,0,0,0,0,0,0,0,0
443381,1171,6,306,295,11,12,1,0
0,0,0,0,0,0,0,0,0
0,0,0,0,0,0,0,0,0
2410,34,0,8,0,8,0,0,0
0,0,0,0,0,0,0,0,0
747354,9581,9,336,285,51,31,0,0
28644,273,2,15,15,0,0,1,0
15525,120,2,14,14,0,0,1,0
68964,454,7,100,98,2,3,1,0
0,0,0,0,0,0,0,0,0
54634,762,7,178,172,6,7,1,0
0,0,0,0,0,0,0,0,0
22987,125,6,7,6,1,5,1,0
22987,125,6,7,6,1,5,1,0
270582,2888,7,557,539,18,4,1,0
93303,1289,6,234,218,16,3,1,0
17753,268,4,82,81,1,0,0,0
5408,87,4,12,11,1,0,0,0
0,0,0,0,0,0,0,0,0
38435,251,1,46,42,4,9,1,0
1163389,3206,5,394,369,25,6,1,0
0,0,0,0,0,0,0,0,0
0,0,0,0,0,0,0,0,0
67689,248,10,11,9,2,2,1,0
92467,1041,2,60,33,27,2,1,0
76889,621,3,104,89,15,3,0,0
0,0,0,0,0,0,0,0,0
0,0,0,0,0,0,0,0,0
268205,3638,1,1015,1010,5,128,1,0
2045741,8502,16,979,835,144,42,1,0
747995,2014,16,340,329,11,32,1,0
495296,2855,6,459,251,208,31,1,0
575761,2918,3,100,91,9,6,0,0
539127,4978,4,817,729,88,37,1,0
0,0,0,0,0,0,0,0,0
400709,1560,8,220,197,23,15,1,0
0,0,0,0,0,0,0,0,0
64930,634,9,114,97,17,3,1,0
0,0,0,0,0,0,0,0,0
223296,1657,10,250,209,41,7,1,0
0,0,0,0,0,0,0,0,0
0,0,0,0,0,0,0,0,0
0,0,0,0,0,0,0,0,0
157882,674,8,102,91,11,27,1,0
146178,558,7,32,24,8,25,1,0
87407,887,9,190,183,7,1,1,0
321435,1058,3,81,74,7,4,1,0
0,0,0,0,0,0,0,0,0
0,0,0,0,0,0,0,0,0
93165,1143,1,276,268,8,2,1,0
4558,64,2,2,2,0,0,1,0
0,0,0,0,0,0,0,0,0
333486,1552,6,162,99,63,19,1,0
9908,132,0,10,5,5,0,1,0
165717,1633,6,258,238,20,5,1,0
165766,1633,6,258,238,20,5,1,0
0,0,0,0,0,0,0,0,0
0,0,0,0,0,0,0,0,0
48613,510,7,94,71,23,2,1,0
24951,321,1,125,24,101,0,0,0
0,0,0,0,0,0,0,0,0
262708,1664,8,201,167,34,11,1,0
18759,186,2,18,15,3,13,1,1
0,0,0,0,0,0,0,0,0
0,0,0,0,0,0,0,0,0
0,0,0,0,0,0,0,0,0
0,0,0,0,0,0,0,0,0
0,0,0,0,0,0,0,0,0
531776,1180,7,230,218,12,14,1,0
472924,434,7,72,62,10,14,1,0
0,0,0,0,0,0,0,0,0
125559,1228,3,128,125,3,5,1,0
0,0,0,0,0,0,0,0,0
115097,1229,5,202,3,199,0,0,0
0,0,0,0,0,0,0,0,0
40428,547,2,63,60,3,0,1,0
0,0,0,0,0,0,0,0,0
0,0,0,0,0,0,0,0,0
206536,2354,3,329,247,82,5,0,0
0,0,0,0,0,0,0,0,0
0,0,0,0,0,0,0,0,0
0,0,0,0,0,0,0,0,0
0,0,0,0,0,0,0,0,0
46736,536,9,165,163,2,0,1,0
63413,615,7,95,89,6,2,1,0
301933,365,0,17,13,4,2,1,0
0,0,0,0,0,0,0,0,0
61704,598,5,102,71,31,1,1,0
0,0,0,0,0,0,0,0,0
14361,158,2,29,23,6,7,1,0
0,0,0,0,0,0,0,0,0
40220,373,5,84,74,10,4,1,0
0,0,0,0,0,0,0,0,0
0,0,0,0,0,0,0,0,0
0,0,0,0,0,0,0,0,0
85535,509,11,59,9,50,5,0,0
25350,318,4,27,19,8,2,0,0
363664,2510,10,883,870,13,0,0,0
348795,2493,10,883,870,13,0,0,0
198111,739,8,173,140,33,2,1,0
325745,1672,10,304,292,12,113,1,0
219304,2256,8,694,678,16,5,1,0
80052,679,3,146,138,8,0,0,0
36797,244,3,22,15,7,0,0,0
18327,414,1,70,66,4,0,0,0
0,0,0,0,0,0,0,0,0
388980,2380,12,179,167,12,14,1,0
316799,1503,12,63,62,1,16,1,0
142492,1268,6,264,260,4,3,1,0
27880,42,0,2,1,1,0,0,0
0,0,0,0,0,0,0,0,0
196264,592,10,83,63,20,7,1,0
187351,170,3,17,8,9,0,1,0
94151,1259,4,598,598,0,0,1,0
459282,2882,3,348,302,46,10,1,0
93917,1329,3,160,149,11,3,1,0
343286,2435,10,585,580,5,0,1,0
343085,2435,10,585,580,5,0,1,0
36159,469,6,108,106,2,3,1,0
1302176,2783,10,618,613,5,71,1,0
118659,1431,10,319,281,38,2,1,0
269831,927,12,128,126,2,33,0,0
0,0,0,0,0,0,0,0,0
0,0,0,0,0,0,0,0,0
109099,1380,7,314,312,2,5,1,0
0,0,0,0,0,0,0,0,0
12900,280,4,50,50,0,1,0,0
14157,149,2,23,20,3,5,0,0
41205,888,1,143,15,128,0,1,0
576657,6429,0,2719,1,2718,0,1,0
137231,1198,9,253,223,30,7,0,0
0,0,0,0,0,0,0,0,0
0,0,0,0,0,0,0,0,0
33812,391,6,103,50,53,1,0,0
76971,700,5,142,104,38,0,0,0
28485,45,0,4,1,3,0,0,0
89161,660,3,148,126,22,0,1,0
0,0,0,0,0,0,0,0,0
171866,1246,8,196,185,11,28,1,0
0,0,0,0,0,0,0,0,0
1085377,2758,5,714,705,9,36,1,0
842571,426,5,62,55,7,7,1,0
44801,332,10,22,14,8,0,1,0
0,0,0,0,0,0,0,0,0
828807,612,14,59,12,47,2,1,0
15773,136,5,18,6,12,7,0,0
340339,1078,4,69,59,10,3,1,0
0,0,0,0,0,0,0,0,0
983670,2299,23,113,82,31,78,1,0
0,0,0,0,0,0,0,0,0
0,0,0,0,0,0,0,0,0
50088,1074,2,213,152,61,0,0,0
138330,785,9,144,123,21,10,1,0
49681,817,4,180,147,33,11,1,0
0,0,0,0,0,0,0,0,0
0,0,0,0,0,0,0,0,0
0,0,0,0,0,0,0,0,0
0,0,0,0,0,0,0,0,0
4512,93,2,13,7,6,0,1,0
298579,3597,5,1121,1067,54,3,0,0
0,0,0,0,0,0,0,0,0
68412,410,8,84,81,3,0,0,0
238289,1065,3,129,120,9,20,1,0
153351,514,3,76,73,3,8,1,0
0,0,0,0,0,0,0,0,0
207518,4180,1,273,162,111,11,1,1
216042,1164,5,183,169,14,5,0,0
86849,1149,4,152,122,30,11,1,0
7549,86,7,5,5,0,0,0,0
214294,558,10,117,113,4,17,1,0
358963,2647,1,368,364,4,11,1,0
101337,684,1,134,134,0,5,1,0
265805,1192,5,260,218,42,11,0,0
170594,729,11,61,54,7,11,1,0
11962,191,3,21,21,0,0,1,0
271154,856,7,153,141,12,17,1,0
271691,763,7,99,87,12,18,1,0
0,0,0,0,0,0,0,0,0
0,0,0,0,0,0,0,0,0
0,0,0,0,0,0,0,0,0
109176,376,12,57,42,15,2,1,0
0,0,0,0,0,0,0,0,0
10656,73,5,12,10,2,3,0,0
0,0,0,0,0,0,0,0,0
112271,1228,8,256,237,19,1,1,0
691432,535,0,3,0,3,2,1,1
0,0,0,0,0,0,0,0,0
0,0,0,0,0,0,0,0,0
0,0,0,0,0,0,0,0,0
64475,953,5,175,117,58,0,1,0
259988,748,8,88,88,0,9,1,0
15431,104,0,1,0,1,0,0,0
220393,2423,0,276,272,4,0,1,0
90124,393,1,71,67,4,1,1,0
19829,399,3,99,75,24,0,1,0
0,0,0,0,0,0,0,0,0
943146,3500,9,409,388,21,2,0,0
262931,2456,8,342,293,49,21,1,0
340954,1419,10,129,97,32,56,1,0
136745,1764,6,414,412,2,8,0,0
130084,1206,7,198,173,25,6,1,0
130692,1205,7,198,173,25,6,1,0
0,0,0,0,0,0,0,0,0
732035,7640,5,1619,1609,10,10,1,0
141010,829,5,184,172,12,10,1,0
0,0,0,0,0,0,0,0,0
0,0,0,0,0,0,0,0,0
145256,953,8,143,136,7,1,1,0
51632,419,8,121,117,4,0,1,0
234455,1089,5,183,145,38,3,1,0
6673,95,0,17,14,3,1,0,0
25190,246,5,35,28,7,3,0,0
30415,454,1,64,62,2,2,1,0
221873,1601,4,174,173,1,3,1,0
1088860,844,5,113,98,15,12,1,0
18516,73,0,5,5,0,0,0,0
0,0,0,0,0,0,0,0,0
86363,1218,4,186,153,33,5,1,0
0,0,0,0,0,0,0,0,0
0,0,0,0,0,0,0,0,0
47543,559,2,216,212,4,8,1,0
94339,434,2,16,14,2,8,1,0
0,0,0,0,0,0,0,0,0
0,0,0,0,0,0,0,0,0
0,0,0,0,0,0,0,0,0
226150,1637,13,195,179,16,13,1,0
106003,1609,10,254,243,11,2,1,1
0,0,0,0,0,0,0,0,0
208969,1528,3,156,142,14,4,1,0
197410,1333,11,82,62,20,3,1,0
0,0,0,0,0,0,0,0,0
0,0,0,0,0,0,0,0,0
18262,344,2,84,78,6,0,0,0
15693,243,3,16,16,0,0,1,0
138126,1046,5,335,310,25,10,1,0
0,0,0,0,0,0,0,0,0
167065,548,14,99,6,93,8,1,0
0,0,0,0,0,0,0,0,0
0,0,0,0,0,0,0,0,0
754581,6670,10,1050,630,420,1,1,0
0,0,0,0,0,0,0,0,0
91660,1102,7,185,173,12,5,1,0
94971,1224,6,242,222,20,1,0,0
0,0,0,0,0,0,0,0,0
0,0,0,0,0,0,0,0,0
167599,551,5,85,81,4,1,0,0
157277,320,3,28,26,2,2,1,0
154370,290,3,28,27,1,0,1,0
331106,1284,10,155,143,12,4,1,0
213403,594,9,12,9,3,13,1,0
0,0,0,0,0,0,0,0,0
1198842,1107,3,86,86,0,3,1,0
338380,2062,9,446,16,430,29,1,0
22941,38,0,2,2,0,0,1,0
0,0,0,0,0,0,0,0,0
0,0,0,0,0,0,0,0,0
436608,1265,7,106,99,7,0,0,0
0,0,0,0,0,0,0,0,0
153084,1167,7,343,198,145,7,0,0
0,0,0,0,0,0,0,0,0
66669,274,4,15,15,0,16,1,0
53003,169,7,11,11,0,12,1,0
27504,124,8,16,15,1,0,1,0
0,0,0,0,0,0,0,0,0
23438,37,0,2,1,1,0,1,0
0,0,0,0,0,0,0,0,0
333301,1408,12,219,183,36,22,1,0
792958,776,15,93,75,18,15,1,0
284637,2116,6,219,188,31,5,1,0
0,0,0,0,0,0,0,0,0
27534,40,0,2,1,1,0,0,0
1067119,3267,4,251,233,18,5,1,0
0,0,0,0,0,0,0,0,0
136061,369,5,60,53,7,2,1,0
757,16,0,0,0,0,0,0,0
116113,970,13,160,115,45,3,1,0
0,0,0,0,0,0,0,0,0
0,0,0,0,0,0,0,0,0
330999,2188,7,327,311,16,22,1,0
0,0,0,0,0,0,0,0,0
0,0,0,0,0,0,0,0,0
0,0,0,0,0,0,0,0,0
0,0,0,0,0,0,0,0,0
531693,4303,3,540,491,49,3,1,0
522001,570,9,78,69,9,19,1,0
0,0,0,0,0,0,0,0,0
936447,2100,3,221,202,19,2,1,0
1539918,198,2,8,7,1,4,1,0
91089,709,6,140,106,34,8,1,0
0,0,0,0,0,0,0,0,0
0,0,0,0,0,0,0,0,0
1081466,1318,14,152,135,17,2,1,0
884436,427,14,76,57,19,2,1,0
756132,1626,13,430,420,10,24,1,0
47658,738,4,119,115,4,8,1,0
223505,957,5,166,141,25,19,1,0
0,0,0,0,0,0,0,0,0
0,0,0,0,0,0,0,0,0
0,0,0,0,0,0,0,0,0
123537,1401,3,437,436,1,3,1,0
18990,231,3,17,16,1,3,1,0
0,0,0,0,0,0,0,0,0
0,0,0,0,0,0,0,0,0
0,0,0,0,0,0,0,0,0
361703,1317,6,268,160,108,30,0,0
210211,898,9,198,197,1,3,1,0
0,0,0,0,0,0,0,0,0
0,0,0,0,0,0,0,0,0
114367,574,4,246,246,0,7,1,0
27672,169,4,12,6,6,9,0,0
0,0,0,0,0,0,0,0,0
0,0,0,0,0,0,0,0,0
0,0,0,0,0,0,0,0,0
0,0,0,0,0,0,0,0,0
0,0,0,0,0,0,0,0,0
307416,696,1,7,6,1,3,0,0
278663,1114,13,108,95,13,3,1,0
27868,346,3,43,10,33,0,1,0
0,0,0,0,0,0,0,0,0
0,0,0,0,0,0,0,0,0
0,0,0,0,0,0,0,0,0
0,0,0,0,0,0,0,0,0
294183,1607,11,235,60,175,10,1,0
8352,46,2,3,2,1,0,1,0
0,0,0,0,0,0,0,0,0
38952,602,0,140,130,10,14,1,0
101787,463,10,89,89,0,0,1,0
0,0,0,0,0,0,0,0,0
444701,1858,3,89,75,14,3,0,0
251187,1067,5,45,35,10,3,0,0
0,0,0,0,0,0,0,0,0
115552,1519,8,396,148,248,0,1,0
37196,320,8,97,90,7,0,1,0
42496,195,10,19,12,7,13,0,0
68871,282,0,65,14,51,1,1,0
0,0,0,0,0,0,0,0,0
147236,1757,6,219,207,12,10,0,0
52395,359,4,43,39,4,2,0,0
80809,354,4,37,33,4,2,0,0
168135,518,10,69,56,13,0,1,0
610604,802,6,134,119,15,7,1,0
0,0,0,0,0,0,0,0,0
281159,1121,7,107,96,11,4,1,0
216387,1175,11,269,206,63,18,0,0
0,0,0,0,0,0,0,0,0
0,0,0,0,0,0,0,0,0
0,0,0,0,0,0,0,0,0
108273,856,7,200,196,4,3,1,0
100873,816,7,188,184,4,5,1,0
0,0,0,0,0,0,0,0,0
0,0,0,0,0,0,0,0,0
120189,713,8,90,82,8,13,1,0
37407,343,6,115,103,12,0,1,0
51277,853,5,119,118,1,4,0,0
16895,152,7,13,13,0,4,0,0
174425,2094,3,783,760,23,8,1,0
479238,989,6,136,109,27,6,1,0
0,0,0,0,0,0,0,0,0
0,0,0,0,0,0,0,0,0
207092,1552,4,213,195,18,10,0,0
0,0,0,0,0,0,0,0,0
0,0,0,0,0,0,0,0,0
7712,102,5,10,7,3,0,1,0
289153,2002,10,324,312,12,23,1,1
0,0,0,0,0,0,0,0,0
101285,953,13,83,76,7,1,1,0
64178,370,15,37,30,7,1,1,0
193368,2644,7,784,771,13,3,1,0
0,0,0,0,0,0,0,0,0
0,0,0,0,0,0,0,0,0
0,0,0,0,0,0,0,0,0
193302,912,13,98,66,32,11,1,0
0,0,0,0,0,0,0,0,0
16793,223,3,28,28,0,3,1,0
0,0,0,0,0,0,0,0,0
0,0,0,0,0,0,0,0,0
0,0,0,0,0,0,0,0,0
29606,322,3,31,29,2,2,1,0
7095,143,1,21,20,1,0,1,0
565352,2800,19,294,271,23,10,1,0
25091,48,1,1,1,0,0,0,0
0,0,0,0,0,0,0,0,0
580122,3088,12,645,126,519,3,1,0
26753,127,3,3,0,3,3,0,0
467689,1432,5,202,14,188,9,1,0
594446,4175,10,406,394,12,137,1,0
124578,75,2,3,0,3,0,0,0
257781,1188,5,160,132,28,13,1,0
335447,673,2,90,80,10,0,1,0
377200,133,2,9,8,1,2,1,0
442148,4583,13,633,252,381,9,1,0
14729,270,3,33,31,2,0,1,0
0,0,0,0,0,0,0,0,0
184817,918,12,101,89,12,5,1,0
0,0,0,0,0,0,0,0,0
0,0,0,0,0,0,0,0,0
114202,879,7,148,138,10,5,1,0
10203,68,2,5,5,0,0,1,0
337391,2499,6,204,142,62,43,1,0
0,0,0,0,0,0,0,0,0
0,0,0,0,0,0,0,0,0
0,0,0,0,0,0,0,0,0
0,0,0,0,0,0,0,0,0
0,0,0,0,0,0,0,0,0
223165,1467,9,231,218,13,21,1,0
273885,1567,11,218,204,14,43,1,0
357901,1874,4,215,180,35,2,1,0
0,0,0,0,0,0,0,0,0
455379,2706,17,440,421,19,22,1,0
245582,2492,1,244,178,66,0,1,0
44919,180,7,21,21,0,11,1,0
619992,6878,5,1819,1803,16,5,0,0
354241,4100,5,1429,1417,12,8,0,0
54657,1088,5,159,143,16,0,1,0
298633,661,5,115,113,2,0,1,0
74558,485,10,40,30,10,3,0,0
138843,1147,3,214,213,1,3,1,0
562343,4812,11,1222,1172,50,0,1,0
273246,593,6,141,136,5,1,1,0
203167,1833,14,319,316,3,9,1,1
436143,776,7,105,88,17,8,1,0
331274,5751,2,1941,1941,0,2,1,0
0,0,0,0,0,0,0,0,0
87432,1945,1,369,350,19,3,1,0
5169,87,2,8,6,2,0,1,0
71123,775,4,147,133,14,2,1,0
36334,192,6,20,18,2,6,0,0
28134,42,0,2,1,1,0,0,0
45523,792,3,133,131,2,0,0,0
6459,105,3,15,13,2,0,0,0
22905,37,0,2,1,1,0,1,0
0,0,0,0,0,0,0,0,0
0,0,0,0,0,0,0,0,0
0,0,0,0,0,0,0,0,0
0,0,0,0,0,0,0,0,0
6203,100,1,3,3,0,15,0,0
0,0,0,0,0,0,0,0,0
273393,1960,9,160,145,15,4,1,0
0,0,0,0,0,0,0,0,0
0,0,0,0,0,0,0,0,0
65854,367,8,40,15,25,4,1,0
291385,198,2,12,11,1,11,1,0
469700,2934,1,743,634,109,4,1,0
163400,330,1,74,24,50,0,1,0
0,0,0,0,0,0,0,0,0
0,0,0,0,0,0,0,0,0
0,0,0,0,0,0,0,0,0
409027,1959,7,226,223,3,62,1,0
0,0,0,0,0,0,0,0,0
0,0,0,0,0,0,0,0,0
0,0,0,0,0,0,0,0,0
25609,302,5,62,41,21,3,1,0
0,0,0,0,0,0,0,0,0
275033,2093,15,799,796,3,8,1,0
228996,1691,15,688,682,6,7,1,0
45960,448,9,20,18,2,10,1,0
7958,86,4,4,4,0,2,0,0
13722,211,7,24,20,4,2,1,0
303935,2987,5,1097,1062,35,0,0,0
31263,143,5,10,8,2,0,0,0
0,0,0,0,0,0,0,0,0
0,0,0,0,0,0,0,0,0
0,0,0,0,0,0,0,0,0
0,0,0,0,0,0,0,0,0
286095,2141,13,366,316,50,12,0,0
180891,1964,3,477,368,109,1,1,0
245069,987,1,74,39,35,0,0,0
747540,3083,7,314,307,7,11,1,0
0,0,0,0,0,0,0,0,0
29219,222,7,16,15,1,7,0,0
187614,887,4,104,92,12,5,0,0
128851,648,3,98,90,8,6,0,0
0,0,0,0,0,0,0,0,0
66250,595,1,101,94,7,7,1,0
104010,449,8,102,96,6,0,1,0
133599,1242,14,278,265,13,19,1,0
0,0,0,0,0,0,0,0,0
199461,1263,8,321,293,28,4,1,0
338193,1667,12,186,136,50,12,1,0
0,0,0,0,0,0,0,0,0
0,0,0,0,0,0,0,0,0
12009,178,2,19,10,9,0,0,0
208624,2313,6,513,493,20,15,1,0
113618,1453,6,319,310,9,3,1,0
200163,1405,4,323,290,33,2,1,0
478843,1170,7,155,143,12,0,1,0
0,0,0,0,0,0,0,0,0
128412,1328,16,242,232,10,23,1,1
0,0,0,0,0,0,0,0,0
581267,1326,2,146,133,13,8,1,0
132082,1870,8,277,276,1,2,1,0
0,0,0,0,0,0,0,0,0
12801,70,3,13,4,9,4,1,0
0,0,0,0,0,0,0,0,0
385787,1526,2,88,65,23,34,1,0
222860,382,2,48,33,15,3,1,0
0,0,0,0,0,0,0,0,0
80414,862,7,80,76,4,0,1,0
13491,104,7,10,8,2,0,0,0
0,0,0,0,0,0,0,0,0
0,0,0,0,0,0,0,0,0
540815,808,9,156,155,1,27,1,0
553570,661,9,133,132,1,25,1,0
143550,1202,7,371,339,32,1,0,0
87905,239,4,54,48,6,0,1,0
154535,1357,5,176,160,16,16,1,0
0,0,0,0,0,0,0,0,0
0,0,0,0,0,0,0,0,0
0,0,0,0,0,0,0,0,0
0,0,0,0,0,0,0,0,0
36351,165,1,48,37,11,0,1,0
290920,2200,7,383,370,13,93,1,1
50662,464,8,100,96,4,1,1,0
0,0,0,0,0,0,0,0,0
0,0,0,0,0,0,0,0,0
179267,1240,8,130,68,62,22,1,0
425023,1083,7,156,154,2,0,1,0
97134,960,9,225,222,3,47,1,0
60660,571,5,178,175,3,6,1,0
0,0,0,0,0,0,0,0,0
0,0,0,0,0,0,0,0,0
0,0,0,0,0,0,0,0,0
0,0,0,0,0,0,0,0,0
23002,38,0,2,1,1,0,1,0
843371,523,7,96,76,20,0,1,0
0,0,0,0,0,0,0,0,0
105442,907,6,141,131,10,12,1,0
45189,231,5,30,29,1,0,1,0
43224,534,6,112,107,5,4,1,0
0,0,0,0,0,0,0,0,0
0,0,0,0,0,0,0,0,0
0,0,0,0,0,0,0,0,0
234612,1508,3,409,375,34,7,0,0
0,0,0,0,0,0,0,0,0
0,0,0,0,0,0,0,0,0
391126,3612,11,1155,991,164,15,1,0
62032,713,6,72,62,10,23,1,0
174089,2414,7,635,626,9,1,0,0
12952,139,3,31,31,0,0,0,0
432693,915,5,61,61,0,0,1,0
0,0,0,0,0,0,0,0,0
51497,366,7,95,94,1,0,1,0
648084,4224,4,352,233,119,41,1,0
0,0,0,0,0,0,0,0,0
0,0,0,0,0,0,0,0,0
0,0,0,0,0,0,0,0,0
0,0,0,0,0,0,0,0,0
129352,1646,8,368,326,42,8,1,0
0,0,0,0,0,0,0,0,0
14209,182,6,67,66,1,0,0,0
2062065,715,5,176,170,6,6,1,0
0,0,0,0,0,0,0,0,0
64500,1112,2,210,206,4,9,1,0
50783,436,7,61,48,13,9,1,0
50962,437,7,61,39,22,9,1,0
0,0,0,0,0,0,0,0,0
4637,54,1,3,0,3,0,0,0
0,0,0,0,0,0,0,0,0
0,0,0,0,0,0,0,0,0
63964,125,4,16,14,2,1,1,0
77540,1002,6,206,186,20,9,1,0
0,0,0,0,0,0,0,0,0
0,0,0,0,0,0,0,0,0
17897,299,4,57,26,31,2,1,0
31746,284,4,31,18,13,5,1,0
189888,1250,6,186,117,69,20,1,0
248263,175,5,5,5,0,3,0,0
0,0,0,0,0,0,0,0,0
80665,248,1,31,31,0,9,1,0
5648,100,2,22,15,7,0,1,0
416197,1295,2,56,24,32,0,0,0
321033,2669,5,471,36,435,10,1,0
0,0,0,0,0,0,0,0,0
299178,591,5,142,124,18,9,0,0
24042,195,4,9,4,5,3,0,0
0,0,0,0,0,0,0,0,0
0,0,0,0,0,0,0,0,0
144024,402,4,72,72,0,0,1,0
404364,2395,7,165,111,54,2,1,0
87963,125,3,1,0,1,2,0,0
0,0,0,0,0,0,0,0,0
73338,432,5,27,24,3,0,0,0
0,0,0,0,0,0,0,0,0
0,0,0,0,0,0,0,0,0
92467,1041,2,60,33,27,2,1,0
0,0,0,0,0,0,0,0,0
0,0,0,0,0,0,0,0,0
256994,2178,17,452,396,56,6,1,0
486463,3816,4,905,875,30,15,0,0
193346,1174,15,242,232,10,4,1,0
2631,39,1,6,2,4,0,0,0
13224,108,3,7,6,1,2,0,0
46280,268,5,58,58,0,8,1,0
0,0,0,0,0,0,0,0,0
0,0,0,0,0,0,0,0,0
543146,3130,21,410,370,40,167,1,0
1852797,1035,11,169,125,44,12,1,0
53875,1061,4,332,285,47,1,1,0
0,0,0,0,0,0,0,0,0
0,0,0,0,0,0,0,0,0
230644,1409,10,333,318,15,1,1,0
171966,645,8,52,37,15,7,1,0
0,0,0,0,0,0,0,0,0
223580,3112,7,219,210,9,3,1,0
0,0,0,0,0,0,0,0,0
231936,903,3,83,76,7,6,1,0
312723,861,1,4,1,3,3,0,0
0,0,0,0,0,0,0,0,0
119414,1521,5,320,311,9,3,1,0
0,0,0,0,0,0,0,0,0
90309,71,0,9,9,0,6,0,0
79786,618,8,82,71,11,7,1,0
0,0,0,0,0,0,0,0,0
0,0,0,0,0,0,0,0,0
0,0,0,0,0,0,0,0,0
27262,600,1,284,277,7,5,1,0
0,0,0,0,0,0,0,0,0
107449,953,4,71,64,7,1,1,0
21173,76,0,1,0,1,0,0,0
0,0,0,0,0,0,0,0,0
832719,362,6,53,50,3,0,1,0
0,0,0,0,0,0,0,0,0
0,0,0,0,0,0,0,0,0
68715,712,4,24,19,5,2,0,0
233604,1844,3,5,5,0,2,1,0
0,0,0,0,0,0,0,0,0
456983,1051,5,105,76,29,0,1,0
0,0,0,0,0,0,0,0,0
0,0,0,0,0,0,0,0,0
183174,1451,21,226,201,25,11,1,0
182909,1452,21,226,201,25,10,1,0
0,0,0,0,0,0,0,0,0
0,0,0,0,0,0,0,0,0
0,0,0,0,0,0,0,0,0
0,0,0,0,0,0,0,0,0
0,0,0,0,0,0,0,0,0
22897,37,0,2,1,1,0,1,0
0,0,0,0,0,0,0,0,0
0,0,0,0,0,0,0,0,0
0,0,0,0,0,0,0,0,0
226126,2467,9,171,143,28,6,1,0
22751,197,4,36,36,0,7,1,0
0,0,0,0,0,0,0,0,0
353354,719,6,87,0,87,6,1,0
10206,230,0,34,24,10,3,0,0
62360,366,0,11,6,5,1,0,0
59392,308,9,65,58,7,4,1,0
0,0,0,0,0,0,0,0,0
7787,100,0,11,8,3,2,1,0
457281,57,1,2,2,0,0,1,0
178752,538,8,82,72,10,11,1,0
20512533,1196,6,235,231,4,0,0,0
57085,340,6,51,49,2,7,0,0
43755,238,6,18,18,0,9,0,0
87652,839,14,96,94,2,15,0,0
0,0,0,0,0,0,0,0,0
75203,1229,3,195,148,47,3,1,0
13121,181,2,56,54,2,0,1,0
120800,1628,12,292,286,6,12,1,1
0,0,0,0,0,0,0,0,0
196730,1650,3,231,228,3,7,1,0
115418,1147,3,43,40,3,5,1,0
2252,29,1,1,1,0,0,0,0
245543,873,7,97,97,0,7,1,0
32606,469,0,95,93,2,0,0,0
0,0,0,0,0,0,0,0,0
282261,2534,9,716,484,232,13,1,0
74367,489,12,95,76,19,2,1,0
10643,169,2,34,33,1,0,1,0
388215,1553,1,101,95,6,20,0,0
80390,788,6,76,76,0,28,1,0
0,0,0,0,0,0,0,0,0
62700,400,6,79,70,9,2,1,0
218617,3767,2,1129,1127,2,2,1,0
137055,2668,2,884,881,3,2,1,0
470560,2112,4,303,258,45,4,1,0
385222,2599,8,475,334,141,5,1,0
855597,1634,4,87,62,25,37,0,0
0,0,0,0,0,0,0,0,0
50253,219,4,20,20,0,21,1,0
581479,142,4,12,12,0,8,1,0
664616,408,9,22,21,1,22,1,0
0,0,0,0,0,0,0,0,0
0,0,0,0,0,0,0,0,0
1169580,927,4,75,60,15,4,1,0
0,0,0,0,0,0,0,0,0
54221,576,7,103,100,3,0,1,0
54221,576,7,103,100,3,0,1,0
153351,1192,18,124,57,67,4,1,0
153351,1192,18,124,57,67,4,1,0
461165,571,5,50,42,8,1,1,0
91866,463,5,44,36,8,1,1,0
198624,1896,10,290,209,81,12,1,0
128181,113,0,6,3,3,2,1,0
46159,654,3,147,127,20,2,1,0
0,0,0,0,0,0,0,0,0
0,0,0,0,0,0,0,0,0
0,0,0,0,0,0,0,0,0
186435,1228,14,261,253,8,11,1,0
59260,648,7,149,144,5,7,1,0
0,0,0,0,0,0,0,0,0
0,0,0,0,0,0,0,0,0
0,0,0,0,0,0,0,0,0
0,0,0,0,0,0,0,0,0
0,0,0,0,0,0,0,0,0
910598,2127,2,355,347,8,3,1,0
686539,545,4,11,8,3,3,1,0
412717,1725,6,476,430,46,2,1,0
525946,1278,3,224,214,10,0,0,0
46404,117,2,7,7,0,0,0,0
0,0,0,0,0,0,0,0,0
0,0,0,0,0,0,0,0,0
0,0,0,0,0,0,0,0,0
108838,794,14,129,115,14,7,1,0
108853,794,14,129,115,14,7,1,0
0,0,0,0,0,0,0,0,0
0,0,0,0,0,0,0,0,0
32005,441,5,51,51,0,5,0,0
0,0,0,0,0,0,0,0,0
0,0,0,0,0,0,0,0,0
0,0,0,0,0,0,0,0,0
67149,215,3,23,22,1,0,1,0
91419,889,10,151,144,7,8,1,0
69309,638,10,133,126,7,8,1,0
217553,1407,7,185,135,50,8,1,0
445949,1916,10,318,258,60,15,1,0
358803,1459,11,285,274,11,16,1,0
384410,1693,5,234,207,27,2,0,0
152660,1816,2,175,167,8,4,1,0
0,0,0,0,0,0,0,0,0
0,0,0,0,0,0,0,0,0
54552,541,5,25,16,9,0,1,0
0,0,0,0,0,0,0,0,0
0,0,0,0,0,0,0,0,0
607575,1858,5,279,207,72,49,1,0
5905,95,0,15,15,0,0,1,0
40065,480,2,73,64,9,0,0,0
0,0,0,0,0,0,0,0,0
26955,34,0,2,1,1,0,0,0
178812,1301,3,176,170,6,12,1,0
228548,1560,15,243,196,47,15,1,0
0,0,0,0,0,0,0,0,0
0,0,0,0,0,0,0,0,0
74570,996,4,299,189,110,14,1,0
42139,293,1,35,31,4,2,1,0
0,0,0,0,0,0,0,0,0
85952,628,6,97,87,10,4,1,0
219639,963,14,63,42,21,0,1,0
612115,4220,20,586,520,66,31,1,0
613012,4219,20,586,520,66,31,1,0
149909,677,9,156,106,50,1,1,0
0,0,0,0,0,0,0,0,0
0,0,0,0,0,0,0,0,0
0,0,0,0,0,0,0,0,0
176031,102,0,2,2,0,2,1,0
765453,1194,5,95,79,16,0,1,0
0,0,0,0,0,0,0,0,0
103835,1717,2,522,492,30,9,0,0
114174,1363,4,301,71,230,2,1,0
9727,141,3,7,7,0,5,0,0
161776,1074,1,156,121,35,16,0,0
0,0,0,0,0,0,0,0,0
478939,1949,15,311,81,230,4,1,0
165402,309,2,14,14,0,2,1,0
16794,277,2,63,63,0,3,1,0
122216,1074,7,220,214,6,2,0,0
0,0,0,0,0,0,0,0,0
108176,931,7,153,149,4,20,1,0
204029,1159,11,215,199,16,2,1,0
34969,766,2,190,170,20,1,1,0
184492,1566,7,344,281,63,10,1,0
0,0,0,0,0,0,0,0,0
0,0,0,0,0,0,0,0,0
184147,975,9,77,71,6,15,1,0
67657,341,9,44,38,6,0,1,0
60511,714,7,136,122,14,19,0,0
98326,218,1,19,14,5,6,1,0
73238,456,5,78,75,3,5,1,0
1071123,8804,5,4,3,1,6,0,0
0,0,0,0,0,0,0,0,0
166675,1221,9,196,143,53,17,1,0
0,0,0,0,0,0,0,0,0
74248,504,11,144,143,1,6,1,0
0,0,0,0,0,0,0,0,0
124777,1077,3,133,103,30,1,1,0
64757,301,5,75,65,10,3,1,0
465006,1453,7,253,198,55,3,0,0
328992,1845,8,255,252,3,33,1,0
21858,33,0,1,1,0,0,1,0
27078,36,0,3,1,2,0,0,0
0,0,0,0,0,0,0,0,0
48158,562,0,107,102,5,0,0,0
1309780,13229,9,2453,2412,41,864,1,0
62428,89,0,2,2,0,0,0,0
0,0,0,0,0,0,0,0,0
207184,1229,11,117,69,48,17,1,0
77411,661,5,69,61,8,13,1,0
86570,698,8,39,32,7,24,1,0
0,0,0,0,0,0,0,0,0
0,0,0,0,0,0,0,0,0
0,0,0,0,0,0,0,0,0
110293,443,0,61,60,1,0,1,0
0,0,0,0,0,0,0,0,0
696877,6341,0,290,248,42,92,1,0
0,0,0,0,0,0,0,0,0
67160,301,4,36,36,0,0,1,0
61400,332,8,72,71,1,3,1,0
388125,1399,2,263,240,23,1,0,0
92467,1041,2,60,33,27,2,1,0
0,0,0,0,0,0,0,0,0
217063,1435,6,220,214,6,4,1,0
244840,1026,9,302,261,41,106,1,0
28759,45,0,4,1,3,0,0,0
66306,1381,3,402,387,15,21,1,0
5926,41,1,2,1,1,0,0,0
116695,1315,5,146,107,39,2,1,0
0,0,0,0,0,0,0,0,0
103322,1337,7,220,200,20,3,1,0
12863,151,1,8,0,8,1,0,0
157152,572,7,129,89,40,2,0,0
0,0,0,0,0,0,0,0,0
0,0,0,0,0,0,0,0,0
79254,1032,8,239,210,29,6,1,0
0,0,0,0,0,0,0,0,0
202314,1058,6,123,88,35,12,0,0
0,0,0,0,0,0,0,0,0
0,0,0,0,0,0,0,0,0
71396,992,1,26,23,3,8,1,0
0,0,0,0,0,0,0,0,0
0,0,0,0,0,0,0,0,0
54057,161,3,13,8,5,0,0,0
41461,557,3,78,74,4,2,0,0
358761,1245,9,204,200,4,20,1,0
150687,433,9,126,115,11,40,1,0
0,0,0,0,0,0,0,0,0
156810,896,11,84,77,7,20,1,0
127224,525,9,85,76,9,10,1,0
200278,2354,4,57,2,55,26,1,0
51112,180,4,18,18,0,6,1,0
198778,1037,13,80,62,18,41,1,0
233521,1398,13,84,61,23,43,1,0
0,0,0,0,0,0,0,0,0
22170,35,0,1,1,0,0,1,0
38315,271,5,65,65,0,1,1,0
6495,67,2,1,0,1,0,0,0
52007,143,2,108,107,1,0,0,0
59220,913,3,122,121,1,0,1,0
0,0,0,0,0,0,0,0,0
0,0,0,0,0,0,0,0,0
309052,911,9,59,55,4,2,1,0
383333,1010,1,159,146,13,1,1,0
5973,21,0,1,1,0,0,1,0
38264,391,6,25,25,0,0,0,0
153084,804,8,15,15,0,3,1,0
0,0,0,0,0,0,0,0,0
249988,749,1,147,136,11,0,1,0
0,0,0,0,0,0,0,0,0
131294,71,1,0,0,0,0,0,0
521024,2107,12,145,126,19,12,1,0
0,0,0,0,0,0,0,0,0
273061,911,6,148,6,142,11,1,0
808943,7308,6,651,646,5,6,0,0
178495,1779,10,351,198,153,11,1,0
74939,1151,3,113,103,10,0,1,0
0,0,0,0,0,0,0,0,0
0,0,0,0,0,0,0,0,0
217114,1703,9,231,200,31,5,1,0
0,0,0,0,0,0,0,0,0
476411,998,6,126,119,7,13,1,0
0,0,0,0,0,0,0,0,0
304852,3071,9,665,638,27,9,1,0
143584,1448,3,321,309,12,11,1,0
92082,877,6,221,209,12,13,1,0
322200,1991,6,284,258,26,3,1,0
0,0,0,0,0,0,0,0,0
0,0,0,0,0,0,0,0,0
0,0,0,0,0,0,0,0,0
0,0,0,0,0,0,0,0,0
988,17,0,1,0,1,0,0,0
28838,42,0,2,1,1,0,0,0
72750,1578,2,594,592,2,1,0,0
0,0,0,0,0,0,0,0,0
0,0,0,0,0,0,0,0,0
1802136,11183,6,690,661,29,6,1,0
198210,782,5,34,26,8,1,0,0
0,0,0,0,0,0,0,0,0
91149,269,4,26,25,1,4,1,0
153715,1088,11,184,170,14,7,1,0
21526,243,5,56,43,13,5,1,0
191455,2890,7,438,420,18,2,1,0
0,0,0,0,0,0,0,0,0
84837,1116,8,121,68,53,3,1,0
153122,1528,8,348,334,14,2,0,0
0,0,0,0,0,0,0,0,0
119383,1440,6,269,253,16,32,1,1
165256,1075,6,170,146,24,8,1,0
0,0,0,0,0,0,0,0,0
0,0,0,0,0,0,0,0,0
0,0,0,0,0,0,0,0,0
1455300,1245,1,235,222,13,1,1,0
391279,120,0,5,5,0,0,1,0
83082,624,3,70,30,40,5,1,0
0,0,0,0,0,0,0,0,0
232030,1778,5,230,171,59,17,0,0
169183,1409,11,90,84,6,3,1,0
848683,2352,6,137,122,15,17,0,0
0,0,0,0,0,0,0,0,0
96754,955,5,240,0,240,0,0,0
112426,1604,7,225,214,11,5,1,0
206571,2325,14,450,436,14,17,1,0
285950,233,0,4,3,1,1,1,0
0,0,0,0,0,0,0,0,0
11671,211,2,69,28,41,0,1,0
0,0,0,0,0,0,0,0,0
412372,3623,6,320,298,22,18,1,0
0,0,0,0,0,0,0,0,0
571699,1788,8,503,500,3,6,1,0
0,0,0,0,0,0,0,0,0
101940,1554,6,170,104,66,8,0,0
465493,2468,6,540,441,99,12,0,0
9051,82,2,2,2,0,0,0,0
60309,232,2,5,5,0,3,1,0
219363,559,2,78,69,9,0,1,0
72837,212,4,19,13,6,5,1,0
0,0,0,0,0,0,0,0,0
0,0,0,0,0,0,0,0,0
0,0,0,0,0,0,0,0,0
193402,814,3,77,74,3,1,1,0
144574,408,4,33,31,2,5,1,0
0,0,0,0,0,0,0,0,0
0,0,0,0,0,0,0,0,0
0,0,0,0,0,0,0,0,0
149635,2510,11,38,30,8,4,1,0
10955,79,6,3,2,1,1,0,0
46413,250,10,33,28,5,0,1,0
100182,1075,1,377,375,2,0,0,0
2979,46,0,0,0,0,0,0,0
0,0,0,0,0,0,0,0,0
0,0,0,0,0,0,0,0,0
215946,998,9,270,268,2,9,1,0
17053,339,2,88,77,11,0,0,0
235575,2288,11,776,762,14,5,1,0
215960,2108,11,753,739,14,6,1,0
0,0,0,0,0,0,0,0,0
0,0,0,0,0,0,0,0,0
157921,234,1,12,12,0,0,1,0
22438,185,1,13,13,0,0,1,0
0,0,0,0,0,0,0,0,0
0,0,0,0,0,0,0,0,0
3824335,31671,5,3312,1806,1506,9,1,0
47106,132,8,3,0,3,0,1,0
0,0,0,0,0,0,0,0,0
0,0,0,0,0,0,0,0,0
0,0,0,0,0,0,0,0,0
0,0,0,0,0,0,0,0,0
1245288,974,16,94,67,27,6,1,0
0,0,0,0,0,0,0,0,0
0,0,0,0,0,0,0,0,0
18734,424,3,169,167,2,0,1,0
9634,224,2,82,82,0,0,1,0
30835,249,4,27,21,6,0,0,0
463381,2003,8,195,158,37,6,1,0
0,0,0,0,0,0,0,0,0
790065,4798,6,459,434,25,1,0,0
0,0,0,0,0,0,0,0,0
21724,188,6,15,10,5,0,1,0
0,0,0,0,0,0,0,0,0
0,0,0,0,0,0,0,0,0
0,0,0,0,0,0,0,0,0
0,0,0,0,0,0,0,0,0
135794,2247,2,602,501,101,6,0,0
84145,1462,2,432,379,53,6,0,0
0,0,0,0,0,0,0,0,0
148356,828,6,178,174,4,6,1,0
1241545,379,8,14,13,1,3,1,0
55089,545,8,113,81,32,5,0,0
117781,1183,7,258,233,25,4,1,0
0,0,0,0,0,0,0,0,0
0,0,0,0,0,0,0,0,0
188864,1157,6,167,157,10,7,1,0
232500,2137,17,431,425,6,11,1,0
0,0,0,0,0,0,0,0,0
461753,973,12,183,173,10,15,1,0
101183,723,12,67,42,25,2,1,0
166630,784,12,145,131,14,7,1,0
1650,11,0,1,1,0,0,0,0
0,0,0,0,0,0,0,0,0
0,0,0,0,0,0,0,0,0
240379,621,6,97,96,1,3,1,0
807026,2101,15,427,418,9,4,1,0
386135,1140,9,311,302,9,0,1,0
0,0,0,0,0,0,0,0,0
610517,2333,7,210,194,16,12,1,0
0,0,0,0,0,0,0,0,0
35844,544,4,97,97,0,4,1,0
23968,311,7,85,85,0,1,1,0
108543,488,8,153,151,2,8,1,0
332533,464,2,67,53,14,0,1,0
103340,703,4,81,55,26,2,1,0
1316710,5056,2,809,797,12,73,1,0
0,0,0,0,0,0,0,0,0
0,0,0,0,0,0,0,0,0
0,0,0,0,0,0,0,0,0
249816,2011,6,397,373,24,9,1,1
98242,1326,9,253,240,13,3,0,0
61401,501,9,87,79,8,1,0,0
157981,1485,3,162,40,122,27,1,0
2380101,10429,15,255,61,194,9,1,0
0,0,0,0,0,0,0,0,0
0,0,0,0,0,0,0,0,0
87718,1012,6,195,189,6,19,1,0
200333,957,11,154,114,40,11,1,0
0,0,0,0,0,0,0,0,0
39740,344,6,42,30,12,0,1,0
0,0,0,0,0,0,0,0,0
0,0,0,0,0,0,0,0,0
0,0,0,0,0,0,0,0,0
0,0,0,0,0,0,0,0,0
0,0,0,0,0,0,0,0,0
0,0,0,0,0,0,0,0,0
185074,1490,8,273,252,21,8,1,0
0,0,0,0,0,0,0,0,0
628525,8112,12,1623,1621,2,38,0,0
104805,1042,2,208,171,37,20,1,0
0,0,0,0,0,0,0,0,0
0,0,0,0,0,0,0,0,0
44979,386,7,55,19,36,0,1,0
0,0,0,0,0,0,0,0,0
32963,138,8,7,7,0,0,1,0
61687,495,4,113,36,77,0,0,0
23395,297,3,15,3,12,0,1,0
198360,1084,7,146,124,22,1,0,0
305344,365,0,17,13,4,2,1,0
131140,1971,5,524,463,61,25,1,0
100346,1391,5,455,404,51,29,1,0
0,0,0,0,0,0,0,0,0
24292542,1286,11,99,93,6,1,1,0
0,0,0,0,0,0,0,0,0
68003,268,3,14,9,5,2,1,0
0,0,0,0,0,0,0,0,0
275805,2461,5,420,386,34,3,1,0
71877,845,5,125,95,30,6,1,0
223712,431,3,87,79,8,0,0,0
34076,127,5,2,2,0,4,0,0
0,0,0,0,0,0,0,0,0
218653,2847,10,630,601,29,8,1,0
300641,3280,8,823,756,67,9,0,0
0,0,0,0,0,0,0,0,0
193482,1680,10,226,218,8,43,1,0
168081,1597,9,184,178,6,48,1,0
0,0,0,0,0,0,0,0,0
33114,478,4,54,52,2,1,0,0
0,0,0,0,0,0,0,0,0
0,0,0,0,0,0,0,0,0
27903,10,0,0,0,0,0,0,0
0,0,0,0,0,0,0,0,0
25066,246,4,71,71,0,5,1,0
0,0,0,0,0,0,0,0,0
0,0,0,0,0,0,0,0,0
61095,1088,3,249,232,17,6,0,0
112990,813,2,136,42,94,1,1,0
285939,233,0,4,3,1,1,1,0
0,0,0,0,0,0,0,0,0
0,0,0,0,0,0,0,0,0
223834,2034,15,237,215,22,14,1,0
0,0,0,0,0,0,0,0,0
281551,1415,8,136,75,61,18,1,0
0,0,0,0,0,0,0,0,0
93519,741,5,161,141,20,11,1,0
280944,1322,12,165,165,0,2,0,0
498690,2823,7,624,616,8,2,1,0
406367,1074,16,107,80,27,10,1,0
0,0,0,0,0,0,0,0,0
266289,1743,16,413,395,18,5,1,0
65750,721,5,74,71,3,15,1,0
0,0,0,0,0,0,0,0,0
31620,350,9,33,29,4,2,1,0
36123,314,10,30,23,7,8,1,0
0,0,0,0,0,0,0,0,0
0,0,0,0,0,0,0,0,0
30649,101,2,2,0,2,0,0,0
256420,1503,7,259,252,7,30,1,0
0,0,0,0,0,0,0,0,0
0,0,0,0,0,0,0,0,0
116448,261,9,20,20,0,0,1,0
510567,1171,7,99,84,15,11,1,0
62009,329,12,37,32,5,2,1,0
139177,887,16,135,120,15,6,1,0
13683,102,2,5,5,0,0,1,0
1781,37,0,2,2,0,0,1,0
0,0,0,0,0,0,0,0,0
42484,596,10,140,132,8,9,1,0
0,0,0,0,0,0,0,0,0
5988,49,2,13,13,0,0,1,0
436697,6411,1,862,760,102,15,1,0
65054,674,9,79,53,26,2,1,0
67018,393,7,25,19,6,14,1,0
0,0,0,0,0,0,0,0,0
0,0,0,0,0,0,0,0,0
51504,1168,3,250,248,2,4,1,0
11724,137,2,29,27,2,3,1,0
0,0,0,0,0,0,0,0,0
55579,490,6,72,51,21,9,0,0
0,0,0,0,0,0,0,0,0
841640,4941,6,328,320,8,453,1,0
0,0,0,0,0,0,0,0,0
267066,3797,17,645,625,20,11,1,0
623253,6639,15,1374,1366,8,140,1,0
819,41,0,0,0,0,0,0,0
0,0,0,0,0,0,0,0,0
0,0,0,0,0,0,0,0,0
0,0,0,0,0,0,0,0,0
0,0,0,0,0,0,0,0,0
956630,2963,15,211,198,13,28,1,0
843972,2743,15,122,112,10,15,1,0
224355,2539,8,171,133,38,0,1,0
224353,2539,8,171,133,38,0,1,0
219506,1371,9,116,95,21,0,0,0
129472,788,8,133,131,2,3,1,0
0,0,0,0,0,0,0,0,0
71308,462,6,41,29,12,6,1,0
11754,118,5,30,28,2,1,0,0
96843,1005,3,220,216,4,1,1,0
272734,1077,11,145,128,17,48,1,0
291650,1050,4,99,78,21,2,1,0
194367,1141,6,167,157,10,58,1,0
0,0,0,0,0,0,0,0,0
177165,1053,3,102,98,4,9,0,0
561,6,0,0,0,0,0,0,0
497655,8579,9,945,932,13,42,1,0
335979,1604,16,210,197,13,13,1,0
8913,154,4,15,3,12,0,0,0
0,0,0,0,0,0,0,0,0
0,0,0,0,0,0,0,0,0
573023,2923,21,377,361,16,13,1,0
0,0,0,0,0,0,0,0,0
167195,723,6,110,99,11,0,1,0
144312,322,6,43,42,1,1,1,0
80115,1767,2,502,476,26,0,1,0
0,0,0,0,0,0,0,0,0
137460,1149,12,100,91,9,5,0,0
160202,456,10,67,64,3,3,1,0
1507602,4368,3,1168,1166,2,5,1,0
94014,1115,0,226,226,0,0,1,0
30905,300,5,35,22,13,1,1,0
5211,61,3,3,3,0,3,0,0
1629011,1274,7,133,127,6,2,1,0
479364,910,7,86,78,8,9,1,0
0,0,0,0,0,0,0,0,0
8761,91,2,4,1,3,0,0,0
23193,38,0,2,2,0,0,1,0
0,0,0,0,0,0,0,0,0
265828,723,6,144,119,25,6,1,0
325220,3399,12,125,123,2,3,1,0
0,0,0,0,0,0,0,0,0
0,0,0,0,0,0,0,0,0
117580,446,10,44,32,12,1,1,0
106659,315,2,24,17,7,0,1,0
0,0,0,0,0,0,0,0,0
301181,3059,11,383,366,17,164,1,0
163755,1016,9,207,198,9,19,1,0
65575,433,7,60,59,1,0,1,0
0,0,0,0,0,0,0,0,0
0,0,0,0,0,0,0,0,0
71004,557,5,53,47,6,2,1,0
0,0,0,0,0,0,0,0,0
0,0,0,0,0,0,0,0,0
89296,1009,5,82,74,8,1,1,0
242337,1785,5,491,489,2,7,0,0
0,0,0,0,0,0,0,0,0
100048,769,10,149,119,30,4,0,0
0,0,0,0,0,0,0,0,0
0,0,0,0,0,0,0,0,0
72735,486,8,28,26,2,3,1,0
6305,54,2,10,7,3,0,1,0
0,0,0,0,0,0,0,0,0
137263,1253,4,366,281,85,12,1,0
3983,75,2,4,3,1,0,1,0
0,0,0,0,0,0,0,0,0
0,0,0,0,0,0,0,0,0
310654,733,9,101,22,79,12,1,0
170286,193,7,28,15,13,1,1,0
0,0,0,0,0,0,0,0,0
228962,788,1,136,131,5,4,1,0
163400,330,1,74,24,50,0,1,0
0,0,0,0,0,0,0,0,0
12522,308,2,16,14,2,0,1,0
401218,3598,8,146,133,13,3,1,0
0,0,0,0,0,0,0,0,0
0,0,0,0,0,0,0,0,0
55205,961,7,126,37,89,11,1,0
314006,2184,5,676,590,86,11,0,0
270472,1946,5,632,552,80,11,0,0
0,0,0,0,0,0,0,0,0
273039,1365,9,266,253,13,21,1,0
0,0,0,0,0,0,0,0,0
113027,877,9,115,113,2,10,1,0
0,0,0,0,0,0,0,0,0
0,0,0,0,0,0,0,0,0
252798,1991,7,325,78,247,54,1,0
0,0,0,0,0,0,0,0,0
795983,1756,13,236,226,10,19,1,0
871746,4105,5,187,150,37,3,1,0
0,0,0,0,0,0,0,0,0
1145919,4618,6,1087,825,262,11,1,1
130268,173,8,13,9,4,6,0,0
114947,160,4,4,4,0,7,1,0
436294,1051,1,106,98,8,2,1,0
754262,893,6,165,116,49,21,1,0
0,0,0,0,0,0,0,0,0
0,0,0,0,0,0,0,0,0
53693,202,1,58,58,0,1,1,0
206633,1079,7,33,20,13,0,1,0
51067,1359,2,399,230,169,1,1,0
0,0,0,0,0,0,0,0,0
210556,1518,7,259,256,3,7,0,0
285317,1483,13,219,102,117,10,1,0
0,0,0,0,0,0,0,0,0
0,0,0,0,0,0,0,0,0
35460,419,4,105,103,2,5,1,0
0,0,0,0,0,0,0,0,0
125437,2746,1,253,247,6,2,1,0
63440,684,8,43,17,26,8,1,0
68622,1000,3,223,193,30,2,1,0
3525,27,3,0,0,0,0,0,0
96303,184,3,11,6,5,3,1,0
445143,2571,7,400,296,104,26,1,0
782534,2434,4,645,609,36,3,1,0
606005,3858,13,193,145,48,33,1,0
400260,1937,12,117,72,45,18,1,0
0,0,0,0,0,0,0,0,0
183738,855,5,64,55,9,27,1,0
0,0,0,0,0,0,0,0,0
249690,1192,5,129,129,0,0,1,0
0,0,0,0,0,0,0,0,0
76726,1054,8,246,243,3,5,1,0
68828,497,7,54,51,3,11,1,0
0,0,0,0,0,0,0,0,0
0,0,0,0,0,0,0,0,0
44070,756,3,133,103,30,0,0,0
457940,2789,4,382,362,20,3,1,0
579207,1343,1,151,102,49,1,1,0
0,0,0,0,0,0,0,0,0
65121,810,7,206,206,0,12,1,0
180848,530,2,85,82,3,9,1,0
0,0,0,0,0,0,0,0,0
83584,1290,7,159,75,84,2,1,0
82332,467,1,75,41,34,2,1,0
42490,625,1,144,109,35,2,1,0
37655,571,1,127,96,31,1,1,0
761258,960,7,78,65,13,0,1,0
35774,450,4,76,73,3,7,1,0
0,0,0,0,0,0,0,0,0
21996,33,0,1,1,0,0,1,0
35534,279,5,63,63,0,2,1,0
31694,269,5,70,69,1,2,1,0
203097,379,4,39,33,6,0,1,0
465071,2091,9,152,80,72,17,1,0
0,0,0,0,0,0,0,0,0
0,0,0,0,0,0,0,0,0
8448,104,4,17,13,4,0,1,0
126654,1114,3,171,163,8,21,0,0
162623,573,3,148,129,19,0,0,0
56635,349,9,32,31,1,0,1,0
0,0,0,0,0,0,0,0,0
247221,1165,13,236,34,202,2,0,0
230160,1925,12,444,432,12,2,1,0
154273,1576,14,361,351,10,6,1,0
29746,507,4,133,130,3,0,1,0
1870695,6531,5,413,405,8,0,1,0
0,0,0,0,0,0,0,0,0
211118,1339,3,208,173,35,1,1,0
36929,106,0,1,0,1,0,1,0
134399,2096,11,547,542,5,3,1,0
62398,454,4,91,82,9,0,1,0
384655,2505,9,191,148,43,56,1,0
0,0,0,0,0,0,0,0,0
5443,101,1,29,29,0,0,1,0
2113038,2646,11,899,866,33,15,1,0
2046195,1328,11,440,407,33,8,1,0
115542,604,6,63,56,7,10,1,0
70890,249,7,9,9,0,10,1,0
7126,105,4,9,2,7,3,1,0
0,0,0,0,0,0,0,0,0
103507,642,12,42,37,5,1,1,0
60847,308,11,33,28,5,1,1,0
0,0,0,0,0,0,0,0,0
0,0,0,0,0,0,0,0,0
0,0,0,0,0,0,0,0,0
903489,6497,7,946,929,17,23,0,0
351727,4976,9,205,193,12,17,0,0
113498,2278,8,488,433,55,14,1,0
0,0,0,0,0,0,0,0,0
184105,410,5,68,55,13,1,1,0
28205,602,2,128,114,14,3,1,0
0,0,0,0,0,0,0,0,0
0,0,0,0,0,0,0,0,0
0,0,0,0,0,0,0,0,0
0,0,0,0,0,0,0,0,0
0,0,0,0,0,0,0,0,0
81453,1181,4,282,275,7,3,1,0
31175,396,4,90,84,6,2,1,0
130657,1089,3,184,147,37,30,1,0
0,0,0,0,0,0,0,0,0
0,0,0,0,0,0,0,0,0
36584,367,0,44,40,4,1,1,0
0,0,0,0,0,0,0,0,0
38220,357,2,67,60,7,8,1,0
523631,3785,16,268,205,63,9,1,0
18138,253,3,31,30,1,7,1,0
51901,143,2,108,107,1,0,0,0
0,0,0,0,0,0,0,0,0
29715,391,4,97,83,14,1,1,0
28759,45,0,4,1,3,0,0,0
0,0,0,0,0,0,0,0,0
410818,2391,13,202,155,47,7,1,0
191018,648,10,95,93,2,7,1,0
538952,3371,6,731,720,11,27,1,0
393786,2243,6,595,585,10,3,1,0
0,0,0,0,0,0,0,0,0
0,0,0,0,0,0,0,0,0
0,0,0,0,0,0,0,0,0
0,0,0,0,0,0,0,0,0
213698,856,12,215,207,8,10,1,0
0,0,0,0,0,0,0,0,0
17461,176,2,68,66,2,0,1,0
162150,636,5,149,144,5,19,1,0
276248,1247,12,156,114,42,18,1,0
0,0,0,0,0,0,0,0,0
0,0,0,0,0,0,0,0,0
91938,1463,6,261,252,9,16,1,0
20563,112,3,7,7,0,6,1,0
54553,392,4,42,41,1,9,1,0
35787,190,4,19,18,1,9,1,0
0,0,0,0,0,0,0,0,0
195896,2512,7,691,660,31,19,1,0
89093,980,2,257,9,248,0,1,0
96195,410,6,52,52,0,0,1,0
190985,653,8,78,71,7,1,0,0
13627,96,5,8,8,0,3,0,0
0,0,0,0,0,0,0,0,0
0,0,0,0,0,0,0,0,0
286863,1762,15,204,197,7,21,1,0
122849,1049,3,107,93,14,1,1,0
89869,1536,3,372,364,8,2,1,0
28712,45,0,4,1,3,0,0,0
0,0,0,0,0,0,0,0,0
47929,350,5,52,42,10,4,1,0
1668863,2418,2,188,174,14,1,1,0
357235,105,0,5,5,0,0,1,0
0,0,0,0,0,0,0,0,0
0,0,0,0,0,0,0,0,0
0,0,0,0,0,0,0,0,0
0,0,0,0,0,0,0,0,0
189805,624,10,115,110,5,4,1,0
0,0,0,0,0,0,0,0,0
0,0,0,0,0,0,0,0,0
0,0,0,0,0,0,0,0,0
0,0,0,0,0,0,0,0,0
8933,156,3,9,7,2,0,1,0
0,0,0,0,0,0,0,0,0
155815,1086,7,166,165,1,10,1,0
80800,212,0,46,23,23,0,1,1
0,0,0,0,0,0,0,0,0
97130,1044,8,93,83,10,0,0,0
523433,6561,6,479,474,5,287,1,0
415682,1702,1,502,437,65,24,1,0
163421,330,1,74,24,50,0,1,0
501120,3975,10,837,798,39,5,1,0
77673,666,2,175,167,8,0,0,0
32182,332,1,119,111,8,0,0,0
155196,1389,5,114,98,16,7,1,0
452076,2577,10,422,393,29,12,1,0
0,0,0,0,0,0,0,0,0
0,0,0,0,0,0,0,0,0
219535,3222,9,90,72,18,3,1,0
502388,1649,4,144,121,23,4,0,0
0,0,0,0,0,0,0,0,0
306480,3003,13,824,815,9,22,1,0
0,0,0,0,0,0,0,0,0
625586,8010,5,697,694,3,0,1,0
28822,231,4,32,32,0,2,1,0
93364,636,10,161,156,5,7,1,0
881891,8173,18,1271,1197,74,11,1,0
141161,1247,8,199,190,9,3,1,0
435618,3703,9,1181,1120,61,36,0,0
0,0,0,0,0,0,0,0,0
468326,2187,5,76,42,34,44,1,0
0,0,0,0,0,0,0,0,0
91855,1082,1,194,192,2,0,0,0
0,0,0,0,0,0,0,0,0
22896,37,0,2,1,1,0,1,0
1243431,7672,1,253,215,38,8,1,0
183172,1515,4,204,126,78,39,1,0
19525,138,3,3,3,0,0,0,0
209308,997,5,216,212,4,4,0,0
395463,2361,20,92,70,22,16,1,0
3017,79,0,8,8,0,0,1,0
0,0,0,0,0,0,0,0,0
0,0,0,0,0,0,0,0,0
279260,804,6,107,72,35,13,1,0
157075,1575,1,525,524,1,3,1,0
129273,165,1,22,17,5,0,1,0
50658,241,4,6,3,3,1,0,0
0,0,0,0,0,0,0,0,0
694557,1678,5,118,105,13,7,1,0
0,0,0,0,0,0,0,0,0
38923,514,3,125,107,18,0,1,0
0,0,0,0,0,0,0,0,0
314036,1773,13,390,341,49,73,1,0
532878,1671,3,254,141,113,15,1,0
81615,112,1,10,7,3,2,0,0
0,0,0,0,0,0,0,0,0
0,0,0,0,0,0,0,0,0
92752,1231,8,67,67,0,11,1,0
16807,184,6,28,28,0,6,1,0
89544,696,4,40,28,12,0,1,0
6683,80,4,12,12,0,4,1,0
0,0,0,0,0,0,0,0,0
0,0,0,0,0,0,0,0,0
538684,1737,2,255,112,143,13,1,0
80914,112,1,10,7,3,2,0,0
23910,171,3,1,0,1,3,0,0
90236,374,5,72,64,8,5,1,0
105920,611,4,143,135,8,6,1,0
0,0,0,0,0,0,0,0,0
61163,494,3,100,100,0,9,1,0
29113,429,6,99,95,4,0,1,0
128539,447,7,73,49,24,0,1,0
149381,896,11,27,17,10,1,0,0
62371,659,7,174,170,4,3,1,0
0,0,0,0,0,0,0,0,0
160705,3773,4,1350,1293,57,3,1,0
8893,96,3,28,28,0,0,1,0
0,0,0,0,0,0,0,0,0
138378,2208,3,789,788,1,5,1,0
770890,3682,12,522,513,9,15,1,0
414496,2069,11,456,451,5,16,1,0
0,0,0,0,0,0,0,0,0
0,0,0,0,0,0,0,0,0
76844,505,13,59,54,5,4,1,0
0,0,0,0,0,0,0,0,0
26413,265,12,13,13,0,2,1,0
49327,385,3,68,59,9,7,1,0
64765,732,4,153,150,3,14,1,0
0,0,0,0,0,0,0,0,0
248196,2031,7,217,173,44,2,0,0
231669,1463,5,93,58,35,4,0,0
232346,1744,11,458,389,69,7,1,0
0,0,0,0,0,0,0,0,0
104070,1001,10,218,204,14,3,1,0
0,0,0,0,0,0,0,0,0
16541,260,2,46,31,15,0,1,0
10913,166,2,25,23,2,1,1,0
5094,81,4,17,12,5,0,1,0
3922,55,4,7,5,2,0,1,0
41622,361,6,111,38,73,0,0,0
186224,950,1,185,182,3,0,1,0
25015,332,3,61,60,1,0,1,0
166350,3851,7,1530,1509,21,3,0,0
0,0,0,0,0,0,0,0,0
228190,1443,5,75,61,14,69,1,0
96159,732,8,128,118,10,1,0,0
32161,210,6,10,3,7,20,0,0
898,28,0,2,2,0,0,0,0
121499,1360,2,283,275,8,5,1,0
184078,451,2,55,49,6,8,0,0
7151,89,0,10,8,2,0,0,0
21599,234,2,24,11,13,0,1,0
0,0,0,0,0,0,0,0,0
286261,1359,10,294,252,42,13,1,0
142862,831,10,175,175,0,12,1,0
0,0,0,0,0,0,0,0,0
251761,1837,8,404,296,108,15,1,1
64515,1297,1,96,66,30,3,1,0
0,0,0,0,0,0,0,0,0
0,0,0,0,0,0,0,0,0
250776,2850,12,284,127,157,2,1,0
0,0,0,0,0,0,0,0,0
0,0,0,0,0,0,0,0,0
0,0,0,0,0,0,0,0,0
102357,1012,6,217,197,20,4,1,0
225803,1037,2,207,188,19,2,1,0
270970,882,14,125,121,4,6,1,0
0,0,0,0,0,0,0,0,0
1527094,7235,8,966,960,6,15,1,0
43265,487,6,129,117,12,11,1,0
115373,443,7,71,71,0,3,1,0
118094,965,9,137,82,55,10,1,0
71564,915,8,91,59,32,6,0,0
0,0,0,0,0,0,0,0,0
1615937,2089,9,215,212,3,0,1,0
210253,176,3,6,6,0,0,1,0
123690,842,5,264,263,1,20,1,0
38665,261,5,13,12,1,4,1,0
36403,541,5,149,143,6,3,0,0
0,0,0,0,0,0,0,0,0
0,0,0,0,0,0,0,0,0
0,0,0,0,0,0,0,0,0
0,0,0,0,0,0,0,0,0
390723,1290,8,94,81,13,7,1,0
0,0,0,0,0,0,0,0,0
0,0,0,0,0,0,0,0,0
17658,247,9,50,50,0,0,1,0
0,0,0,0,0,0,0,0,0
160506,1399,10,283,277,6,18,1,0
10534,69,3,5,5,0,0,1,0
0,0,0,0,0,0,0,0,0
177811,669,9,136,116,20,1,1,0
55928,712,9,124,105,19,0,0,0
56633,1056,4,336,328,8,0,0,0
0,0,0,0,0,0,0,0,0
0,0,0,0,0,0,0,0,0
0,0,0,0,0,0,0,0,0
112151,1277,12,328,323,5,9,1,0
143527,1801,3,308,276,32,0,1,0
264111,1276,9,243,230,13,21,1,0
0,0,0,0,0,0,0,0,0
0,0,0,0,0,0,0,0,0
0,0,0,0,0,0,0,0,0
65171,1330,5,557,546,11,1,0,0
26894,177,5,16,15,1,1,0,0
21977,35,0,1,1,0,0,1,0
972,9,1,0,0,0,0,0,0
0,0,0,0,0,0,0,0,0
0,0,0,0,0,0,0,0,0
0,0,0,0,0,0,0,0,0
207558,2837,2,646,561,85,37,1,0
209002,1917,5,398,369,29,1,1,0
27587,97,0,7,6,1,5,1,0
1820448,8615,17,957,884,73,52,1,0
172864,1218,14,243,188,55,10,1,0
223152,1953,9,393,386,7,28,1,0
0,0,0,0,0,0,0,0,0
0,0,0,0,0,0,0,0,0
136214,1379,6,196,188,8,13,1,0
0,0,0,0,0,0,0,0,0
32716,677,1,93,72,21,4,1,0
70313,879,4,228,1,227,19,1,0
277827,2306,4,1171,1168,3,0,1,0
11102,119,4,16,13,3,0,1,0
512090,2383,13,266,257,9,47,1,0
227592,1064,12,175,166,9,17,1,0
156685,2085,8,372,365,7,0,1,0
142120,1243,2,9,1,8,0,0,0
253023,1624,5,377,338,39,12,1,0
0,0,0,0,0,0,0,0,0
0,0,0,0,0,0,0,0,0
0,0,0,0,0,0,0,0,0
133607,552,5,54,52,2,1,0,0
651971,1931,2,490,470,20,2,1,0
651908,1932,2,491,471,20,2,1,0
701745,2775,14,286,249,37,30,1,0
0,0,0,0,0,0,0,0,0
120784,1087,8,201,185,16,11,0,0
87674,254,0,48,24,24,0,1,1
0,0,0,0,0,0,0,0,0
0,0,0,0,0,0,0,0,0
0,0,0,0,0,0,0,0,0
244787,1291,3,138,99,39,3,1,0
116484,522,8,41,16,25,2,1,0
0,0,0,0,0,0,0,0,0
19737,106,8,1,1,0,0,1,0
0,0,0,0,0,0,0,0,0
0,0,0,0,0,0,0,0,0
83870,720,1,74,63,11,7,0,0
579,7,0,0,0,0,0,0,0
196469,504,6,23,20,3,0,1,0
90403,1432,2,299,162,137,13,1,0
24828,382,0,70,45,25,18,1,0
0,0,0,0,0,0,0,0,0
292479,1248,10,197,16,181,27,1,0
121119,1145,12,164,154,10,10,1,0
1096723,1216,10,66,54,12,15,1,0
342723,1474,15,84,63,21,14,0,0
258564,2378,3,378,354,24,36,1,0
0,0,0,0,0,0,0,0,0
0,0,0,0,0,0,0,0,0
0,0,0,0,0,0,0,0,0
0,0,0,0,0,0,0,0,0
198921,1139,10,238,234,4,4,1,0
166248,1074,10,158,155,3,4,1,0
7767,101,1,17,15,2,0,1,0
28024,406,2,85,82,3,7,1,0
9177,155,2,24,21,3,0,1,0
615877,2048,2,474,465,9,27,1,0
514502,1269,2,290,282,8,22,1,0
194263,1650,16,334,333,1,5,0,0
420932,802,8,92,91,1,2,1,0
287604,2870,9,315,308,7,14,1,0
8740,175,0,16,12,4,0,1,0
5132,92,0,13,11,2,0,1,0
53202,754,2,320,316,4,4,1,0
176438,1293,4,282,241,41,13,1,0
96964,1268,7,245,238,7,5,1,0
0,0,0,0,0,0,0,0,0
256404,1331,14,164,149,15,13,1,0
126576,1528,10,324,287,37,0,1,0
101796,902,9,227,220,7,2,1,0
0,0,0,0,0,0,0,0,0
0,0,0,0,0,0,0,0,0
0,0,0,0,0,0,0,0,0
0,0,0,0,0,0,0,0,0
92430,1041,2,60,33,27,2,1,0
0,0,0,0,0,0,0,0,0
85282,1138,14,214,125,89,0,1,0
16018,102,6,3,3,0,0,0,0
21729,33,0,1,1,0,0,1,0
52080,491,5,83,77,6,1,1,0
0,0,0,0,0,0,0,0,0
187411,2211,3,479,470,9,6,1,0
0,0,0,0,0,0,0,0,0
358791,959,7,46,32,14,1,1,0
0,0,0,0,0,0,0,0,0
336772,3922,15,395,372,23,14,1,0
15469,63,5,0,0,0,0,0,0
616270,1278,5,155,128,27,6,1,0
1973856,849,4,106,93,13,1,1,0
0,0,0,0,0,0,0,0,0
70637,752,12,80,70,10,13,1,0
39310,357,12,43,33,10,8,1,0
0,0,0,0,0,0,0,0,0
87208,1013,3,178,174,4,22,0,0
0,0,0,0,0,0,0,0,0
0,0,0,0,0,0,0,0,0
218322,1877,6,350,340,10,2,0,0
0,0,0,0,0,0,0,0,0
0,0,0,0,0,0,0,0,0
0,0,0,0,0,0,0,0,0
177659,1287,6,343,195,148,5,1,0
35888,394,4,96,53,43,5,1,0
41629,257,2,46,46,0,9,1,0
65566,918,4,151,142,9,4,1,0
3815,110,1,14,13,1,0,0,0
1014665,1688,5,210,177,33,6,1,0
246076,1154,9,281,258,23,36,1,0
8856,127,3,30,30,0,2,1,0
6734,122,2,28,28,0,0,1,0
55407,462,2,55,51,4,0,0,0
0,0,0,0,0,0,0,0,0
230306,1105,6,157,130,27,17,1,0
131611,790,6,142,121,21,17,1,0
108202,1341,7,90,76,14,0,1,0
127171,1205,5,152,152,0,12,1,0
0,0,0,0,0,0,0,0,0
194066,1677,10,390,372,18,16,1,0
0,0,0,0,0,0,0,0,0
0,0,0,0,0,0,0,0,0
339349,3486,6,212,193,19,7,1,0
95593,683,0,78,71,7,6,1,0
0,0,0,0,0,0,0,0,0
594967,1334,17,79,25,54,7,1,0
0,0,0,0,0,0,0,0,0
0,0,0,0,0,0,0,0,0
392138,3542,6,60,55,5,1,1,0
375013,3349,6,50,48,2,1,1,0
0,0,0,0,0,0,0,0,0
152127,534,6,93,21,72,0,1,0
133694,1094,5,239,204,35,2,1,0
0,0,0,0,0,0,0,0,0
0,0,0,0,0,0,0,0,0
0,0,0,0,0,0,0,0,0
0,0,0,0,0,0,0,0,0
178442,351,7,51,51,0,12,1,0
0,0,0,0,0,0,0,0,0
29894,325,8,54,52,2,0,1,0
75311,683,7,208,185,23,0,0,0
0,0,0,0,0,0,0,0,0
0,0,0,0,0,0,0,0,0
751285,2964,9,290,279,11,52,1,0
46379,134,4,7,5,2,0,1,0
0,0,0,0,0,0,0,0,0
0,0,0,0,0,0,0,0,0
0,0,0,0,0,0,0,0,0
94878,1000,13,78,57,21,14,1,0
0,0,0,0,0,0,0,0,0
0,0,0,0,0,0,0,0,0
202965,667,4,15,6,9,6,1,0
3331,44,5,2,2,0,0,0,1
316401,46,0,6,4,2,0,0,0
112844,794,5,117,107,10,10,1,1
0,0,0,0,0,0,0,0,0
0,0,0,0,0,0,0,0,0
33325,266,8,14,14,0,4,1,0
82528,352,3,10,5,5,1,0,0
488395,2244,12,238,229,9,104,1,0
0,0,0,0,0,0,0,0,0
190672,1613,9,1195,1173,22,7,1,0
0,0,0,0,0,0,0,0,0
333296,2066,2,324,322,2,1,1,0
6745,96,2,3,3,0,0,1,0
333451,1325,9,167,125,42,12,1,0
199247,1094,6,119,112,7,4,1,0
258476,940,7,84,44,40,14,1,0
117830,750,12,116,109,7,5,1,0
0,0,0,0,0,0,0,0,0
0,0,0,0,0,0,0,0,0
47466,819,2,248,247,1,4,1,0
4096,67,1,4,4,0,0,1,0
1622206,5531,11,365,325,40,50,1,0
284072,1149,10,187,174,13,4,1,0
982836,6040,7,845,790,55,2,1,0
0,0,0,0,0,0,0,0,0
0,0,0,0,0,0,0,0,0
499133,2608,7,394,288,106,27,1,0
364867,3682,8,719,665,54,0,1,0
0,0,0,0,0,0,0,0,0
0,0,0,0,0,0,0,0,0
214209,1732,8,72,1,71,1,1,0
107877,1048,4,499,499,0,12,1,0
0,0,0,0,0,0,0,0,0
0,0,0,0,0,0,0,0,0
0,0,0,0,0,0,0,0,0
116532,451,8,75,52,23,10,1,0
24261,51,1,1,1,0,0,0,0
185121,1718,6,440,407,33,1,1,0
259931,2182,6,139,112,27,5,0,0
0,0,0,0,0,0,0,0,0
1032465,1184,5,169,163,6,5,1,0
93770,500,14,67,56,11,3,1,0
0,0,0,0,0,0,0,0,0
186939,963,11,252,244,8,17,1,0
26480,81,0,3,1,2,5,1,0
417031,1747,7,221,201,20,35,1,0
0,0,0,0,0,0,0,0,0
124523,1646,11,356,344,12,10,1,0
614433,2068,4,210,152,58,8,1,0
0,0,0,0,0,0,0,0,0
252956,2253,12,635,593,42,12,0,0
111805,254,1,10,9,1,5,1,0
156005,1227,14,156,140,16,4,0,0
854498,4487,14,280,272,8,14,1,0
97204,753,4,134,133,1,0,0,0
33602,512,2,233,232,1,2,1,0
0,0,0,0,0,0,0,0,0
0,0,0,0,0,0,0,0,0
101691,805,8,48,42,6,0,0,0
0,0,0,0,0,0,0,0,0
0,0,0,0,0,0,0,0,0
311586,809,1,122,97,25,0,1,0
217153,1446,8,247,236,11,5,1,0
0,0,0,0,0,0,0,0,0
24110,328,1,16,16,0,0,1,0
4161,74,2,12,11,1,0,1,0
0,0,0,0,0,0,0,0,0
557286,2286,7,185,178,7,7,1,0
0,0,0,0,0,0,0,0,0
72127,202,2,4,3,1,0,1,0
20653,655,4,242,218,24,6,0,0
0,0,0,0,0,0,0,0,0
0,0,0,0,0,0,0,0,0
9444,131,1,14,6,8,3,1,0
96871,558,9,76,66,10,0,1,0
0,0,0,0,0,0,0,0,0
3834,39,0,5,2,3,0,1,0
0,0,0,0,0,0,0,0,0
0,0,0,0,0,0,0,0,0
212156,1990,6,308,292,16,9,1,0
98877,755,4,130,122,8,7,1,0
0,0,0,0,0,0,0,0,0
75772,430,12,90,87,3,3,1,0
554367,2925,12,697,667,30,50,1,0
394275,2460,12,633,607,26,21,1,0
0,0,0,0,0,0,0,0,0
0,0,0,0,0,0,0,0,0
0,0,0,0,0,0,0,0,0
0,0,0,0,0,0,0,0,0
0,0,0,0,0,0,0,0,0
0,0,0,0,0,0,0,0,0
18940,115,2,19,17,2,4,0,0
45047,376,6,69,66,3,0,1,0
0,0,0,0,0,0,0,0,0
0,0,0,0,0,0,0,0,0
0,0,0,0,0,0,0,0,0
0,0,0,0,0,0,0,0,0
0,0,0,0,0,0,0,0,0
23638,301,2,134,134,0,1,0,0
341641,2838,13,579,504,75,10,1,0
30604,255,5,43,43,0,8,1,0
0,0,0,0,0,0,0,0,0
0,0,0,0,0,0,0,0,0
0,0,0,0,0,0,0,0,0
792302,3424,6,401,377,24,61,1,0
0,0,0,0,0,0,0,0,0
65102,724,9,183,165,18,7,1,0
82253,465,7,146,133,13,0,1,0
71819,330,8,61,52,9,3,1,0
8798,42,0,0,0,0,0,0,0
0,0,0,0,0,0,0,0,0
150583,1507,5,175,166,9,7,1,0
0,0,0,0,0,0,0,0,0
285491,1957,12,349,325,24,3,1,0
261481,1900,4,260,256,4,15,1,0
153841,575,4,30,30,0,3,0,0
8608,246,1,16,16,0,0,1,0
98563,1492,5,300,253,47,1,1,0
155492,1026,9,192,36,156,2,1,0
0,0,0,0,0,0,0,0,0
0,0,0,0,0,0,0,0,0
0,0,0,0,0,0,0,0,0
951336,2354,8,310,297,13,11,1,0
207025,1622,11,181,139,42,0,0,0
160980,774,11,153,139,14,2,1,0
0,0,0,0,0,0,0,0,0
112200,1502,8,134,130,4,6,1,0
16725,278,2,51,50,1,2,1,0
0,0,0,0,0,0,0,0,0
87615,653,6,164,163,1,1,1,0
102,4,0,0,0,0,0,0,0
0,0,0,0,0,0,0,0,0
0,0,0,0,0,0,0,0,0
78899,1596,2,777,763,14,0,1,0
151281,815,13,137,122,15,5,1,0
122784,1231,7,167,139,28,3,1,0
28928,135,7,4,4,0,0,1,0
0,0,0,0,0,0,0,0,0
140309,1473,5,427,396,31,3,0,0
13631,99,6,8,5,3,2,1,0
53977,541,2,180,171,9,3,1,0
135077,1966,3,218,190,28,2,0,0
570350,1598,6,253,238,15,0,1,0
0,0,0,0,0,0,0,0,0
428336,2396,12,258,250,8,23,1,0
59489,1093,2,271,262,9,6,0,0
77414,1035,9,307,285,22,14,1,0
0,0,0,0,0,0,0,0,0
211683,3071,8,835,825,10,7,1,0
0,0,0,0,0,0,0,0,0
67248,985,2,215,205,10,2,0,0
0,0,0,0,0,0,0,0,0
0,0,0,0,0,0,0,0,0
1019681,2039,5,300,52,248,9,1,0
131531,1353,5,210,199,11,3,0,0
100431,556,8,74,72,2,3,1,0
135056,985,9,245,203,42,2,1,0
554567,1190,5,68,62,6,6,0,0
228532,1373,10,97,81,16,4,1,0
425508,3865,9,1082,1053,29,6,1,0
816619,9493,2,2072,2001,71,142,1,0
0,0,0,0,0,0,0,0,0
0,0,0,0,0,0,0,0,0
319688,697,9,124,93,31,2,1,0
0,0,0,0,0,0,0,0,0
0,0,0,0,0,0,0,0,0
62927,781,5,157,154,3,0,1,0
0,0,0,0,0,0,0,0,0
0,0,0,0,0,0,0,0,0
12920,178,4,52,49,3,0,0,0
24224,327,1,105,104,1,1,1,0
0,0,0,0,0,0,0,0,0
96912,1205,2,305,241,64,26,0,0
36048,176,1,33,28,5,0,0,0
74290,1935,2,571,571,0,1,1,0
242949,1310,9,216,201,15,1,0,0
467412,3188,9,471,279,192,29,1,0
0,0,0,0,0,0,0,0,0
1384551,489,14,38,32,6,4,1,0
629439,1479,13,241,189,52,18,1,0
164659,2656,4,896,889,7,28,1,0
0,0,0,0,0,0,0,0,0
429607,1786,8,112,106,6,31,1,0
719791,4039,5,482,454,28,10,1,0
386065,1538,5,275,266,9,2,1,0
115849,634,9,86,82,4,5,0,0
142941,2479,2,635,629,6,10,1,0
898216,1805,4,177,172,5,2,0,0
578479,871,4,107,102,5,2,0,0
263053,2083,5,161,120,41,0,1,0
0,0,0,0,0,0,0,0,0
179668,934,3,28,18,10,69,1,0
217683,1438,3,338,322,16,6,0,0
1653886,1940,2,259,246,13,1,1,0
392089,120,0,5,5,0,0,1,0
63350,923,4,151,144,7,4,1,0
3815,110,1,14,13,1,0,0,0
0,0,0,0,0,0,0,0,0
0,0,0,0,0,0,0,0,0
0,0,0,0,0,0,0,0,0
194809,541,11,98,76,22,19,1,0
0,0,0,0,0,0,0,0,0
0,0,0,0,0,0,0,0,0
210834,2625,9,420,355,65,6,0,0
745428,1861,1,189,174,15,2,1,0
0,0,0,0,0,0,0,0,0
273665,962,5,81,70,11,4,1,0
28204,329,4,101,101,0,0,1,0
173702,240,10,9,9,0,1,0,0
77914,1307,5,224,189,35,8,1,0
0,0,0,0,0,0,0,0,0
0,0,0,0,0,0,0,0,0
394922,1557,8,226,219,7,0,1,0
0,0,0,0,0,0,0,0,0
0,0,0,0,0,0,0,0,0
185866,681,6,28,26,2,31,1,1
0,0,0,0,0,0,0,0,0
407769,1259,8,260,23,237,0,1,0
5563,57,6,3,2,1,0,0,0
160619,820,10,148,117,31,7,1,0
207139,990,12,86,82,4,5,1,0
47484,487,2,175,171,4,8,1,0
0,0,0,0,0,0,0,0,0
0,0,0,0,0,0,0,0,0
505019,1817,6,282,263,19,1,1,0
133040,189,1,3,0,3,0,0,0
0,0,0,0,0,0,0,0,0
190413,1221,5,115,100,15,2,0,0
161386,708,4,105,88,17,5,1,0
9002,71,3,4,3,1,2,0,0
0,0,0,0,0,0,0,0,0
354042,1934,6,343,331,12,31,1,0
254567,1546,6,261,245,16,6,1,0
118847,837,4,103,79,24,1,0,0
221273,842,11,71,66,5,0,1,0
0,0,0,0,0,0,0,0,0
95307,1237,10,272,232,40,9,1,0
0,0,0,0,0,0,0,0,0
180619,997,7,97,73,24,0,1,0
50548,172,5,9,1,8,0,1,0
0,0,0,0,0,0,0,0,0
98373,905,9,231,231,0,0,1,0
984,20,0,0,0,0,0,0,0
194841,913,3,172,106,66,4,1,0
0,0,0,0,0,0,0,0,0
466223,2615,13,532,499,33,1,1,0
204964,903,11,161,147,14,0,1,0
130543,1513,4,357,279,78,14,1,0
191771,1536,3,302,288,14,18,1,0
0,0,0,0,0,0,0,0,0
0,0,0,0,0,0,0,0,0
136952,705,8,79,79,0,39,1,0
145605,402,12,74,68,6,5,1,0
0,0,0,0,0,0,0,0,0
0,0,0,0,0,0,0,0,0
715671,2564,5,180,173,7,22,1,0
356448,1647,8,296,289,7,7,1,0
43912,489,7,121,109,12,11,1,0
397090,1085,3,139,130,9,8,1,0
10164,173,1,37,25,12,1,0,0
0,0,0,0,0,0,0,0,0
137207,892,6,108,93,15,7,0,0
109343,636,6,76,59,17,7,0,0
131835,444,6,60,58,2,0,1,0
0,0,0,0,0,0,0,0,0
131064,858,5,186,156,30,2,1,0
856384,3890,7,596,582,14,12,1,0
23277,134,4,17,16,1,0,1,0
0,0,0,0,0,0,0,0,0
329146,1576,13,106,70,36,3,1,0
363144,197,3,3,3,0,0,0,0
82493,321,7,33,18,15,1,1,0
0,0,0,0,0,0,0,0,0
0,0,0,0,0,0,0,0,0
0,0,0,0,0,0,0,0,0
0,0,0,0,0,0,0,0,0
9074,176,3,53,50,3,1,1,0
0,0,0,0,0,0,0,0,0
313950,2503,7,532,359,173,22,1,0
205782,1392,12,175,146,29,23,1,0
250355,747,0,89,80,9,0,1,0
0,0,0,0,0,0,0,0,0
0,0,0,0,0,0,0,0,0
0,0,0,0,0,0,0,0,0
28065,42,0,2,1,1,0,0,0
295485,1732,6,339,321,18,8,0,0
195525,711,5,158,143,15,6,0,0
85476,840,9,126,126,0,0,1,0
25888,189,9,24,24,0,0,1,0
0,0,0,0,0,0,0,0,0
1359,29,0,2,0,2,0,0,0
0,0,0,0,0,0,0,0,0
784675,5364,5,841,494,347,3,1,0
0,0,0,0,0,0,0,0,0
0,0,0,0,0,0,0,0,0
0,0,0,0,0,0,0,0,0
1317197,16032,9,1196,1184,12,403,1,0
327869,2207,9,384,372,12,3,1,0
0,0,0,0,0,0,0,0,0
1436391,4444,1,556,555,1,1,0,0
1435395,4445,1,556,554,2,1,0,0
0,0,0,0,0,0,0,0,0
121676,790,7,34,4,30,42,1,0
0,0,0,0,0,0,0,0,0
165884,603,5,61,49,12,3,1,0
696448,1937,17,298,288,10,3,1,0
0,0,0,0,0,0,0,0,0
0,0,0,0,0,0,0,0,0
221302,575,4,123,123,0,7,1,0
0,0,0,0,0,0,0,0,0
109700,1093,11,187,180,7,2,1,0
26461,206,9,10,10,0,3,0,0
0,0,0,0,0,0,0,0,0
311684,980,0,59,56,3,4,1,0
0,0,0,0,0,0,0,0,0
122895,597,13,86,82,4,9,0,0
59882,386,3,73,60,13,0,1,0
127937,884,14,179,158,21,2,1,0
43212,673,7,134,130,4,3,1,0
57887,540,11,103,96,7,1,1,0
1754441,5755,9,515,508,7,8,1,0
44478,163,1,33,20,13,7,1,0
0,0,0,0,0,0,0,0,0
632038,5611,9,321,288,33,45,0,0
106360,851,5,131,121,10,1,1,0
0,0,0,0,0,0,0,0,0
0,0,0,0,0,0,0,0,0
47402,490,4,60,34,26,2,0,0
78833,1448,4,289,284,5,0,1,0
0,0,0,0,0,0,0,0,0
228834,1305,4,186,174,12,0,1,0
0,0,0,0,0,0,0,0,0
0,0,0,0,0,0,0,0,0
74775,1245,2,315,284,31,0,1,0
125785,602,4,128,124,4,2,1,0
1034016,1172,8,156,141,15,10,1,0
917994,553,8,95,90,5,10,1,0
0,0,0,0,0,0,0,0,0
0,0,0,0,0,0,0,0,0
0,0,0,0,0,0,0,0,0
7927,85,3,11,9,2,0,1,0
6947,69,4,10,8,2,0,1,0
0,0,0,0,0,0,0,0,0
0,0,0,0,0,0,0,0,0
0,0,0,0,0,0,0,0,0
0,0,0,0,0,0,0,0,0
0,0,0,0,0,0,0,0,0
83568,425,14,96,87,9,3,1,0
22931,412,3,99,73,26,1,1,0
490625,997,9,119,104,15,8,1,0
494848,3105,8,893,883,10,13,1,0
71576,838,6,266,263,3,12,1,0
253731,965,9,121,115,6,10,1,0
56297,491,13,57,54,3,3,0,0
222213,2344,13,349,288,61,68,1,0
439077,3687,11,548,545,3,65,1,0
155450,1292,10,260,257,3,65,1,0
126040,844,6,79,79,0,2,1,0
0,0,0,0,0,0,0,0,0
0,0,0,0,0,0,0,0,0
0,0,0,0,0,0,0,0,0
0,0,0,0,0,0,0,0,0
0,0,0,0,0,0,0,0,0
166724,1108,10,93,87,6,4,0,0
0,0,0,0,0,0,0,0,0
0,0,0,0,0,0,0,0,0
798992,3714,15,293,269,24,47,1,0
0,0,0,0,0,0,0,0,0
65540,440,11,40,39,1,3,1,0
0,0,0,0,0,0,0,0,0
26371,376,2,103,57,46,2,1,0
37568,835,1,109,109,0,0,1,0
4046,84,0,16,16,0,3,1,0
154800,1709,10,562,535,27,1,1,0
159321,1050,9,181,114,67,1,0,0
90672,1021,7,256,243,13,12,1,0
1334643,5041,22,166,129,37,15,1,0
24407,37,0,2,1,1,0,1,0
0,0,0,0,0,0,0,0,0
60354,749,8,99,76,23,1,1,0
13349,88,0,23,22,1,0,1,0
92430,1041,2,60,33,27,2,1,0
77545,880,4,167,157,10,8,0,0
973711,3830,3,514,507,7,9,1,0
359001,1141,13,190,158,32,8,0,0
131796,637,6,122,110,12,4,1,0
112005,366,8,72,61,11,4,1,0
211116,1468,4,25,22,3,21,0,0
3310,29,1,1,1,0,0,0,0
0,0,0,0,0,0,0,0,0
430425,2325,7,403,361,42,2,1,0
744933,706,4,100,45,55,7,1,0
0,0,0,0,0,0,0,0,0
223789,869,3,111,103,8,35,0,0
173438,573,3,58,50,8,29,0,0
623104,3364,6,90,55,35,6,0,0
0,0,0,0,0,0,0,0,0
338043,851,2,141,70,71,7,1,0
85841,1802,3,373,364,9,1,0,0
19583,213,3,106,103,3,1,0,0
98716,266,3,42,42,0,0,1,0
0,0,0,0,0,0,0,0,0
282237,2225,10,369,358,11,12,1,0
116950,1507,9,300,292,8,5,1,0
73348,669,3,148,147,1,17,1,0
288090,2595,8,401,378,23,4,1,0
24408,178,2,12,5,7,3,0,0
1137185,2441,14,249,245,4,31,1,0
668772,1323,13,149,146,3,18,1,0
0,0,0,0,0,0,0,0,0
0,0,0,0,0,0,0,0,0
378600,1397,3,118,112,6,0,1,0
434552,872,17,86,8,78,2,1,0
86298,755,12,207,186,21,0,1,0
0,0,0,0,0,0,0,0,0
402523,2685,6,710,700,10,14,1,0
425461,759,11,138,113,25,7,1,0
18385,310,3,102,102,0,0,1,0
46023,489,11,80,72,8,5,0,0
0,0,0,0,0,0,0,0,0
0,0,0,0,0,0,0,0,0
225647,2289,7,343,333,10,5,1,1
141101,2064,1,336,336,0,10,1,0
112074,460,10,75,67,8,5,1,0
255073,757,3,44,22,22,21,1,0
24472,100,7,3,3,0,4,0,0
36812,487,5,39,36,3,2,1,0
22747,273,5,50,9,41,7,1,0
284182,1664,7,449,440,9,7,1,0
246061,1389,5,392,380,12,8,1,0
101090,1427,3,455,445,10,4,1,0
58920,484,13,91,59,32,2,1,0
187979,2230,10,454,409,45,6,1,0
155206,1895,10,385,372,13,5,1,0
15589,314,6,11,11,0,1,0,0
56593,231,6,12,2,10,0,1,0
42819,523,3,133,101,32,1,1,1
68411,1441,2,116,116,0,0,1,0
268720,2189,3,354,327,27,0,1,0
0,0,0,0,0,0,0,0,0
146407,1715,5,316,309,7,0,1,0
43517,547,5,111,104,7,0,1,0
203171,1456,5,293,254,39,5,1,0
0,0,0,0,0,0,0,0,0
153866,945,13,193,193,0,10,1,0
155045,342,18,56,56,0,3,1,0
311009,2031,14,383,375,8,5,1,0
38057,464,3,78,72,6,0,0,0
1256222,1998,4,746,731,15,2,0,0
1246438,1781,3,735,726,9,1,0,0
131963,2086,9,366,108,258,9,0,0
19786,299,7,27,11,16,6,1,0
176897,1301,5,210,200,10,38,1,0
22017,33,0,1,1,0,0,1,0
0,0,0,0,0,0,0,0,0
180068,1027,4,104,97,7,12,1,0
33876,438,3,72,57,15,2,1,0
818018,3942,14,506,492,14,7,1,0
314554,2575,3,527,520,7,23,0,0
51651,478,0,137,137,0,0,1,0
0,0,0,0,0,0,0,0,0
3285543,3052,6,158,144,14,1,1,0
2767165,181,6,4,4,0,1,1,0
22141,35,0,1,1,0,0,1,0
108034,445,6,81,73,8,8,0,0
33665,140,4,11,6,5,0,0,0
65618,427,5,103,3,100,4,1,0
205422,1211,12,230,214,16,25,1,0
189768,1506,10,92,72,20,32,1,0
341810,4873,2,322,286,36,29,0,0
0,0,0,0,0,0,0,0,0
5507,57,4,2,1,1,0,0,0
0,0,0,0,0,0,0,0,0
0,0,0,0,0,0,0,0,0
436483,2091,14,294,286,8,7,1,0
436200,2086,14,294,286,8,7,1,0
231255,1808,4,226,190,36,14,1,0
1091697,4983,9,318,310,8,29,1,0
241267,875,16,56,44,12,1,1,0
0,0,0,0,0,0,0,0,0
372996,2842,5,246,225,21,35,1,0
8070,90,2,12,9,3,0,0,0
77243,1045,10,287,267,20,0,1,0
28444,42,0,2,1,1,0,0,0
0,0,0,0,0,0,0,0,0
96498,975,14,191,181,10,2,0,0
0,0,0,0,0,0,0,0,0
460515,1286,11,87,15,72,7,1,0
0,0,0,0,0,0,0,0,0
6411,138,2,31,28,3,0,1,0
0,0,0,0,0,0,0,0,0
126566,527,7,68,1,67,5,1,0
1632875,14109,5,159,149,10,3,1,0
825488,1594,7,219,175,44,2,1,1
7023,36,0,5,0,5,0,1,0
0,0,0,0,0,0,0,0,0
0,0,0,0,0,0,0,0,0
0,0,0,0,0,0,0,0,0
187003,606,11,90,31,59,15,1,0
63777,27,1,1,0,1,2,0,0
12002,96,2,9,2,7,0,1,0
10280,91,2,9,3,6,0,1,0
0,0,0,0,0,0,0,0,0
0,0,0,0,0,0,0,0,0
0,0,0,0,0,0,0,0,0
0,0,0,0,0,0,0,0,0
0,0,0,0,0,0,0,0,0
171030,769,9,46,43,3,28,1,0
83629,682,6,114,108,6,3,1,0
89100,864,1,229,223,6,7,0,0
107317,1736,4,756,739,17,17,0,0
0,0,0,0,0,0,0,0,0
171321,1531,16,372,368,4,7,1,0
0,0,0,0,0,0,0,0,0
0,0,0,0,0,0,0,0,0
144021,2876,5,1225,1202,23,4,1,0
0,0,0,0,0,0,0,0,0
91920,1056,5,185,177,8,7,1,0
0,0,0,0,0,0,0,0,0
0,0,0,0,0,0,0,0,0
0,0,0,0,0,0,0,0,0
0,0,0,0,0,0,0,0,0
256047,4264,6,1095,1006,89,26,1,0
40403,428,6,100,91,9,5,1,0
0,0,0,0,0,0,0,0,0
0,0,0,0,0,0,0,0,0
0,0,0,0,0,0,0,0,0
0,0,0,0,0,0,0,0,0
39514,299,1,89,89,0,7,1,0
0,0,0,0,0,0,0,0,0
77444,674,9,108,103,5,5,1,0
129613,292,8,26,15,11,16,1,0
63417,67,2,1,1,0,1,0,0
0,0,0,0,0,0,0,0,0
0,0,0,0,0,0,0,0,0
0,0,0,0,0,0,0,0,0
20485,137,2,26,25,1,13,1,0
0,0,0,0,0,0,0,0,0
0,0,0,0,0,0,0,0,0
22000,33,0,1,1,0,0,1,0
0,0,0,0,0,0,0,0,0
84995,1129,1,73,62,11,1,0,0
0,0,0,0,0,0,0,0,0
0,0,0,0,0,0,0,0,0
302194,1641,15,286,243,43,32,1,0
240002,1875,7,331,298,33,12,1,0
280003,2921,12,648,627,21,32,1,0
88864,1317,6,199,179,20,14,1,0
14394,108,3,12,7,5,0,0,0
78052,840,5,127,126,1,3,0,0
36205,204,5,4,4,0,0,1,0
95505,901,7,140,123,17,14,1,0
50982,672,2,173,171,2,4,1,0
0,0,0,0,0,0,0,0,0
0,0,0,0,0,0,0,0,0
0,0,0,0,0,0,0,0,0
0,0,0,0,0,0,0,0,0
217044,1382,6,320,302,18,3,0,0
8651,68,5,3,3,0,0,1,0
0,0,0,0,0,0,0,0,0
14882,233,5,23,21,2,0,1,0
121494,658,9,125,119,6,18,1,0
129557,679,10,66,42,24,1,1,0
70788,1153,7,482,473,9,6,1,0
105592,881,9,134,129,5,0,1,0
0,0,0,0,0,0,0,0,0
0,0,0,0,0,0,0,0,0
0,0,0,0,0,0,0,0,0
3925,46,4,5,4,1,0,0,0
188908,1636,12,188,186,2,22,1,0
113867,1201,0,296,267,29,0,0,0
0,0,0,0,0,0,0,0,0
68580,949,8,180,172,8,4,0,0
0,0,0,0,0,0,0,0,0
41529,134,4,16,15,1,7,0,0
7712,85,0,23,23,0,0,1,0
44034,384,7,55,19,36,0,1,0
192009,983,8,191,188,3,54,1,0
0,0,0,0,0,0,0,0,0
0,0,0,0,0,0,0,0,0
0,0,0,0,0,0,0,0,0
355123,1711,14,441,417,24,18,0,0
317281,1991,9,261,253,8,15,1,0
0,0,0,0,0,0,0,0,0
55125,399,12,63,59,4,1,1,0
0,0,0,0,0,0,0,0,0
132940,1034,5,97,95,2,3,1,0
191293,414,10,43,39,4,7,1,0
0,0,0,0,0,0,0,0,0
0,0,0,0,0,0,0,0,0
114396,723,5,96,93,3,3,1,0
28119,42,0,2,1,1,0,0,0
0,0,0,0,0,0,0,0,0
26504,311,1,35,35,0,0,0,0
0,0,0,0,0,0,0,0,0
269960,1473,14,204,203,1,27,1,0
0,0,0,0,0,0,0,0,0
0,0,0,0,0,0,0,0,0
564129,5268,16,1021,967,54,137,1,0
405474,4558,15,957,914,43,22,1,0
0,0,0,0,0,0,0,0,0
187756,897,7,137,93,44,19,1,1
0,0,0,0,0,0,0,0,0
0,0,0,0,0,0,0,0,0
0,0,0,0,0,0,0,0,0
139093,1543,2,141,132,9,16,1,0
176133,1739,5,422,387,35,0,0,0
31269,143,5,10,8,2,0,0,0
27795,271,7,57,54,3,2,1,0
0,0,0,0,0,0,0,0,0
0,0,0,0,0,0,0,0,0
33553,408,3,94,72,22,16,0,0
0,0,0,0,0,0,0,0,0
230423,2076,4,278,258,20,7,1,0
575012,2226,0,475,11,464,0,0,0
21915,104,9,10,7,3,2,0,0
0,0,0,0,0,0,0,0,0
0,0,0,0,0,0,0,0,0
47543,857,4,173,170,3,9,1,0
7676,52,0,6,1,5,0,0,0
262039,2051,8,318,46,272,0,1,0
27897,42,0,2,1,1,0,0,0
187169,3142,5,1058,1057,1,1,1,0
29984,553,5,168,167,1,1,1,0
735347,5066,5,465,456,9,31,0,0
0,0,0,0,0,0,0,0,0
322772,1832,6,356,287,69,8,1,0
0,0,0,0,0,0,0,0,0
40255,286,6,54,0,54,0,0,0
0,0,0,0,0,0,0,0,0
108780,916,10,158,150,8,8,1,0
0,0,0,0,0,0,0,0,0
376799,1906,13,347,308,39,2,1,0
315736,1306,13,221,207,14,2,1,0
40464,243,5,25,24,1,9,0,0
0,0,0,0,0,0,0,0,0
0,0,0,0,0,0,0,0,0
92921,699,6,116,91,25,3,1,0
0,0,0,0,0,0,0,0,0
0,0,0,0,0,0,0,0,0
411766,2372,6,120,113,7,7,1,0
0,0,0,0,0,0,0,0,0
148264,1245,4,163,59,104,1,0,0
80091,774,2,91,79,12,19,1,0
39443,322,2,80,71,9,10,1,0
0,0,0,0,0,0,0,0,0
0,0,0,0,0,0,0,0,0
0,0,0,0,0,0,0,0,0
0,0,0,0,0,0,0,0,0
0,0,0,0,0,0,0,0,0
108636,687,8,208,177,31,0,1,0
155799,1388,9,305,289,16,7,1,0
0,0,0,0,0,0,0,0,0
163896,1233,7,343,331,12,8,1,0
12631,73,1,4,3,1,0,0,0
29842,290,3,22,22,0,3,1,0
5271,77,2,13,13,0,0,1,0
0,0,0,0,0,0,0,0,0
48266,438,9,73,70,3,0,1,0
275358,2449,10,293,239,54,5,1,0
0,0,0,0,0,0,0,0,0
609999,2537,16,316,9,307,5,1,0
0,0,0,0,0,0,0,0,0
270573,2110,9,452,446,6,5,1,0
0,0,0,0,0,0,0,0,0
226344,818,8,64,60,4,1,0,0
0,0,0,0,0,0,0,0,0
0,0,0,0,0,0,0,0,0
0,0,0,0,0,0,0,0,0
128203,529,7,137,58,79,1,0,1
0,0,0,0,0,0,0,0,0
1636,11,0,1,1,0,0,0,0
0,0,0,0,0,0,0,0,0
247086,1855,11,514,513,1,17,1,0
37062,341,7,50,50,0,7,1,0
82040,903,8,86,74,12,3,1,0
0,0,0,0,0,0,0,0,0
0,0,0,0,0,0,0,0,0
0,0,0,0,0,0,0,0,0
152502,2617,1,570,560,10,0,0,0
0,0,0,0,0,0,0,0,0
453208,1529,9,316,299,17,4,1,0
89409,1159,3,95,68,27,0,1,0
129918,738,15,123,109,14,1,0,0
0,0,0,0,0,0,0,0,0
188003,1320,3,240,239,1,2,1,0
0,0,0,0,0,0,0,0,0
0,0,0,0,0,0,0,0,0
327590,1205,11,73,59,14,17,1,0
301745,1075,6,179,3,176,6,1,0
0,0,0,0,0,0,0,0,0
0,0,0,0,0,0,0,0,0
0,0,0,0,0,0,0,0,0
824184,79,9,8,8,0,0,1,0
0,0,0,0,0,0,0,0,0
0,0,0,0,0,0,0,0,0
0,0,0,0,0,0,0,0,0
0,0,0,0,0,0,0,0,0
27908,486,3,35,34,1,0,1,0
162093,942,8,258,257,1,0,1,0
132077,1367,2,262,253,9,1,1,0
45743,486,2,116,105,11,1,1,0
66746,534,7,14,12,2,0,1,0
3399,48,0,3,3,0,0,0,0
19921,105,4,14,0,14,0,1,0
0,0,0,0,0,0,0,0,0
0,0,0,0,0,0,0,0,0
88551,848,4,258,258,0,6,0,0
0,0,0,0,0,0,0,0,0
396970,4247,8,421,334,87,10,1,0
85772,554,6,135,134,1,3,0,0
541997,1783,1,272,144,128,13,1,0
81420,112,1,10,7,3,2,0,0
0,0,0,0,0,0,0,0,0
0,0,0,0,0,0,0,0,0
65485,1425,2,358,348,10,1,1,0
34690,430,0,0,0,0,1,1,0
0,0,0,0,0,0,0,0,0
44217,511,4,45,27,18,0,1,0
8444,120,6,22,17,5,1,1,0
0,0,0,0,0,0,0,0,0
39047,352,3,48,45,3,13,1,0
23692,265,2,66,60,6,3,1,0
12695,174,2,30,27,3,3,1,0
35774,438,3,71,63,8,0,1,0
165577,2299,10,217,182,35,15,0,0
0,0,0,0,0,0,0,0,0
470398,1284,6,109,102,7,3,1,0
0,0,0,0,0,0,0,0,0
0,0,0,0,0,0,0,0,0
0,0,0,0,0,0,0,0,0
645620,4711,14,161,66,95,4,1,0
22869,37,0,2,1,1,0,1,0
0,0,0,0,0,0,0,0,0
0,0,0,0,0,0,0,0,0
407033,1647,7,200,188,12,5,1,0
288407,1383,7,159,147,12,4,1,0
619304,7263,5,427,289,138,48,1,0
526163,1561,7,166,157,9,20,1,0
0,0,0,0,0,0,0,0,0
0,0,0,0,0,0,0,0,0
420,6,0,0,0,0,0,0,0
180208,1070,9,201,191,10,3,1,0
75196,105,2,5,1,4,2,1,0
44989,151,6,11,9,2,0,1,0
657562,3935,6,265,235,30,57,0,0
0,0,0,0,0,0,0,0,0
106070,995,4,178,173,5,16,1,0
289747,1797,11,151,128,23,37,1,0
2898,44,1,2,2,0,0,0,0
88962,835,8,184,181,3,2,0,0
0,0,0,0,0,0,0,0,0
0,0,0,0,0,0,0,0,0
57806,494,1,77,68,9,0,1,0
210572,1371,11,54,47,7,9,1,0
87713,422,10,33,28,5,9,1,0
0,0,0,0,0,0,0,0,0
113448,720,6,101,50,51,10,1,0
353632,573,9,146,112,34,5,1,0
0,0,0,0,0,0,0,0,0
0,0,0,0,0,0,0,0,0
329722,2130,4,195,159,36,5,1,0
81212,522,7,4,4,0,5,0,0
272186,1378,15,72,63,9,3,1,0
109143,910,5,191,177,14,3,0,0
0,0,0,0,0,0,0,0,0
215111,1409,8,160,157,3,15,1,0
121536,1380,5,249,239,10,0,1,0
88118,829,5,161,159,2,0,1,0
0,0,0,0,0,0,0,0,0
0,0,0,0,0,0,0,0,0
78601,828,7,125,110,15,6,1,0
0,0,0,0,0,0,0,0,0
0,0,0,0,0,0,0,0,0
470200,2291,3,282,274,8,2,1,0
0,0,0,0,0,0,0,0,0
0,0,0,0,0,0,0,0,0
66527,64,4,5,3,2,0,1,0
184527,521,9,62,58,4,10,1,0
17447,98,7,7,6,1,0,0,0
0,0,0,0,0,0,0,0,0
150186,2257,4,1382,410,972,6,1,0
62566,633,5,23,15,8,0,1,0
0,0,0,0,0,0,0,0,0
61291,601,5,65,44,21,6,0,0
69634,381,2,2,2,0,0,0,0
66287,403,2,117,114,3,8,1,0
44722,168,2,44,41,3,8,1,0
0,0,0,0,0,0,0,0,0
0,0,0,0,0,0,0,0,0
0,0,0,0,0,0,0,0,0
0,0,0,0,0,0,0,0,0
0,0,0,0,0,0,0,0,0
0,0,0,0,0,0,0,0,0
52920,679,7,153,130,23,7,1,0
31579,205,3,8,8,0,0,0,0
63414,488,6,111,103,8,0,0,0
11267,101,6,5,5,0,0,0,0
0,0,0,0,0,0,0,0,0
0,0,0,0,0,0,0,0,0
0,0,0,0,0,0,0,0,0
0,0,0,0,0,0,0,0,0
98098,839,9,67,66,1,8,1,0
0,0,0,0,0,0,0,0,0
207578,1178,9,214,206,8,1,1,0
207580,1178,9,214,206,8,1,1,0
64667,1274,4,152,133,19,9,1,0
0,0,0,0,0,0,0,0,0
119416,614,3,118,118,0,11,0,0
94249,278,3,40,40,0,10,0,0
412684,3602,11,560,465,95,66,1,0
54631,470,3,61,57,4,11,0,0
21682,344,7,28,26,2,0,1,0
0,0,0,0,0,0,0,0,0
0,0,0,0,0,0,0,0,0
0,0,0,0,0,0,0,0,0
181625,2157,11,198,137,61,2,1,0
0,0,0,0,0,0,0,0,0
0,0,0,0,0,0,0,0,0
0,0,0,0,0,0,0,0,0
0,0,0,0,0,0,0,0,0
0,0,0,0,0,0,0,0,0
180146,1471,7,308,304,4,10,1,0
0,0,0,0,0,0,0,0,0
141536,425,9,79,56,23,0,1,0
863948,2457,0,194,186,8,2,1,0
295385,354,0,17,13,4,2,1,0
154745,611,6,92,91,1,0,1,0
0,0,0,0,0,0,0,0,0
0,0,0,0,0,0,0,0,0
76095,577,8,135,135,0,7,1,0
285126,478,5,81,65,16,0,1,0
0,0,0,0,0,0,0,0,0
0,0,0,0,0,0,0,0,0
173635,916,11,109,87,22,6,0,0
165902,2305,7,704,693,11,5,1,0
110242,1687,7,505,494,11,5,1,0
269243,2926,7,643,637,6,2,1,1
135849,1107,9,238,232,6,2,1,0
27992,42,0,2,1,1,0,0,0
0,0,0,0,0,0,0,0,0
0,0,0,0,0,0,0,0,0
0,0,0,0,0,0,0,0,0
24058,128,0,22,6,16,0,0,0
73706,1928,2,568,568,0,1,1,0
594340,3545,7,218,190,28,3,1,0
398902,970,5,247,237,10,12,1,0
406460,1893,6,193,176,17,30,1,0
286625,762,11,53,38,15,8,1,0
238215,2909,5,318,316,2,34,1,0
79361,574,4,80,78,2,36,1,0
0,0,0,0,0,0,0,0,0
19162,256,1,55,39,16,0,0,0
84085,339,8,66,58,8,1,1,0
0,0,0,0,0,0,0,0,0
160614,832,10,119,105,14,4,1,0
61884,657,4,98,93,5,10,1,0
210326,1454,13,230,214,16,13,1,0
0,0,0,0,0,0,0,0,0
32287,324,3,79,78,1,4,0,0
342364,518,1,53,52,1,0,0,0
32381,321,5,46,38,8,3,1,0
0,0,0,0,0,0,0,0,0
0,0,0,0,0,0,0,0,0
585580,3843,11,339,315,24,15,1,0
12973,193,1,21,10,11,0,0,0
0,0,0,0,0,0,0,0,0
0,0,0,0,0,0,0,0,0
0,0,0,0,0,0,0,0,0
0,0,0,0,0,0,0,0,0
0,0,0,0,0,0,0,0,0
63318,590,1,80,51,29,8,1,0
25943,314,1,66,60,6,5,1,0
275583,1356,8,278,205,73,9,0,0
368563,1858,9,294,287,7,2,1,0
0,0,0,0,0,0,0,0,0
0,0,0,0,0,0,0,0,0
27876,42,0,2,1,1,0,0,0
40502,614,4,174,169,5,1,1,0
38065,418,1,63,63,0,7,1,0
0,0,0,0,0,0,0,0,0
144017,312,3,34,28,6,1,1,0
765057,333,1,40,24,16,1,1,0
17863,273,2,55,43,12,4,0,0
22896,37,0,2,1,1,0,1,0
112931,1002,1,81,80,1,0,1,0
112856,431,8,179,170,9,1,0,0
120564,386,7,181,173,8,4,0,0
109226,964,1,73,49,24,0,0,0
537897,1679,1,268,257,11,1,1,0
137702,1306,5,240,154,86,3,1,0
230176,869,9,81,10,71,10,1,0
422086,1406,7,218,209,9,9,1,0
0,0,0,0,0,0,0,0,0
39978,563,2,112,109,3,4,0,0
22215,340,2,87,84,3,1,0,0
0,0,0,0,0,0,0,0,0
259466,1467,9,267,251,16,7,0,0
222974,1094,9,235,225,10,2,0,0
27717,150,7,15,10,5,1,1,0
29176,144,7,14,9,5,1,1,0
76927,505,8,46,44,2,2,0,0
392680,1087,9,27,27,0,25,1,0
0,0,0,0,0,0,0,0,0
0,0,0,0,0,0,0,0,0
0,0,0,0,0,0,0,0,0
282014,614,10,101,98,3,13,1,0
0,0,0,0,0,0,0,0,0
0,0,0,0,0,0,0,0,0
0,0,0,0,0,0,0,0,0
0,0,0,0,0,0,0,0,0
179859,1188,10,174,165,9,25,1,0
260135,4266,1,1580,1512,68,2,1,0
19484,152,1,26,26,0,2,1,0
78018,254,3,36,16,20,0,1,0
35552,118,6,12,10,2,0,0,0
0,0,0,0,0,0,0,0,0
40594,303,2,57,9,48,1,1,0
0,0,0,0,0,0,0,0,0
30159,544,3,112,105,7,1,1,0
139924,998,3,227,49,178,1,0,0
8440,186,1,25,24,1,2,1,0
0,0,0,0,0,0,0,0,0
0,0,0,0,0,0,0,0,0
0,0,0,0,0,0,0,0,0
93494,706,3,106,94,12,12,1,0
41655,417,6,39,39,0,3,0,0
124302,2585,4,298,297,1,0,1,0
0,0,0,0,0,0,0,0,0
0,0,0,0,0,0,0,0,0
0,0,0,0,0,0,0,0,0
125727,723,7,106,101,5,8,0,0
117902,979,12,203,181,22,13,1,0
5948,145,1,7,7,0,0,0,0
0,0,0,0,0,0,0,0,0
0,0,0,0,0,0,0,0,0
0,0,0,0,0,0,0,0,0
1105975,604,8,49,38,11,2,1,0
14403,99,5,6,4,2,0,1,0
305174,3754,3,282,263,19,10,0,0
123931,786,7,160,99,61,7,1,0
152106,965,11,263,254,9,14,1,0
0,0,0,0,0,0,0,0,0
229583,1607,11,232,211,21,2,1,0
269951,3682,1,1028,901,127,129,1,0
44871,624,3,94,87,7,11,1,0
998230,1667,8,357,305,52,25,1,0
892254,243,8,13,10,3,5,1,0
143685,1972,4,472,448,24,7,1,0
42822,953,2,355,336,19,0,1,0
768895,6209,6,1295,1251,44,6,0,0
783251,2378,10,511,451,60,28,1,0
365214,2050,7,156,143,13,9,1,0
110821,789,5,115,115,0,0,1,0
109915,1326,6,369,356,13,9,1,0
163768,919,14,64,60,4,3,0,0
8630,63,0,1,1,0,0,1,0
0,0,0,0,0,0,0,0,0
115043,683,7,156,153,3,16,1,0
0,0,0,0,0,0,0,0,0
208432,560,4,51,51,0,1,1,0
67745,885,4,139,114,25,20,1,0
67291,739,5,34,15,19,0,1,0
172268,751,7,173,96,77,14,1,0
308978,1978,6,471,459,12,3,1,0
217998,1342,6,193,181,12,5,1,0
159920,791,5,138,133,5,5,1,0
61040,854,4,202,194,8,1,1,0
170796,1405,2,207,204,3,20,1,0
0,0,0,0,0,0,0,0,0
0,0,0,0,0,0,0,0,0
211563,2687,10,492,474,18,12,1,0
0,0,0,0,0,0,0,0,0
0,0,0,0,0,0,0,0,0
242532,1524,7,115,101,14,0,1,0
600453,202,4,15,14,1,1,1,0
0,0,0,0,0,0,0,0,0
199758,535,4,52,45,7,0,1,0
210514,176,3,6,6,0,0,1,0
1408315,693,10,93,63,30,7,1,0
149238,943,8,104,103,1,2,1,0
0,0,0,0,0,0,0,0,0
0,0,0,0,0,0,0,0,0
0,0,0,0,0,0,0,0,0
52103,722,0,69,48,21,0,1,0
0,0,0,0,0,0,0,0,0
1224596,12351,14,296,277,19,7,0,0
526662,1593,4,242,149,93,13,1,0
80975,112,1,10,7,3,2,0,0
0,0,0,0,0,0,0,0,0
0,0,0,0,0,0,0,0,0
13905,211,3,15,13,2,0,1,0
0,0,0,0,0,0,0,0,0
279889,1586,5,81,70,11,5,1,0
429601,1418,9,123,116,7,1,1,0
0,0,0,0,0,0,0,0,0
0,0,0,0,0,0,0,0,0
0,0,0,0,0,0,0,0,0
0,0,0,0,0,0,0,0,0
0,0,0,0,0,0,0,0,0
0,0,0,0,0,0,0,0,0
0,0,0,0,0,0,0,0,0
53714,488,9,109,106,3,0,1,0
128126,2157,4,602,602,0,1,1,0
80991,1245,4,296,296,0,1,1,0
47973,788,4,178,178,0,0,1,0
268602,1059,25,135,120,15,10,1,0
202636,505,9,99,93,6,8,1,0
0,0,0,0,0,0,0,0,0
88838,64,0,8,3,5,6,0,0
20430,134,1,15,14,1,7,0,0
71939,572,16,84,51,33,1,1,0
0,0,0,0,0,0,0,0,0
0,0,0,0,0,0,0,0,0
0,0,0,0,0,0,0,0,0
322116,2244,4,176,172,4,0,1,0
208462,1038,1,153,148,5,0,1,0
102976,1268,5,163,155,8,3,1,0
0,0,0,0,0,0,0,0,0
0,0,0,0,0,0,0,0,0
11747,117,4,16,16,0,1,0,0
154897,1802,7,316,273,43,4,1,0
0,0,0,0,0,0,0,0,0
304058,978,6,90,53,37,9,1,0
0,0,0,0,0,0,0,0,0
30806,449,4,121,117,4,0,1,0
9418,81,2,7,6,1,0,1,0
0,0,0,0,0,0,0,0,0
0,0,0,0,0,0,0,0,0
218875,876,2,84,50,34,1,1,0
0,0,0,0,0,0,0,0,0
5152,125,1,13,11,2,0,1,0
725263,2474,11,261,248,13,21,1,0
74109,797,7,139,117,22,2,1,0
242207,1006,18,171,153,18,14,1,0
45468,350,6,64,27,37,5,1,0
87716,915,6,130,119,11,3,1,0
249656,2758,6,615,550,65,45,1,0
5397,90,1,17,15,2,0,1,0
52819,682,2,105,99,6,2,1,0
0,0,0,0,0,0,0,0,0
40680,486,3,86,53,33,0,1,0
206691,426,5,32,10,22,0,1,0
0,0,0,0,0,0,0,0,0
44781,385,7,55,19,36,0,1,0
108692,482,7,77,72,5,1,1,0
35896,532,4,163,154,9,17,1,0
0,0,0,0,0,0,0,0,0
9276,147,1,24,22,2,0,0,0
0,0,0,0,0,0,0,0,0
464216,2005,11,639,633,6,15,1,0
528728,1110,10,194,187,7,12,1,0
0,0,0,0,0,0,0,0,0
155009,1369,9,200,27,173,7,1,0
32120,194,7,9,7,2,4,1,0
20325,393,2,155,155,0,0,0,0
720552,2384,6,489,455,34,19,1,0
310908,535,6,85,69,16,13,1,0
0,0,0,0,0,0,0,0,0
163139,376,6,5,5,0,7,0,0
206109,1571,4,200,197,3,0,1,0
0,0,0,0,0,0,0,0,0
0,0,0,0,0,0,0,0,0
61078,458,3,102,97,5,8,1,0
25567,318,2,60,59,1,10,1,0
197816,1888,10,287,209,78,12,1,0
0,0,0,0,0,0,0,0,0
543502,1774,1,271,190,81,11,1,0
80594,112,1,10,5,5,2,0,0
117808,352,3,35,35,0,0,0,0
0,0,0,0,0,0,0,0,0
0,0,0,0,0,0,0,0,0
0,0,0,0,0,0,0,0,0
0,0,0,0,0,0,0,0,0
196264,203,5,12,11,1,2,1,1
1185848,3145,8,387,129,258,42,1,0
0,0,0,0,0,0,0,0,0
259790,386,6,10,6,4,0,1,0
227527,2517,11,120,106,14,1,0,0
37118,641,4,130,130,0,0,1,0
0,0,0,0,0,0,0,0,0
653230,4648,10,188,178,10,14,1,0
350090,1068,6,59,33,26,0,0,0
321195,1293,10,121,109,12,33,1,0
8905,104,4,9,6,3,1,1,0
0,0,0,0,0,0,0,0,0
0,0,0,0,0,0,0,0,0
465477,2758,13,437,390,47,4,0,0
24222,338,5,36,24,12,12,1,0
195125,1508,0,438,422,16,10,1,0
220097,1101,3,180,3,177,5,1,0
215141,1054,3,180,149,31,5,1,0
0,0,0,0,0,0,0,0,0
31202,391,10,27,26,1,1,1,0
2511,41,4,2,2,0,0,0,0
60555,587,9,120,111,9,3,1,0
59239,628,6,122,120,2,14,1,0
0,0,0,0,0,0,0,0,0
118715,1845,8,113,111,2,5,1,0
1722,26,0,0,0,0,0,0,0
0,0,0,0,0,0,0,0,0
386469,2276,9,147,134,13,61,1,0
55029,449,7,7,4,3,16,1,0
0,0,0,0,0,0,0,0,0
0,0,0,0,0,0,0,0,0
408153,2137,10,285,273,12,17,1,0
410381,2141,10,285,273,12,17,1,0
556566,572,10,82,57,25,11,1,0
0,0,0,0,0,0,0,0,0
23707,447,4,32,23,9,2,1,0
3399,53,1,4,4,0,0,0,0
47112,410,4,60,24,36,1,0,0
581041,2154,3,152,109,43,3,1,0
148218,2215,7,323,313,10,48,1,0
0,0,0,0,0,0,0,0,0
0,0,0,0,0,0,0,0,0
27568,147,4,23,22,1,1,1,0
0,0,0,0,0,0,0,0,0
184678,952,6,80,59,21,5,1,0
68144,855,5,163,153,10,2,0,0
19044,54,1,1,1,0,1,0,0
0,0,0,0,0,0,0,0,0
285485,2593,4,310,277,33,11,1,0
0,0,0,0,0,0,0,0,0
271650,1986,13,56,53,3,3,1,0
17700,119,7,8,8,0,4,1,0
182999,782,10,169,152,17,13,1,0
0,0,0,0,0,0,0,0,0
6034,40,0,3,1,2,0,1,0
2978,40,2,2,2,0,0,1,0
0,0,0,0,0,0,0,0,0
105386,1330,6,352,340,12,1,0,0
236772,1663,3,282,267,15,9,1,0
98974,424,3,54,44,10,6,1,0
0,0,0,0,0,0,0,0,0
0,0,0,0,0,0,0,0,0
0,0,0,0,0,0,0,0,0
0,0,0,0,0,0,0,0,0
0,0,0,0,0,0,0,0,0
31882,214,2,27,18,9,13,1,1
21867,204,2,13,10,3,4,1,1
0,0,0,0,0,0,0,0,0
4127,75,1,13,10,3,0,0,0
251973,2662,2,540,524,16,1,1,0
1118896,3735,12,488,442,46,57,1,0
104630,604,10,109,83,26,3,1,0
110757,719,10,121,98,23,3,1,0
781226,6085,18,290,276,14,31,1,0
13293,89,1,9,5,4,0,1,0
0,0,0,0,0,0,0,0,0
0,0,0,0,0,0,0,0,0
0,0,0,0,0,0,0,0,0
444826,3547,8,813,713,100,7,1,0
13126,202,3,37,27,10,3,1,0
0,0,0,0,0,0,0,0,0
106623,786,9,205,205,0,13,1,0
0,0,0,0,0,0,0,0,0
154453,2276,1,294,284,10,1,1,0
42597,419,0,58,50,8,1,1,0
0,0,0,0,0,0,0,0,0
0,0,0,0,0,0,0,0,0
0,0,0,0,0,0,0,0,0
739876,2690,4,637,630,7,2,1,0
484239,1801,1,88,81,7,4,1,0
42774,589,8,91,83,8,3,1,0
0,0,0,0,0,0,0,0,0
0,0,0,0,0,0,0,0,0
75218,1060,2,185,176,9,5,1,0
561634,3191,3,97,80,17,2,1,0
148818,562,3,71,62,9,3,1,0
38647,855,2,157,156,1,2,0,0
0,0,0,0,0,0,0,0,0
400739,1206,2,137,137,0,5,1,0
83648,763,2,199,134,65,1,0,0
28402,73,3,3,3,0,9,1,0
0,0,0,0,0,0,0,0,0
191226,1436,10,250,213,37,8,1,0
131342,1042,7,73,65,8,5,1,0
115813,392,4,4,4,0,1,0,0
0,0,0,0,0,0,0,0,0
0,0,0,0,0,0,0,0,0
220023,691,14,71,48,23,8,0,0
1096377,1757,4,162,126,36,3,1,0
131829,971,12,181,177,4,13,1,0
44304,180,0,2,0,2,0,0,0
0,0,0,0,0,0,0,0,0
0,0,0,0,0,0,0,0,0
42199,945,1,30,20,10,3,1,0
5846,100,1,19,17,2,3,1,0
2344588,1158,17,117,105,12,27,1,0
0,0,0,0,0,0,0,0,0
0,0,0,0,0,0,0,0,0
0,0,0,0,0,0,0,0,0
176042,650,4,49,46,3,6,0,0
89756,742,5,265,252,13,7,1,0
0,0,0,0,0,0,0,0,0
86104,235,5,2,1,1,0,0,0
189643,1550,4,280,269,11,0,0,0
118156,554,8,101,100,1,3,1,0
0,0,0,0,0,0,0,0,0
28133,39,0,2,1,1,0,0,0
0,0,0,0,0,0,0,0,0
1389678,1417,8,288,286,2,19,1,0
1303290,199,7,22,20,2,6,1,0
0,0,0,0,0,0,0,0,0
53151,274,6,38,35,3,1,1,0
336898,1303,6,227,224,3,3,0,0
0,0,0,0,0,0,0,0,0
0,0,0,0,0,0,0,0,0
221881,1025,12,196,192,4,2,1,0
202780,814,5,148,133,15,3,1,1
186497,2194,8,608,572,36,2,1,0
45091,385,7,55,19,36,0,1,0
620194,2078,6,147,142,5,1,1,0
0,0,0,0,0,0,0,0,0
394639,805,5,96,95,1,11,1,0
0,0,0,0,0,0,0,0,0
138528,1799,6,343,334,9,2,0,0
671769,1560,4,196,35,161,5,1,0
0,0,0,0,0,0,0,0,0
5219,83,0,26,0,26,0,1,0
0,0,0,0,0,0,0,0,0
0,0,0,0,0,0,0,0,0
0,0,0,0,0,0,0,0,0
660439,1588,8,190,173,17,5,1,0
600570,1107,7,168,155,13,5,1,0
0,0,0,0,0,0,0,0,0
319210,2004,5,323,319,4,4,1,0
54590,593,9,114,6,108,5,1,0
0,0,0,0,0,0,0,0,0
0,0,0,0,0,0,0,0,0
155487,809,6,123,97,26,3,1,0
0,0,0,0,0,0,0,0,0
169578,948,13,198,196,2,6,1,0
1439971,521,10,115,109,6,2,1,0
608602,2092,18,193,185,8,32,1,0
0,0,0,0,0,0,0,0,0
0,0,0,0,0,0,0,0,0
45437,487,4,37,37,0,5,1,0
0,0,0,0,0,0,0,0,0
0,0,0,0,0,0,0,0,0
0,0,0,0,0,0,0,0,0
103607,928,6,80,59,21,20,1,0
100082,835,4,95,89,6,10,1,0
210919,1505,11,199,189,10,24,0,0
1386887,1233,7,96,83,13,12,1,0
108607,363,0,84,84,0,0,0,0
46436,546,7,146,132,14,2,1,0
103587,1068,8,214,206,8,2,1,0
21900,35,0,1,1,0,0,1,0
88739,1079,1,142,134,8,1,0,0
0,0,0,0,0,0,0,0,0
112165,413,12,41,20,21,0,1,0
677703,4705,16,736,728,8,1,0,0
212692,1644,15,113,106,7,17,1,0
100235,447,14,60,52,8,15,1,0
0,0,0,0,0,0,0,0,0
153125,575,7,118,115,3,10,1,0
129972,368,6,24,21,3,8,0,0
0,0,0,0,0,0,0,0,0
31784,536,2,81,80,1,0,1,0
18863,228,2,56,55,1,0,1,0
0,0,0,0,0,0,0,0,0
80903,595,4,28,26,2,4,0,0
0,0,0,0,0,0,0,0,0
507590,4770,9,935,898,37,181,1,0
0,0,0,0,0,0,0,0,0
232340,2284,5,592,591,1,12,0,0
148307,1886,4,525,524,1,4,0,0
22807,185,3,46,32,14,0,1,0
0,0,0,0,0,0,0,0,0
142384,743,7,79,77,2,14,1,0
873026,6696,5,1739,1731,8,21,1,0
0,0,0,0,0,0,0,0,0
245103,895,10,102,96,6,5,1,0
0,0,0,0,0,0,0,0,0
0,0,0,0,0,0,0,0,0
161873,892,4,67,55,12,11,0,0
0,0,0,0,0,0,0,0,0
325643,2108,8,460,415,45,61,1,0
188920,1968,7,302,288,14,0,1,0
0,0,0,0,0,0,0,0,0
722723,10183,9,1365,144,1221,16,1,0
0,0,0,0,0,0,0,0,0
561217,8319,3,912,862,50,11,1,0
171928,789,8,204,189,15,0,1,0
80356,1052,7,284,252,32,4,1,0
0,0,0,0,0,0,0,0,0
0,0,0,0,0,0,0,0,0
16320,141,0,7,0,7,0,1,0
0,0,0,0,0,0,0,0,0
143606,1090,9,82,77,5,3,0,0
488373,2090,9,362,351,11,18,1,0
327003,1465,9,341,330,11,15,1,0
1044501,1790,4,197,188,9,6,1,0
121374,1969,2,487,474,13,23,1,0
56044,895,5,226,216,10,6,1,0
0,0,0,0,0,0,0,0,0
27415,295,2,35,35,0,8,1,0
14371,101,2,10,10,0,7,1,0
98220,1481,4,285,274,11,1,1,0
112888,515,5,87,83,4,12,0,0
0,0,0,0,0,0,0,0,0
54425,1169,0,223,97,126,0,1,0
20191,433,0,47,47,0,0,1,0
0,0,0,0,0,0,0,0,0
48353,584,1,146,131,15,0,1,0
14440,131,3,3,3,0,0,1,0
0,0,0,0,0,0,0,0,0
73402,673,7,201,159,42,6,1,0
29823,96,7,9,4,5,2,1,0
274692,1126,10,17,14,3,3,1,0
0,0,0,0,0,0,0,0,0
20068,88,0,8,5,3,2,1,0
201345,902,4,171,157,14,0,1,0
0,0,0,0,0,0,0,0,0
1062761,15130,4,3181,148,3033,14,0,0
0,0,0,0,0,0,0,0,0
0,0,0,0,0,0,0,0,0
0,0,0,0,0,0,0,0,0
0,0,0,0,0,0,0,0,0
16286,89,0,15,1,14,0,1,0
0,0,0,0,0,0,0,0,0
0,0,0,0,0,0,0,0,0
0,0,0,0,0,0,0,0,0
506537,1470,11,300,287,13,15,1,0
466721,656,11,137,124,13,13,1,0
120692,972,12,233,230,3,21,1,0
0,0,0,0,0,0,0,0,0
0,0,0,0,0,0,0,0,0
43573,700,7,149,96,53,0,1,0
0,0,0,0,0,0,0,0,0
544707,4831,3,1195,1160,35,65,1,0
37683,215,3,15,15,0,6,0,0
62636,668,8,98,87,11,2,1,0
382786,1563,2,157,134,23,0,0,0
91783,500,4,81,45,36,4,1,0
109311,482,4,48,46,2,1,1,0
0,0,0,0,0,0,0,0,0
85768,1089,8,197,183,14,18,1,0
43769,368,8,54,42,12,3,1,0
0,0,0,0,0,0,0,0,0
202183,753,6,165,159,6,2,1,0
461344,705,4,90,82,8,2,1,0
190445,951,10,107,92,15,6,1,0
175076,848,11,95,82,13,6,1,0
284951,3055,0,200,172,28,24,1,0
157828,1489,0,131,108,23,2,1,0
0,0,0,0,0,0,0,0,0
0,0,0,0,0,0,0,0,0
0,0,0,0,0,0,0,0,0
0,0,0,0,0,0,0,0,0
0,0,0,0,0,0,0,0,0
308287,1559,3,280,165,115,11,0,0
86037,374,0,79,69,10,9,0,0
107861,817,11,170,154,16,3,1,0
51545,402,9,90,85,5,7,1,0
76306,539,5,65,59,6,16,1,0
27320,197,5,21,15,6,3,1,0
100305,1184,8,206,187,19,20,1,0
113522,842,13,70,58,12,2,1,0
55400,301,9,48,41,7,0,1,0
61522,573,11,65,62,3,4,1,0
37578,447,1,14,13,1,2,1,0
6154,67,4,12,10,2,2,1,0
99330,833,4,187,169,18,12,1,0
77540,66,2,4,2,2,1,0,0
1420479,3840,7,278,258,20,4,0,0
0,0,0,0,0,0,0,0,0
49128,848,3,182,176,6,0,1,0
23516,147,1,18,15,3,2,1,0
0,0,0,0,0,0,0,0,0
233049,1064,10,181,150,31,2,1,0
8351,72,5,4,4,0,0,0,0
0,0,0,0,0,0,0,0,0
943,9,0,0,0,0,0,0,0
103125,617,4,64,64,0,0,0,0
113637,1065,8,111,107,4,9,1,0
474190,3372,6,305,282,23,16,1,0
0,0,0,0,0,0,0,0,0
189362,777,11,132,126,6,13,1,0
0,0,0,0,0,0,0,0,0
140322,379,12,27,26,1,9,1,0
44916,385,7,55,19,36,0,1,0
90101,695,10,91,82,9,0,1,0
0,0,0,0,0,0,0,0,0
0,0,0,0,0,0,0,0,0
13320,61,3,4,2,2,0,1,0
372727,1490,6,157,148,9,13,1,0
29601,353,5,91,91,0,4,1,0
0,0,0,0,0,0,0,0,0
0,0,0,0,0,0,0,0,0
0,0,0,0,0,0,0,0,0
105246,855,6,19,7,12,0,0,0
154805,835,20,81,74,7,18,1,0
136015,785,19,68,61,7,20,1,0
107784,970,3,306,306,0,2,0,0
280574,1377,13,296,268,28,22,1,0
0,0,0,0,0,0,0,0,0
0,0,0,0,0,0,0,0,0
568497,3606,2,803,794,9,8,1,0
0,0,0,0,0,0,0,0,0
0,0,0,0,0,0,0,0,0
697885,3052,6,207,203,4,10,1,0
66512,537,10,54,43,11,3,1,0
0,0,0,0,0,0,0,0,0
0,0,0,0,0,0,0,0,0
0,0,0,0,0,0,0,0,0
0,0,0,0,0,0,0,0,0
0,0,0,0,0,0,0,0,0
0,0,0,0,0,0,0,0,0
0,0,0,0,0,0,0,0,0
497205,4080,3,327,250,77,86,1,0
130535,850,2,96,93,3,1,1,0
12500,129,4,8,8,0,2,1,0
0,0,0,0,0,0,0,0,0
55830,442,11,67,66,1,3,1,0
0,0,0,0,0,0,0,0,0
0,0,0,0,0,0,0,0,0
211143,180,0,47,32,15,1,1,0
271477,77,0,5,0,5,0,0,0
106067,1043,8,209,202,7,3,0,0
261482,1227,16,115,99,16,3,1,0
214712,2928,6,100,82,18,7,1,0
0,0,0,0,0,0,0,0,0
78966,781,11,216,177,39,6,1,0
198384,1966,3,507,507,0,0,1,0
49825,341,4,73,73,0,1,1,0
88563,103,0,12,5,7,0,1,0
0,0,0,0,0,0,0,0,0
634781,2264,6,323,309,14,2,1,1
0,0,0,0,0,0,0,0,0
177141,405,2,26,20,6,32,1,0
0,0,0,0,0,0,0,0,0
184373,2394,2,692,639,53,7,1,0
0,0,0,0,0,0,0,0,0
0,0,0,0,0,0,0,0,0
0,0,0,0,0,0,0,0,0
0,0,0,0,0,0,0,0,0
22620,38,0,2,1,1,0,1,0
89460,677,0,127,117,10,1,1,0
265675,1373,14,189,171,18,15,0,0
0,0,0,0,0,0,0,0,0
0,0,0,0,0,0,0,0,0
1359645,2215,5,175,171,4,0,1,0
1367306,2307,5,180,176,4,0,1,0
1429240,649,5,26,5,21,4,1,0
0,0,0,0,0,0,0,0,0
122353,711,4,82,73,9,1,1,0
0,0,0,0,0,0,0,0,0
0,0,0,0,0,0,0,0,0
18633,251,2,103,75,28,0,1,0
144253,1570,4,192,167,25,2,1,0
0,0,0,0,0,0,0,0,0
0,0,0,0,0,0,0,0,0
59289,428,5,75,74,1,0,1,0
0,0,0,0,0,0,0,0,0
241693,3007,8,649,620,29,26,1,0
80163,708,7,143,137,6,10,1,0
124340,1795,3,214,214,0,0,0,0
0,0,0,0,0,0,0,0,0
0,0,0,0,0,0,0,0,0
0,0,0,0,0,0,0,0,0
0,0,0,0,0,0,0,0,0
26376,597,2,98,74,24,0,1,0
8251,131,0,33,32,1,0,0,0
22950,38,0,3,1,2,0,1,0
518318,1305,5,70,35,35,1,1,0
211622,1050,11,138,135,3,7,0,0
44962,384,7,55,19,36,0,1,0
80593,877,3,179,57,122,3,0,0
0,0,0,0,0,0,0,0,0
107513,881,7,221,221,0,15,1,0
0,0,0,0,0,0,0,0,0
573323,2246,6,447,165,282,11,1,0
84159,609,8,101,93,8,3,1,0
56774,365,9,63,55,8,3,1,0
176141,467,4,0,0,0,8,1,0
53834,798,0,29,8,21,8,1,0
14009,99,4,11,0,11,2,1,0
383508,2170,10,414,400,14,14,0,0
0,0,0,0,0,0,0,0,0
0,0,0,0,0,0,0,0,0
0,0,0,0,0,0,0,0,0
91298,817,7,63,58,5,4,1,0
101115,858,3,127,118,9,18,0,0
0,0,0,0,0,0,0,0,0
454953,2669,7,228,217,11,7,1,0
374501,2478,7,204,193,11,8,1,0
552572,3748,5,436,205,231,27,1,0
223805,1365,5,139,130,9,3,1,0
2297643,683,3,86,79,7,3,1,0
309626,2344,4,971,2,969,0,1,0
441420,1641,8,232,197,35,33,1,0
75512,927,7,245,241,4,0,1,0
0,0,0,0,0,0,0,0,0
0,0,0,0,0,0,0,0,0
0,0,0,0,0,0,0,0,0
0,0,0,0,0,0,0,0,0
174757,863,9,131,125,6,9,1,0
0,0,0,0,0,0,0,0,0
4013,31,0,3,3,0,0,1,0
176447,2748,3,693,626,67,3,1,0
144875,965,12,138,134,4,25,1,0
136058,358,0,64,5,59,0,1,0
166413,613,4,73,61,12,33,1,0
167890,1617,2,278,269,9,1,1,0
0,0,0,0,0,0,0,0,0
332719,2411,11,489,468,21,1,1,0
91837,1228,6,301,293,8,2,1,0
1955953,374,3,67,49,18,0,1,0
0,0,0,0,0,0,0,0,0
1291741,2068,11,253,244,9,38,1,0
1178268,14255,6,6171,6168,3,0,1,0
63942,983,4,153,150,3,0,1,0
26634,248,3,32,29,3,0,1,0
127202,1668,9,474,381,93,2,1,0
375906,2566,9,424,364,60,11,1,0
90899,677,20,117,65,52,4,1,0
171845,467,7,32,25,7,12,1,0
107610,629,1,154,141,13,0,1,0
110862,1165,13,25,22,3,3,1,0
0,0,0,0,0,0,0,0,0
70950,1931,2,568,568,0,1,1,0
0,0,0,0,0,0,0,0,0
0,0,0,0,0,0,0,0,0
37255,379,9,14,14,0,4,0,0
36622,274,0,9,9,0,27,1,0
0,0,0,0,0,0,0,0,0
0,0,0,0,0,0,0,0,0
0,0,0,0,0,0,0,0,0
0,0,0,0,0,0,0,0,0
360685,1492,1,453,419,34,0,1,0
351356,1092,10,59,58,1,10,1,0
103354,1013,8,231,214,17,35,1,0
160225,1175,3,133,120,13,7,1,0
90603,1592,8,425,406,19,4,1,0
5054,68,3,7,6,1,0,0,0
0,0,0,0,0,0,0,0,0
146851,461,3,64,54,10,3,1,0
0,0,0,0,0,0,0,0,0
0,0,0,0,0,0,0,0,0
0,0,0,0,0,0,0,0,0
345266,2893,7,338,286,52,7,0,0
0,0,0,0,0,0,0,0,0
0,0,0,0,0,0,0,0,0
0,0,0,0,0,0,0,0,0
167468,1049,5,133,90,43,1,1,0
0,0,0,0,0,0,0,0,0
0,0,0,0,0,0,0,0,0
197523,856,2,62,44,18,3,1,0
0,0,0,0,0,0,0,0,0
717727,1827,7,163,159,4,19,1,0
144561,1261,9,163,163,0,10,1,0
443660,2573,7,383,283,100,28,1,0
98501,1935,4,428,387,41,2,1,0
303629,2076,10,624,621,3,6,1,0
214128,1191,10,379,377,2,6,1,0
183715,2337,2,222,207,15,3,1,0
235320,1207,9,221,214,7,4,1,0
209771,732,9,178,171,7,5,1,0
0,0,0,0,0,0,0,0,0
0,0,0,0,0,0,0,0,0
515340,3648,10,402,389,13,29,1,0
127725,248,6,5,4,1,4,1,0
1372086,2370,5,256,236,20,6,1,0
67764,436,10,67,39,28,1,0,0
261842,1032,14,313,310,3,0,1,0
0,0,0,0,0,0,0,0,0
8324,54,4,2,2,0,2,0,0
282830,1404,12,224,215,9,3,1,0
54370,613,12,117,115,2,6,1,0
0,0,0,0,0,0,0,0,0
73634,359,5,70,37,33,0,1,0
0,0,0,0,0,0,0,0,0
213625,869,12,105,86,19,23,1,0
532183,1547,9,179,156,23,4,0,0
45772,173,4,16,12,4,4,0,0
174581,911,5,158,147,11,2,1,0
64173,129,3,8,6,2,1,0,0
0,0,0,0,0,0,0,0,0
0,0,0,0,0,0,0,0,0
80605,1368,1,258,256,2,3,1,0
0,0,0,0,0,0,0,0,0
0,0,0,0,0,0,0,0,0
0,0,0,0,0,0,0,0,0
100058,1221,10,183,180,3,13,1,0
320237,1382,6,182,173,9,7,1,0
412645,1433,15,213,132,81,12,1,0
227390,497,14,66,55,11,18,1,0
257967,1573,5,261,254,7,15,1,0
250048,1827,11,197,192,5,12,0,0
0,0,0,0,0,0,0,0,0
43659,675,5,203,202,1,0,1,0
99399,1246,1,122,104,18,4,0,0
239750,697,7,115,110,5,6,1,0
0,0,0,0,0,0,0,0,0
79956,943,10,183,177,6,8,1,0
246828,788,12,111,107,4,17,1,0
24636,389,1,105,102,3,98,1,0
12128,205,0,40,37,3,0,1,0
0,0,0,0,0,0,0,0,0
83651,1553,8,280,231,49,8,1,0
0,0,0,0,0,0,0,0,0
457335,3486,13,299,282,17,21,1,0
4195,39,4,1,1,0,0,0,0
175640,650,10,72,20,52,27,0,0
0,0,0,0,0,0,0,0,0
13696,96,2,13,9,4,1,1,0
0,0,0,0,0,0,0,0,0
0,0,0,0,0,0,0,0,0
0,0,0,0,0,0,0,0,0
213253,1460,2,199,179,20,5,0,0
0,0,0,0,0,0,0,0,0
65605,938,5,153,137,16,1,1,0
0,0,0,0,0,0,0,0,0
0,0,0,0,0,0,0,0,0
655761,749,6,136,125,11,4,1,0
0,0,0,0,0,0,0,0,0
0,0,0,0,0,0,0,0,0
276891,1627,13,162,159,3,1,0,0
267928,1196,14,108,101,7,12,0,0
0,0,0,0,0,0,0,0,0
0,0,0,0,0,0,0,0,0
312162,2667,11,612,544,68,19,1,0
408976,865,1,67,67,0,0,1,0
0,0,0,0,0,0,0,0,0
0,0,0,0,0,0,0,0,0
0,0,0,0,0,0,0,0,0
0,0,0,0,0,0,0,0,0
44826,210,6,32,32,0,2,0,0
0,0,0,0,0,0,0,0,0
331989,945,13,188,165,23,5,1,0
79276,773,10,200,163,37,8,1,0
0,0,0,0,0,0,0,0,0
0,0,0,0,0,0,0,0,0
0,0,0,0,0,0,0,0,0
253489,877,1,237,230,7,1,1,0
198175,1259,10,302,281,21,0,0,0
1909,42,0,8,8,0,0,0,0
0,0,0,0,0,0,0,0,0
0,0,0,0,0,0,0,0,0
0,0,0,0,0,0,0,0,0
211834,468,5,56,46,10,14,1,0
0,0,0,0,0,0,0,0,0
206466,1748,10,321,200,121,35,1,0
0,0,0,0,0,0,0,0,0
890155,868,14,225,196,29,4,1,0
17981,205,3,55,47,8,0,1,0
89605,1693,3,313,16,297,2,1,0
22913,38,0,2,2,0,0,1,0
0,0,0,0,0,0,0,0,0
57191,652,3,167,157,10,0,0,0
35055,248,5,47,4,43,5,1,0
32591,229,5,45,22,23,5,1,0
178189,1853,4,246,245,1,0,1,0
574776,3718,4,415,414,1,2,1,0
373232,1955,7,209,208,1,11,1,0
0,0,0,0,0,0,0,0,0
0,0,0,0,0,0,0,0,0
80903,718,10,64,63,1,0,1,0
102798,925,5,69,56,13,14,1,0
276135,2198,16,110,87,23,6,1,0
71870,224,4,7,3,4,1,1,0
12158,78,0,6,3,3,1,0,0
102591,804,2,92,58,34,34,1,0
135239,386,6,52,50,2,8,1,0
550119,691,7,108,99,9,3,1,0
1439050,1250,16,104,85,19,4,1,0
0,0,0,0,0,0,0,0,0
144541,1140,5,172,160,12,7,0,0
54776,269,3,56,55,1,11,0,0
171871,847,9,78,69,9,9,1,0
101143,951,4,369,367,2,0,1,0
92931,843,4,346,344,2,0,1,0
103814,969,4,234,231,3,0,1,0
0,0,0,0,0,0,0,0,0
0,0,0,0,0,0,0,0,0
0,0,0,0,0,0,0,0,0
0,0,0,0,0,0,0,0,0
0,0,0,0,0,0,0,0,0
0,0,0,0,0,0,0,0,0
0,0,0,0,0,0,0,0,0
27718,42,0,2,1,1,0,0,0
395583,996,2,143,131,12,0,1,0
457168,132,2,9,1,8,2,1,0
0,0,0,0,0,0,0,0,0
0,0,0,0,0,0,0,0,0
65950,857,10,162,160,2,1,1,0
0,0,0,0,0,0,0,0,0
91468,1899,1,444,439,5,0,1,0
0,0,0,0,0,0,0,0,0
128566,1455,8,196,191,5,5,1,0
47568,527,8,99,94,5,2,1,0
63671,956,1,81,79,2,0,1,0
12822,207,5,56,55,1,2,1,0
21865,33,0,1,1,0,0,1,0
0,0,0,0,0,0,0,0,0
22844,37,0,2,1,1,0,1,0
0,0,0,0,0,0,0,0,0
0,0,0,0,0,0,0,0,0
179050,794,17,84,70,14,12,1,0
177747,1604,9,156,112,44,19,1,0
464635,1331,9,103,27,76,4,1,0
346405,536,10,43,14,29,4,1,0
0,0,0,0,0,0,0,0,0
151589,832,9,130,126,4,0,1,0
199842,1790,10,289,267,22,0,0,0
0,0,0,0,0,0,0,0,0
18340,352,4,98,86,12,2,1,0
0,0,0,0,0,0,0,0,0
0,0,0,0,0,0,0,0,0
72499,1084,3,227,207,20,0,1,0
0,0,0,0,0,0,0,0,0
349824,517,10,87,86,1,10,1,0
55551,403,5,83,70,13,14,1,0
32901,256,4,63,59,4,12,1,0
36637,270,1,40,32,8,1,1,0
59703,886,1,129,103,26,14,1,0
0,0,0,0,0,0,0,0,0
0,0,0,0,0,0,0,0,0
70596,395,0,22,20,2,0,0,0
33156,129,0,18,16,2,1,0,0
63070,1258,5,246,239,7,5,1,0
11429,305,4,75,71,4,3,1,0
257470,2494,6,525,486,39,1,1,0
330943,2581,16,445,444,1,9,0,0
0,0,0,0,0,0,0,0,0
0,0,0,0,0,0,0,0,0
102530,2197,6,745,741,4,8,1,0
48266,474,1,82,77,5,4,1,0
0,0,0,0,0,0,0,0,0
0,0,0,0,0,0,0,0,0
631342,2183,12,34,24,10,14,1,0
70598,534,4,97,96,1,38,0,0
100884,700,10,102,94,8,18,1,0
259567,3711,5,679,664,15,3,1,0
395315,1747,1,417,399,18,5,1,0
163819,332,1,74,24,50,0,1,0
0,0,0,0,0,0,0,0,0
1077299,1280,8,136,91,45,17,1,0
49468,139,5,7,6,1,8,0,0
28819,317,7,28,28,0,2,1,0
9806,120,6,19,19,0,0,1,0
0,0,0,0,0,0,0,0,0
0,0,0,0,0,0,0,0,0
624921,3020,3,306,104,202,1,1,0
0,0,0,0,0,0,0,0,0
55458,840,4,141,113,28,1,1,0
92729,649,9,103,98,5,0,1,0
0,0,0,0,0,0,0,0,0
227316,1067,8,208,197,11,6,1,0
279265,1689,11,143,118,25,18,1,0
138127,2410,4,267,188,79,0,0,0
46918,619,4,94,93,1,0,0,0
0,0,0,0,0,0,0,0,0
222568,1280,14,265,5,260,3,1,1
0,0,0,0,0,0,0,0,0
122772,1093,2,58,43,15,8,1,0
0,0,0,0,0,0,0,0,0
0,0,0,0,0,0,0,0,0
0,0,0,0,0,0,0,0,0
312356,1772,8,252,229,23,3,1,0
15997,212,2,41,20,21,0,1,0
0,0,0,0,0,0,0,0,0
0,0,0,0,0,0,0,0,0
0,0,0,0,0,0,0,0,0
60974,507,5,157,149,8,0,0,0
787476,2461,15,496,443,53,24,1,0
123015,488,10,59,55,4,0,1,0
16345,188,3,28,5,23,1,1,0
39698,509,6,143,125,18,3,0,0
21594,272,6,71,55,16,3,0,0
314777,1142,1,142,133,9,1,1,0
0,0,0,0,0,0,0,0,0
1910030,6144,4,411,403,8,0,1,0
0,0,0,0,0,0,0,0,0
45297,775,5,249,239,10,0,1,0
85135,647,5,198,198,0,1,1,0
99105,1584,2,514,510,4,40,1,0
276291,1103,6,254,248,6,3,1,0
498793,877,6,137,137,0,19,1,0
104958,589,5,138,131,7,0,1,0
0,0,0,0,0,0,0,0,0
131399,599,8,108,105,3,4,1,0
33902,227,8,34,31,3,5,1,0
0,0,0,0,0,0,0,0,0
131776,537,5,117,117,0,11,0,0
0,0,0,0,0,0,0,0,0
0,0,0,0,0,0,0,0,0
114736,599,5,71,68,3,39,0,0
0,0,0,0,0,0,0,0,0
0,0,0,0,0,0,0,0,0
223169,1546,3,263,246,17,2,0,0
213618,686,4,72,54,18,2,1,0
1336387,2512,7,220,187,33,3,1,0
422117,2164,9,315,278,37,18,1,0
129704,1010,9,181,152,29,4,1,0
0,0,0,0,0,0,0,0,0
0,0,0,0,0,0,0,0,0
1072376,3888,0,250,241,9,1,1,0
7898,103,2,26,26,0,0,1,0
194013,1944,2,438,431,7,6,1,0
0,0,0,0,0,0,0,0,0
0,0,0,0,0,0,0,0,0
157118,350,7,34,31,3,3,1,0
0,0,0,0,0,0,0,0,0
1381177,4035,4,434,317,117,10,1,0
2296016,7043,2,268,249,19,0,0,0
360068,1588,5,92,74,18,4,1,0
34081,390,6,35,34,1,2,1,0
40559,83,6,3,2,1,4,0,0
62653,623,5,107,92,15,9,0,0
193244,834,5,73,68,5,4,1,0
0,0,0,0,0,0,0,0,0
56295,525,4,103,102,1,17,1,0
0,0,0,0,0,0,0,0,0
23308,38,0,2,1,1,0,1,0
340540,3272,10,687,664,23,5,1,0
0,0,0,0,0,0,0,0,0
0,0,0,0,0,0,0,0,0
0,0,0,0,0,0,0,0,0
0,0,0,0,0,0,0,0,0
0,0,0,0,0,0,0,0,0
332321,2405,8,1065,1056,9,75,1,0
158134,934,5,148,134,14,19,1,0
18992,103,3,3,0,3,0,0,0
136363,1006,16,128,120,8,16,1,0
10997,259,0,55,49,6,0,1,0
325932,1131,5,188,181,7,10,1,0
0,0,0,0,0,0,0,0,0
0,0,0,0,0,0,0,0,0
201738,1814,17,283,274,9,9,1,0
0,0,0,0,0,0,0,0,0
0,0,0,0,0,0,0,0,0
0,0,0,0,0,0,0,0,0
369861,1710,7,245,213,32,12,1,0
0,0,0,0,0,0,0,0,0
140259,2771,5,301,293,8,3,1,0
109193,177,6,15,10,5,25,1,0
0,0,0,0,0,0,0,0,0
404494,4431,6,380,370,10,7,1,0
78949,644,6,116,110,6,5,1,0
23397,38,0,2,1,1,0,1,0
123972,846,10,11,4,7,0,1,0
0,0,0,0,0,0,0,0,0
233879,1357,8,239,229,10,11,1,0
118300,1506,4,356,353,3,3,1,0
0,0,0,0,0,0,0,0,0
230420,1061,3,89,78,11,5,1,0
5879,71,1,7,6,1,0,1,0
0,0,0,0,0,0,0,0,0
18479,347,3,68,68,0,1,1,0
254013,1275,6,95,87,8,18,1,0
47203,333,6,69,64,5,0,1,0
0,0,0,0,0,0,0,0,0
0,0,0,0,0,0,0,0,0
0,0,0,0,0,0,0,0,0
39671,255,3,59,51,8,1,1,0
113490,454,6,34,23,11,9,1,0
0,0,0,0,0,0,0,0,0
65896,270,8,29,23,6,5,1,0
0,0,0,0,0,0,0,0,0
102649,837,4,151,45,106,14,1,0
24202,184,3,13,12,1,10,0,0
155656,993,6,133,131,2,17,0,0
0,0,0,0,0,0,0,0,0
0,0,0,0,0,0,0,0,0
315433,1225,7,241,227,14,4,1,0
0,0,0,0,0,0,0,0,0
0,0,0,0,0,0,0,0,0
0,0,0,0,0,0,0,0,0
148160,419,2,44,29,15,6,1,0
82173,677,5,169,161,8,10,0,0
0,0,0,0,0,0,0,0,0
0,0,0,0,0,0,0,0,0
29562,466,1,91,91,0,4,1,0
3835,43,1,8,8,0,0,1,0
289572,725,8,129,106,23,6,1,0
36800,318,5,54,53,1,3,1,0
0,0,0,0,0,0,0,0,0
3752,58,0,9,8,1,0,0,0
5683,73,2,9,8,1,0,0,0
0,0,0,0,0,0,0,0,0
0,0,0,0,0,0,0,0,0
422952,1819,9,414,402,12,2,1,0
0,0,0,0,0,0,0,0,0
21994,35,0,1,1,0,0,1,0
8877,128,3,30,30,0,2,1,0
6755,123,2,28,28,0,0,1,0
640416,811,0,241,178,63,5,1,0
37096,354,1,4,2,2,2,0,0
0,0,0,0,0,0,0,0,0
0,0,0,0,0,0,0,0,0
1087532,2645,8,411,379,32,9,1,0
92896,1052,12,235,75,160,8,1,0
0,0,0,0,0,0,0,0,0
23972,48,5,2,0,2,0,0,0
0,0,0,0,0,0,0,0,0
47540,641,1,74,74,0,0,1,0
294568,1527,11,390,372,18,5,1,0
0,0,0,0,0,0,0,0,0
143665,456,12,78,62,16,1,1,0
0,0,0,0,0,0,0,0,0
336544,1857,1,378,342,36,1,1,0
111080,548,8,93,73,20,2,0,0
0,0,0,0,0,0,0,0,0
59349,861,7,174,170,4,7,1,0
19048,384,5,110,106,4,0,1,0
0,0,0,0,0,0,0,0,0
85428,1268,4,475,467,8,3,0,0
345909,824,6,158,6,152,11,1,0
163314,349,6,37,34,3,6,1,0
361522,2576,8,351,340,11,48,1,0
65196,653,7,231,224,7,2,1,0
3708,75,2,8,8,0,0,1,0
0,0,0,0,0,0,0,0,0
0,0,0,0,0,0,0,0,0
0,0,0,0,0,0,0,0,0
0,0,0,0,0,0,0,0,0
0,0,0,0,0,0,0,0,0
0,0,0,0,0,0,0,0,0
245537,2497,7,393,379,14,3,1,0
0,0,0,0,0,0,0,0,0
0,0,0,0,0,0,0,0,0
46154,541,8,97,62,35,17,1,0
0,0,0,0,0,0,0,0,0
56483,763,4,182,162,20,0,1,0
91939,507,10,30,29,1,3,1,0
6095,83,0,9,9,0,0,0,0
64318,905,2,148,142,6,0,1,0
0,0,0,0,0,0,0,0,0
77949,506,14,77,76,1,6,1,0
44861,1202,0,143,133,10,0,1,0
96966,1474,4,218,110,108,14,1,0
0,0,0,0,0,0,0,0,0
120416,2399,5,621,568,53,18,1,0
0,0,0,0,0,0,0,0,0
0,0,0,0,0,0,0,0,0
119163,900,9,185,185,0,5,1,0
0,0,0,0,0,0,0,0,0
25751,401,0,32,6,26,0,0,0
0,0,0,0,0,0,0,0,0
690960,2573,16,306,284,22,51,1,0
163143,1083,13,155,139,16,8,1,0
0,0,0,0,0,0,0,0,0
0,0,0,0,0,0,0,0,0
114914,1405,10,321,130,191,8,1,0
119902,1436,7,245,237,8,11,1,0
23631,429,3,119,114,5,4,1,0
117081,485,6,87,71,16,4,1,0
0,0,0,0,0,0,0,0,0
0,0,0,0,0,0,0,0,0
0,0,0,0,0,0,0,0,0
92954,2430,1,376,371,5,0,1,0
0,0,0,0,0,0,0,0,0
107201,1880,6,415,415,0,1,0,0
12614,179,4,42,42,0,2,0,0
4810,119,0,22,22,0,0,0,0
208427,1062,11,205,196,9,10,1,0
0,0,0,0,0,0,0,0,0
74275,1086,4,183,173,10,3,1,0
116698,587,11,99,84,15,15,1,0
100849,966,6,172,160,12,6,0,0
332507,1808,12,291,281,10,28,1,0
85362,442,4,34,32,2,6,0,0
78095,275,7,23,22,1,5,0,0
800448,3620,4,582,578,4,4,1,0
0,0,0,0,0,0,0,0,0
0,0,0,0,0,0,0,0,0
0,0,0,0,0,0,0,0,0
1046083,1872,0,286,264,22,6,0,0
1008424,3508,16,194,106,88,42,1,0
690040,4725,7,1430,1414,16,320,1,0
0,0,0,0,0,0,0,0,0
24016,37,0,2,1,1,0,1,0
1144499,3788,5,170,68,102,39,1,0
56099,315,7,40,36,4,0,1,0
127359,1353,3,61,25,36,26,1,0
0,0,0,0,0,0,0,0,0
0,0,0,0,0,0,0,0,0
171991,3543,14,94,20,74,25,1,0
419360,3252,8,546,515,31,6,1,0
88896,595,7,10,7,3,2,1,0
76903,630,12,85,62,23,3,0,0
10421,78,2,3,3,0,3,0,0
0,0,0,0,0,0,0,0,0
58771,644,3,98,95,3,33,1,0
0,0,0,0,0,0,0,0,0
62441,634,4,203,183,20,2,0,0
22367,198,5,6,6,0,1,0,0
0,0,0,0,0,0,0,0,0
0,0,0,0,0,0,0,0,0
0,0,0,0,0,0,0,0,0
521726,1604,1,241,125,116,14,1,0
81278,112,1,10,10,0,2,0,0
241578,1195,16,265,250,15,21,1,0
444956,2389,10,321,308,13,28,1,0
217894,1878,6,432,410,22,0,0,0
33754,433,4,73,60,13,0,0,0
0,0,0,0,0,0,0,0,0
0,0,0,0,0,0,0,0,0
45104,386,7,55,19,36,0,1,0
44060,477,5,83,80,3,4,1,0
0,0,0,0,0,0,0,0,0
0,0,0,0,0,0,0,0,0
0,0,0,0,0,0,0,0,0
329897,3207,5,655,599,56,13,0,0
21930,35,0,1,1,0,0,1,0
0,0,0,0,0,0,0,0,0
0,0,0,0,0,0,0,0,0
0,0,0,0,0,0,0,0,0
295434,1480,9,185,151,34,9,1,0
26444090,2873,5,34,33,1,126,1,0
200653,1526,1,197,117,80,96,1,0
563541,3104,7,672,660,12,3,1,0
153621,1049,2,73,10,63,0,1,0
314307,1735,7,424,412,12,5,0,0
0,0,0,0,0,0,0,0,0
112229,1212,8,414,382,32,30,1,0
34811,207,5,13,12,1,0,1,0
0,0,0,0,0,0,0,0,0
0,0,0,0,0,0,0,0,0
50513,466,4,54,54,0,1,1,0
0,0,0,0,0,0,0,0,0
0,0,0,0,0,0,0,0,0
136030,1319,2,283,268,15,1,0,0
113614,517,4,129,128,1,0,1,0
0,0,0,0,0,0,0,0,0
178543,2330,3,434,221,213,0,0,0
6063,84,3,16,15,1,0,0,0
470263,3529,19,282,261,21,259,1,0
154348,913,6,52,43,9,2,1,0
37612,339,10,42,39,3,0,1,0
468870,1094,2,307,245,62,2,1,0
1071662,2052,7,318,289,29,25,1,0
0,0,0,0,0,0,0,0,0
66433,1220,0,408,361,47,0,0,0
138253,1606,7,251,232,19,3,1,0
0,0,0,0,0,0,0,0,0
0,0,0,0,0,0,0,0,0
0,0,0,0,0,0,0,0,0
24691,52,5,4,3,1,0,0,0
95224,922,8,194,194,0,3,1,0
0,0,0,0,0,0,0,0,0
457135,2201,9,361,9,352,8,0,0
0,0,0,0,0,0,0,0,0
48030,404,1,93,35,58,2,1,0
48030,404,1,93,26,67,2,1,0
168562,1016,3,188,168,20,0,1,0
0,0,0,0,0,0,0,0,0
0,0,0,0,0,0,0,0,0
0,0,0,0,0,0,0,0,0
424440,1557,17,271,271,0,30,1,0
0,0,0,0,0,0,0,0,0
0,0,0,0,0,0,0,0,0
13864,121,6,17,15,2,0,1,0
0,0,0,0,0,0,0,0,0
0,0,0,0,0,0,0,0,0
264049,1143,10,229,221,8,6,1,0
16756,143,2,11,11,0,1,0,0
385414,3333,4,498,490,8,27,1,0
0,0,0,0,0,0,0,0,0
754077,902,5,97,91,6,17,1,0
629100,603,4,40,29,11,1,1,0
27834,42,0,2,1,1,0,0,0
0,0,0,0,0,0,0,0,0
96563,536,3,16,14,2,0,1,0
876185,2667,6,546,485,61,17,1,0
336468,517,6,77,52,25,13,1,0
330321,1496,3,252,227,25,56,0,0
53285,178,2,18,15,3,1,1,0
272409,1124,6,217,201,16,1,0,0
0,0,0,0,0,0,0,0,0
259790,386,6,10,6,4,0,1,0
0,0,0,0,0,0,0,0,0
0,0,0,0,0,0,0,0,0
0,0,0,0,0,0,0,0,0
210438,655,1,44,41,3,0,1,0
268393,1632,11,141,134,7,1,1,0
29612,368,2,99,99,0,3,1,0
0,0,0,0,0,0,0,0,0
0,0,0,0,0,0,0,0,0
111677,655,6,156,138,18,0,0,0
0,0,0,0,0,0,0,0,0
83496,945,10,192,177,15,5,1,0
119587,190,0,15,14,1,11,0,0
146088,976,2,83,74,9,3,0,0
0,0,0,0,0,0,0,0,0
175832,619,6,111,98,13,4,1,0
0,0,0,0,0,0,0,0,0
515090,2174,2,193,89,104,6,1,0
0,0,0,0,0,0,0,0,0
192436,705,10,104,68,36,11,1,0
63709,182,7,1,0,1,7,0,0
7617,156,3,34,33,1,0,1,0
426742,6187,6,1751,765,986,8,0,0
43684,319,9,39,39,0,3,1,0
224019,3616,6,822,672,150,0,1,0
335564,1195,7,182,141,41,18,1,0
0,0,0,0,0,0,0,0,0
0,0,0,0,0,0,0,0,0
59101,907,12,272,265,7,18,1,0
346354,4305,7,800,789,11,22,1,0
4149,33,0,5,5,0,0,1,0
0,0,0,0,0,0,0,0,0
371923,516,7,71,69,2,15,1,0
902959,942,8,195,167,28,12,1,0
866518,314,10,56,37,19,4,1,0
0,0,0,0,0,0,0,0,0
59781,489,13,66,66,0,5,1,0
0,0,0,0,0,0,0,0,0
303036,581,4,20,17,3,5,0,0
314489,3193,13,582,450,132,26,1,0
56132,171,6,4,0,4,8,1,0
37848,244,2,63,61,2,10,0,0
30301,401,4,88,38,50,0,0,0
222495,1841,6,282,255,27,2,1,0
222428,1839,6,282,255,27,2,1,0
81128,347,9,48,44,4,0,0,0
946386,3975,10,800,434,366,6,1,0
18285,245,2,34,21,13,0,1,0
2837,37,2,3,3,0,0,0,0
19546,280,0,49,46,3,3,1,0
0,0,0,0,0,0,0,0,0
0,0,0,0,0,0,0,0,0
0,0,0,0,0,0,0,0,0
0,0,0,0,0,0,0,0,0
287675,1540,8,333,210,123,9,1,0
31835,309,8,53,48,5,4,1,0
22788,37,0,2,1,1,0,1,0
0,0,0,0,0,0,0,0,0
634448,933,6,164,158,6,7,1,0
0,0,0,0,0,0,0,0,0
300288,1540,5,174,166,8,12,1,0
167590,488,8,70,68,2,0,1,0
565672,1303,10,131,107,24,17,1,0
215476,1863,3,307,246,61,7,1,0
30447,148,4,19,18,1,8,0,0
56608,642,3,89,80,9,1,1,0
0,0,0,0,0,0,0,0,0
0,0,0,0,0,0,0,0,0
164674,1357,5,192,190,2,3,0,0
0,0,0,0,0,0,0,0,0
0,0,0,0,0,0,0,0,0
100935,1028,6,184,181,3,3,0,0
66908,538,7,141,134,7,3,0,0
0,0,0,0,0,0,0,0,0
330116,766,4,59,50,9,4,0,0
14432,66,5,2,2,0,3,1,0
0,0,0,0,0,0,0,0,0
25951,231,5,34,34,0,0,0,0
590036,2003,5,299,289,10,23,0,0
88415,1323,7,290,279,11,11,1,0
27314,384,4,71,65,6,6,1,0
63180,546,2,118,111,7,16,1,0
0,0,0,0,0,0,0,0,0
79535,1012,4,195,189,6,1,1,0
5311,63,2,14,14,0,0,0,0
5246,49,2,2,2,0,0,0,0
49633,615,3,149,128,21,7,1,0
30251,333,4,10,10,0,2,1,0
24465,301,4,76,75,1,10,1,0
0,0,0,0,0,0,0,0,0
0,0,0,0,0,0,0,0,0
0,0,0,0,0,0,0,0,0
932885,2462,10,288,266,22,74,1,0
58052,658,3,59,58,1,60,0,0
0,0,0,0,0,0,0,0,0
316100,1394,15,147,146,1,0,1,0
264367,1140,16,175,174,1,0,1,0
0,0,0,0,0,0,0,0,0
0,0,0,0,0,0,0,0,0
5061,21,0,0,0,0,0,1,0
66638,995,2,406,402,4,0,1,0
0,0,0,0,0,0,0,0,0
132620,798,7,100,90,10,3,1,0
0,0,0,0,0,0,0,0,0
1150016,3026,9,410,233,177,33,1,0
34102,272,6,26,19,7,2,1,0
19945,173,6,20,15,5,3,1,0
131089,727,6,75,1,74,0,1,0
71407,397,8,40,37,3,2,1,0
0,0,0,0,0,0,0,0,0
2106,24,1,5,5,0,0,0,0
362666,2372,2,232,197,35,3,1,0
168208,168,0,73,52,21,0,1,0
0,0,0,0,0,0,0,0,0
0,0,0,0,0,0,0,0,0
0,0,0,0,0,0,0,0,0
0,0,0,0,0,0,0,0,0
104841,1817,6,293,285,8,28,1,0
255371,1194,6,40,32,8,8,1,0
124302,241,7,6,4,2,1,0,0
37439,387,3,80,68,12,7,1,0
246096,2356,10,151,141,10,37,1,0
0,0,0,0,0,0,0,0,0
496431,2034,11,345,318,27,51,1,0
1123911,4738,6,133,126,7,3,1,0
0,0,0,0,0,0,0,0,0
0,0,0,0,0,0,0,0,0
582129,2136,5,148,140,8,0,1,0
0,0,0,0,0,0,0,0,0
247349,902,17,21,21,0,9,1,0
99299,610,5,66,57,9,3,1,0
20494,230,5,43,34,9,1,1,0
0,0,0,0,0,0,0,0,0
0,0,0,0,0,0,0,0,0
0,0,0,0,0,0,0,0,0
0,0,0,0,0,0,0,0,0
286236,584,2,106,83,23,4,1,0
0,0,0,0,0,0,0,0,0
252790,911,13,166,153,13,22,1,0
0,0,0,0,0,0,0,0,0
65406,968,6,111,102,9,3,1,0
1912298,1121,7,100,62,38,3,1,0
169133,1419,6,239,230,9,24,0,0
0,0,0,0,0,0,0,0,0
36039,358,0,52,26,26,2,0,0
0,0,0,0,0,0,0,0,0
754052,4992,8,439,245,194,5,1,0
0,0,0,0,0,0,0,0,0
0,0,0,0,0,0,0,0,0
18469,274,4,60,59,1,0,1,0
91224,1098,3,249,249,0,3,1,0
0,0,0,0,0,0,0,0,0
153124,661,2,188,172,16,13,0,0
0,0,0,0,0,0,0,0,0
0,0,0,0,0,0,0,0,0
281880,1132,2,234,227,7,3,1,0
779294,802,6,124,97,27,0,1,0
198559,886,7,139,1,138,1,1,0
0,0,0,0,0,0,0,0,0
0,0,0,0,0,0,0,0,0
182469,1021,2,242,26,216,0,1,0
0,0,0,0,0,0,0,0,0
80390,974,5,111,73,38,4,1,0
0,0,0,0,0,0,0,0,0
157313,883,3,84,78,6,19,1,0
119851,890,4,142,132,10,0,0,0
5105448,24880,10,327,321,6,516,1,0
210562,176,3,6,6,0,0,1,0
180480,1261,7,202,182,20,11,1,0
125814,490,7,51,23,28,11,1,0
0,0,0,0,0,0,0,0,0
0,0,0,0,0,0,0,0,0
120922,714,9,127,122,5,2,1,0
0,0,0,0,0,0,0,0,0
112401,1373,8,270,264,6,8,1,0
0,0,0,0,0,0,0,0,0
0,0,0,0,0,0,0,0,0
0,0,0,0,0,0,0,0,0
726556,3471,17,552,529,23,5,1,0
0,0,0,0,0,0,0,0,0
6036,76,5,4,2,2,0,1,0
5389,63,5,3,1,2,0,1,0
80030,811,9,161,121,40,1,1,0
0,0,0,0,0,0,0,0,0
284492,1052,11,161,139,22,13,1,0
242100,1196,7,93,88,5,5,1,0
117444,254,4,12,11,1,0,1,0
0,0,0,0,0,0,0,0,0
0,0,0,0,0,0,0,0,0
34620,334,7,89,89,0,1,0,0
0,0,0,0,0,0,0,0,0
38691,368,8,38,34,4,6,1,0
0,0,0,0,0,0,0,0,0
0,0,0,0,0,0,0,0,0
0,0,0,0,0,0,0,0,0
0,0,0,0,0,0,0,0,0
457747,810,10,100,90,10,6,1,0
11715,78,2,1,1,0,0,0,0
0,0,0,0,0,0,0,0,0
0,0,0,0,0,0,0,0,0
0,0,0,0,0,0,0,0,0
6124,45,0,9,7,2,0,0,0
960547,343,5,15,9,6,5,1,0
443028,2825,15,354,318,36,5,0,0
0,0,0,0,0,0,0,0,0
0,0,0,0,0,0,0,0,0
138142,988,9,169,122,47,58,1,0
0,0,0,0,0,0,0,0,0
0,0,0,0,0,0,0,0,0
119025,547,9,107,81,26,11,1,0
119043,547,9,107,81,26,11,1,0
91241,1045,14,101,97,4,6,1,0
350011,5073,2,1490,1480,10,80,1,0
91839,1001,8,296,253,43,22,0,0
534,11,0,2,2,0,0,0,0
3650,51,3,3,1,2,0,0,0
0,0,0,0,0,0,0,0,0
648069,3106,3,269,193,76,18,1,0
0,0,0,0,0,0,0,0,0
1108028,5103,10,799,774,25,24,1,0
1031544,2667,12,342,263,79,34,1,0
135955,767,6,151,147,4,11,1,0
409593,1557,10,233,113,120,4,1,0
6225,70,2,0,0,0,2,0,0
176327,2661,5,394,360,34,2,1,0
0,0,0,0,0,0,0,0,0
36206,615,5,49,41,8,1,1,0
0,0,0,0,0,0,0,0,0
0,0,0,0,0,0,0,0,0
106096,691,6,117,102,15,19,1,0
75085,689,6,117,102,15,19,1,0
218984,1891,7,408,358,50,5,1,0
38572,613,5,181,153,28,6,1,0
0,0,0,0,0,0,0,0,0
157877,234,1,12,12,0,0,1,0
22434,185,1,13,13,0,0,1,0
0,0,0,0,0,0,0,0,0
0,0,0,0,0,0,0,0,0
28087,279,8,18,16,2,4,1,0
343435,1297,5,143,19,124,0,1,0
0,0,0,0,0,0,0,0,0
179395,1364,6,295,283,12,1,0,0
0,0,0,0,0,0,0,0,0
396253,1425,15,131,128,3,6,1,0
2179959,414,9,56,54,2,7,1,0
223884,626,2,48,45,3,1,0,0
0,0,0,0,0,0,0,0,0
0,0,0,0,0,0,0,0,0
53074,318,14,55,51,4,0,1,0
25626,555,2,171,154,17,0,1,0
59419,414,2,180,180,0,7,1,0
11613,175,1,29,27,2,0,1,0
874379,3867,8,417,322,95,24,1,0
269027,906,11,179,169,10,2,1,0
568563,166,3,16,8,8,2,0,0
151992,1624,9,385,366,19,3,1,0
0,0,0,0,0,0,0,0,0
0,0,0,0,0,0,0,0,0
0,0,0,0,0,0,0,0,0
224223,995,4,362,342,20,1,0,0
16980,225,8,23,22,1,0,1,0
0,0,0,0,0,0,0,0,0
0,0,0,0,0,0,0,0,0
0,0,0,0,0,0,0,0,0
0,0,0,0,0,0,0,0,0
289693,4886,5,381,372,9,32,1,0
33066,421,5,102,93,9,12,1,0
0,0,0,0,0,0,0,0,0
67583,546,12,100,99,1,2,1,0
15921,183,2,24,22,2,3,1,0
65392,600,2,173,169,4,12,1,0
245706,1022,5,88,79,9,6,1,0
1170143,4260,0,295,270,25,5,1,0
1574,31,0,4,0,4,0,0,0
1616743,2577,6,70,70,0,6,1,0
92467,1041,2,60,33,27,2,1,0
459906,4052,6,542,514,28,20,1,0
22204,34,0,1,1,0,0,1,0
93921,589,9,102,99,3,5,1,0
135949,788,14,173,158,15,3,1,0
0,0,0,0,0,0,0,0,0
0,0,0,0,0,0,0,0,0
182350,1073,10,231,223,8,15,1,0
74800,405,11,55,47,8,3,1,0
0,0,0,0,0,0,0,0,0
0,0,0,0,0,0,0,0,0
160893,940,12,157,143,14,9,1,0
0,0,0,0,0,0,0,0,0
323950,2151,8,416,402,14,12,0,0
41205,288,4,62,47,15,2,0,0
175194,1033,3,95,84,11,4,1,0
0,0,0,0,0,0,0,0,0
82321,808,8,178,167,11,6,1,0
212203,3121,0,354,353,1,0,1,0
0,0,0,0,0,0,0,0,0
68434,565,8,144,138,6,0,1,0
77966,1002,2,153,147,6,5,1,0
69626,612,5,161,158,3,33,1,0
3533,64,2,12,12,0,2,1,0
0,0,0,0,0,0,0,0,0
90915,838,8,154,138,16,3,1,0
344198,1907,8,368,354,14,20,1,0
0,0,0,0,0,0,0,0,0
0,0,0,0,0,0,0,0,0
66133,262,4,20,20,0,1,1,0
0,0,0,0,0,0,0,0,0
0,0,0,0,0,0,0,0,0
0,0,0,0,0,0,0,0,0
77172,677,3,128,116,12,0,0,0
11881,57,4,3,3,0,2,0,0
15291,210,2,56,50,6,1,0,0
11999,169,3,36,33,3,1,0,0
1142654,1695,13,323,300,23,26,1,0
0,0,0,0,0,0,0,0,0
90127,778,9,313,313,0,11,1,0
23804,166,9,34,34,0,7,1,0
0,0,0,0,0,0,0,0,0
0,0,0,0,0,0,0,0,0
267915,1326,13,155,149,6,14,1,0
333506,1498,11,139,137,2,4,1,0
720994,541,0,4,0,4,2,1,1
0,0,0,0,0,0,0,0,0
60347,650,7,191,153,38,1,1,0
303517,1658,6,281,267,14,3,0,0
667872,2815,5,154,5,149,8,1,0
328981,130,2,7,6,1,0,1,0
0,0,0,0,0,0,0,0,0
0,0,0,0,0,0,0,0,0
252933,1813,7,140,111,29,18,1,0
200169,2017,18,322,315,7,17,0,0
196440,1035,4,95,93,2,12,1,0
0,0,0,0,0,0,0,0,0
0,0,0,0,0,0,0,0,0
0,0,0,0,0,0,0,0,0
200097,2218,13,322,106,216,12,1,0
151323,2643,3,327,320,7,47,1,0
32463,321,2,11,9,2,0,1,0
32463,321,2,11,9,2,0,1,0
459839,1547,9,233,224,9,14,1,0
0,0,0,0,0,0,0,0,0
25015,293,5,32,26,6,0,1,0
23691,46,0,5,2,3,0,0,0
41572,388,5,36,14,22,0,1,0
70262,725,4,134,129,5,13,1,0
7439,148,0,2,1,1,0,0,0
0,0,0,0,0,0,0,0,0
0,0,0,0,0,0,0,0,0
0,0,0,0,0,0,0,0,0
0,0,0,0,0,0,0,0,0
0,0,0,0,0,0,0,0,0
1155751,4394,6,1084,1076,8,10,1,0
1058129,3888,6,1016,1014,2,12,1,0
220249,2326,6,293,275,18,2,0,0
356268,381,9,31,31,0,3,1,0
168333,1567,8,275,256,19,40,1,0
0,0,0,0,0,0,0,0,0
150931,3612,2,1120,1114,6,20,1,0
1644,39,0,4,4,0,0,1,0
91592,544,9,89,85,4,0,0,0
0,0,0,0,0,0,0,0,0
188433,760,6,226,208,18,2,1,0
0,0,0,0,0,0,0,0,0
0,0,0,0,0,0,0,0,0
0,0,0,0,0,0,0,0,0
0,0,0,0,0,0,0,0,0
0,0,0,0,0,0,0,0,0
0,0,0,0,0,0,0,0,0
0,0,0,0,0,0,0,0,0
0,0,0,0,0,0,0,0,0
0,0,0,0,0,0,0,0,0
0,0,0,0,0,0,0,0,0
0,0,0,0,0,0,0,0,0
0,0,0,0,0,0,0,0,0
0,0,0,0,0,0,0,0,0
0,0,0,0,0,0,0,0,0
0,0,0,0,0,0,0,0,0
0,0,0,0,0,0,0,0,0
0,0,0,0,0,0,0,0,0
0,0,0,0,0,0,0,0,0
0,0,0,0,0,0,0,0,0
0,0,0,0,0,0,0,0,0
0,0,0,0,0,0,0,0,0
0,0,0,0,0,0,0,0,0
0,0,0,0,0,0,0,0,0
0,0,0,0,0,0,0,0,0
0,0,0,0,0,0,0,0,0
0,0,0,0,0,0,0,0,0
0,0,0,0,0,0,0,0,0
0,0,0,0,0,0,0,0,0
0,0,0,0,0,0,0,0,0
0,0,0,0,0,0,0,0,0
0,0,0,0,0,0,0,0,0
0,0,0,0,0,0,0,0,0
0,0,0,0,0,0,0,0,0
0,0,0,0,0,0,0,0,0
0,0,0,0,0,0,0,0,0
0,0,0,0,0,0,0,0,0
0,0,0,0,0,0,0,0,0
0,0,0,0,0,0,0,0,0
0,0,0,0,0,0,0,0,0
0,0,0,0,0,0,0,0,0
0,0,0,0,0,0,0,0,0
0,0,0,0,0,0,0,0,0
0,0,0,0,0,0,0,0,0
0,0,0,0,0,0,0,0,0
0,0,0,0,0,0,0,0,0
0,0,0,0,0,0,0,0,0
0,0,0,0,0,0,0,0,0
0,0,0,0,0,0,0,0,0
0,0,0,0,0,0,0,0,0
0,0,0,0,0,0,0,0,0
0,0,0,0,0,0,0,0,0
0,0,0,0,0,0,0,0,0
0,0,0,0,0,0,0,0,0
0,0,0,0,0,0,0,0,0
0,0,0,0,0,0,0,0,0
0,0,0,0,0,0,0,0,0
0,0,0,0,0,0,0,0,0
0,0,0,0,0,0,0,0,0
0,0,0,0,0,0,0,0,0
0,0,0,0,0,0,0,0,0
0,0,0,0,0,0,0,0,0
0,0,0,0,0,0,0,0,0
0,0,0,0,0,0,0,0,0
0,0,0,0,0,0,0,0,0
0,0,0,0,0,0,0,0,0
0,0,0,0,0,0,0,0,0
0,0,0,0,0,0,0,0,0
0,0,0,0,0,0,0,0,0
0,0,0,0,0,0,0,0,0
0,0,0,0,0,0,0,0,0
0,0,0,0,0,0,0,0,0
0,0,0,0,0,0,0,0,0
0,0,0,0,0,0,0,0,0
0,0,0,0,0,0,0,0,0
0,0,0,0,0,0,0,0,0
0,0,0,0,0,0,0,0,0
0,0,0,0,0,0,0,0,0
0,0,0,0,0,0,0,0,0
0,0,0,0,0,0,0,0,0
0,0,0,0,0,0,0,0,0
0,0,0,0,0,0,0,0,0
0,0,0,0,0,0,0,0,0
0,0,0,0,0,0,0,0,0
0,0,0,0,0,0,0,0,0
0,0,0,0,0,0,0,0,0
0,0,0,0,0,0,0,0,0
0,0,0,0,0,0,0,0,0
0,0,0,0,0,0,0,0,0
0,0,0,0,0,0,0,0,0
0,0,0,0,0,0,0,0,0
0,0,0,0,0,0,0,0,0
0,0,0,0,0,0,0,0,0
0,0,0,0,0,0,0,0,0
0,0,0,0,0,0,0,0,0
0,0,0,0,0,0,0,0,0
0,0,0,0,0,0,0,0,0
0,0,0,0,0,0,0,0,0
0,0,0,0,0,0,0,0,0
0,0,0,0,0,0,0,0,0
0,0,0,0,0,0,0,0,0
0,0,0,0,0,0,0,0,0
0,0,0,0,0,0,0,0,0
0,0,0,0,0,0,0,0,0
0,0,0,0,0,0,0,0,0
0,0,0,0,0,0,0,0,0
0,0,0,0,0,0,0,0,0
0,0,0,0,0,0,0,0,0
0,0,0,0,0,0,0,0,0
0,0,0,0,0,0,0,0,0
0,0,0,0,0,0,0,0,0
0,0,0,0,0,0,0,0,0
0,0,0,0,0,0,0,0,0
0,0,0,0,0,0,0,0,0
0,0,0,0,0,0,0,0,0
0,0,0,0,0,0,0,0,0
0,0,0,0,0,0,0,0,0
0,0,0,0,0,0,0,0,0
0,0,0,0,0,0,0,0,0
0,0,0,0,0,0,0,0,0
0,0,0,0,0,0,0,0,0
0,0,0,0,0,0,0,0,0
0,0,0,0,0,0,0,0,0
0,0,0,0,0,0,0,0,0
0,0,0,0,0,0,0,0,0
0,0,0,0,0,0,0,0,0
0,0,0,0,0,0,0,0,0
0,0,0,0,0,0,0,0,0
0,0,0,0,0,0,0,0,0
0,0,0,0,0,0,0,0,0
0,0,0,0,0,0,0,0,0
0,0,0,0,0,0,0,0,0
0,0,0,0,0,0,0,0,0
0,0,0,0,0,0,0,0,0
0,0,0,0,0,0,0,0,0
0,0,0,0,0,0,0,0,0
0,0,0,0,0,0,0,0,0
0,0,0,0,0,0,0,0,0
0,0,0,0,0,0,0,0,0
0,0,0,0,0,0,0,0,0
0,0,0,0,0,0,0,0,0
0,0,0,0,0,0,0,0,0
0,0,0,0,0,0,0,0,0
0,0,0,0,0,0,0,0,0
0,0,0,0,0,0,0,0,0
0,0,0,0,0,0,0,0,0
0,0,0,0,0,0,0,0,0
0,0,0,0,0,0,0,0,0
0,0,0,0,0,0,0,0,0
0,0,0,0,0,0,0,0,0
0,0,0,0,0,0,0,0,0
0,0,0,0,0,0,0,0,0
0,0,0,0,0,0,0,0,0
0,0,0,0,0,0,0,0,0
0,0,0,0,0,0,0,0,0
0,0,0,0,0,0,0,0,0
0,0,0,0,0,0,0,0,0
0,0,0,0,0,0,0,0,0
0,0,0,0,0,0,0,0,0
0,0,0,0,0,0,0,0,0
0,0,0,0,0,0,0,0,0
0,0,0,0,0,0,0,0,0
0,0,0,0,0,0,0,0,0
0,0,0,0,0,0,0,0,0
0,0,0,0,0,0,0,0,0
0,0,0,0,0,0,0,0,0
0,0,0,0,0,0,0,0,0
0,0,0,0,0,0,0,0,0
0,0,0,0,0,0,0,0,0
0,0,0,0,0,0,0,0,0
0,0,0,0,0,0,0,0,0
0,0,0,0,0,0,0,0,0
0,0,0,0,0,0,0,0,0
0,0,0,0,0,0,0,0,0
0,0,0,0,0,0,0,0,0
0,0,0,0,0,0,0,0,0
0,0,0,0,0,0,0,0,0
0,0,0,0,0,0,0,0,0
0,0,0,0,0,0,0,0,0
0,0,0,0,0,0,0,0,0
0,0,0,0,0,0,0,0,0
0,0,0,0,0,0,0,0,0
0,0,0,0,0,0,0,0,0
0,0,0,0,0,0,0,0,0
0,0,0,0,0,0,0,0,0
0,0,0,0,0,0,0,0,0
0,0,0,0,0,0,0,0,0
0,0,0,0,0,0,0,0,0
0,0,0,0,0,0,0,0,0
0,0,0,0,0,0,0,0,0
0,0,0,0,0,0,0,0,0
0,0,0,0,0,0,0,0,0
0,0,0,0,0,0,0,0,0
0,0,0,0,0,0,0,0,0
0,0,0,0,0,0,0,0,0
0,0,0,0,0,0,0,0,0
0,0,0,0,0,0,0,0,0
0,0,0,0,0,0,0,0,0
0,0,0,0,0,0,0,0,0
0,0,0,0,0,0,0,0,0
0,0,0,0,0,0,0,0,0
0,0,0,0,0,0,0,0,0
0,0,0,0,0,0,0,0,0
0,0,0,0,0,0,0,0,0
0,0,0,0,0,0,0,0,0
0,0,0,0,0,0,0,0,0
0,0,0,0,0,0,0,0,0
0,0,0,0,0,0,0,0,0
0,0,0,0,0,0,0,0,0
0,0,0,0,0,0,0,0,0
0,0,0,0,0,0,0,0,0
0,0,0,0,0,0,0,0,0
0,0,0,0,0,0,0,0,0
0,0,0,0,0,0,0,0,0
0,0,0,0,0,0,0,0,0
0,0,0,0,0,0,0,0,0
0,0,0,0,0,0,0,0,0
605534,5362,10,558,461,97,28,1,1
255836,680,10,120,101,19,22,1,0
0,0,0,0,0,0,0,0,0
108231,478,6,84,83,1,0,0,0
0,0,0,0,0,0,0,0,0
0,0,0,0,0,0,0,0,0
295429,1148,6,130,15,115,6,1,0
0,0,0,0,0,0,0,0,0
174231,1167,6,175,163,12,12,1,0
234345,423,2,15,13,2,4,1,0
278284,1327,9,271,256,15,13,1,0
105944,1530,7,383,370,13,21,1,0
0,0,0,0,0,0,0,0,0
0,0,0,0,0,0,0,0,0
0,0,0,0,0,0,0,0,0
25619,272,3,47,47,0,0,1,0
0,0,0,0,0,0,0,0,0
0,0,0,0,0,0,0,0,0
647357,3693,9,412,393,19,7,1,0
44439,981,4,352,352,0,1,0,0
203262,1452,2,176,163,13,4,1,0
0,0,0,0,0,0,0,0,0
244268,1265,4,153,132,21,1,1,0
105773,678,6,194,185,9,0,1,0
160404,1474,10,88,80,8,13,0,0
104592,907,10,68,62,6,15,0,0
115694,816,2,139,134,5,36,0,0
64518,238,4,20,20,0,0,1,0
215774,1450,3,209,200,9,4,1,0
106921,1228,5,279,261,18,1,1,0
0,0,0,0,0,0,0,0,0
509495,4328,13,568,508,60,80,1,0
19599,117,4,18,17,1,0,1,0
0,0,0,0,0,0,0,0,0
0,0,0,0,0,0,0,0,0
0,0,0,0,0,0,0,0,0
7084,153,0,46,40,6,0,0,0
0,0,0,0,0,0,0,0,0
0,0,0,0,0,0,0,0,0
202343,1254,8,230,192,38,2,1,0
39975,90,2,5,5,0,0,1,0
54370,323,8,73,73,0,2,1,0
0,0,0,0,0,0,0,0,0
393022,2222,6,432,416,16,13,1,0
436539,1018,3,159,146,13,2,1,0
6747,58,0,10,10,0,0,0,0
16832,132,1,10,10,0,0,0,0
27880,42,0,2,1,1,0,0,0
557300,2710,11,471,441,30,30,1,0
556327,2710,11,471,441,30,30,1,0
0,0,0,0,0,0,0,0,0
0,0,0,0,0,0,0,0,0
398961,2818,4,318,294,24,9,1,0
77667,729,2,68,57,11,7,1,0
102166,1032,3,239,237,2,10,1,0
192211,1387,2,393,374,19,19,1,0
0,0,0,0,0,0,0,0,0
133316,792,8,193,182,11,2,1,0
521650,1846,12,208,184,24,19,1,0
412876,1466,11,194,170,24,20,1,0
0,0,0,0,0,0,0,0,0
9202,144,4,44,44,0,3,1,0
0,0,0,0,0,0,0,0,0
0,0,0,0,0,0,0,0,0
140471,2328,10,540,486,54,25,1,0
119509,352,10,69,17,52,12,1,0
197706,547,0,15,4,11,17,0,0
25365,193,3,31,21,10,2,1,0
13521,82,3,12,11,1,3,1,0
0,0,0,0,0,0,0,0,0
0,0,0,0,0,0,0,0,0
0,0,0,0,0,0,0,0,0
0,0,0,0,0,0,0,0,0
52775,493,1,99,48,51,0,1,0
211035,180,0,47,32,15,1,1,0
22844,37,0,2,1,1,0,1,0
0,0,0,0,0,0,0,0,0
89200,848,1,82,11,71,4,1,0
0,0,0,0,0,0,0,0,0
147701,615,3,83,79,4,2,1,0
196673,2059,3,400,390,10,1,1,0
232840,346,0,17,11,6,0,1,0
0,0,0,0,0,0,0,0,0
680367,1137,6,132,116,16,4,1,0
0,0,0,0,0,0,0,0,0
27687,42,0,2,1,1,0,0,0
0,0,0,0,0,0,0,0,0
0,0,0,0,0,0,0,0,0
296121,4373,6,560,548,12,64,1,0
0,0,0,0,0,0,0,0,0
162281,948,7,3,0,3,28,0,0
0,0,0,0,0,0,0,0,0
1411,32,0,4,4,0,0,0,0
19106,239,4,40,35,5,2,1,0
27420,86,0,1,0,1,0,0,0
0,0,0,0,0,0,0,0,0
0,0,0,0,0,0,0,0,0
0,0,0,0,0,0,0,0,0
210289,2325,7,401,298,103,36,1,0
0,0,0,0,0,0,0,0,0
414739,2283,2,279,227,52,2,1,0
3713,75,2,8,8,0,0,1,0
57433,567,3,100,96,4,9,1,0
19463,216,2,44,42,2,8,1,0
0,0,0,0,0,0,0,0,0
173570,1133,9,157,31,126,2,0,0
92875,445,9,59,57,2,0,0,0
0,0,0,0,0,0,0,0,0
0,0,0,0,0,0,0,0,0
0,0,0,0,0,0,0,0,0
156684,3306,2,819,784,35,480,1,0
0,0,0,0,0,0,0,0,0
0,0,0,0,0,0,0,0,0
0,0,0,0,0,0,0,0,0
0,0,0,0,0,0,0,0,0
267198,1521,13,435,435,0,14,1,0
255820,2056,14,371,370,1,14,1,0
165037,815,8,71,58,13,5,1,0
0,0,0,0,0,0,0,0,0
0,0,0,0,0,0,0,0,0
160232,485,4,42,35,7,4,1,0
0,0,0,0,0,0,0,0,0
0,0,0,0,0,0,0,0,0
126389,916,7,160,147,13,2,1,1
48225,826,1,127,127,0,6,1,0
47781,598,0,101,85,16,13,1,0
24705,333,0,88,79,9,8,1,0
68393,292,9,34,13,21,0,0,0
91149,999,11,155,142,13,7,1,0
46982,369,10,72,67,5,8,1,0
38737,425,4,48,41,7,0,0,0
0,0,0,0,0,0,0,0,0
5663,103,1,8,8,0,0,0,0
92467,1041,2,60,33,27,2,1,0
9166,64,1,7,6,1,7,1,0
2148614,3138,7,235,229,6,4,1,0
628993,5391,6,420,411,9,13,1,0
629380,5392,6,420,412,8,13,1,0
0,0,0,0,0,0,0,0,0
114657,979,15,207,199,8,7,1,0
0,0,0,0,0,0,0,0,0
0,0,0,0,0,0,0,0,0
0,0,0,0,0,0,0,0,0
0,0,0,0,0,0,0,0,0
0,0,0,0,0,0,0,0,0
27858,210,4,26,25,1,0,1,0
0,0,0,0,0,0,0,0,0
0,0,0,0,0,0,0,0,0
196733,1884,10,287,209,78,12,1,0
0,0,0,0,0,0,0,0,0
312767,1749,9,268,243,25,20,1,0
20712,209,4,24,24,0,0,1,0
128570,821,14,83,73,10,6,1,0
17873,425,5,122,116,6,0,0,0
0,0,0,0,0,0,0,0,0
336940,1739,6,158,116,42,4,0,0
136181,402,7,84,78,6,8,1,0
0,0,0,0,0,0,0,0,0
0,0,0,0,0,0,0,0,0
27646,42,0,2,1,1,0,0,0
0,0,0,0,0,0,0,0,0
0,0,0,0,0,0,0,0,0
155033,2698,4,243,235,8,2,1,0
10923,148,3,10,8,2,1,1,0
55432,721,0,154,152,2,0,1,0
20438,211,0,30,29,1,0,1,0
0,0,0,0,0,0,0,0,0
43398,328,7,101,97,4,0,1,0
612991,1966,4,501,475,26,1,1,1
0,0,0,0,0,0,0,0,0
404960,3787,4,565,423,142,1,1,0
254484,1216,13,264,237,27,26,1,0
0,0,0,0,0,0,0,0,0
28300,42,0,2,1,1,0,0,0
77221,931,7,110,102,8,3,0,0
0,0,0,0,0,0,0,0,0
98971,1170,8,87,85,2,0,1,0
98972,1170,8,87,85,2,0,1,0
125991,590,6,98,95,3,8,1,0
211918,701,10,95,74,21,8,1,0
206179,622,9,22,20,2,14,1,0
44905,385,7,55,19,36,0,1,0
0,0,0,0,0,0,0,0,0
39013,347,9,53,42,11,0,1,0
356718,1086,10,346,181,165,2,1,0
0,0,0,0,0,0,0,0,0
671921,8547,4,1714,1457,257,7,1,0
222549,1680,7,409,312,97,13,1,0
47688,541,5,110,102,8,4,1,0
0,0,0,0,0,0,0,0,0
17968,279,0,67,48,19,3,1,0
16249,191,0,16,10,6,3,0,0
446040,1895,5,236,194,42,6,1,0
44418,346,5,23,14,9,0,1,0
0,0,0,0,0,0,0,0,0
0,0,0,0,0,0,0,0,0
806347,1015,1,134,116,18,3,0,0
0,0,0,0,0,0,0,0,0
590784,1208,12,115,111,4,7,1,0
74490,234,9,10,8,2,7,1,0
0,0,0,0,0,0,0,0,0
103437,526,7,68,67,1,3,1,0
229874,759,5,147,146,1,10,1,0
0,0,0,0,0,0,0,0,0
24407,327,0,77,77,0,0,1,0
1376336,2804,4,339,330,9,23,1,0
0,0,0,0,0,0,0,0,0
1295841,9959,11,310,304,6,16,1,0
77692,997,5,160,149,11,3,0,0
293273,1557,6,214,202,12,5,1,0
0,0,0,0,0,0,0,0,0
0,0,0,0,0,0,0,0,0
0,0,0,0,0,0,0,0,0
134952,842,8,106,98,8,20,1,0
8218,74,7,4,4,0,0,0,0
0,0,0,0,0,0,0,0,0
23050,264,4,34,25,9,2,1,0
140992,452,4,22,11,11,0,1,0
377626,3031,9,412,401,11,2,0,0
0,0,0,0,0,0,0,0,0
0,0,0,0,0,0,0,0,0
39994,444,0,83,79,4,1,1,0
49130,713,8,59,54,5,9,1,0
1941,31,0,6,0,6,0,0,0
59208,1031,4,341,312,29,10,1,0
289230,1065,0,75,63,12,4,1,0
0,0,0,0,0,0,0,0,0
0,0,0,0,0,0,0,0,0
0,0,0,0,0,0,0,0,0
61612,896,2,126,35,91,24,1,0
106920,553,1,47,4,43,11,1,0
499844,3671,13,551,538,13,18,1,0
373317,1087,16,132,122,10,10,1,0
21954,33,0,1,1,0,0,1,0
225607,921,8,78,5,73,0,1,0
188966,563,8,64,57,7,0,1,0
28250,44,0,4,3,1,0,0,0
21999,33,0,1,1,0,0,1,0
0,0,0,0,0,0,0,0,0
254801,811,7,120,81,39,16,1,0
59617,214,0,34,32,2,0,0,0
1369958,4887,4,463,457,6,179,1,0
173141,2638,6,429,375,54,41,1,0
548441,4348,4,962,649,313,4,0,0
521890,3155,3,764,732,32,3,1,0
0,0,0,0,0,0,0,0,0
466126,2551,12,315,301,14,5,0,0
91826,1475,8,83,76,7,13,1,0
42043,815,3,217,189,28,3,1,0
10693,87,3,15,14,1,1,1,0
497823,1476,7,178,176,2,10,1,0
28415,248,6,8,4,4,1,1,0
95670,846,4,170,142,28,0,1,0
0,0,0,0,0,0,0,0,0
99931,484,10,41,41,0,0,1,0
133748,1008,8,294,259,35,2,1,0
107555,560,5,81,40,41,3,1,0
0,0,0,0,0,0,0,0,0
0,0,0,0,0,0,0,0,0
113169,655,7,172,158,14,0,1,0
0,0,0,0,0,0,0,0,0
0,0,0,0,0,0,0,0,0
0,0,0,0,0,0,0,0,0
0,0,0,0,0,0,0,0,0
0,0,0,0,0,0,0,0,0
0,0,0,0,0,0,0,0,0
26390,304,1,25,23,2,7,0,0
418218,1281,14,126,2,124,55,1,0
0,0,0,0,0,0,0,0,0
0,0,0,0,0,0,0,0,0
729045,1411,8,116,5,111,2,1,0
3880,61,1,6,5,1,0,0,0
0,0,0,0,0,0,0,0,0
0,0,0,0,0,0,0,0,0
1053726,6755,13,1972,1946,26,51,1,0
93432,786,10,152,128,24,16,1,0
233695,1324,10,218,211,7,17,1,0
0,0,0,0,0,0,0,0,0
0,0,0,0,0,0,0,0,0
0,0,0,0,0,0,0,0,0
54253,602,8,30,30,0,19,1,0
30794,288,6,26,25,1,8,1,0
0,0,0,0,0,0,0,0,0
174354,1335,7,181,152,29,11,1,0
123177,776,7,123,99,24,11,1,0
112012,643,8,93,86,7,0,1,0
110525,870,6,148,126,22,8,1,0
427347,746,7,139,123,16,14,1,0
0,0,0,0,0,0,0,0,0
337156,1635,17,102,98,4,1,1,0
0,0,0,0,0,0,0,0,0
66181,572,6,85,82,3,14,1,0
0,0,0,0,0,0,0,0,0
0,0,0,0,0,0,0,0,0
0,0,0,0,0,0,0,0,0
21901,33,0,1,1,0,0,1,0
10462,122,0,24,24,0,0,1,0
135883,1562,4,621,494,127,43,1,0
135883,1562,4,621,494,127,43,1,0
135883,1562,4,621,494,127,43,1,0
0,0,0,0,0,0,0,0,0
179419,1230,11,104,84,20,10,1,0
54574,218,10,6,6,0,1,0,0
0,0,0,0,0,0,0,0,0
0,0,0,0,0,0,0,0,0
145159,1161,3,266,243,23,9,0,0
71168,817,1,208,202,6,1,1,0
403562,2250,7,121,105,16,2,1,0
62497,40,0,5,5,0,0,0,0
195804,2488,8,462,446,16,13,1,0
0,0,0,0,0,0,0,0,0
0,0,0,0,0,0,0,0,0
2340862,3262,7,149,137,12,5,0,0
0,0,0,0,0,0,0,0,0
22357,145,3,30,22,8,0,0,0
986523,3865,4,430,110,320,0,1,0
72186,493,0,6,3,3,3,0,0
136280,472,8,85,71,14,10,1,0
103796,949,5,214,179,35,0,0,0
31263,143,5,10,8,2,0,0,0
0,0,0,0,0,0,0,0,0
43165,744,4,175,138,37,3,1,0
22439,239,0,43,35,8,0,1,0
0,0,0,0,0,0,0,0,0
0,0,0,0,0,0,0,0,0
339290,2726,5,730,710,20,30,1,0
0,0,0,0,0,0,0,0,0
0,0,0,0,0,0,0,0,0
21914,35,0,1,1,0,0,1,0
172036,2186,10,335,305,30,1,1,0
61320,968,10,138,111,27,2,1,0
0,0,0,0,0,0,0,0,0
217907,297,8,44,37,7,0,1,0
0,0,0,0,0,0,0,0,0
27420,312,4,93,85,8,2,0,0
0,0,0,0,0,0,0,0,0
172216,1123,6,160,153,7,6,1,0
0,0,0,0,0,0,0,0,0
0,0,0,0,0,0,0,0,0
0,0,0,0,0,0,0,0,0
303720,1715,8,140,46,94,6,0,0
386275,1131,9,177,159,18,28,1,0
77451,903,5,93,65,28,5,1,0
47531,114,3,5,5,0,1,0,0
0,0,0,0,0,0,0,0,0
0,0,0,0,0,0,0,0,0
0,0,0,0,0,0,0,0,0
0,0,0,0,0,0,0,0,0
0,0,0,0,0,0,0,0,0
233710,1065,9,90,87,3,4,1,0
0,0,0,0,0,0,0,0,0
356269,929,5,95,74,21,8,1,0
0,0,0,0,0,0,0,0,0
87359,714,11,83,73,10,2,1,0
0,0,0,0,0,0,0,0,0
0,0,0,0,0,0,0,0,0
224610,1378,4,336,324,12,18,1,0
104213,1127,12,157,147,10,6,1,0
0,0,0,0,0,0,0,0,0
0,0,0,0,0,0,0,0,0
99916,585,5,151,144,7,18,0,0
0,0,0,0,0,0,0,0,0
577226,4216,5,505,442,63,18,0,0
354724,2793,5,332,268,64,19,0,0
82402,665,6,130,129,1,35,0,0
80972,662,6,130,129,1,36,0,0
0,0,0,0,0,0,0,0,0
75272,1149,8,113,82,31,11,1,0
37752,463,8,89,50,39,2,0,0
23036,350,6,50,45,5,0,1,0
0,0,0,0,0,0,0,0,0
0,0,0,0,0,0,0,0,0
143756,1144,3,209,181,28,33,1,0
2132691,5672,5,1566,1529,37,3,1,0
0,0,0,0,0,0,0,0,0
80223,112,1,14,14,0,4,1,0
141856,545,2,119,102,17,1,1,0
0,0,0,0,0,0,0,0,0
6043,72,2,3,1,2,0,1,0
408272,2786,5,216,212,4,2,0,0
0,0,0,0,0,0,0,0,0
105359,153,1,6,6,0,3,1,0
106824,179,1,14,12,2,4,1,0
0,0,0,0,0,0,0,0,0
100028,402,1,50,37,13,1,0,0
392299,2641,10,144,108,36,1,0,0
0,0,0,0,0,0,0,0,0
0,0,0,0,0,0,0,0,0
141311,210,7,43,41,2,1,1,0
0,0,0,0,0,0,0,0,0
124445,855,9,131,118,13,1,1,0
299532,2260,11,273,253,20,12,1,0
0,0,0,0,0,0,0,0,0
124003,1052,0,156,78,78,0,1,0
101845,1208,8,339,339,0,1,1,0
0,0,0,0,0,0,0,0,0
0,0,0,0,0,0,0,0,0
875490,9909,2,97,86,11,1,1,0
68453,649,6,108,94,14,14,1,0
0,0,0,0,0,0,0,0,0
0,0,0,0,0,0,0,0,0
425152,1550,11,352,346,6,22,1,0
0,0,0,0,0,0,0,0,0
0,0,0,0,0,0,0,0,0
0,0,0,0,0,0,0,0,0
0,0,0,0,0,0,0,0,0
0,0,0,0,0,0,0,0,0
0,0,0,0,0,0,0,0,0
237936,711,5,90,69,21,4,1,0
0,0,0,0,0,0,0,0,0
0,0,0,0,0,0,0,0,0
316555,1239,3,235,220,15,5,1,0
0,0,0,0,0,0,0,0,0
238801,3108,10,204,175,29,8,1,0
64805,328,11,12,9,3,7,0,0
0,0,0,0,0,0,0,0,0
50047,687,4,126,123,3,9,0,0
17229,242,4,55,54,1,3,0,0
0,0,0,0,0,0,0,0,0
238929,3140,1,873,749,124,127,1,0
436318,3734,20,513,441,72,9,1,0
701404,927,7,41,0,41,4,0,0
184263,1600,4,185,181,4,4,1,0
0,0,0,0,0,0,0,0,0
0,0,0,0,0,0,0,0,0
0,0,0,0,0,0,0,0,0
73661,600,6,67,52,15,0,1,0
35976,437,9,81,67,14,5,1,0
0,0,0,0,0,0,0,0,0
610839,2214,2,60,57,3,0,1,0
607726,2172,2,71,68,3,0,1,0
0,0,0,0,0,0,0,0,0
155049,1694,4,289,273,16,14,1,0
107985,1318,10,179,170,9,6,1,0
3676,41,4,2,2,0,0,0,0
0,0,0,0,0,0,0,0,0
44330,485,7,47,42,5,1,1,0
0,0,0,0,0,0,0,0,0
84242,603,7,118,95,23,8,1,0
1339812,669,7,6,6,0,7,1,0
566189,4061,15,679,425,254,24,1,0
0,0,0,0,0,0,0,0,0
0,0,0,0,0,0,0,0,0
219200,1356,6,207,200,7,70,1,0
289189,1881,4,124,82,42,4,1,0
0,0,0,0,0,0,0,0,0
48021,451,3,84,41,43,4,0,0
55968,873,3,240,230,10,11,0,0
15817,272,2,72,67,5,11,0,0
210835,4826,3,882,881,1,0,0,0
3829,53,1,5,5,0,0,0,0
0,0,0,0,0,0,0,0,0
201358,1563,7,184,139,45,2,1,0
192527,1149,8,192,39,153,24,1,0
278615,5355,3,521,510,11,0,0,0
87567,1179,4,172,167,5,0,1,0
9027,82,2,4,1,3,2,0,0
22719,37,0,2,1,1,0,1,0
139271,809,4,161,120,41,5,0,0
0,0,0,0,0,0,0,0,0
213297,2214,10,383,382,1,0,1,0
0,0,0,0,0,0,0,0,0
176723,1279,7,201,195,6,20,1,0
0,0,0,0,0,0,0,0,0
0,0,0,0,0,0,0,0,0
0,0,0,0,0,0,0,0,0
0,0,0,0,0,0,0,0,0
0,0,0,0,0,0,0,0,0
152945,649,13,66,64,2,22,1,0
0,0,0,0,0,0,0,0,0
0,0,0,0,0,0,0,0,0
0,0,0,0,0,0,0,0,0
193849,752,14,172,157,15,21,1,0
0,0,0,0,0,0,0,0,0
0,0,0,0,0,0,0,0,0
0,0,0,0,0,0,0,0,0
162316,868,6,108,85,23,5,1,0
96048,994,11,132,119,13,30,0,0
334194,1833,1,378,327,51,1,1,0
0,0,0,0,0,0,0,0,0
0,0,0,0,0,0,0,0,0
0,0,0,0,0,0,0,0,0
44323,494,2,75,64,11,0,1,0
160972,1457,13,175,153,22,17,0,0
0,0,0,0,0,0,0,0,0
0,0,0,0,0,0,0,0,0
51192,306,3,64,26,38,4,1,0
194449,853,6,157,152,5,17,1,0
278258,2608,4,261,252,9,88,0,0
89241,1392,6,296,236,60,5,1,0
0,0,0,0,0,0,0,0,0
113761,886,3,108,94,14,8,1,0
0,0,0,0,0,0,0,0,0
0,0,0,0,0,0,0,0,0
0,0,0,0,0,0,0,0,0
58107,649,9,34,33,1,0,1,0
0,0,0,0,0,0,0,0,0
0,0,0,0,0,0,0,0,0
0,0,0,0,0,0,0,0,0
124756,1028,8,257,223,34,4,1,0
0,0,0,0,0,0,0,0,0
96580,1406,8,49,47,2,29,1,0
195625,1645,12,404,403,1,56,1,0
89677,263,0,48,40,8,0,1,1
0,0,0,0,0,0,0,0,0
0,0,0,0,0,0,0,0,0
0,0,0,0,0,0,0,0,0
116292,583,6,78,69,9,8,1,0
1886209,16067,6,5643,5633,10,4,1,0
221365,1184,4,83,14,69,4,0,0
550290,1535,8,180,175,5,10,0,0
48764,672,6,92,66,26,2,1,0
0,0,0,0,0,0,0,0,0
0,0,0,0,0,0,0,0,0
0,0,0,0,0,0,0,0,0
234770,577,3,27,9,18,1,0,0
0,0,0,0,0,0,0,0,0
0,0,0,0,0,0,0,0,0
0,0,0,0,0,0,0,0,0
0,0,0,0,0,0,0,0,0
198,6,0,0,0,0,0,0,0
0,0,0,0,0,0,0,0,0
656539,2255,12,210,78,132,18,1,0
0,0,0,0,0,0,0,0,0
0,0,0,0,0,0,0,0,0
42361,478,3,123,41,82,0,1,0
28357,282,1,44,43,1,1,1,0
0,0,0,0,0,0,0,0,0
0,0,0,0,0,0,0,0,0
0,0,0,0,0,0,0,0,0
0,0,0,0,0,0,0,0,0
146343,1518,5,169,83,86,0,1,0
506670,2854,9,376,301,75,32,1,0
68312,427,6,67,67,0,2,0,0
0,0,0,0,0,0,0,0,0
0,0,0,0,0,0,0,0,0
78901,874,7,235,220,15,12,1,0
56150,645,5,192,181,11,6,1,0
1125690,7843,4,2154,1711,443,4,1,0
674662,556,0,4,2,2,2,1,1
228493,2343,2,261,259,2,1,1,0
233997,1838,13,460,403,57,18,1,0
6922,116,3,39,35,4,0,0,0
22909,37,0,2,1,1,0,1,0
142302,964,7,232,222,10,6,1,0
0,0,0,0,0,0,0,0,0
43788,578,2,126,94,32,0,1,0
0,0,0,0,0,0,0,0,0
0,0,0,0,0,0,0,0,0
0,0,0,0,0,0,0,0,0
46752,715,4,154,130,24,2,1,0
0,0,0,0,0,0,0,0,0
364699,4582,13,933,909,24,16,1,0
0,0,0,0,0,0,0,0,0
505336,2502,16,141,86,55,22,1,0
158600,1533,10,283,277,6,8,1,0
93705,1333,10,251,245,6,8,1,0
103885,977,8,35,25,10,2,1,0
0,0,0,0,0,0,0,0,0
226402,973,9,218,212,6,6,1,0
0,0,0,0,0,0,0,0,0
21640,213,5,31,28,3,0,1,0
0,0,0,0,0,0,0,0,0
125574,1196,12,258,235,23,5,1,0
2453,43,3,0,0,0,0,0,0
180042,1131,3,289,246,43,0,1,0
22667,34,0,1,1,0,0,1,0
0,0,0,0,0,0,0,0,0
33879,656,3,105,99,6,0,1,0
1596600,10677,12,247,241,6,6,1,0
1501824,12615,12,131,125,6,9,1,0
0,0,0,0,0,0,0,0,0
0,0,0,0,0,0,0,0,0
1401540,14149,8,2913,2904,9,7,1,0
749940,6686,8,1447,1434,13,14,1,0
124934,2232,6,297,264,33,3,0,0
90304,263,0,48,24,24,0,1,1
175010,141,0,5,5,0,0,0,0
282306,1120,7,243,241,2,8,1,0
1301569,2606,9,98,71,27,6,1,0
705392,1195,8,68,43,25,6,1,0
0,0,0,0,0,0,0,0,0
145236,760,7,139,114,25,8,1,0
0,0,0,0,0,0,0,0,0
586454,2588,5,215,201,14,3,1,0
2539,33,0,2,2,0,0,0,0
127413,991,1,189,182,7,82,1,0
32742,118,2,16,10,6,4,1,0
295617,4615,11,719,698,21,31,1,0
0,0,0,0,0,0,0,0,0
109218,1357,5,220,193,27,7,1,0
0,0,0,0,0,0,0,0,0
252275,1975,4,172,144,28,6,1,0
43652,423,6,86,83,3,10,0,0
99669,673,7,87,44,43,4,1,0
110094,594,10,39,22,17,2,1,0
10934,238,1,99,96,3,0,1,0
0,0,0,0,0,0,0,0,0
646079,2377,9,334,268,66,17,1,0
0,0,0,0,0,0,0,0,0
140791,2192,12,421,416,5,5,1,0
238017,2074,2,213,170,43,1,0,0
94664,796,4,130,124,6,6,1,0
158452,473,10,64,34,30,7,1,0
0,0,0,0,0,0,0,0,0
0,0,0,0,0,0,0,0,0
22027,34,0,1,1,0,0,1,0
0,0,0,0,0,0,0,0,0
0,0,0,0,0,0,0,0,0
380554,1444,11,94,90,4,12,1,0
0,0,0,0,0,0,0,0,0
71646,1202,0,191,189,2,0,1,0
229079,3017,4,667,655,12,4,1,0
76521,700,5,74,74,0,6,1,0
9995,65,0,3,3,0,0,0,0
15111,323,3,116,116,0,0,1,0
0,0,0,0,0,0,0,0,0
2491,28,4,0,0,0,0,0,0
81007,1389,2,268,257,11,0,1,1
395411,2203,11,91,84,7,5,1,0
0,0,0,0,0,0,0,0,0
0,0,0,0,0,0,0,0,0
0,0,0,0,0,0,0,0,0
22950,37,0,2,1,1,0,1,0
122038,857,9,117,112,5,3,0,0
139106,911,9,122,112,10,3,0,0
111257,663,1,138,137,1,20,1,0
351433,2247,9,191,152,39,13,1,0
163813,878,10,77,38,39,20,1,0
0,0,0,0,0,0,0,0,0
0,0,0,0,0,0,0,0,0
0,0,0,0,0,0,0,0,0
49683,974,1,452,428,24,0,1,0
3346,65,0,14,14,0,0,1,0
0,0,0,0,0,0,0,0,0
0,0,0,0,0,0,0,0,0
626116,2762,15,358,350,8,17,1,0
257668,470,15,53,46,7,16,1,0
0,0,0,0,0,0,0,0,0
106556,1330,9,114,110,4,19,1,0
0,0,0,0,0,0,0,0,0
76683,578,1,25,25,0,2,1,0
0,0,0,0,0,0,0,0,0
9803,104,3,12,12,0,2,1,0
0,0,0,0,0,0,0,0,0
189571,566,11,77,65,12,6,1,0
0,0,0,0,0,0,0,0,0
935918,8160,6,2708,2645,63,76,1,0
0,0,0,0,0,0,0,0,0
0,0,0,0,0,0,0,0,0
0,0,0,0,0,0,0,0,0
0,0,0,0,0,0,0,0,0
55278,553,8,112,77,35,9,0,0
127567,456,11,36,34,2,3,1,0
24222,365,1,90,71,19,2,1,0
585421,502,5,67,60,7,4,0,0
5968,73,2,4,4,0,0,0,0
0,0,0,0,0,0,0,0,0
0,0,0,0,0,0,0,0,0
0,0,0,0,0,0,0,0,0
0,0,0,0,0,0,0,0,0
0,0,0,0,0,0,0,0,0
0,0,0,0,0,0,0,0,0
66358,651,5,145,137,8,1,1,0
32748,396,7,78,74,4,1,1,0
59715,919,2,372,372,0,8,0,0
0,0,0,0,0,0,0,0,0
47179,409,7,57,19,38,0,1,0
0,0,0,0,0,0,0,0,0
0,0,0,0,0,0,0,0,0
0,0,0,0,0,0,0,0,0
0,0,0,0,0,0,0,0,0
73914,1313,3,345,329,16,6,0,0
62492,1130,2,324,312,12,6,0,0
88511,644,2,118,101,17,3,1,0
1192425,2924,7,614,545,69,17,1,0
703245,577,7,90,60,30,13,1,0
34875,253,8,50,48,2,0,1,0
198965,2392,6,233,223,10,12,1,0
46614,426,6,62,49,13,10,1,0
0,0,0,0,0,0,0,0,0
0,0,0,0,0,0,0,0,0
0,0,0,0,0,0,0,0,0
0,0,0,0,0,0,0,0,0
106729,556,5,128,65,63,1,0,0
0,0,0,0,0,0,0,0,0
0,0,0,0,0,0,0,0,0
57045,913,3,220,213,7,4,1,0
26552,371,3,111,106,5,3,1,0
49482,382,4,47,34,13,12,0,0
379384,947,8,53,41,12,8,0,0
13265,134,4,3,1,2,9,0,0
0,0,0,0,0,0,0,0,0
433593,4188,3,1810,74,1736,22,0,0
28834,42,0,2,1,1,0,0,0
239317,284,2,53,1,52,1,1,0
62010,298,5,29,12,17,0,1,0
97637,624,13,122,122,0,0,1,0
98918,296,13,38,36,2,0,1,0
369569,2153,9,453,388,65,3,1,0
0,0,0,0,0,0,0,0,0
1566838,2441,14,307,272,35,21,1,0
186463,1776,4,278,255,23,11,1,0
50362,500,4,50,31,19,15,1,0
22978,34,0,1,1,0,0,1,0
11196,46,1,1,0,1,0,0,0
195249,1118,3,87,82,5,22,1,0
1280,19,2,0,0,0,0,0,0
648103,4888,4,281,269,12,71,1,0
40204,369,4,41,28,13,2,1,0
90381,1249,5,365,365,0,4,1,0
0,0,0,0,0,0,0,0,0
110083,2015,7,222,216,6,6,1,0
47164,597,6,207,202,5,6,1,0
0,0,0,0,0,0,0,0,0
0,0,0,0,0,0,0,0,0
55736,583,9,112,100,12,0,0,0
59501,526,9,88,70,18,0,0,0
151862,1057,4,354,105,249,2,1,0
60746,733,5,249,64,185,1,1,0
736871,2859,12,254,202,52,7,0,0
0,0,0,0,0,0,0,0,0
3551,21,0,7,0,7,0,0,0
182564,1001,3,307,270,37,11,1,0
0,0,0,0,0,0,0,0,0
0,0,0,0,0,0,0,0,0
311646,872,9,172,164,8,59,1,0
353292,1856,8,216,167,49,42,1,0
51378,792,3,176,171,5,2,1,0
0,0,0,0,0,0,0,0,0
0,0,0,0,0,0,0,0,0
116821,443,2,14,12,2,11,1,0
69467,469,10,52,47,5,1,1,0
72371,504,10,55,50,5,1,1,0
114239,737,6,96,69,27,3,0,0
0,0,0,0,0,0,0,0,0
0,0,0,0,0,0,0,0,0
0,0,0,0,0,0,0,0,0
79126,970,3,237,220,17,0,1,0
0,0,0,0,0,0,0,0,0
97596,609,6,172,170,2,0,1,0
132022,626,16,86,77,9,10,1,0
30542,468,3,73,72,1,0,1,0
87720,589,2,59,56,3,3,0,0
132729,1940,4,587,580,7,14,1,0
0,0,0,0,0,0,0,0,0
18956,328,0,81,75,6,2,0,0
11359,190,0,50,46,4,0,0,0
0,0,0,0,0,0,0,0,0
0,0,0,0,0,0,0,0,0
0,0,0,0,0,0,0,0,0
1112,16,0,0,0,0,0,0,0
9218,119,5,16,13,3,1,1,0
11254,127,6,7,7,0,2,1,0
53993,134,4,8,6,2,0,0,0
51675,309,12,55,52,3,0,0,0
0,0,0,0,0,0,0,0,0
0,0,0,0,0,0,0,0,0
0,0,0,0,0,0,0,0,0
0,0,0,0,0,0,0,0,0
0,0,0,0,0,0,0,0,0
0,0,0,0,0,0,0,0,0
621535,566,8,92,86,6,6,1,0
620973,496,10,62,55,7,7,1,0
570114,5469,7,225,216,9,2,1,0
0,0,0,0,0,0,0,0,0
0,0,0,0,0,0,0,0,0
271664,1602,6,116,7,109,12,1,0
0,0,0,0,0,0,0,0,0
31834,361,3,76,68,8,0,1,0
0,0,0,0,0,0,0,0,0
249035,2037,4,488,486,2,13,1,0
27853,326,4,49,47,2,13,1,0
0,0,0,0,0,0,0,0,0
25056,323,3,33,31,2,2,1,0
6962,60,3,0,0,0,0,1,0
40554,271,7,51,44,7,2,1,0
0,0,0,0,0,0,0,0,0
0,0,0,0,0,0,0,0,0
45116,531,4,99,96,3,9,1,0
543871,5925,8,1511,1439,72,17,0,0
0,0,0,0,0,0,0,0,0
27407,486,3,77,75,2,2,1,0
394959,319,0,10,10,0,0,1,0
0,0,0,0,0,0,0,0,0
0,0,0,0,0,0,0,0,0
0,0,0,0,0,0,0,0,0
59165,197,1,6,4,2,0,0,0
178470,483,8,111,102,9,0,1,0
264664,910,13,121,116,5,19,1,0
0,0,0,0,0,0,0,0,0
558099,2904,4,472,466,6,8,1,0
279232,2186,4,404,398,6,8,1,0
0,0,0,0,0,0,0,0,0
642342,2173,14,396,43,353,16,1,0
327096,517,11,55,41,14,13,1,0
229028,2483,10,54,47,7,2,0,0
0,0,0,0,0,0,0,0,0
420220,1260,15,155,29,126,40,1,0
309620,716,15,70,51,19,34,1,0
138645,996,7,181,176,5,11,1,0
52163,545,8,144,144,0,2,1,0
0,0,0,0,0,0,0,0,0
125535,970,12,177,168,9,9,1,0
92720,315,12,29,29,0,7,0,0
92467,1041,2,60,33,27,2,1,0
350033,1727,5,157,124,33,2,1,0
0,0,0,0,0,0,0,0,0
22882,37,0,2,1,1,0,1,0
520759,562,2,69,66,3,1,1,0
120057,771,4,85,80,5,101,1,0
0,0,0,0,0,0,0,0,0
0,0,0,0,0,0,0,0,0
0,0,0,0,0,0,0,0,0
94497,1224,1,203,160,43,9,1,0
409626,4703,7,469,459,10,11,1,0
91297,1114,2,217,209,8,6,1,0
0,0,0,0,0,0,0,0,0
211870,1711,6,265,228,37,46,1,0
0,0,0,0,0,0,0,0,0
0,0,0,0,0,0,0,0,0
0,0,0,0,0,0,0,0,0
0,0,0,0,0,0,0,0,0
333150,1678,11,149,142,7,5,1,0
410687,1573,13,77,69,8,21,1,0
20335,325,2,80,78,2,0,1,0
2570,45,1,4,4,0,0,0,0
115795,1321,7,132,115,17,14,1,0
46105,340,4,38,34,4,19,1,0
77242,794,10,137,107,30,13,1,0
1584507,582,10,131,110,21,0,1,0
0,0,0,0,0,0,0,0,0
51110,548,5,192,188,4,8,1,0
436357,987,13,107,94,13,3,1,0
380566,900,6,9,7,2,1,0,0
545333,2079,12,261,235,26,34,1,0
1059641,8791,6,154,144,10,5,1,0
1113189,10190,10,57,52,5,8,1,0
38321,653,1,178,106,72,1,0,0
14535,272,1,82,68,14,1,0,0
63097,561,11,99,90,9,3,1,0
48553,324,11,53,44,9,4,1,0
0,0,0,0,0,0,0,0,0
0,0,0,0,0,0,0,0,0
223210,1028,10,81,81,0,3,0,0
117870,1188,9,206,205,1,43,1,0
556698,4326,10,584,564,20,7,0,0
0,0,0,0,0,0,0,0,0
261336,1233,8,308,288,20,14,1,0
117544,1454,6,255,237,18,4,1,0
66307,932,1,72,17,55,0,1,0
103596,1312,7,317,284,33,0,1,0
0,0,0,0,0,0,0,0,0
226641,839,7,144,127,17,14,0,0
0,0,0,0,0,0,0,0,0
101267,844,3,133,118,15,6,1,1
393908,921,11,83,62,21,1,1,0
63377,121,3,3,3,0,0,0,0
0,0,0,0,0,0,0,0,0
81989,489,9,42,40,2,0,1,0
0,0,0,0,0,0,0,0,0
422132,3443,12,93,40,53,5,1,0
0,0,0,0,0,0,0,0,0
72943,855,3,120,101,19,3,1,0
0,0,0,0,0,0,0,0,0
0,0,0,0,0,0,0,0,0
1535195,15602,7,992,920,72,14,1,0
955231,9797,7,960,925,35,12,1,0
175790,977,1,99,85,14,10,1,0
265553,1576,7,253,132,121,12,1,0
115202,1835,4,411,251,160,2,1,0
0,0,0,0,0,0,0,0,0
0,0,0,0,0,0,0,0,0
22062,35,0,1,1,0,0,1,0
0,0,0,0,0,0,0,0,0
34168,286,4,40,36,4,1,0,0
0,0,0,0,0,0,0,0,0
0,0,0,0,0,0,0,0,0
573309,2088,12,28,26,2,24,1,0
24099,138,7,7,7,0,1,1,0
0,0,0,0,0,0,0,0,0
0,0,0,0,0,0,0,0,0
0,0,0,0,0,0,0,0,0
37738,404,1,61,13,48,0,1,0
250691,1886,17,244,197,47,20,1,0
89694,255,0,48,24,24,0,1,1
296129,2195,4,162,154,8,2,1,0
18410,59,1,2,0,2,2,0,0
150120,1744,7,195,190,5,17,1,0
121495,1361,7,149,144,5,17,1,0
84620,1048,7,261,251,10,4,1,0
40160,680,7,208,203,5,3,1,0
151032,1015,9,133,116,17,2,1,0
175924,102,0,2,1,1,2,1,0
32608,794,0,311,307,4,0,1,0
59260,794,4,165,150,15,15,1,0
540810,1745,2,264,111,153,14,1,0
80561,112,1,10,1,9,2,0,0
0,0,0,0,0,0,0,0,0
0,0,0,0,0,0,0,0,0
0,0,0,0,0,0,0,0,0
353099,2690,8,240,171,69,30,1,0
9938,120,2,11,11,0,2,1,0
283925,1529,14,197,159,38,18,1,0
130809,880,4,557,542,15,0,1,0
34434,171,3,21,21,0,0,1,0
0,0,0,0,0,0,0,0,0
50634,945,7,160,158,2,18,1,0
0,0,0,0,0,0,0,0,0
0,0,0,0,0,0,0,0,0
0,0,0,0,0,0,0,0,0
43260,231,5,7,3,4,3,1,0
7391,57,3,5,2,3,0,1,0
19731,355,1,122,121,1,1,0,0
75675,551,9,97,85,12,8,1,0
0,0,0,0,0,0,0,0,0
0,0,0,0,0,0,0,0,0
741905,917,4,55,47,8,17,1,0
55404,303,6,15,13,2,5,1,0
0,0,0,0,0,0,0,0,0
0,0,0,0,0,0,0,0,0
499577,1042,13,60,30,30,0,1,0
0,0,0,0,0,0,0,0,0
250251,1362,13,271,13,258,0,1,0
329594,1648,9,151,139,12,6,1,0
0,0,0,0,0,0,0,0,0
58275,1070,3,267,264,3,6,0,0
0,0,0,0,0,0,0,0,0
22598,451,3,126,100,26,1,1,0
0,0,0,0,0,0,0,0,0
0,0,0,0,0,0,0,0,0
0,0,0,0,0,0,0,0,0
152607,1317,9,200,174,26,14,1,0
23978,174,5,7,4,3,4,0,0
0,0,0,0,0,0,0,0,0
20713,323,4,90,89,1,3,1,0
3641,37,0,4,0,4,0,1,0
139653,690,12,131,127,4,2,1,0
149329,863,0,168,154,14,5,1,0
55075,408,2,102,102,0,1,1,0
0,0,0,0,0,0,0,0,0
122828,754,7,76,71,5,0,1,0
0,0,0,0,0,0,0,0,0
5770,139,0,23,6,17,0,1,0
0,0,0,0,0,0,0,0,0
0,0,0,0,0,0,0,0,0
469289,4044,11,811,716,95,25,1,0
231616,1904,10,152,90,62,33,1,0
0,0,0,0,0,0,0,0,0
179293,1070,6,185,172,13,10,1,0
93708,601,6,141,131,10,6,1,0
172567,2256,11,359,351,8,32,1,0
83835,290,8,14,10,4,0,1,0
194442,2273,3,529,464,65,9,1,0
25862,146,5,13,11,2,5,1,0
1197,12,0,0,0,0,0,0,0
0,0,0,0,0,0,0,0,0
45453,601,3,138,130,8,2,1,0
105021,224,2,41,2,39,0,1,0
0,0,0,0,0,0,0,0,0
318355,1414,8,222,176,46,13,1,0
0,0,0,0,0,0,0,0,0
0,0,0,0,0,0,0,0,0
22912,37,0,2,1,1,0,1,0
681917,2253,3,238,213,25,15,1,0
0,0,0,0,0,0,0,0,0
0,0,0,0,0,0,0,0,0
942994,3451,7,726,623,103,5,1,0
2921488,1121,4,110,87,23,22,1,0
178155,1207,5,157,154,3,25,1,0
643455,261,3,13,7,6,1,1,0
0,0,0,0,0,0,0,0,0
1298776,4425,2,292,223,69,3,1,0
0,0,0,0,0,0,0,0,0
294886,1130,14,178,141,37,6,1,0
0,0,0,0,0,0,0,0,0
0,0,0,0,0,0,0,0,0
581044,1514,16,37,35,2,40,1,0
627827,2616,9,439,251,188,60,1,0
0,0,0,0,0,0,0,0,0
0,0,0,0,0,0,0,0,0
0,0,0,0,0,0,0,0,0
38003,387,5,101,101,0,9,1,0
9277,125,4,14,14,0,0,1,0
550141,3098,6,458,428,30,0,1,0
258192,1682,15,473,11,462,7,1,0
0,0,0,0,0,0,0,0,0
0,0,0,0,0,0,0,0,0
0,0,0,0,0,0,0,0,0
3278,36,3,5,1,4,0,0,0
26938,130,6,5,0,5,2,0,0
615682,2523,7,408,387,21,2,1,0
1645451,1296,10,225,212,13,19,0,0
0,0,0,0,0,0,0,0,0
0,0,0,0,0,0,0,0,0
477979,6058,6,1520,1517,3,14,1,0
735844,1455,17,154,153,1,42,0,0
1309865,10456,9,168,157,11,16,1,0
286318,836,10,35,26,9,0,1,0
0,0,0,0,0,0,0,0,0
825761,3793,8,392,329,63,11,1,0
0,0,0,0,0,0,0,0,0
222961,3990,1,1611,1586,25,2,0,0
0,0,0,0,0,0,0,0,0
66621,989,3,63,62,1,1,1,0
10268,75,5,5,5,0,0,1,0
47801,781,5,85,81,4,4,0,0
0,0,0,0,0,0,0,0,0
392784,1578,14,137,132,5,3,1,0
122586,716,5,123,108,15,1,1,0
0,0,0,0,0,0,0,0,0
198292,1829,5,146,105,41,3,1,0
0,0,0,0,0,0,0,0,0
344752,3762,14,686,620,66,17,1,0
936638,4070,1,281,10,271,14,1,0
40746,362,0,8,5,3,6,0,0
5152,48,0,2,2,0,0,0,0
261063,1498,15,378,363,15,9,1,0
284873,771,3,68,57,11,2,1,0
321088,859,3,72,61,11,2,1,0
0,0,0,0,0,0,0,0,0
98257,1164,9,226,211,15,3,1,0
204855,624,14,44,33,11,2,1,0
0,0,0,0,0,0,0,0,0
407207,3512,7,357,319,38,16,0,0
78767,1772,3,104,101,3,0,1,0
0,0,0,0,0,0,0,0,0
52152,519,2,104,101,3,0,1,0
37722,539,3,78,73,5,0,0,0
56316,535,3,51,49,2,10,0,0
22616,37,0,2,1,1,0,1,0
359913,2803,6,469,454,15,4,1,0
246889,2391,5,443,429,14,4,1,0
161065,1210,7,264,237,27,8,1,0
0,0,0,0,0,0,0,0,0
1145798,8212,15,706,682,24,51,1,0
27528,321,2,63,63,0,0,1,0
13265,197,2,35,35,0,0,1,0
964081,449,5,61,44,17,0,1,0
967082,376,6,41,24,17,0,1,0
29220,356,1,40,5,35,0,1,0
212653,1218,16,113,109,4,1,1,0
240675,1402,4,63,63,0,7,0,0
82761,708,0,140,129,11,16,0,0
89557,1019,9,243,237,6,8,0,0
14370,233,4,22,19,3,0,1,0
7135,96,4,19,16,3,0,1,0
108766,835,6,74,51,23,8,1,0
0,0,0,0,0,0,0,0,0
26263,338,1,43,34,9,6,1,0
168950,811,4,101,70,31,3,1,0
164810,755,4,92,60,32,3,1,0
0,0,0,0,0,0,0,0,0
0,0,0,0,0,0,0,0,0
0,0,0,0,0,0,0,0,0
0,0,0,0,0,0,0,0,0
0,0,0,0,0,0,0,0,0
166671,610,3,70,55,15,0,0,0
167842,1355,13,264,255,9,11,0,0
72962,407,13,55,50,5,6,0,0
0,0,0,0,0,0,0,0,0
1222500,888,9,154,34,120,7,1,0
286491,4912,1,748,746,2,0,0,0
1008321,664,8,82,51,31,0,1,0
170201,148,4,0,0,0,0,0,0
0,0,0,0,0,0,0,0,0
511208,1853,8,396,276,120,6,1,0
15361,98,2,5,5,0,0,0,0
145400,733,8,65,45,20,1,1,0
67885,576,5,111,104,7,3,1,0
0,0,0,0,0,0,0,0,0
0,0,0,0,0,0,0,0,0
19877,166,0,14,14,0,0,0,0
57998,631,5,100,96,4,6,0,0
83706,132,3,8,5,3,2,0,0
2393146,3600,12,236,181,55,41,1,0
217458,4335,4,484,380,104,7,1,0
54181,535,8,106,77,29,9,0,0
418026,2470,2,181,158,23,9,1,0
249872,1373,3,157,152,5,5,1,0
74637,739,8,123,111,12,1,1,0
0,0,0,0,0,0,0,0,0
396915,3952,8,943,936,7,2,0,0
29121,334,8,67,60,7,0,0,0
0,0,0,0,0,0,0,0,0
0,0,0,0,0,0,0,0,0
0,0,0,0,0,0,0,0,0
111316,695,9,108,102,6,1,1,0
0,0,0,0,0,0,0,0,0
2481809,22008,7,96,89,7,6,1,0
1728205,15788,7,108,94,14,6,1,0
0,0,0,0,0,0,0,0,0
52703,691,5,104,89,15,14,0,0
0,0,0,0,0,0,0,0,0
122712,729,6,139,129,10,1,1,0
36746,182,6,37,35,2,2,1,0
469480,1573,9,181,176,5,24,0,0
469484,1573,9,181,176,5,24,0,0
68598,911,8,233,216,17,9,1,0
0,0,0,0,0,0,0,0,0
0,0,0,0,0,0,0,0,0
19051,311,0,36,34,2,0,1,0
0,0,0,0,0,0,0,0,0
267267,364,13,71,70,1,0,1,0
100970,404,6,69,4,65,1,1,0
85696,929,7,193,173,20,0,1,0
0,0,0,0,0,0,0,0,0
334440,2109,7,625,611,14,6,1,0
52911,145,3,5,4,1,3,0,0
141362,1223,7,264,241,23,8,1,0
112963,783,7,182,154,28,7,1,0
343461,8744,3,511,510,1,0,1,0
0,0,0,0,0,0,0,0,0
0,0,0,0,0,0,0,0,0
230279,1313,8,279,262,17,10,1,0
21743,455,3,77,73,4,0,1,0
35389,512,5,55,48,7,3,1,0
51171,517,5,155,150,5,9,1,0
29841,342,5,79,76,3,7,1,0
158046,744,7,93,53,40,4,0,0
0,0,0,0,0,0,0,0,0
199760,612,8,50,50,0,0,1,0
0,0,0,0,0,0,0,0,0
76986,1378,4,370,363,7,23,1,0
29011,453,2,143,141,2,26,1,0
0,0,0,0,0,0,0,0,0
0,0,0,0,0,0,0,0,0
495589,1593,9,84,82,2,24,1,0
114615,302,2,32,31,1,0,0,0
0,0,0,0,0,0,0,0,0
1069,20,1,0,0,0,0,0,0
0,0,0,0,0,0,0,0,0
110240,862,10,220,215,5,3,1,0
130675,1522,12,183,177,6,3,1,0
123067,986,9,216,215,1,0,0,0
1710804,5058,5,233,185,48,9,1,0
239124,1270,3,14,5,9,1,1,0
775362,6319,5,524,425,99,2,1,0
0,0,0,0,0,0,0,0,0
172923,817,10,138,135,3,18,1,0
108677,524,10,70,68,2,17,1,0
92467,1041,2,60,33,27,2,1,0
107574,811,0,63,37,26,53,0,0
203323,394,10,2,0,2,3,0,0
915454,3591,5,586,519,67,16,1,0
702205,2290,5,556,539,17,2,1,0
0,0,0,0,0,0,0,0,0
0,0,0,0,0,0,0,0,0
60993,757,5,86,84,2,3,1,0
0,0,0,0,0,0,0,0,0
0,0,0,0,0,0,0,0,0
0,0,0,0,0,0,0,0,0
103782,1650,3,315,295,20,3,0,0
0,0,0,0,0,0,0,0,0
0,0,0,0,0,0,0,0,0
0,0,0,0,0,0,0,0,0
50791,454,7,190,169,21,12,1,0
34316,485,6,151,151,0,8,0,0
10750,170,5,46,44,2,2,0,0
101993,887,6,357,319,38,2,1,0
48103,326,5,98,93,5,0,1,0
5143298,36515,18,3674,2270,1404,17,1,0
47106,132,8,3,0,3,0,1,0
196008,1473,8,125,124,1,0,1,0
0,0,0,0,0,0,0,0,0
0,0,0,0,0,0,0,0,0
27438,361,1,29,28,1,0,1,0
7263,112,1,16,15,1,0,1,0
71183,554,8,73,61,12,1,1,0
436123,78,3,9,9,0,4,0,0
0,0,0,0,0,0,0,0,0
214857,2230,9,343,317,26,5,0,0
86923,974,4,264,264,0,3,1,0
53474,579,4,172,170,2,3,1,0
402081,1940,4,374,294,80,14,0,0
0,0,0,0,0,0,0,0,0
0,0,0,0,0,0,0,0,0
1031851,3892,4,546,521,25,14,1,0
0,0,0,0,0,0,0,0,0
455811,1398,12,185,163,22,12,1,0
19644,123,4,4,2,2,3,1,0
97714,610,0,40,39,1,0,1,0
0,0,0,0,0,0,0,0,0
0,0,0,0,0,0,0,0,0
0,0,0,0,0,0,0,0,0
233025,1718,3,168,162,6,7,1,0
245176,1298,6,159,139,20,0,1,0
91278,175,2,12,12,0,0,1,0
598963,1386,2,107,39,68,36,0,0
34955,216,4,18,11,7,3,0,0
65717,1032,5,121,121,0,10,1,0
105601,701,2,181,180,1,8,1,0
59643,370,8,75,58,17,0,0,0
29895,598,6,138,111,27,13,1,0
0,0,0,0,0,0,0,0,0
90580,1017,7,188,177,11,35,1,0
318035,1338,8,68,28,40,9,0,0
216440,531,6,24,13,11,9,0,0
0,0,0,0,0,0,0,0,0
211014,1008,9,182,162,20,16,1,0
1570478,1170,11,182,143,39,11,1,0
540199,2229,8,522,407,115,2,0,0
0,0,0,0,0,0,0,0,0
0,0,0,0,0,0,0,0,0
0,0,0,0,0,0,0,0,0
181979,1482,8,264,256,8,8,1,1
816310,4892,12,1069,1040,29,647,0,0
357568,2495,9,583,462,121,12,1,0
335717,2408,8,569,448,121,12,1,0
45966,323,7,59,54,5,0,1,0
37259,758,3,221,215,6,0,0,0
0,0,0,0,0,0,0,0,0
324764,1027,7,80,68,12,8,1,0
396222,360,12,7,5,2,9,1,0
0,0,0,0,0,0,0,0,0
0,0,0,0,0,0,0,0,0
157404,967,12,154,141,13,12,0,0
0,0,0,0,0,0,0,0,0
339957,1728,7,126,105,21,5,0,0
0,0,0,0,0,0,0,0,0
2515629,6583,5,674,667,7,6,1,0
0,0,0,0,0,0,0,0,0
0,0,0,0,0,0,0,0,0
37975,255,1,72,3,69,1,0,0
1572795,26590,0,426,115,311,0,1,0
0,0,0,0,0,0,0,0,0
0,0,0,0,0,0,0,0,0
92005,2433,2,453,449,4,3,1,0
0,0,0,0,0,0,0,0,0
0,0,0,0,0,0,0,0,0
0,0,0,0,0,0,0,0,0
246349,1614,5,147,92,55,48,1,0
0,0,0,0,0,0,0,0,0
28521,45,0,4,1,3,0,0,0
0,0,0,0,0,0,0,0,0
391924,2460,6,391,373,18,3,1,0
156421,886,5,170,158,12,3,1,0
0,0,0,0,0,0,0,0,0
667562,3832,6,998,626,372,8,1,0
144326,518,10,88,88,0,0,1,0
52576,699,5,155,142,13,2,1,0
47793,671,5,160,145,15,2,1,0
0,0,0,0,0,0,0,0,0
119390,852,5,233,180,53,4,1,0
301495,318,10,38,33,5,18,1,0
0,0,0,0,0,0,0,0,0
0,0,0,0,0,0,0,0,0
0,0,0,0,0,0,0,0,0
173838,394,6,25,24,1,7,1,0
0,0,0,0,0,0,0,0,0
602110,3630,10,303,292,11,32,1,0
175882,1012,6,195,185,10,2,0,0
974776,4885,6,776,770,6,12,1,0
287508,1314,3,125,83,42,1,1,0
0,0,0,0,0,0,0,0,0
2108177,1428,6,158,152,6,9,1,0
214947,1101,7,238,15,223,12,1,0
471100,103,0,6,4,2,1,1,0
0,0,0,0,0,0,0,0,0
0,0,0,0,0,0,0,0,0
143815,1391,1,287,282,5,2,1,0
0,0,0,0,0,0,0,0,0
16687,58,4,4,4,0,0,1,0
0,0,0,0,0,0,0,0,0
0,0,0,0,0,0,0,0,0
500006,3066,6,377,303,74,39,1,0
0,0,0,0,0,0,0,0,0
0,0,0,0,0,0,0,0,0
195101,992,9,189,22,167,13,1,0
0,0,0,0,0,0,0,0,0
0,0,0,0,0,0,0,0,0
240601,2255,7,328,305,23,22,0,0
30884,408,4,61,47,14,7,0,0
195659,870,5,75,63,12,4,1,0
474612,462,2,104,100,4,2,1,0
28668,96,2,10,8,2,0,1,0
19320,281,3,33,30,3,0,0,0
11955,182,3,22,22,0,0,0,0
78929,742,4,212,211,1,15,1,0
61413,1077,3,407,338,69,2,0,0
605412,1009,12,82,68,14,7,1,0
0,0,0,0,0,0,0,0,0
235032,2350,13,499,482,17,14,1,0
0,0,0,0,0,0,0,0,0
168041,1052,11,176,152,24,10,0,0
0,0,0,0,0,0,0,0,0
0,0,0,0,0,0,0,0,0
0,0,0,0,0,0,0,0,0
168802,2027,8,425,419,6,6,1,0
0,0,0,0,0,0,0,0,0
0,0,0,0,0,0,0,0,0
0,0,0,0,0,0,0,0,0
0,0,0,0,0,0,0,0,0
353959,1434,10,211,204,7,17,1,0
114257,884,7,85,83,2,0,0,0
0,0,0,0,0,0,0,0,0
0,0,0,0,0,0,0,0,0
33849,537,3,211,179,32,0,1,0
692585,1294,2,63,44,19,5,1,0
33744,272,0,8,8,0,27,1,0
224148,1985,3,229,117,112,8,1,0
181205,890,6,84,82,2,2,1,0
524265,7625,5,1393,1381,12,1,1,0
0,0,0,0,0,0,0,0,0
24448,326,0,89,67,22,0,1,0
143109,261,5,84,79,5,0,0,0
0,0,0,0,0,0,0,0,0
71763,768,5,132,109,23,3,1,0
3794,48,0,10,10,0,0,0,0
15403,28,3,0,0,0,0,0,0
0,0,0,0,0,0,0,0,0
0,0,0,0,0,0,0,0,0
207061,1845,4,375,365,10,4,1,0
866960,130,2,9,8,1,1,0,0
8319,187,3,24,24,0,0,1,0
7667,152,3,19,19,0,0,1,0
0,0,0,0,0,0,0,0,0
95320,37,3,4,4,0,0,1,0
0,0,0,0,0,0,0,0,0
204789,1221,8,199,189,10,0,1,0
16290,89,0,15,0,15,0,1,0
0,0,0,0,0,0,0,0,0
103731,594,7,115,104,11,1,0,0
0,0,0,0,0,0,0,0,0
35964,451,3,59,47,12,1,1,0
19194,288,3,52,40,12,1,1,0
574230,2226,2,327,298,29,1,0,0
0,0,0,0,0,0,0,0,0
0,0,0,0,0,0,0,0,0
0,0,0,0,0,0,0,0,0
0,0,0,0,0,0,0,0,0
263593,1611,3,339,326,13,2,1,0
23808,43,0,2,1,1,0,1,0
700245,6715,10,1125,1115,10,1,0,0
23857,359,0,21,18,3,0,0,0
0,0,0,0,0,0,0,0,0
27876,42,0,2,1,1,0,0,0
0,0,0,0,0,0,0,0,0
23163,134,9,11,11,0,7,1,0
364369,1278,6,178,166,12,8,1,0
28877,283,2,84,41,43,0,1,0
88938,925,8,307,289,18,3,0,0
289889,1345,14,371,355,16,5,1,0
261945,1360,6,207,206,1,0,0,0
0,0,0,0,0,0,0,0,0
0,0,0,0,0,0,0,0,0
208660,621,7,123,117,6,2,1,0
0,0,0,0,0,0,0,0,0
0,0,0,0,0,0,0,0,0
0,0,0,0,0,0,0,0,0
0,0,0,0,0,0,0,0,0
0,0,0,0,0,0,0,0,0
41579,164,4,11,2,9,10,0,0
0,0,0,0,0,0,0,0,0
0,0,0,0,0,0,0,0,0
0,0,0,0,0,0,0,0,0
312894,1878,4,172,158,14,135,1,0
20786,61,3,1,0,1,2,1,0
0,0,0,0,0,0,0,0,0
64126,297,9,21,12,9,0,0,0
0,0,0,0,0,0,0,0,0
0,0,0,0,0,0,0,0,0
91496,751,6,107,102,5,3,1,0
22972,97,0,2,2,0,0,0,0
145682,957,8,140,138,2,3,0,0
562181,827,8,221,209,12,7,1,0
101128,1179,6,113,85,28,6,1,0
39796,421,5,86,80,6,3,1,0
0,0,0,0,0,0,0,0,0
0,0,0,0,0,0,0,0,0
212233,1158,13,162,126,36,8,1,0
124303,596,14,89,85,4,15,1,0
223267,3995,7,447,393,54,6,1,0
0,0,0,0,0,0,0,0,0
171886,1734,14,388,384,4,7,1,0
149226,1387,14,366,362,4,6,1,0
221550,1681,20,441,388,53,31,1,0
0,0,0,0,0,0,0,0,0
188733,1379,5,168,155,13,14,1,0
0,0,0,0,0,0,0,0,0
1320529,893,2,164,146,18,0,1,0
1264499,167,2,26,19,7,0,1,0
37672,369,3,57,51,6,0,1,0
23720,34,0,2,1,1,0,0,0
174837,358,8,48,48,0,10,1,0
3126,37,3,4,3,1,0,0,0
187974,531,10,60,59,1,0,1,0
75260,667,2,136,124,12,7,1,0
0,0,0,0,0,0,0,0,0
0,0,0,0,0,0,0,0,0
21911,33,0,1,1,0,0,1,0
62641,596,10,69,66,3,7,1,0
80472,212,0,46,23,23,0,1,1
52773,493,1,99,50,49,0,1,0
211027,180,0,47,32,15,1,1,0
336477,375,5,50,43,7,3,1,0
17954,107,7,1,1,0,4,0,0
0,0,0,0,0,0,0,0,0
38681,346,3,30,28,2,11,1,0
30547,241,3,27,25,2,6,1,0
0,0,0,0,0,0,0,0,0
250932,1864,5,291,279,12,1,1,0
0,0,0,0,0,0,0,0,0
0,0,0,0,0,0,0,0,0
0,0,0,0,0,0,0,0,0
0,0,0,0,0,0,0,0,0
475246,2356,6,306,263,43,7,1,0
0,0,0,0,0,0,0,0,0
285974,2553,7,550,526,24,9,1,0
7263,82,4,6,6,0,0,1,0
0,0,0,0,0,0,0,0,0
0,0,0,0,0,0,0,0,0
71813,802,9,135,133,2,0,0,0
0,0,0,0,0,0,0,0,0
0,0,0,0,0,0,0,0,0
0,0,0,0,0,0,0,0,0
38742,353,2,113,103,10,1,0,0
82780,709,4,154,123,31,23,1,0
22234,334,3,117,83,34,0,1,0
182597,1224,9,264,80,184,2,1,0
404688,2795,16,323,277,46,13,1,0
209593,1243,16,240,234,6,5,1,0
0,0,0,0,0,0,0,0,0
186961,669,1,78,69,9,1,0,0
0,0,0,0,0,0,0,0,0
1036059,4433,2,357,352,5,0,0,0
18420,273,4,68,68,0,1,0,0
11571,153,4,31,31,0,1,0,0
4268,54,3,2,1,1,0,0,0
530668,3097,6,261,192,69,37,1,0
8517,99,1,9,1,8,1,0,0
0,0,0,0,0,0,0,0,0
129137,902,11,90,80,10,3,1,0
55594,517,3,66,51,15,2,1,0
45595,690,5,179,179,0,4,0,0
19202,198,3,34,34,0,4,0,0
495874,2327,9,477,469,8,29,1,0
0,0,0,0,0,0,0,0,0
177374,677,8,95,76,19,19,1,0
450663,1979,2,179,19,160,11,0,0
1641583,16135,11,349,213,136,1,1,0
0,0,0,0,0,0,0,0,0
0,0,0,0,0,0,0,0,0
0,0,0,0,0,0,0,0,0
38421,337,6,41,32,9,2,0,0
32854,228,6,39,32,7,2,0,0
28237,42,0,2,1,1,0,0,0
122379,1066,6,280,262,18,9,1,0
0,0,0,0,0,0,0,0,0
100325,1573,1,370,361,9,0,0,0
0,0,0,0,0,0,0,0,0
22042,35,0,1,1,0,0,1,0
439762,2164,9,225,216,9,6,1,0
208450,738,4,72,64,8,2,0,0
243202,2007,10,431,417,14,13,1,0
44518,535,3,84,72,12,7,1,0
0,0,0,0,0,0,0,0,0
0,0,0,0,0,0,0,0,0
1106249,3325,6,132,74,58,10,0,0
218298,2945,8,115,90,25,0,1,0
92467,1041,2,60,33,27,2,1,0
594245,2524,16,303,282,21,50,1,0
160445,1089,13,154,139,15,7,1,0
119877,184,2,17,9,8,2,1,0
616489,3791,6,336,294,42,10,1,0
0,0,0,0,0,0,0,0,0
0,0,0,0,0,0,0,0,0
57403,814,6,118,59,59,1,1,0
51921,518,3,81,69,12,8,1,0
0,0,0,0,0,0,0,0,0
0,0,0,0,0,0,0,0,0
0,0,0,0,0,0,0,0,0
146963,850,5,139,131,8,4,1,0
0,0,0,0,0,0,0,0,0
7373,61,4,3,3,0,0,1,0
0,0,0,0,0,0,0,0,0
110027,1231,6,176,146,30,0,1,0
78339,250,4,4,3,1,2,1,0
0,0,0,0,0,0,0,0,0
89617,823,4,251,230,21,7,0,0
56664,465,7,56,49,7,5,1,0
26507,418,4,128,128,0,0,1,0
587657,1698,6,175,161,14,6,1,0
0,0,0,0,0,0,0,0,0
0,0,0,0,0,0,0,0,0
0,0,0,0,0,0,0,0,0
0,0,0,0,0,0,0,0,0
0,0,0,0,0,0,0,0,0
100166,661,7,130,115,15,8,1,0
0,0,0,0,0,0,0,0,0
78239,503,6,17,13,4,0,1,0
0,0,0,0,0,0,0,0,0
54988,516,5,24,13,11,0,1,0
119443,2418,3,696,690,6,0,1,0
30088,170,2,22,21,1,10,1,0
0,0,0,0,0,0,0,0,0
0,0,0,0,0,0,0,0,0
61900,856,4,152,117,35,0,1,0
48824,728,3,111,100,11,0,0,0
0,0,0,0,0,0,0,0,0
0,0,0,0,0,0,0,0,0
92011,339,2,32,12,20,9,0,0
0,0,0,0,0,0,0,0,0
0,0,0,0,0,0,0,0,0
325265,4879,7,1055,1041,14,25,0,0
205094,2542,6,371,19,352,7,1,0
0,0,0,0,0,0,0,0,0
67323,470,9,92,92,0,0,1,0
14746,170,4,31,30,1,0,0,0
248759,1635,3,313,302,11,1,1,0
23200,411,5,43,32,11,0,1,0
0,0,0,0,0,0,0,0,0
14547,276,0,63,63,0,0,1,0
0,0,0,0,0,0,0,0,0
0,0,0,0,0,0,0,0,0
0,0,0,0,0,0,0,0,0
248540,1020,5,83,70,13,6,1,0
112634,546,3,157,148,9,7,1,0
345951,2124,8,341,292,49,4,0,0
175889,875,8,91,85,6,4,0,0
209558,676,7,117,107,10,20,0,0
99100,365,7,66,58,8,17,0,0
50260,769,1,275,269,6,0,1,0
57274,505,6,106,92,14,14,0,0
0,0,0,0,0,0,0,0,0
0,0,0,0,0,0,0,0,0
163864,1280,12,206,198,8,24,1,0
158260,1257,13,207,202,5,21,1,0
0,0,0,0,0,0,0,0,0
33892,433,4,93,70,23,0,0,0
33800,334,1,72,71,1,0,1,0
351297,2679,3,262,246,16,2,1,0
902930,8258,6,146,137,9,4,1,0
0,0,0,0,0,0,0,0,0
149004,1026,9,237,177,60,3,1,0
249600,1044,6,150,129,21,6,1,0
179855,1571,5,347,309,38,2,1,0
7854,138,1,23,23,0,0,0,0
0,0,0,0,0,0,0,0,0
0,0,0,0,0,0,0,0,0
295806,539,1,19,13,6,1,1,0
0,0,0,0,0,0,0,0,0
737344,5449,3,793,777,16,14,1,0
0,0,0,0,0,0,0,0,0
0,0,0,0,0,0,0,0,0
0,0,0,0,0,0,0,0,0
51595,584,2,80,78,2,1,1,0
11955,181,2,28,28,0,2,1,0
0,0,0,0,0,0,0,0,0
1538381,1421,3,116,111,5,2,1,0
0,0,0,0,0,0,0,0,0
185227,1282,7,264,219,45,6,1,0
143930,614,7,95,69,26,6,1,0
257125,1436,16,183,160,23,28,1,0
0,0,0,0,0,0,0,0,0
194250,1723,7,59,52,7,27,1,0
0,0,0,0,0,0,0,0,0
3332,85,2,18,18,0,0,0,0
0,0,0,0,0,0,0,0,0
8206,107,2,5,5,0,1,1,0
7521,100,2,6,6,0,1,1,0
4403,50,2,7,6,1,1,0,0
12697,152,2,52,45,7,0,1,0
85441,1101,4,89,24,65,4,0,0
39570,350,2,11,7,4,0,0,0
0,0,0,0,0,0,0,0,0
0,0,0,0,0,0,0,0,0
0,0,0,0,0,0,0,0,0
0,0,0,0,0,0,0,0,0
0,0,0,0,0,0,0,0,0
235539,978,6,102,75,27,8,1,0
369532,747,3,120,108,12,1,1,0
0,0,0,0,0,0,0,0,0
0,0,0,0,0,0,0,0,0
0,0,0,0,0,0,0,0,0
805554,3242,13,494,436,58,8,1,0
13376,98,9,3,3,0,2,0,0
0,0,0,0,0,0,0,0,0
34358,507,2,25,25,0,0,1,0
8374,90,1,5,5,0,0,1,0
1000873,5482,3,372,362,10,104,1,0
0,0,0,0,0,0,0,0,0
0,0,0,0,0,0,0,0,0
0,0,0,0,0,0,0,0,0
0,0,0,0,0,0,0,0,0
34145,566,1,175,174,1,7,1,0
1116461,2115,3,132,120,12,0,1,0
377996,3394,6,736,720,16,13,1,0
11508,152,3,7,6,1,0,1,0
0,0,0,0,0,0,0,0,0
0,0,0,0,0,0,0,0,0
0,0,0,0,0,0,0,0,0
177053,1204,15,99,65,34,4,1,0
0,0,0,0,0,0,0,0,0
0,0,0,0,0,0,0,0,0
660071,2900,10,315,312,3,36,1,0
279755,415,11,67,65,2,9,1,0
20568,267,3,19,19,0,1,1,0
68307,459,1,30,19,11,8,1,0
780038,6925,3,364,280,84,8,1,0
294920,926,9,116,112,4,3,1,0
0,0,0,0,0,0,0,0,0
36121,222,4,25,24,1,0,1,0
0,0,0,0,0,0,0,0,0
0,0,0,0,0,0,0,0,0
0,0,0,0,0,0,0,0,0
4510743,1241,10,278,256,22,27,1,0
105818,741,5,163,155,8,25,1,0
389150,740,9,75,63,12,28,1,0
381036,2394,6,640,637,3,102,1,0
0,0,0,0,0,0,0,0,0
0,0,0,0,0,0,0,0,0
0,0,0,0,0,0,0,0,0
161313,822,6,132,124,8,7,1,0
63315,479,6,152,143,9,0,1,0
0,0,0,0,0,0,0,0,0
921,20,0,0,0,0,0,0,0
38721,104,5,10,8,2,1,1,0
774121,2866,4,459,451,8,13,0,0
22693,58,4,7,4,3,0,1,0
324858,2174,10,626,610,16,7,0,0
118368,824,10,100,86,14,12,1,0
0,0,0,0,0,0,0,0,0
237462,1125,7,179,142,37,1,1,0
30655,85,3,8,4,4,1,1,0
0,0,0,0,0,0,0,0,0
122939,1485,3,226,192,34,10,0,0
267822,565,5,51,46,5,4,1,0
20196,392,2,11,11,0,4,1,0
20595,250,3,31,17,14,4,0,0
0,0,0,0,0,0,0,0,0
114356,1280,5,295,283,12,2,1,0
83940,767,5,175,163,12,1,1,0
64570,955,4,235,133,102,0,1,0
88852,942,10,179,98,81,14,1,0
0,0,0,0,0,0,0,0,0
0,0,0,0,0,0,0,0,0
0,0,0,0,0,0,0,0,0
96223,1108,6,205,179,26,4,1,0
0,0,0,0,0,0,0,0,0
90764,1507,7,337,329,8,10,1,0
26884,341,4,68,62,6,9,1,0
126840,832,4,128,123,5,14,0,0
89008,496,4,78,75,3,4,0,0
330253,1478,7,326,27,299,44,1,0
0,0,0,0,0,0,0,0,0
0,0,0,0,0,0,0,0,0
161159,1390,8,295,139,156,4,0,0
0,0,0,0,0,0,0,0,0
0,0,0,0,0,0,0,0,0
0,0,0,0,0,0,0,0,0
92804,1062,13,231,217,14,12,1,0
0,0,0,0,0,0,0,0,0
96990,887,6,200,153,47,11,1,0
226281,1342,4,248,2,246,11,1,0
1821137,8517,6,1834,1053,781,9,1,0
0,0,0,0,0,0,0,0,0
0,0,0,0,0,0,0,0,0
126567,897,10,166,155,11,1,1,0
24906,382,3,35,28,7,1,1,0
0,0,0,0,0,0,0,0,0
1325317,6196,6,818,813,5,75,0,0
305923,251,3,21,21,0,3,0,0
223989,1013,6,81,77,4,11,1,0
0,0,0,0,0,0,0,0,0
293186,2159,15,333,297,36,11,0,0
0,0,0,0,0,0,0,0,0
7364,98,2,17,16,1,0,0,0
366018,1743,5,131,127,4,20,1,0
242428,1603,8,184,160,24,21,1,0
0,0,0,0,0,0,0,0,0
297635,1815,4,331,264,67,1,0,0
0,0,0,0,0,0,0,0,0
0,0,0,0,0,0,0,0,0
249599,1222,8,155,140,15,5,0,0
30202,416,5,77,67,10,3,1,0
37014,405,5,71,62,9,7,1,0
129006,837,3,217,217,0,10,1,0
0,0,0,0,0,0,0,0,0
1616,11,0,1,1,0,0,0,0
52742,482,3,91,91,0,8,0,0
20353,302,6,82,82,0,0,0,0
0,0,0,0,0,0,0,0,0
589887,1134,14,69,47,22,5,1,0
0,0,0,0,0,0,0,0,0
380309,1046,4,140,129,11,9,1,0
171108,664,10,69,63,6,39,0,0
31215,145,4,3,2,1,6,0,0
51771,482,1,156,156,0,3,1,0
7765,143,0,49,49,0,0,1,0
665104,3802,8,112,107,5,20,1,0
768976,868,3,12,11,1,13,0,0
790746,3648,6,321,319,2,8,1,0
97864,705,10,92,90,2,8,1,0
251646,1201,6,168,165,3,6,1,0
231441,1061,7,152,149,3,9,1,0
231551,341,0,16,3,13,0,1,0
501084,1624,3,224,210,14,8,1,0
0,0,0,0,0,0,0,0,0
144033,301,3,63,38,25,9,1,0
36470,522,4,133,129,4,3,1,0
245813,1495,3,218,210,8,6,1,0
98492,1117,2,229,221,8,7,0,0
112679,803,1,127,121,6,9,1,0
32701,118,2,16,10,6,4,1,0
131414,1046,12,131,98,33,13,0,0
147199,1345,7,152,144,8,2,0,0
0,0,0,0,0,0,0,0,0
493015,1227,14,161,144,17,5,1,0
89250,626,10,48,46,2,0,1,0
0,0,0,0,0,0,0,0,0
166755,1808,9,277,252,25,15,1,1
0,0,0,0,0,0,0,0,0
214863,757,5,176,173,3,7,1,0
177269,435,6,112,109,3,9,1,0
0,0,0,0,0,0,0,0,0
0,0,0,0,0,0,0,0,0
47934,523,1,135,133,2,1,1,0
34086,410,1,88,85,3,2,1,0
20347,213,1,45,42,3,1,1,0
121798,1737,4,309,304,5,142,0,0
464270,2285,10,433,407,26,143,1,0
116078,634,8,79,77,2,5,1,0
210895,1021,12,258,101,157,4,1,0
0,0,0,0,0,0,0,0,0
315199,1746,12,358,339,19,26,1,0
315186,1746,12,358,339,19,26,1,0
127626,1397,2,385,230,155,3,1,0
0,0,0,0,0,0,0,0,0
0,0,0,0,0,0,0,0,0
0,0,0,0,0,0,0,0,0
0,0,0,0,0,0,0,0,0
85773,632,10,152,140,12,0,1,0
145714,925,6,209,201,8,1,1,0
35162,158,6,19,15,4,4,0,0
0,0,0,0,0,0,0,0,0
32144,251,1,74,74,0,7,1,0
100302,783,6,152,143,9,8,1,0
188910,450,4,7,4,3,9,0,0
0,0,0,0,0,0,0,0,0
86236,506,6,30,21,9,0,0,0
0,0,0,0,0,0,0,0,0
58680,379,4,55,10,45,0,1,0
301787,365,0,17,13,4,2,1,0
770917,1898,6,563,389,174,162,1,0
0,0,0,0,0,0,0,0,0
27723,284,3,68,65,3,0,1,0
48546,303,6,49,44,5,8,1,0
875868,550,6,46,44,2,8,1,0
74799,1102,4,276,275,1,40,1,0
88363,803,5,151,149,2,11,1,0
0,0,0,0,0,0,0,0,0
0,0,0,0,0,0,0,0,0
43126,468,1,120,30,90,1,1,0
35355,302,6,36,20,16,2,1,0
0,0,0,0,0,0,0,0,0
345807,794,8,96,89,7,2,1,0
103744,868,9,61,12,49,30,1,0
74248,308,6,19,13,6,7,1,0
55524,961,7,126,38,88,11,1,0
91728,647,7,61,54,7,2,1,0
73405,354,7,46,39,7,3,1,0
369720,643,6,61,57,4,5,1,0
319153,446,7,46,42,4,9,1,0
100875,889,12,110,88,22,13,1,0
50252,416,11,65,61,4,4,1,0
0,0,0,0,0,0,0,0,0
48156,620,11,97,88,9,11,1,0
195951,2981,8,812,807,5,5,1,0
0,0,0,0,0,0,0,0,0
0,0,0,0,0,0,0,0,0
1012,18,1,0,0,0,0,0,0
97384,387,3,71,71,0,0,1,0
0,0,0,0,0,0,0,0,0
716030,4065,4,566,538,28,9,1,0
175711,1294,8,140,120,20,7,0,0
23097,104,3,12,12,0,2,1,0
18777,102,3,12,12,0,0,1,0
63936,667,10,137,125,12,10,0,0
0,0,0,0,0,0,0,0,0
13951,37,1,0,0,0,1,0,0
40459,507,7,123,122,1,2,1,0
0,0,0,0,0,0,0,0,0
0,0,0,0,0,0,0,0,0
41469,457,9,55,46,9,4,1,0
0,0,0,0,0,0,0,0,0
206640,1746,3,154,124,30,17,0,0
165910,162,5,4,1,3,3,0,0
117677,1080,10,299,288,11,11,1,0
14371,270,5,64,59,5,0,1,0
0,0,0,0,0,0,0,0,0
1940,25,2,2,2,0,0,0,0
194690,1865,6,327,278,49,0,1,0
115292,1049,13,62,50,12,11,1,0
48035,201,1,30,29,1,7,1,0
11014,154,3,17,17,0,0,0,0
0,0,0,0,0,0,0,0,0
0,0,0,0,0,0,0,0,0
143870,2999,4,684,667,17,1,1,0
287319,2093,10,286,253,33,6,1,0
229809,1448,10,95,66,29,3,0,0
0,0,0,0,0,0,0,0,0
65610,882,9,146,140,6,2,1,0
0,0,0,0,0,0,0,0,0
198771,523,6,96,90,6,24,1,0
143245,974,12,163,97,66,11,1,0
130835,889,12,148,146,2,12,1,0
0,0,0,0,0,0,0,0,0
86001,674,8,148,139,9,9,1,0
50638,305,8,66,59,7,6,1,0
0,0,0,0,0,0,0,0,0
0,0,0,0,0,0,0,0,0
56649,181,1,2,2,0,2,0,0
3276,57,1,9,6,3,0,1,0
251725,1059,6,65,60,5,7,1,0
41892,276,7,50,43,7,2,1,0
0,0,0,0,0,0,0,0,0
100944,2416,2,522,97,425,15,1,0
14945,379,2,34,32,2,1,1,0
857488,8375,15,239,229,10,20,1,0
677898,6899,13,222,205,17,22,1,0
1337890,1264,5,144,142,2,0,1,0
146674,1301,0,261,98,163,0,0,0
56908,1310,3,93,25,68,0,1,0
1155193,983,13,123,117,6,7,1,0
0,0,0,0,0,0,0,0,0
50635,550,3,168,157,11,3,1,0
2770594,4202,13,453,442,11,43,1,0
2017313,2919,13,311,299,12,9,1,0
0,0,0,0,0,0,0,0,0
101938,1259,7,292,250,42,37,1,0
96676,1630,4,397,271,126,54,0,0
0,0,0,0,0,0,0,0,0
0,0,0,0,0,0,0,0,0
117398,608,8,62,58,4,1,0,0
0,0,0,0,0,0,0,0,0
0,0,0,0,0,0,0,0,0
1379573,6618,15,987,805,182,7,1,0
122736,2388,1,887,882,5,9,0,0
112149,609,8,89,77,12,10,1,0
36898,192,9,25,25,0,9,1,0
0,0,0,0,0,0,0,0,0
195777,1089,8,143,135,8,5,0,0
502124,802,7,100,96,4,9,1,0
0,0,0,0,0,0,0,0,0
30316,284,1,47,46,1,6,1,0
22903,37,0,2,1,1,0,1,0
173173,3480,11,367,361,6,3,1,0
0,0,0,0,0,0,0,0,0
40246,290,2,41,24,17,9,0,0
22026,33,0,1,1,0,0,1,0
0,0,0,0,0,0,0,0,0
0,0,0,0,0,0,0,0,0
94073,448,4,79,79,0,0,1,0
0,0,0,0,0,0,0,0,0
8378,136,4,25,25,0,0,0,0
0,0,0,0,0,0,0,0,0
192191,1243,11,288,253,35,7,1,0
197523,1036,7,305,282,23,13,1,0
0,0,0,0,0,0,0,0,0
205873,1359,9,319,311,8,4,1,0
0,0,0,0,0,0,0,0,0
1051505,3617,9,286,268,18,8,1,0
229001,2297,2,159,158,1,9,1,0
0,0,0,0,0,0,0,0,0
0,0,0,0,0,0,0,0,0
6581,170,1,8,0,8,0,0,0
0,0,0,0,0,0,0,0,0
0,0,0,0,0,0,0,0,0
112300,574,9,14,14,0,0,1,0
0,0,0,0,0,0,0,0,0
0,0,0,0,0,0,0,0,0
0,0,0,0,0,0,0,0,0
55784,431,2,88,81,7,0,0,0
48255,255,6,30,30,0,9,1,0
25133,151,1,45,45,0,0,0,0
55497,963,7,126,40,86,11,1,0
0,0,0,0,0,0,0,0,0
119089,1032,9,67,34,33,0,1,0
331259,1895,11,297,270,27,4,0,0
83278,506,0,31,23,8,5,0,0
210253,176,3,6,6,0,0,1,0
0,0,0,0,0,0,0,0,0
230172,541,6,107,90,17,10,1,0
28081,42,0,2,1,1,0,0,0
201373,1585,10,314,269,45,14,1,0
160378,1159,13,226,224,2,4,1,0
0,0,0,0,0,0,0,0,0
0,0,0,0,0,0,0,0,0
0,0,0,0,0,0,0,0,0
1827,30,0,3,2,1,0,0,0
0,0,0,0,0,0,0,0,0
0,0,0,0,0,0,0,0,0
1678998,3186,3,312,307,5,76,1,0
1311465,1148,4,156,151,5,1,1,0
0,0,0,0,0,0,0,0,0
111410,223,6,8,6,2,6,1,0
537025,1493,6,226,204,22,6,1,0
194953,1276,5,65,65,0,2,1,0
30808,431,5,42,36,6,5,1,0
0,0,0,0,0,0,0,0,0
64264,671,6,104,96,8,8,1,0
0,0,0,0,0,0,0,0,0
271765,1699,2,269,243,26,2,1,0
0,0,0,0,0,0,0,0,0
0,0,0,0,0,0,0,0,0
0,0,0,0,0,0,0,0,0
0,0,0,0,0,0,0,0,0
69903,742,9,108,52,56,4,1,0
55455,507,9,95,80,15,4,1,0
74752,644,7,125,125,0,3,1,0
0,0,0,0,0,0,0,0,0
0,0,0,0,0,0,0,0,0
0,0,0,0,0,0,0,0,0
0,0,0,0,0,0,0,0,0
189248,1098,10,212,204,8,3,1,0
64547,105,2,5,5,0,2,1,0
46068,470,5,18,18,0,3,1,0
0,0,0,0,0,0,0,0,0
22079,35,0,1,1,0,0,1,0
0,0,0,0,0,0,0,0,0
1358566,4609,7,467,443,24,18,1,0
157521,2249,6,472,472,0,2,1,0
0,0,0,0,0,0,0,0,0
0,0,0,0,0,0,0,0,0
2403019,739,12,110,99,11,41,1,0
169132,1188,9,99,88,11,4,1,0
325860,1389,4,141,126,15,14,1,0
77432,212,0,46,23,23,0,1,1
541479,2425,16,260,237,23,95,1,0
937825,3971,7,839,833,6,76,1,1
9657,76,6,5,4,1,0,0,0
0,0,0,0,0,0,0,0,0
0,0,0,0,0,0,0,0,0
48318,397,3,87,67,20,4,1,0
0,0,0,0,0,0,0,0,0
22023,32,0,1,1,0,0,1,0
22097,35,0,1,1,0,0,1,0
140138,397,9,81,3,78,5,1,0
134896,1282,12,177,169,8,14,1,0
143947,1890,4,393,390,3,10,1,0
1335934,2330,8,340,325,15,6,1,0
1165077,1308,9,229,221,8,6,1,0
11466,159,3,22,19,3,2,0,0
0,0,0,0,0,0,0,0,0
75024,1252,3,308,291,17,6,0,0
418890,857,3,246,244,2,11,1,0
156168,2710,1,404,403,1,0,1,0
0,0,0,0,0,0,0,0,0
16039,365,1,108,104,4,1,1,0
339295,1518,7,190,182,8,24,1,0
0,0,0,0,0,0,0,0,0
0,0,0,0,0,0,0,0,0
407988,1352,9,61,58,3,36,1,0
108008,863,6,203,202,1,15,1,0
0,0,0,0,0,0,0,0,0
9029,161,1,13,13,0,0,0,0
28159,44,0,4,3,1,0,0,0
114021,786,4,221,210,11,2,1,0
0,0,0,0,0,0,0,0,0
0,0,0,0,0,0,0,0,0
154797,524,2,57,54,3,3,1,0
0,0,0,0,0,0,0,0,0
20890,308,3,77,75,2,0,1,0
1622,11,0,1,1,0,0,0,0
387483,1804,4,101,95,6,36,1,0
110127,448,4,65,65,0,11,1,0
0,0,0,0,0,0,0,0,0
1491062,4903,12,860,839,21,25,1,0
153708,794,13,104,101,3,8,1,0
15690,142,1,13,5,8,0,0,0
0,0,0,0,0,0,0,0,0
518960,3133,17,508,504,4,7,0,0
0,0,0,0,0,0,0,0,0
0,0,0,0,0,0,0,0,0
57708,794,3,175,172,3,10,1,0
37083,312,3,54,51,3,11,1,0
212784,1258,6,248,213,35,1,1,0
426316,2422,13,525,515,10,11,1,0
287935,1496,13,427,420,7,14,1,0
0,0,0,0,0,0,0,0,0
0,0,0,0,0,0,0,0,0
1046229,3108,20,521,291,230,44,1,0
0,0,0,0,0,0,0,0,0
616232,1565,3,216,198,18,1,0,0
0,0,0,0,0,0,0,0,0
0,0,0,0,0,0,0,0,0
91395,478,7,91,90,1,7,1,0
281893,1328,3,163,25,138,0,1,0
0,0,0,0,0,0,0,0,0
615012,1436,4,242,216,26,2,1,0
0,0,0,0,0,0,0,0,0
0,0,0,0,0,0,0,0,0
398927,3105,5,303,213,90,32,0,0
68048,965,5,159,155,4,0,1,0
157098,703,0,16,14,2,0,1,0
0,0,0,0,0,0,0,0,0
0,0,0,0,0,0,0,0,0
0,0,0,0,0,0,0,0,0
0,0,0,0,0,0,0,0,0
0,0,0,0,0,0,0,0,0
271323,523,5,49,45,4,2,1,0
255203,978,9,130,128,2,11,1,0
227301,935,8,66,57,9,1,1,0
175266,2500,3,299,295,4,0,1,0
0,0,0,0,0,0,0,0,0
57932,539,5,106,105,1,0,1,0
0,0,0,0,0,0,0,0,0
22533,554,2,100,83,17,0,1,0
137137,697,9,109,104,5,2,1,0
0,0,0,0,0,0,0,0,0
553,9,0,1,1,0,0,0,0
0,0,0,0,0,0,0,0,0
681757,1292,10,270,254,16,9,1,0
675245,556,0,4,4,0,2,1,1
13136,190,8,37,30,7,5,1,0
0,0,0,0,0,0,0,0,0
0,0,0,0,0,0,0,0,0
712491,4478,7,1213,1198,15,17,1,0
332554,2783,5,1049,1035,14,7,1,0
7125,74,4,8,4,4,2,1,0
158218,1631,4,446,439,7,1,1,0
102386,1081,4,359,352,7,1,1,0
0,0,0,0,0,0,0,0,0
277602,3924,8,766,762,4,5,1,0
0,0,0,0,0,0,0,0,0
180970,610,8,117,6,111,8,1,0
257683,839,1,107,91,16,7,1,0
121177,895,9,202,188,14,10,1,0
0,0,0,0,0,0,0,0,0
372170,3641,5,302,284,18,6,1,0
19615,149,1,4,0,4,0,0,0
0,0,0,0,0,0,0,0,0
1054742,9279,7,35,27,8,11,1,0
855502,837,5,224,202,22,2,1,0
493570,2707,13,317,286,31,22,1,0
4047,27,2,0,0,0,0,0,0
47295,1035,4,237,227,10,6,1,0
113951,1181,3,193,192,1,34,0,0
53022,536,2,93,93,0,27,0,0
166886,1321,12,147,129,18,2,1,0
269873,3587,3,885,820,65,3,1,0
28516,97,3,6,4,2,0,0,0
62822,1504,3,205,203,2,19,0,0
20041,441,2,68,66,2,4,0,0
0,0,0,0,0,0,0,0,0
0,0,0,0,0,0,0,0,0
77871,1330,11,286,272,14,6,1,0
9862,98,4,6,6,0,2,1,0
1114814,2083,14,149,132,17,1,0,0
0,0,0,0,0,0,0,0,0
0,0,0,0,0,0,0,0,0
138301,379,7,24,21,3,12,1,0
60225,1041,4,385,341,44,0,1,0
43485,586,5,41,41,0,6,0,0
0,0,0,0,0,0,0,0,0
95293,854,11,84,75,9,6,1,0
2785804,18862,10,4122,4099,23,1241,1,0
90713,858,5,189,163,26,8,1,0
148885,1079,3,233,233,0,0,0,0
20420,220,5,37,37,0,0,1,0
446663,3201,7,1111,1079,32,38,1,0
356447,2936,5,1091,1064,27,30,1,0
287651,2798,16,624,620,4,28,1,0
28039,42,0,2,1,1,0,0,0
0,0,0,0,0,0,0,0,0
0,0,0,0,0,0,0,0,0
522069,1592,8,266,210,56,6,1,0
425844,689,8,59,46,13,7,1,0
0,0,0,0,0,0,0,0,0
0,0,0,0,0,0,0,0,0
24751,212,2,50,45,5,0,1,0
0,0,0,0,0,0,0,0,0
323222,2022,6,417,354,63,14,1,0
253780,4769,3,377,372,5,14,1,0
114277,635,9,89,89,0,10,1,0
156748,604,13,109,86,23,1,1,0
6393,109,1,10,9,1,0,0,0
0,0,0,0,0,0,0,0,0
0,0,0,0,0,0,0,0,0
0,0,0,0,0,0,0,0,0
239382,1407,7,137,66,71,10,0,0
0,0,0,0,0,0,0,0,0
147369,2312,5,302,283,19,13,1,0
73304,1934,2,571,570,1,1,1,0
87201,931,0,179,122,57,0,1,0
33823,386,0,64,5,59,1,1,0
28269,42,0,2,1,1,0,0,0
166718,1254,4,231,193,38,15,1,0
181554,1878,2,265,252,13,12,1,0
0,0,0,0,0,0,0,0,0
0,0,0,0,0,0,0,0,0
225240,1458,12,217,64,153,18,1,0
80114,745,5,123,114,9,1,0,0
40171,361,7,3,1,2,1,0,0
0,0,0,0,0,0,0,0,0
328509,1269,3,172,140,32,10,0,0
273290,131,5,5,2,3,3,0,0
0,0,0,0,0,0,0,0,0
364607,1455,11,213,15,198,7,1,0
452381,7588,7,1924,1913,11,9,0,0
0,0,0,0,0,0,0,0,0
44698,1030,3,244,231,13,0,0,0
63710,416,8,84,83,1,0,0,0
0,0,0,0,0,0,0,0,0
95797,861,4,219,216,3,0,0,0
122958,994,16,171,167,4,8,1,0
11740,80,4,7,6,1,0,0,0
154910,2032,3,885,884,1,12,0,0
0,0,0,0,0,0,0,0,0
0,0,0,0,0,0,0,0,0
0,0,0,0,0,0,0,0,0
14233,228,2,2,0,2,2,1,0
0,0,0,0,0,0,0,0,0
0,0,0,0,0,0,0,0,0
495036,2079,2,262,231,31,1,1,0
0,0,0,0,0,0,0,0,0
138134,1647,9,282,264,18,36,1,0
0,0,0,0,0,0,0,0,0
112123,1004,1,276,276,0,3,1,0
129264,165,1,22,17,5,0,1,0
0,0,0,0,0,0,0,0,0
144541,3123,1,422,413,9,1,1,0
353327,590,13,19,17,2,22,0,0
0,0,0,0,0,0,0,0,0
0,0,0,0,0,0,0,0,0
6403,129,0,8,2,6,0,1,0
24407,422,1,7,6,1,0,1,0
1582,11,0,1,1,0,0,0,0
37517,768,4,183,171,12,4,1,0
35100,594,3,96,93,3,2,1,0
0,0,0,0,0,0,0,0,0
123711,568,8,58,57,1,0,0,0
6176,74,4,11,10,1,0,1,0
1398094,1312,14,253,245,8,24,1,0
1362631,879,14,181,172,9,10,1,0
2027,30,1,1,0,1,0,0,0
0,0,0,0,0,0,0,0,0
0,0,0,0,0,0,0,0,0
0,0,0,0,0,0,0,0,0
404190,1821,5,114,67,47,12,0,0
0,0,0,0,0,0,0,0,0
0,0,0,0,0,0,0,0,0
0,0,0,0,0,0,0,0,0
0,0,0,0,0,0,0,0,0
28088,42,0,2,1,1,0,0,0
61889,743,8,220,216,4,15,0,0
3758,82,3,15,13,2,0,0,0
94502,1211,12,272,262,10,9,1,0
0,0,0,0,0,0,0,0,0
0,0,0,0,0,0,0,0,0
27939,42,0,2,1,1,0,0,0
365762,861,5,112,62,50,12,1,0
39724,359,9,33,32,1,7,1,0
36544,341,6,14,13,1,9,1,0
0,0,0,0,0,0,0,0,0
201872,3246,6,28,21,7,0,0,0
26393,116,1,2,1,1,3,0,0
0,0,0,0,0,0,0,0,0
453007,1286,9,148,132,16,28,1,0
0,0,0,0,0,0,0,0,0
0,0,0,0,0,0,0,0,0
194616,1850,7,243,218,25,1,1,0
53147,255,5,4,4,0,2,0,0
50688,204,5,12,12,0,0,1,0
0,0,0,0,0,0,0,0,0
0,0,0,0,0,0,0,0,0
40069,326,2,81,14,67,0,1,0
11722,127,2,6,4,2,0,0,0
0,0,0,0,0,0,0,0,0
15759,158,4,16,0,16,1,0,0
195960,1670,11,198,174,24,19,1,0
0,0,0,0,0,0,0,0,0
0,0,0,0,0,0,0,0,0
60854,979,1,148,138,10,1,1,0
87987,254,0,48,24,24,0,1,1
49187,576,5,105,96,9,4,0,0
70021,883,4,264,146,118,7,1,0
66429,425,11,59,19,40,1,1,0
56386,310,11,26,25,1,4,1,0
0,0,0,0,0,0,0,0,0
0,0,0,0,0,0,0,0,0
0,0,0,0,0,0,0,0,0
0,0,0,0,0,0,0,0,0
1341478,12420,15,1186,1166,20,17,1,0
256177,1590,14,258,202,56,17,1,0
0,0,0,0,0,0,0,0,0
0,0,0,0,0,0,0,0,0
84890,576,7,162,113,49,6,1,0
0,0,0,0,0,0,0,0,0
1029981,1425,6,71,58,13,13,1,0
0,0,0,0,0,0,0,0,0
305953,1874,4,185,182,3,7,1,0
20990,379,4,102,99,3,0,1,0
0,0,0,0,0,0,0,0,0
38618,672,4,82,74,8,3,1,0
103529,608,11,85,80,5,10,1,0
78293,1519,1,489,484,5,6,1,0
16950,263,1,55,55,0,1,1,0
69659,700,9,228,214,14,10,1,0
591,12,0,0,0,0,0,0,0
166872,775,6,109,84,25,4,1,0
442878,5257,7,1942,1681,261,0,1,0
290969,2193,6,318,296,22,4,1,0
10965,82,4,10,10,0,0,0,0
0,0,0,0,0,0,0,0,0
153622,561,11,43,29,14,1,1,0
0,0,0,0,0,0,0,0,0
0,0,0,0,0,0,0,0,0
6790,104,3,10,8,2,0,1,0
6894,61,4,2,2,0,2,0,0
56149,428,15,56,56,0,9,1,0
9206,74,6,5,5,0,0,0,0
0,0,0,0,0,0,0,0,0
178910,951,6,92,72,20,2,1,0
25238,115,6,3,3,0,6,0,1
0,0,0,0,0,0,0,0,0
0,0,0,0,0,0,0,0,0
97991,543,7,50,32,18,1,1,0
81071,189,7,37,20,17,3,1,0
115805,1259,3,349,323,26,4,0,0
0,0,0,0,0,0,0,0,0
74974,649,7,110,109,1,6,1,0
0,0,0,0,0,0,0,0,0
212298,696,12,101,100,1,30,1,0
278078,3099,9,898,894,4,15,1,0
187796,866,15,48,31,17,33,1,0
39562,203,9,20,19,1,1,1,0
0,0,0,0,0,0,0,0,0
969316,1781,9,317,287,30,18,1,0
55749,933,6,155,105,50,159,1,0
401664,1643,10,291,9,282,37,1,0
295803,4118,12,1102,994,108,49,1,0
122823,2223,11,822,22,800,49,1,0
72847,458,0,73,71,2,0,1,0
291011,431,10,34,34,0,1,1,0
0,0,0,0,0,0,0,0,0
168564,1525,5,314,271,43,2,1,0
0,0,0,0,0,0,0,0,0
72354,494,8,0,0,0,11,0,0
221083,655,4,120,114,6,9,1,0
11353,208,4,63,63,0,1,0,0
23610,402,2,28,27,1,2,0,0
235390,738,7,77,50,27,9,1,0
30630,407,6,51,48,3,1,1,0
0,0,0,0,0,0,0,0,0
0,0,0,0,0,0,0,0,0
139682,407,10,49,49,0,0,1,0
25352,347,6,60,56,4,2,0,0
418834,1117,7,155,150,5,0,1,0
0,0,0,0,0,0,0,0,0
307,9,0,0,0,0,0,0,0
6142,84,3,8,8,0,3,0,0
0,0,0,0,0,0,0,0,0
28299,44,0,4,3,1,0,0,0
537008,3089,18,534,507,27,4,1,1
0,0,0,0,0,0,0,0,0
101870,519,6,71,60,11,5,0,0
0,0,0,0,0,0,0,0,0
0,0,0,0,0,0,0,0,0
48269,561,11,187,182,5,3,1,0
2419,36,3,3,2,1,0,0,0
526428,1753,7,227,214,13,28,1,0
526495,1753,7,227,214,13,28,1,0
70442,250,4,36,33,3,1,1,0
0,0,0,0,0,0,0,0,0
138121,466,10,36,28,8,0,1,0
140574,1235,12,196,162,34,16,1,0
8736,84,1,21,16,5,0,0,0
888470,2788,14,128,117,11,2,1,0
22537,54,1,2,2,0,0,0,0
111822,999,8,95,72,23,21,0,0
0,0,0,0,0,0,0,0,0
350974,1761,10,245,225,20,11,1,0
0,0,0,0,0,0,0,0,0
92407,855,5,88,84,4,1,1,0
0,0,0,0,0,0,0,0,0
3941,23,2,0,0,0,1,0,0
0,0,0,0,0,0,0,0,0
0,0,0,0,0,0,0,0,0
154315,1518,5,292,290,2,2,1,0
0,0,0,0,0,0,0,0,0
0,0,0,0,0,0,0,0,0
0,0,0,0,0,0,0,0,0
246989,1773,6,410,395,15,24,1,0
0,0,0,0,0,0,0,0,0
65191,850,7,106,95,11,2,1,0
154557,1423,8,164,123,41,4,1,0
280110,1556,4,400,389,11,7,0,0
58639,874,2,224,209,15,19,1,0
10660,156,2,14,9,5,0,1,0
0,0,0,0,0,0,0,0,0
72551,408,9,58,53,5,1,0,0
0,0,0,0,0,0,0,0,0
0,0,0,0,0,0,0,0,0
80256,693,4,95,80,15,11,1,0
78844,494,2,69,54,15,3,1,0
0,0,0,0,0,0,0,0,0
108463,867,6,181,170,11,7,0,1
0,0,0,0,0,0,0,0,0
0,0,0,0,0,0,0,0,0
0,0,0,0,0,0,0,0,0
0,0,0,0,0,0,0,0,0
85019,700,11,179,168,11,7,1,0
3314,29,1,1,1,0,0,0,0
58703,553,9,92,4,88,2,0,0
18546,188,5,33,33,0,1,0,0
0,0,0,0,0,0,0,0,0
0,0,0,0,0,0,0,0,0
63433,1707,2,462,462,0,1,1,0
0,0,0,0,0,0,0,0,0
0,0,0,0,0,0,0,0,0
0,0,0,0,0,0,0,0,0
340517,1693,7,233,221,12,5,1,0
11164,82,5,5,5,0,0,0,0
127982,940,9,145,139,6,1,1,0
93652,989,8,92,70,22,3,1,0
99710,1087,0,3,2,1,0,0,0
14372,121,2,23,22,1,1,0,0
0,0,0,0,0,0,0,0,0
0,0,0,0,0,0,0,0,0
0,0,0,0,0,0,0,0,0
230682,1743,4,422,412,10,2,1,0
0,0,0,0,0,0,0,0,0
62799,521,4,83,50,33,4,0,0
17174,111,1,0,0,0,0,0,0
0,0,0,0,0,0,0,0,0
0,0,0,0,0,0,0,0,0
475548,2744,8,389,380,9,3,1,0
31340,393,7,56,28,28,0,1,0
0,0,0,0,0,0,0,0,0
0,0,0,0,0,0,0,0,0
208138,2339,4,286,277,9,14,1,0
1156640,1738,2,158,143,15,1,1,0
0,0,0,0,0,0,0,0,0
0,0,0,0,0,0,0,0,0
87480,1823,7,469,468,1,11,1,0
57319,1241,7,326,325,1,13,1,0
0,0,0,0,0,0,0,0,0
0,0,0,0,0,0,0,0,0
126223,371,2,22,20,2,2,1,0
11638,208,1,19,18,1,12,1,0
0,0,0,0,0,0,0,0,0
66860,1200,5,317,315,2,13,1,0
30264,149,6,13,13,0,5,1,0
88658,1276,7,158,144,14,5,0,0
22483,207,5,45,45,0,2,0,0
96000,624,8,91,36,55,0,1,0
63143,254,7,12,9,3,0,1,0
28930,355,2,42,24,18,0,1,0
97608,686,4,177,171,6,7,1,0
42031,245,5,62,59,3,5,1,0
1366749,3000,10,397,227,170,40,1,0
978207,1409,14,102,91,11,4,1,0
0,0,0,0,0,0,0,0,0
21042,282,2,33,29,4,17,1,0
1976,35,1,0,0,0,0,0,0
574537,2635,7,380,347,33,26,1,0
0,0,0,0,0,0,0,0,0
0,0,0,0,0,0,0,0,0
35264,535,4,116,116,0,1,1,0
27459,407,3,92,92,0,0,1,0
599752,1591,16,251,237,14,259,1,0
0,0,0,0,0,0,0,0,0
484918,2028,14,466,453,13,10,1,0
0,0,0,0,0,0,0,0,0
73062,1925,2,566,566,0,1,1,0
0,0,0,0,0,0,0,0,0
303328,1256,9,130,108,22,11,1,0
230321,869,10,107,86,21,11,1,0
0,0,0,0,0,0,0,0,0
311854,533,5,143,51,92,2,1,0
49561,522,5,26,15,11,0,1,0
0,0,0,0,0,0,0,0,0
0,0,0,0,0,0,0,0,0
89813,1190,8,179,177,2,34,1,0
27539,300,7,40,37,3,9,1,0
945432,6250,17,900,894,6,31,1,0
20322,404,3,4,2,2,2,1,0
0,0,0,0,0,0,0,0,0
62190,443,8,120,98,22,9,1,0
0,0,0,0,0,0,0,0,0
55193,410,4,100,80,20,3,0,0
0,0,0,0,0,0,0,0,0
293386,4758,4,417,412,5,1,1,0
112769,931,4,298,295,3,1,1,0
0,0,0,0,0,0,0,0,0
0,0,0,0,0,0,0,0,0
63443,678,0,63,61,2,5,1,0
7330,110,3,12,12,0,0,1,0
0,0,0,0,0,0,0,0,0
35376,387,0,55,52,3,0,0,0
234600,1164,2,236,212,24,4,1,0
0,0,0,0,0,0,0,0,0
55050,997,2,355,349,6,7,1,0
114986,935,2,187,177,10,2,1,0
142124,1127,2,214,204,10,3,1,0
0,0,0,0,0,0,0,0,0
476649,1479,11,218,211,7,11,1,0
390715,501,11,9,7,2,10,1,0
41773,394,1,120,119,1,8,1,0
0,0,0,0,0,0,0,0,0
60155,794,8,189,189,0,6,1,0
32689,150,9,8,7,1,5,1,0
0,0,0,0,0,0,0,0,0
164234,765,5,119,93,26,0,1,0
145034,1608,7,444,422,22,30,1,0
0,0,0,0,0,0,0,0,0
0,0,0,0,0,0,0,0,0
120900,421,6,109,107,2,10,1,0
41641,651,1,86,77,9,10,0,0
0,0,0,0,0,0,0,0,0
0,0,0,0,0,0,0,0,0
114466,715,4,81,79,2,6,1,0
78698,573,4,149,129,20,0,1,0
110000,1487,6,203,198,5,5,1,0
0,0,0,0,0,0,0,0,0
91616,1384,1,344,344,0,1,1,0
267362,1282,2,157,148,9,1,1,0
47306,409,7,57,19,38,0,1,0
0,0,0,0,0,0,0,0,0
0,0,0,0,0,0,0,0,0
220649,747,12,66,58,8,43,1,0
122433,881,4,50,32,18,9,1,0
15135,173,2,41,24,17,0,1,0
111942,330,7,33,2,31,3,0,0
26689,120,5,4,4,0,0,0,0
0,0,0,0,0,0,0,0,0
164563,2166,7,58,57,1,11,1,0
1229936,6399,9,694,676,18,35,1,0
331446,1870,9,401,386,15,30,1,0
17418,94,6,12,12,0,0,0,0
199886,539,5,14,7,7,4,0,0
132470,723,11,134,131,3,2,1,0
376803,1368,2,294,264,30,4,1,0
0,0,0,0,0,0,0,0,0
107840,706,9,130,117,13,1,1,0
0,0,0,0,0,0,0,0,0
0,0,0,0,0,0,0,0,0
0,0,0,0,0,0,0,0,0
0,0,0,0,0,0,0,0,0
131215,932,9,92,88,4,4,1,0
0,0,0,0,0,0,0,0,0
0,0,0,0,0,0,0,0,0
0,0,0,0,0,0,0,0,0
0,0,0,0,0,0,0,0,0
0,0,0,0,0,0,0,0,0
0,0,0,0,0,0,0,0,0
76048,467,9,77,56,21,6,1,0
354395,890,5,140,137,3,7,1,0
73531,480,2,146,144,2,7,1,0
236433,2306,2,234,150,84,33,1,0
0,0,0,0,0,0,0,0,0
36777,445,1,78,66,12,1,1,0
0,0,0,0,0,0,0,0,0
1107027,1144,4,160,143,17,0,0,0
272686,516,9,73,60,13,1,1,0
247784,2624,0,1076,418,658,69,0,0
0,0,0,0,0,0,0,0,0
263723,854,9,87,80,7,2,1,0
11112927,512,5,59,48,11,0,1,0
0,0,0,0,0,0,0,0,0
0,0,0,0,0,0,0,0,0
134039,1609,5,372,364,8,23,1,0
788305,2972,4,212,194,18,6,1,0
0,0,0,0,0,0,0,0,0
0,0,0,0,0,0,0,0,0
0,0,0,0,0,0,0,0,0
71246,616,5,96,73,23,0,1,0
44173,173,5,32,28,4,0,1,0
0,0,0,0,0,0,0,0,0
0,0,0,0,0,0,0,0,0
46655,506,7,146,141,5,0,1,0
23851,172,7,28,24,4,0,1,0
6942,73,1,4,2,2,0,1,0
90774,570,7,74,72,2,12,1,0
1104305,1477,3,146,22,124,4,1,0
163853,332,2,6,2,4,0,0,0
114983,903,9,184,168,16,3,1,0
1314482,2917,9,392,226,166,39,1,0
624636,3775,5,561,528,33,4,1,1
0,0,0,0,0,0,0,0,0
235234,1411,4,324,315,9,1,1,0
198252,2070,2,232,198,34,6,1,0
49636,225,2,19,10,9,1,0,0
150991,580,5,83,70,13,0,0,0
0,0,0,0,0,0,0,0,0
143350,891,3,198,178,20,8,1,0
0,0,0,0,0,0,0,0,0
0,0,0,0,0,0,0,0,0
0,0,0,0,0,0,0,0,0
0,0,0,0,0,0,0,0,0
0,0,0,0,0,0,0,0,0
324412,915,6,160,156,4,3,1,0
260394,367,6,73,69,4,4,1,0
0,0,0,0,0,0,0,0,0
128467,1412,5,195,130,65,1,1,0
464802,4318,8,774,766,8,69,1,0
0,0,0,0,0,0,0,0,0
761151,7782,9,2950,2941,9,16,1,0
580572,6412,12,2763,2753,10,16,1,0
12259,92,6,4,4,0,0,1,0
0,0,0,0,0,0,0,0,0
590834,2583,7,362,350,12,6,0,0
66474,621,9,131,121,10,7,1,0
55497,329,10,22,20,2,11,1,0
122151,1036,7,211,186,25,3,0,0
0,0,0,0,0,0,0,0,0
1658011,18498,13,8641,8591,50,16,1,0
223274,2836,5,514,483,31,12,0,0
0,0,0,0,0,0,0,0,0
25410,434,2,52,40,12,5,1,0
8615,116,3,22,16,6,3,1,0
0,0,0,0,0,0,0,0,0
49167,324,9,47,6,41,3,0,0
45409,410,1,7,4,3,0,0,0
98704,1487,7,173,158,15,0,1,0
36086,459,7,74,64,10,0,1,0
27609,189,2,25,21,4,2,1,0
74068,306,8,61,61,0,7,1,0
584136,1442,10,74,60,14,0,1,0
315684,2167,8,142,120,22,16,1,0
0,0,0,0,0,0,0,0,0
64664,634,8,81,75,6,6,1,0
118580,620,12,77,65,12,14,1,0
0,0,0,0,0,0,0,0,0
32504,547,4,157,140,17,0,1,0
275248,1907,3,214,204,10,12,1,0
124274,1014,10,153,130,23,3,1,0
507230,2970,7,312,296,16,17,1,0
18566,62,0,1,0,1,0,0,0
269430,1901,8,290,281,9,17,1,0
245101,1682,8,261,252,9,17,1,0
531193,3042,11,187,167,20,32,1,0
399526,1350,4,113,107,6,1,1,0
6870,62,1,4,1,3,0,0,0
7037,58,2,1,1,0,2,0,0
684057,3222,4,182,162,20,8,1,0
0,0,0,0,0,0,0,0,0
75009,637,9,144,143,1,0,1,0
0,0,0,0,0,0,0,0,0
314613,4690,9,1350,1339,11,7,1,0
0,0,0,0,0,0,0,0,0
52814,725,4,103,99,4,1,1,0
93894,1380,3,4,4,0,0,0,0
0,0,0,0,0,0,0,0,0
324550,2393,8,131,115,16,15,1,0
0,0,0,0,0,0,0,0,0
14379,162,3,23,23,0,1,1,0
511422,1151,5,189,183,6,18,1,0
89318,599,9,79,64,15,0,1,0
22865,37,0,2,1,1,0,1,0
22893,37,0,2,1,1,0,1,0
130872,1262,2,214,204,10,21,1,0
39828,331,4,61,52,9,10,1,0
377249,3738,8,184,173,11,14,1,0
250865,1587,11,298,286,12,25,1,0
0,0,0,0,0,0,0,0,0
318472,1368,16,243,226,17,48,1,0
11550,89,7,3,2,1,2,0,0
0,0,0,0,0,0,0,0,0
22006,35,0,1,1,0,0,1,0
521094,2232,2,193,89,104,6,1,0
0,0,0,0,0,0,0,0,0
0,0,0,0,0,0,0,0,0
154299,1970,9,242,137,105,16,0,0
104563,716,8,113,85,28,4,0,0
112165,1344,9,277,262,15,5,1,0
922412,2241,3,191,175,16,3,1,0
52310,573,6,52,3,49,3,0,0
641352,2444,6,371,169,202,18,1,0
86130,1267,2,289,270,19,0,1,0
328243,1113,4,114,99,15,1,1,0
202904,923,10,171,132,39,16,1,0
332872,1564,7,425,347,78,17,1,0
35414,265,4,36,19,17,0,1,0
0,0,0,0,0,0,0,0,0
206458,2486,7,233,223,10,23,1,0
18343,102,6,12,12,0,2,0,0
0,0,0,0,0,0,0,0,0
521137,2231,2,193,89,104,6,1,0
0,0,0,0,0,0,0,0,0
0,0,0,0,0,0,0,0,0
103845,895,10,252,196,56,3,1,0
0,0,0,0,0,0,0,0,0
0,0,0,0,0,0,0,0,0
0,0,0,0,0,0,0,0,0
23322,286,1,6,4,2,0,1,0
217323,496,11,117,114,3,4,1,0
343323,4290,7,848,736,112,38,1,0
107082,870,6,222,213,9,3,1,0
0,0,0,0,0,0,0,0,0
326026,1126,5,127,102,25,24,1,0
69499,830,3,51,38,13,17,1,0
136941,549,12,62,46,16,11,1,0
184142,581,4,105,96,9,8,1,0
0,0,0,0,0,0,0,0,0
28798,45,0,4,1,3,0,0,0
0,0,0,0,0,0,0,0,0
48704,761,8,121,121,0,5,1,0
16992,223,6,33,33,0,3,1,0
0,0,0,0,0,0,0,0,0
251507,1780,5,122,107,15,11,1,0
91759,500,2,28,8,20,11,1,0
735350,4130,4,437,416,21,13,1,0
258050,373,6,10,6,4,0,1,0
0,0,0,0,0,0,0,0,0
28269,42,0,2,1,1,0,0,0
120208,1427,9,483,477,6,12,0,0
0,0,0,0,0,0,0,0,0
92080,850,6,207,205,2,0,1,0
0,0,0,0,0,0,0,0,0
186553,1650,7,287,247,40,10,0,0
169510,146,1,1,0,1,3,1,0
0,0,0,0,0,0,0,0,0
0,0,0,0,0,0,0,0,0
0,0,0,0,0,0,0,0,0
982950,2295,5,171,144,27,14,0,0
149452,287,2,14,2,12,2,1,1
0,0,0,0,0,0,0,0,0
287764,1603,10,386,354,32,10,0,0
0,0,0,0,0,0,0,0,0
176714,1127,6,275,270,5,12,1,0
29270,371,4,71,68,3,3,0,0
36922,568,4,68,55,13,4,1,0
108514,438,16,52,46,6,6,1,0
6009,60,6,3,2,1,0,0,0
411678,2550,1,442,394,48,0,1,0
23374,161,0,2,1,1,0,0,0
0,0,0,0,0,0,0,0,0
0,0,0,0,0,0,0,0,0
0,0,0,0,0,0,0,0,0
0,0,0,0,0,0,0,0,0
810839,1720,3,53,38,15,39,1,0
119301,635,8,98,98,0,3,1,0
231151,3147,5,598,524,74,30,1,0
37035,556,4,111,102,9,11,1,0
0,0,0,0,0,0,0,0,0
51673,760,3,191,162,29,0,1,0
0,0,0,0,0,0,0,0,0
0,0,0,0,0,0,0,0,0
0,0,0,0,0,0,0,0,0
19436,305,5,22,14,8,0,1,0
0,0,0,0,0,0,0,0,0
29568,333,4,60,59,1,2,1,0
21411,200,4,38,37,1,2,1,0
95301,1156,0,374,366,8,2,1,0
45823,291,8,29,24,5,1,1,0
121369,250,11,27,23,4,0,1,0
46290,745,3,268,266,2,0,1,0
870734,960,7,144,132,12,1,1,0
825488,191,7,74,72,2,1,1,0
0,0,0,0,0,0,0,0,0
0,0,0,0,0,0,0,0,0
0,0,0,0,0,0,0,0,0
189860,697,8,109,98,11,20,1,0
0,0,0,0,0,0,0,0,0
0,0,0,0,0,0,0,0,0
7387,53,4,0,0,0,1,0,0
0,0,0,0,0,0,0,0,0
0,0,0,0,0,0,0,0,0
1597182,1879,8,357,343,14,13,1,0
0,0,0,0,0,0,0,0,0
0,0,0,0,0,0,0,0,0
143649,1131,6,116,109,7,1,1,0
458739,1045,4,162,140,22,3,1,0
6722,137,1,8,8,0,3,1,0
334121,1113,12,202,184,18,10,1,0
1188,18,0,0,0,0,0,0,0
50483,565,4,27,22,5,5,1,0
29468,520,5,97,89,8,0,1,0
9072,194,5,51,50,1,0,1,0
0,0,0,0,0,0,0,0,0
668950,798,6,205,184,21,2,0,0
143511,2836,5,426,395,31,1,1,0
755728,2688,18,164,157,7,9,1,0
357748,726,4,3,3,0,10,0,0
408602,1920,4,334,323,11,0,1,0
11301,75,4,7,3,4,2,0,0
120638,1475,8,169,151,18,14,0,0
64172,544,4,136,135,1,11,0,0
277166,911,3,61,52,9,2,0,0
22819,37,0,2,1,1,0,1,0
18218,94,0,16,5,11,5,0,0
0,0,0,0,0,0,0,0,0
27205,321,0,32,32,0,0,1,0
6253,73,0,2,2,0,0,1,0
48899,491,3,94,89,5,0,0,0
318032,779,8,172,144,28,8,1,0
211721,351,2,0,0,0,2,0,0
0,0,0,0,0,0,0,0,0
69475,358,4,25,18,7,140,0,0
614702,590,5,70,60,10,8,1,0
30060,120,2,7,7,0,2,1,0
361665,1904,14,252,182,70,7,1,0
35175,248,5,47,4,43,5,1,0
32568,229,5,45,22,23,5,1,0
0,0,0,0,0,0,0,0,0
0,0,0,0,0,0,0,0,0
61273,357,7,61,49,12,19,1,0
0,0,0,0,0,0,0,0,0
0,0,0,0,0,0,0,0,0
0,0,0,0,0,0,0,0,0
0,0,0,0,0,0,0,0,0
0,0,0,0,0,0,0,0,0
580643,748,6,66,55,11,3,1,0
0,0,0,0,0,0,0,0,0
0,0,0,0,0,0,0,0,0
94863,1840,7,456,454,2,18,0,0
11692,144,0,36,29,7,0,1,0
220398,1481,12,236,231,5,7,1,0
0,0,0,0,0,0,0,0,0
259759,739,5,55,53,2,1,1,0
3181,27,2,2,0,2,0,1,0
0,0,0,0,0,0,0,0,0
0,0,0,0,0,0,0,0,0
357412,660,4,25,22,3,1,1,0
57437,126,3,13,12,1,0,0,0
33641,511,6,135,128,7,5,1,0
12533,126,6,19,19,0,5,1,0
0,0,0,0,0,0,0,0,0
72495,688,6,149,102,47,33,1,0
71685,266,6,38,31,7,23,1,0
27935,42,0,2,1,1,0,0,0
108274,646,12,161,157,4,10,1,0
1062,29,0,0,0,0,0,0,0
175725,2162,13,313,312,1,22,0,0
96202,907,13,118,118,0,17,0,0
0,0,0,0,0,0,0,0,0
0,0,0,0,0,0,0,0,0
215072,816,13,63,56,7,25,1,0
1158366,3419,6,258,251,7,7,1,0
0,0,0,0,0,0,0,0,0
14241,257,7,27,27,0,2,1,0
16012,174,7,17,17,0,2,1,0
458671,4146,7,994,986,8,8,1,0
198033,1869,4,128,109,19,2,1,0
96979,655,4,99,86,13,3,1,0
0,0,0,0,0,0,0,0,0
7189,77,0,1,1,0,0,0,0
29804,315,4,71,62,9,4,1,0
63078,693,7,174,106,68,11,1,0
138140,2459,4,316,306,10,8,1,0
0,0,0,0,0,0,0,0,0
0,0,0,0,0,0,0,0,0
682152,2161,13,399,279,120,73,1,0
32794,334,3,29,26,3,8,1,0
0,0,0,0,0,0,0,0,0
124849,1900,3,503,497,6,59,0,0
66538,1017,3,269,263,6,11,0,0
223083,1577,5,292,234,58,1,1,0
32836,387,2,35,33,2,3,0,0
13577,83,1,4,4,0,1,0,0
385,23,0,4,4,0,0,0,0
366066,2495,1,155,94,61,64,1,0
246855,1444,1,110,86,24,62,1,0
0,0,0,0,0,0,0,0,0
51018,137,1,16,16,0,0,1,0
166479,2637,2,450,450,0,0,1,0
17050,459,2,195,195,0,0,1,0
202002,2244,6,352,348,4,6,1,0
117671,1063,6,229,225,4,6,1,0
54519,1140,3,226,214,12,1,1,0
807677,9476,4,1371,1359,12,4,1,0
707498,1594,11,197,187,10,2,1,0
0,0,0,0,0,0,0,0,0
97564,1171,7,168,138,30,3,1,0
123633,141,3,3,2,1,1,0,0
301360,1724,6,63,55,8,0,1,0
491780,4986,13,605,598,7,5,1,0
68370,549,12,105,99,6,4,1,0
19964,286,5,23,23,0,1,1,0
0,0,0,0,0,0,0,0,0
0,0,0,0,0,0,0,0,0
769401,2555,12,360,271,89,43,0,0
165103,579,11,88,76,12,2,1,0
4019570,2033,0,84,81,3,0,1,0
76492,328,1,16,12,4,2,1,0
113483,883,6,151,143,8,2,1,0
0,0,0,0,0,0,0,0,0
0,0,0,0,0,0,0,0,0
16273,180,2,26,24,2,1,1,0
0,0,0,0,0,0,0,0,0
0,0,0,0,0,0,0,0,0
0,0,0,0,0,0,0,0,0
121263,1115,12,137,126,11,2,1,0
0,0,0,0,0,0,0,0,0
104236,1787,1,281,273,8,0,1,0
1168660,2355,4,166,147,19,100,1,0
838684,477,4,75,60,15,9,1,0
199187,965,1,150,137,13,1,1,0
28348,125,2,2,2,0,1,0,0
44831,385,7,55,19,36,0,1,0
0,0,0,0,0,0,0,0,0
0,0,0,0,0,0,0,0,0
0,0,0,0,0,0,0,0,0
192925,964,3,194,68,126,8,0,0
126924,1485,9,233,215,18,8,1,0
23076,169,8,10,9,1,6,1,0
0,0,0,0,0,0,0,0,0
83467,708,9,110,105,5,3,1,0
260313,1263,5,220,189,31,3,0,0
0,0,0,0,0,0,0,0,0
15673,311,3,89,70,19,0,0,0
114755,1063,7,78,67,11,90,1,0
61534,431,6,40,31,9,14,1,0
0,0,0,0,0,0,0,0,0
154810,1150,10,185,180,5,15,1,0
911172,1115,3,125,110,15,8,0,0
0,0,0,0,0,0,0,0,0
0,0,0,0,0,0,0,0,0
907387,715,5,81,31,50,3,1,0
35010,142,9,6,6,0,2,0,0
0,0,0,0,0,0,0,0,0
158803,690,6,73,59,14,2,1,0
323151,1237,9,136,134,2,9,1,0
0,0,0,0,0,0,0,0,0
324210,7409,4,521,514,7,0,1,0
25923,379,4,91,90,1,0,1,0
166618,780,8,160,155,5,0,1,0
51888,943,2,227,224,3,0,1,0
537413,2678,7,354,348,6,4,0,0
339904,1547,7,256,250,6,5,0,0
179895,1993,3,579,556,23,60,1,0
116744,1405,7,227,168,59,2,0,0
0,0,0,0,0,0,0,0,0
0,0,0,0,0,0,0,0,0
0,0,0,0,0,0,0,0,0
189755,2720,4,90,79,11,6,1,0
121329,466,7,50,49,1,1,1,0
0,0,0,0,0,0,0,0,0
244891,1406,8,324,309,15,2,1,0
219093,5081,0,487,486,1,0,1,0
27877,42,0,2,1,1,0,0,0
542510,7294,14,1306,1076,230,11,1,0
474226,6611,14,1183,959,224,11,1,0
0,0,0,0,0,0,0,0,0
145113,956,2,57,23,34,4,1,0
0,0,0,0,0,0,0,0,0
0,0,0,0,0,0,0,0,0
1199147,4742,8,615,117,498,67,1,1
148602,967,10,115,103,12,4,1,0
0,0,0,0,0,0,0,0,0
0,0,0,0,0,0,0,0,0
81200,795,10,241,200,41,2,1,0
309811,1596,15,178,169,9,11,1,0
0,0,0,0,0,0,0,0,0
0,0,0,0,0,0,0,0,0
89365,883,7,119,105,14,0,1,0
12896,122,3,13,13,0,0,1,0
39285,861,1,161,159,2,0,0,0
7299,163,1,50,48,2,0,0,0
0,0,0,0,0,0,0,0,0
80023,1504,4,322,322,0,4,1,0
18474,266,4,47,47,0,4,1,0
1689936,1357,3,105,104,1,2,1,0
0,0,0,0,0,0,0,0,0
0,0,0,0,0,0,0,0,0
743152,3995,0,428,411,17,0,1,0
23206,254,4,37,36,1,0,0,0
11781,189,5,34,28,6,0,1,0
526136,3408,9,847,816,31,21,1,0
388932,1873,4,237,206,31,0,0,0
0,0,0,0,0,0,0,0,0
0,0,0,0,0,0,0,0,0
0,0,0,0,0,0,0,0,0
0,0,0,0,0,0,0,0,0
0,0,0,0,0,0,0,0,0
19333,285,2,71,56,15,1,1,0
9568,73,2,5,5,0,2,0,0
1442559,17077,3,7179,4363,2816,202,1,0
1442559,17077,3,7179,5255,1924,202,1,0
200512,1095,0,118,105,13,8,1,0
0,0,0,0,0,0,0,0,0
0,0,0,0,0,0,0,0,0
0,0,0,0,0,0,0,0,0
477683,2416,12,338,294,44,18,1,0
161653,1158,11,191,156,35,7,1,0
166901,1685,8,152,122,30,37,0,0
0,0,0,0,0,0,0,0,0
254953,1105,12,279,266,13,12,1,0
199947,1270,12,168,158,10,16,1,0
160158,916,10,136,127,9,9,1,0
205244,608,12,43,37,6,1,1,0
465273,3313,9,527,494,33,26,1,0
0,0,0,0,0,0,0,0,0
186594,2791,5,624,537,87,407,1,0
464828,1353,3,134,114,20,3,1,0
0,0,0,0,0,0,0,0,0
312788,1574,7,343,298,45,19,1,0
294912,2889,7,420,362,58,5,1,0
61790,325,13,79,74,5,5,1,0
0,0,0,0,0,0,0,0,0
0,0,0,0,0,0,0,0,0
93841,445,7,123,115,8,7,1,0
692216,537,0,5,3,2,2,1,1
89626,651,3,173,167,6,9,1,0
34976,449,6,84,67,17,5,1,0
0,0,0,0,0,0,0,0,0
0,0,0,0,0,0,0,0,0
0,0,0,0,0,0,0,0,0
0,0,0,0,0,0,0,0,0
270693,322,10,38,2,36,1,1,0
259469,344,12,43,38,5,2,1,0
602340,1055,5,86,84,2,2,1,0
34086,228,4,34,28,6,0,1,0
20997,442,1,63,55,8,3,1,0
79717,849,9,112,79,33,0,1,0
0,0,0,0,0,0,0,0,0
16547,198,2,21,19,2,0,0,0
16547,198,2,21,19,2,0,0,0
14732,235,1,45,42,3,1,1,0
137571,909,7,98,47,51,7,1,0
9031,64,0,0,0,0,0,0,0
141560,482,9,89,80,9,26,1,0
117931,323,7,57,55,2,29,1,0
73563,237,4,35,28,7,4,1,0
0,0,0,0,0,0,0,0,0
417375,1864,6,174,155,19,3,1,0
60490,897,7,169,157,12,6,1,0
24946,406,7,59,59,0,3,1,0
0,0,0,0,0,0,0,0,0
382573,2379,12,370,306,64,13,1,0
31487,373,5,12,11,1,3,0,0
15275,225,4,52,37,15,0,1,0
212748,1345,6,90,81,9,48,1,0
14997,109,6,5,3,2,0,0,0
0,0,0,0,0,0,0,0,0
57884,607,10,55,45,10,7,0,0
40228,273,10,23,20,3,7,0,0
0,0,0,0,0,0,0,0,0
939411,3624,5,568,537,31,1,1,0
78486,689,6,138,134,4,1,1,0
57905,417,6,92,88,4,1,1,0
45120,612,3,91,69,22,11,0,0
25662,113,4,5,4,1,4,0,0
104899,339,3,52,47,5,8,1,0
0,0,0,0,0,0,0,0,0
89461,819,11,86,82,4,2,1,0
168999,1169,4,171,85,86,8,1,0
405981,2941,12,659,82,577,7,1,0
389632,2941,12,681,582,99,3,1,0
0,0,0,0,0,0,0,0,0
195993,2176,1,487,114,373,8,1,0
244365,777,8,112,103,9,2,1,0
0,0,0,0,0,0,0,0,0
0,0,0,0,0,0,0,0,0
181487,1573,7,537,536,1,0,1,0
27857,42,0,2,1,1,0,0,0
322801,1121,9,101,93,8,4,1,0
0,0,0,0,0,0,0,0,0
0,0,0,0,0,0,0,0,0
139608,814,12,159,153,6,7,1,0
414309,2677,10,467,452,15,6,1,0
0,0,0,0,0,0,0,0,0
672424,7533,15,1607,1606,1,5,1,0
239703,3220,16,766,765,1,5,1,0
0,0,0,0,0,0,0,0,0
0,0,0,0,0,0,0,0,0
347295,2039,4,229,180,49,3,1,0
277994,1304,4,72,47,25,5,0,0
296330,866,9,94,86,8,4,1,0
141595,335,6,18,16,2,12,1,0
0,0,0,0,0,0,0,0,0
494538,984,8,108,88,20,7,1,0
164956,2438,1,823,796,27,2,1,0
59623,1178,2,423,422,1,0,1,0
0,0,0,0,0,0,0,0,0
79689,406,6,67,66,1,0,1,0
0,0,0,0,0,0,0,0,0
0,0,0,0,0,0,0,0,0
0,0,0,0,0,0,0,0,0
54809,828,5,211,209,2,3,1,0
34822,490,6,99,90,9,4,1,0
182170,596,7,53,45,8,5,0,0
21997,35,0,1,1,0,0,1,0
5468,202,0,39,37,2,0,0,0
89056,1438,4,201,185,16,3,1,0
232890,335,5,30,30,0,9,1,0
191385,240,5,29,29,0,8,1,0
32116,356,3,77,67,10,1,1,0
254471,1939,7,308,280,28,3,1,0
0,0,0,0,0,0,0,0,0
246366,2865,5,905,900,5,1,1,0
33579,673,4,143,139,4,0,1,0
292156,3642,1,280,262,18,2,1,0
22784,37,0,2,1,1,0,1,0
0,0,0,0,0,0,0,0,0
365269,1094,7,97,75,22,4,1,0
0,0,0,0,0,0,0,0,0
647731,1034,3,196,162,34,8,1,0
0,0,0,0,0,0,0,0,0
65347,587,8,139,132,7,5,1,0
57484,760,7,97,89,8,5,1,0
0,0,0,0,0,0,0,0,0
0,0,0,0,0,0,0,0,0
327624,1192,8,125,75,50,0,0,0
0,0,0,0,0,0,0,0,0
20848,49,2,5,5,0,0,1,0
32448,499,1,68,2,66,0,1,0
139632,239,3,3,2,1,2,0,0
98762,695,4,90,84,6,7,1,0
39445,162,4,17,15,2,7,1,0
229240,1085,8,87,72,15,4,1,0
0,0,0,0,0,0,0,0,0
606496,3520,2,280,237,43,8,1,0
537906,1665,11,111,107,4,42,1,0
0,0,0,0,0,0,0,0,0
106132,1156,2,169,157,12,9,1,0
172792,1035,2,91,80,11,10,1,0
298147,2666,2,55,44,11,12,1,0
0,0,0,0,0,0,0,0,0
0,0,0,0,0,0,0,0,0
0,0,0,0,0,0,0,0,0
0,0,0,0,0,0,0,0,0
1186478,1965,14,303,233,70,34,1,0
172319,836,11,127,119,8,6,1,0
70904,1073,11,268,260,8,14,1,0
0,0,0,0,0,0,0,0,0
0,0,0,0,0,0,0,0,0
34858,614,3,12,6,6,4,1,0
181128,607,15,62,56,6,2,1,0
0,0,0,0,0,0,0,0,0
12822,264,3,47,34,13,0,1,0
16027,324,1,26,25,1,1,0,0
321963,7514,0,732,731,1,0,1,0
186170,1568,9,232,216,16,7,0,0
66840,378,7,73,71,2,0,0,0
50212,470,7,23,19,4,10,1,0
54622,1046,6,135,135,0,1,0,0
90425,1041,9,101,101,0,7,0,0
0,0,0,0,0,0,0,0,0
267084,460,5,133,130,3,6,1,0
97385,815,9,123,119,4,4,1,0
2267,31,3,3,2,1,0,0,0
46045,343,5,23,13,10,0,1,0
0,0,0,0,0,0,0,0,0
67199,785,5,106,13,93,5,1,0
115962,448,7,63,63,0,0,1,0
0,0,0,0,0,0,0,0,0
0,0,0,0,0,0,0,0,0
0,0,0,0,0,0,0,0,0
0,0,0,0,0,0,0,0,0
143330,366,5,17,16,1,6,0,0
283377,1256,12,247,239,8,4,0,0
59684,703,10,80,57,23,26,1,0
21058,337,3,46,45,1,0,0,0
9138,191,3,22,22,0,0,0,0
193302,963,11,60,55,5,3,0,0
123330,421,10,48,43,5,3,0,0
221681,1775,6,167,150,17,15,1,0
0,0,0,0,0,0,0,0,0
0,0,0,0,0,0,0,0,0
54596,496,3,145,136,9,6,1,0
0,0,0,0,0,0,0,0,0
0,0,0,0,0,0,0,0,0
58659,814,2,268,221,47,18,1,0
704000,2472,3,194,3,191,6,1,0
415600,925,3,92,79,13,3,1,0
162063,2411,6,461,457,4,9,1,0
2254,32,3,1,1,0,0,1,0
690813,535,0,3,0,3,2,1,1
0,0,0,0,0,0,0,0,0
0,0,0,0,0,0,0,0,0
263394,2652,14,151,136,15,8,1,0
259842,1866,11,364,356,8,5,1,0
6896,67,6,2,2,0,1,0,0
619261,2678,4,345,341,4,27,1,0
63788,891,6,230,196,34,1,1,0
