page_len,page_tag_num,page_tech_num,page_domain_type_num,page_like_req_domain_num,page_unlike_req_domain_num,page_hidden_tag_num,page_have_copyright,page_have_redirect
36451,48,1,0,0,0,0,0,0
0,0,0,0,0,0,0,0,0
0,0,0,0,0,0,0,0,0
36090,163,0,3,0,3,0,0,0
44447,224,0,12,10,2,0,0,0
0,0,0,0,0,0,0,0,0
0,0,0,0,0,0,0,0,0
0,0,0,0,0,0,0,0,0
11167,82,0,6,1,5,0,1,0
0,0,0,0,0,0,0,0,0
0,0,0,0,0,0,0,0,0
2695,48,0,1,1,0,0,0,0
37143,51,1,2,0,2,2,0,0
716908,599,1,29,0,29,3,1,0
356692,1378,0,136,100,36,0,1,0
0,0,0,0,0,0,0,0,0
390092,241,4,4,2,2,0,1,0
21290,93,8,0,0,0,4,1,0
36563,124,2,7,4,3,1,0,0
0,0,0,0,0,0,0,0,0
40012,126,1,1,1,0,0,1,0
47937,76,2,1,1,0,3,1,0
0,0,0,0,0,0,0,0,0
0,0,0,0,0,0,0,0,0
0,0,0,0,0,0,0,0,0
0,0,0,0,0,0,0,0,0
0,0,0,0,0,0,0,0,0
0,0,0,0,0,0,0,0,0
32177,169,6,13,10,3,1,0,0
0,0,0,0,0,0,0,0,0
0,0,0,0,0,0,0,0,0
27324,150,1,11,10,1,2,1,1
0,0,0,0,0,0,0,0,0
1059221,101,4,5,5,0,3,1,0
22262,106,1,11,10,1,2,0,0
0,0,0,0,0,0,0,0,0
0,0,0,0,0,0,0,0,0
0,0,0,0,0,0,0,0,0
121584,548,2,9,3,6,39,1,0
48562,142,3,6,3,3,2,0,0
0,0,0,0,0,0,0,0,0
270828,167,4,0,0,0,0,1,0
45570,68,0,1,0,1,0,0,0
45588,68,0,1,0,1,0,0,0
21957,209,5,27,11,16,2,0,0
21933,209,5,27,11,16,2,0,0
7308,21,4,0,0,0,0,0,1
7308,21,4,0,0,0,0,0,1
2856,43,1,0,0,0,0,0,0
0,0,0,0,0,0,0,0,0
77887,498,2,8,1,7,1,1,0
44447,224,0,12,10,2,0,0,0
0,0,0,0,0,0,0,0,0
0,0,0,0,0,0,0,0,0
9054,79,1,0,0,0,0,0,0
3903,27,1,0,0,0,0,0,0
0,0,0,0,0,0,0,0,0
3938,26,1,0,0,0,0,0,0
7296,59,2,3,2,1,0,0,0
0,0,0,0,0,0,0,0,0
1479820,171,0,11,3,8,1,1,0
77826,101,1,4,2,2,0,0,0
1952,33,0,0,0,0,2,0,0
116135,251,1,6,6,0,1,1,0
116135,251,1,6,6,0,1,1,0
0,0,0,0,0,0,0,0,0
796090,445,1,82,21,61,1,1,0
62234,77,0,0,0,0,0,0,0
124649,229,3,9,9,0,2,1,0
1873,31,1,3,3,0,1,0,0
7881,42,4,0,0,0,2,0,0
0,0,0,0,0,0,0,0,0
0,0,0,0,0,0,0,0,0
0,0,0,0,0,0,0,0,0
63311,194,2,8,4,4,1,1,0
1059955,101,4,5,5,0,3,1,0
151156,174,1,13,12,1,0,1,0
24597,183,5,1,0,1,2,1,0
0,0,0,0,0,0,0,0,0
6644,34,1,1,1,0,3,0,0
0,0,0,0,0,0,0,0,0
4948,61,5,9,7,2,0,0,0
4949,61,5,9,7,2,0,0,0
0,0,0,0,0,0,0,0,0
283657,174,4,1,1,0,0,1,0
61117,97,0,10,9,1,0,0,0
0,0,0,0,0,0,0,0,0
0,0,0,0,0,0,0,0,0
0,0,0,0,0,0,0,0,0
0,0,0,0,0,0,0,0,0
0,0,0,0,0,0,0,0,0
0,0,0,0,0,0,0,0,0
0,0,0,0,0,0,0,0,0
0,0,0,0,0,0,0,0,0
538,12,1,0,0,0,0,0,0
538,12,1,0,0,0,0,0,0
538,12,1,0,0,0,0,0,0
0,0,0,0,0,0,0,0,0
395,7,1,0,0,0,0,0,0
0,0,0,0,0,0,0,0,0
0,0,0,0,0,0,0,0,0
0,0,0,0,0,0,0,0,0
0,0,0,0,0,0,0,0,0
8156,23,1,0,0,0,0,0,0
0,0,0,0,0,0,0,0,0
0,0,0,0,0,0,0,0,0
0,0,0,0,0,0,0,0,0
0,0,0,0,0,0,0,0,0
226215,1551,10,391,323,68,9,1,0
0,0,0,0,0,0,0,0,0
0,0,0,0,0,0,0,0,0
45473,642,4,163,26,137,3,1,0
69721,45,2,0,0,0,0,0,0
1011,19,1,0,0,0,0,0,0
1011,19,1,0,0,0,0,0,0
36426,48,1,0,0,0,0,0,0
0,0,0,0,0,0,0,0,0
0,0,0,0,0,0,0,0,0
0,0,0,0,0,0,0,0,0
0,0,0,0,0,0,0,0,0
0,0,0,0,0,0,0,0,0
24887,82,1,7,3,4,3,0,0
0,0,0,0,0,0,0,0,0
2035,52,0,4,4,0,0,1,0
0,0,0,0,0,0,0,0,0
0,0,0,0,0,0,0,0,0
0,0,0,0,0,0,0,0,0
151156,174,1,13,12,1,0,1,0
151156,174,1,13,12,1,0,1,0
0,0,0,0,0,0,0,0,0
0,0,0,0,0,0,0,0,0
0,0,0,0,0,0,0,0,0
0,0,0,0,0,0,0,0,0
0,0,0,0,0,0,0,0,0
0,0,0,0,0,0,0,0,0
0,0,0,0,0,0,0,0,0
0,0,0,0,0,0,0,0,0
0,0,0,0,0,0,0,0,0
0,0,0,0,0,0,0,0,0
0,0,0,0,0,0,0,0,0
0,0,0,0,0,0,0,0,0
0,0,0,0,0,0,0,0,0
0,0,0,0,0,0,0,0,0
0,0,0,0,0,0,0,0,0
0,0,0,0,0,0,0,0,0
0,0,0,0,0,0,0,0,0
78486,169,2,5,2,3,1,1,0
0,0,0,0,0,0,0,0,0
21468,528,1,2,2,0,0,0,0
42565,227,4,46,25,21,3,1,0
0,0,0,0,0,0,0,0,0
0,0,0,0,0,0,0,0,0
0,0,0,0,0,0,0,0,0
0,0,0,0,0,0,0,0,0
19608,145,1,3,3,0,21,0,0
0,0,0,0,0,0,0,0,0
35856,169,6,4,1,3,1,0,0
0,0,0,0,0,0,0,0,0
93531,207,4,0,0,0,1,0,0
90461,205,4,0,0,0,1,0,0
0,0,0,0,0,0,0,0,0
0,0,0,0,0,0,0,0,0
0,0,0,0,0,0,0,0,0
0,0,0,0,0,0,0,0,0
0,0,0,0,0,0,0,0,0
0,0,0,0,0,0,0,0,0
0,0,0,0,0,0,0,0,0
0,0,0,0,0,0,0,0,0
0,0,0,0,0,0,0,0,0
215894,1690,6,183,183,0,107,0,0
20708,191,1,13,3,10,0,0,0
6244,42,0,3,1,2,0,1,0
151156,174,1,13,12,1,0,1,0
0,0,0,0,0,0,0,0,0
1777,32,1,0,0,0,0,1,0
208198,273,0,17,4,13,0,1,0
0,0,0,0,0,0,0,0,0
4108,26,1,0,0,0,0,0,0
64924,100,0,11,11,0,0,0,0
0,0,0,0,0,0,0,0,0
959804,1081,0,185,183,2,6,0,0
291774,186,4,1,1,0,0,1,0
0,0,0,0,0,0,0,0,0
24545,163,0,20,16,4,9,0,0
47012,207,2,1,1,0,1,1,0
2868,42,2,2,1,1,0,1,0
0,0,0,0,0,0,0,0,0
9449,67,4,4,4,0,3,0,0
6626,392,0,2,2,0,0,0,0
6626,392,0,2,2,0,0,0,0
108978,76,1,5,5,0,1,0,0
33426,173,6,14,12,2,1,0,0
301350,189,4,1,1,0,0,1,0
4949,61,5,9,7,2,0,0,0
4949,61,5,9,7,2,0,0,0
40020,126,1,1,1,0,0,1,0
253290,1704,10,411,343,68,9,1,0
1089669,108,2,6,6,0,1,1,0
0,0,0,0,0,0,0,0,0
40028,126,1,1,1,0,0,1,0
0,0,0,0,0,0,0,0,0
0,0,0,0,0,0,0,0,0
0,0,0,0,0,0,0,0,0
0,0,0,0,0,0,0,0,0
63282,194,2,7,4,3,1,1,0
72896,63,1,0,0,0,1,0,0
0,0,0,0,0,0,0,0,0
42453,187,2,6,3,3,2,1,0
42453,187,2,6,3,3,2,1,0
0,0,0,0,0,0,0,0,0
0,0,0,0,0,0,0,0,0
112446,161,0,3,3,0,4,0,0
0,0,0,0,0,0,0,0,0
0,0,0,0,0,0,0,0,0
35799,172,6,3,1,2,1,0,0
0,0,0,0,0,0,0,0,0
0,0,0,0,0,0,0,0,0
0,0,0,0,0,0,0,0,0
0,0,0,0,0,0,0,0,0
65738,249,2,18,14,4,6,1,0
0,0,0,0,0,0,0,0,0
0,0,0,0,0,0,0,0,0
0,0,0,0,0,0,0,0,0
0,0,0,0,0,0,0,0,0
0,0,0,0,0,0,0,0,0
0,0,0,0,0,0,0,0,0
0,0,0,0,0,0,0,0,0
0,0,0,0,0,0,0,0,0
0,0,0,0,0,0,0,0,0
0,0,0,0,0,0,0,0,0
0,0,0,0,0,0,0,0,0
0,0,0,0,0,0,0,0,0
0,0,0,0,0,0,0,0,0
0,0,0,0,0,0,0,0,0
0,0,0,0,0,0,0,0,0
0,0,0,0,0,0,0,0,0
0,0,0,0,0,0,0,0,0
0,0,0,0,0,0,0,0,0
0,0,0,0,0,0,0,0,0
0,0,0,0,0,0,0,0,0
0,0,0,0,0,0,0,0,0
0,0,0,0,0,0,0,0,0
822,8,0,0,0,0,0,0,0
822,8,0,0,0,0,0,0,0
2678,42,0,1,1,0,0,0,0
0,0,0,0,0,0,0,0,0
0,0,0,0,0,0,0,0,0
0,0,0,0,0,0,0,0,0
0,0,0,0,0,0,0,0,0
0,0,0,0,0,0,0,0,0
13915,182,4,16,5,11,0,0,0
319785,187,4,1,1,0,0,1,0
0,0,0,0,0,0,0,0,0
0,0,0,0,0,0,0,0,0
0,0,0,0,0,0,0,0,0
16077,72,4,0,0,0,0,1,0
123835,1595,3,210,173,37,10,1,0
0,0,0,0,0,0,0,0,0
20772,158,0,1,0,1,0,1,0
917111,223,0,7,6,1,3,1,0
61401,95,0,11,10,1,0,0,0
1440935,155,0,15,0,15,2,1,0
0,0,0,0,0,0,0,0,0
0,0,0,0,0,0,0,0,0
0,0,0,0,0,0,0,0,0
0,0,0,0,0,0,0,0,0
0,0,0,0,0,0,0,0,0
0,0,0,0,0,0,0,0,0
2871,42,2,2,1,1,0,1,0
62279,50,3,0,0,0,1,0,0
63008,108,0,13,12,1,0,0,0
210857,277,0,18,4,14,0,1,0
0,0,0,0,0,0,0,0,0
0,0,0,0,0,0,0,0,0
2864,42,2,2,1,1,0,1,0
0,0,0,0,0,0,0,0,0
0,0,0,0,0,0,0,0,0
0,0,0,0,0,0,0,0,0
0,0,0,0,0,0,0,0,0
0,0,0,0,0,0,0,0,0
0,0,0,0,0,0,0,0,0
0,0,0,0,0,0,0,0,0
0,0,0,0,0,0,0,0,0
0,0,0,0,0,0,0,0,0
0,0,0,0,0,0,0,0,0
0,0,0,0,0,0,0,0,0
0,0,0,0,0,0,0,0,0
0,0,0,0,0,0,0,0,0
0,0,0,0,0,0,0,0,0
0,0,0,0,0,0,0,0,0
0,0,0,0,0,0,0,0,0
0,0,0,0,0,0,0,0,0
0,0,0,0,0,0,0,0,0
0,0,0,0,0,0,0,0,0
0,0,0,0,0,0,0,0,0
0,0,0,0,0,0,0,0,0
0,0,0,0,0,0,0,0,0
0,0,0,0,0,0,0,0,0
0,0,0,0,0,0,0,0,0
0,0,0,0,0,0,0,0,0
0,0,0,0,0,0,0,0,0
127659,140,6,1,0,1,2,0,0
1515,28,0,0,0,0,0,0,0
1504,28,0,0,0,0,0,0,0
0,0,0,0,0,0,0,0,0
0,0,0,0,0,0,0,0,0
0,0,0,0,0,0,0,0,0
0,0,0,0,0,0,0,0,0
0,0,0,0,0,0,0,0,0
0,0,0,0,0,0,0,0,0
0,0,0,0,0,0,0,0,0
0,0,0,0,0,0,0,0,0
706206,527,0,4,0,4,2,1,1
1026998,1127,2,108,0,108,2,0,0
28652,164,6,4,1,3,1,0,0
0,0,0,0,0,0,0,0,0
0,0,0,0,0,0,0,0,0
21468,528,1,2,2,0,0,0,0
281733,178,4,1,1,0,0,1,0
0,0,0,0,0,0,0,0,0
0,0,0,0,0,0,0,0,0
0,0,0,0,0,0,0,0,0
0,0,0,0,0,0,0,0,0
62291,50,3,0,0,0,1,0,0
6035,40,0,3,2,1,0,1,0
245070,345,3,14,12,2,8,0,0
0,0,0,0,0,0,0,0,0
0,0,0,0,0,0,0,0,0
0,0,0,0,0,0,0,0,0
0,0,0,0,0,0,0,0,0
0,0,0,0,0,0,0,0,0
0,0,0,0,0,0,0,0,0
0,0,0,0,0,0,0,0,0
0,0,0,0,0,0,0,0,0
0,0,0,0,0,0,0,0,0
0,0,0,0,0,0,0,0,0
3918,95,3,2,2,0,0,0,0
0,0,0,0,0,0,0,0,0
0,0,0,0,0,0,0,0,0
0,0,0,0,0,0,0,0,0
0,0,0,0,0,0,0,0,0
0,0,0,0,0,0,0,0,0
0,0,0,0,0,0,0,0,0
0,0,0,0,0,0,0,0,0
0,0,0,0,0,0,0,0,0
0,0,0,0,0,0,0,0,0
141255,297,3,11,2,9,2,0,0
52146,135,4,4,2,2,2,0,0
0,0,0,0,0,0,0,0,0
0,0,0,0,0,0,0,0,0
10787,98,0,4,0,4,4,0,0
0,0,0,0,0,0,0,0,0
0,0,0,0,0,0,0,0,0
0,0,0,0,0,0,0,0,0
23542,128,2,4,2,2,1,0,0
23542,128,2,4,2,2,1,0,0
0,0,0,0,0,0,0,0,0
0,0,0,0,0,0,0,0,0
0,0,0,0,0,0,0,0,0
0,0,0,0,0,0,0,0,0
0,0,0,0,0,0,0,0,0
345188,209,0,7,6,1,7,1,0
3219,38,2,0,0,0,1,0,0
0,0,0,0,0,0,0,0,0
62291,50,3,0,0,0,1,0,0
0,0,0,0,0,0,0,0,0
0,0,0,0,0,0,0,0,0
43103,332,0,27,0,27,2,0,0
43022,332,0,27,0,27,2,0,0
0,0,0,0,0,0,0,0,0
0,0,0,0,0,0,0,0,0
0,0,0,0,0,0,0,0,0
371859,912,5,70,44,26,12,1,0
0,0,0,0,0,0,0,0,0
245086,769,4,74,17,57,8,1,0
0,0,0,0,0,0,0,0,0
0,0,0,0,0,0,0,0,0
0,0,0,0,0,0,0,0,0
2875,25,0,0,0,0,0,0,0
2875,25,0,0,0,0,0,0,0
2367507,2297,1,381,376,5,4,1,0
49560,226,2,2,0,2,1,1,0
0,0,0,0,0,0,0,0,0
0,0,0,0,0,0,0,0,0
0,0,0,0,0,0,0,0,0
0,0,0,0,0,0,0,0,0
15589,86,0,15,1,14,0,1,0
0,0,0,0,0,0,0,0,0
0,0,0,0,0,0,0,0,0
0,0,0,0,0,0,0,0,0
0,0,0,0,0,0,0,0,0
0,0,0,0,0,0,0,0,0
0,0,0,0,0,0,0,0,0
764050,7891,9,91,16,75,14,0,0
0,0,0,0,0,0,0,0,0
0,0,0,0,0,0,0,0,0
4547,35,0,2,0,2,0,0,0
0,0,0,0,0,0,0,0,0
283689,139,1,6,2,4,1,0,0
0,0,0,0,0,0,0,0,0
174112,962,1,164,10,154,2,1,0
174112,962,1,164,10,154,2,1,0
165130,1409,1,264,5,259,2,0,0
153283,1205,15,135,118,17,4,1,0
0,0,0,0,0,0,0,0,0
0,0,0,0,0,0,0,0,0
0,0,0,0,0,0,0,0,0
0,0,0,0,0,0,0,0,0
0,0,0,0,0,0,0,0,0
0,0,0,0,0,0,0,0,0
0,0,0,0,0,0,0,0,0
10849,33,1,0,0,0,1,0,0
0,0,0,0,0,0,0,0,0
2492,25,3,0,0,0,0,0,0
2492,25,3,0,0,0,0,0,0
0,0,0,0,0,0,0,0,0
0,0,0,0,0,0,0,0,0
0,0,0,0,0,0,0,0,0
22434,147,1,1,0,1,0,1,0
22434,147,1,1,0,1,0,1,0
0,0,0,0,0,0,0,0,0
0,0,0,0,0,0,0,0,0
0,0,0,0,0,0,0,0,0
0,0,0,0,0,0,0,0,0
19934,125,1,1,0,1,0,1,0
19934,125,1,1,0,1,0,1,0
19934,125,1,1,0,1,0,1,0
19934,125,1,1,0,1,0,1,0
0,0,0,0,0,0,0,0,0
0,0,0,0,0,0,0,0,0
0,0,0,0,0,0,0,0,0
0,0,0,0,0,0,0,0,0
0,0,0,0,0,0,0,0,0
0,0,0,0,0,0,0,0,0
59074,752,0,233,1,232,0,1,0
59074,752,0,233,1,232,0,1,0
0,0,0,0,0,0,0,0,0
0,0,0,0,0,0,0,0,0
0,0,0,0,0,0,0,0,0
0,0,0,0,0,0,0,0,0
19934,125,1,1,0,1,0,1,0
19934,125,1,1,0,1,0,1,0
0,0,0,0,0,0,0,0,0
0,0,0,0,0,0,0,0,0
0,0,0,0,0,0,0,0,0
0,0,0,0,0,0,0,0,0
0,0,0,0,0,0,0,0,0
0,0,0,0,0,0,0,0,0
0,0,0,0,0,0,0,0,0
0,0,0,0,0,0,0,0,0
0,0,0,0,0,0,0,0,0
0,0,0,0,0,0,0,0,0
0,0,0,0,0,0,0,0,0
0,0,0,0,0,0,0,0,0
0,0,0,0,0,0,0,0,0
0,0,0,0,0,0,0,0,0
0,0,0,0,0,0,0,0,0
0,0,0,0,0,0,0,0,0
0,0,0,0,0,0,0,0,0
0,0,0,0,0,0,0,0,0
0,0,0,0,0,0,0,0,0
0,0,0,0,0,0,0,0,0
0,0,0,0,0,0,0,0,0
0,0,0,0,0,0,0,0,0
867687,60,4,3,3,0,2,1,0
867687,60,4,3,3,0,2,1,0
0,0,0,0,0,0,0,0,0
0,0,0,0,0,0,0,0,0
0,0,0,0,0,0,0,0,0
0,0,0,0,0,0,0,0,0
0,0,0,0,0,0,0,0,0
0,0,0,0,0,0,0,0,0
0,0,0,0,0,0,0,0,0
0,0,0,0,0,0,0,0,0
0,0,0,0,0,0,0,0,0
15007,200,1,46,44,2,2,1,0
709186,541,0,4,0,4,2,1,1
0,0,0,0,0,0,0,0,0
0,0,0,0,0,0,0,0,0
0,0,0,0,0,0,0,0,0
867687,60,4,3,3,0,2,1,0
0,0,0,0,0,0,0,0,0
0,0,0,0,0,0,0,0,0
0,0,0,0,0,0,0,0,0
0,0,0,0,0,0,0,0,0
0,0,0,0,0,0,0,0,0
0,0,0,0,0,0,0,0,0
0,0,0,0,0,0,0,0,0
0,0,0,0,0,0,0,0,0
15007,200,1,46,44,2,2,1,0
15007,200,1,46,44,2,2,1,0
15007,200,1,46,44,2,2,1,0
0,0,0,0,0,0,0,0,0
0,0,0,0,0,0,0,0,0
15007,200,1,46,44,2,2,1,0
15007,200,1,46,44,2,2,1,0
15007,200,1,46,44,2,2,1,0
15007,200,1,46,44,2,2,1,0
0,0,0,0,0,0,0,0,0
0,0,0,0,0,0,0,0,0
0,0,0,0,0,0,0,0,0
0,0,0,0,0,0,0,0,0
0,0,0,0,0,0,0,0,0
0,0,0,0,0,0,0,0,0
0,0,0,0,0,0,0,0,0
0,0,0,0,0,0,0,0,0
0,0,0,0,0,0,0,0,0
0,0,0,0,0,0,0,0,0
0,0,0,0,0,0,0,0,0
0,0,0,0,0,0,0,0,0
0,0,0,0,0,0,0,0,0
0,0,0,0,0,0,0,0,0
0,0,0,0,0,0,0,0,0
0,0,0,0,0,0,0,0,0
0,0,0,0,0,0,0,0,0
0,0,0,0,0,0,0,0,0
0,0,0,0,0,0,0,0,0
409789,68,4,0,0,0,2,0,0
0,0,0,0,0,0,0,0,0
0,0,0,0,0,0,0,0,0
0,0,0,0,0,0,0,0,0
0,0,0,0,0,0,0,0,0
409789,68,4,0,0,0,2,0,0
409789,68,4,0,0,0,2,0,0
0,0,0,0,0,0,0,0,0
409789,68,4,0,0,0,2,0,0
0,0,0,0,0,0,0,0,0
0,0,0,0,0,0,0,0,0
0,0,0,0,0,0,0,0,0
0,0,0,0,0,0,0,0,0
93305,1241,0,224,223,1,7,1,0
6189,66,4,0,0,0,2,0,0
0,0,0,0,0,0,0,0,0
0,0,0,0,0,0,0,0,0
0,0,0,0,0,0,0,0,0
80994,1041,0,29,29,0,5,1,0
0,0,0,0,0,0,0,0,0
39452,368,3,99,98,1,14,1,0
0,0,0,0,0,0,0,0,0
0,0,0,0,0,0,0,0,0
0,0,0,0,0,0,0,0,0
0,0,0,0,0,0,0,0,0
0,0,0,0,0,0,0,0,0
0,0,0,0,0,0,0,0,0
0,0,0,0,0,0,0,0,0
0,0,0,0,0,0,0,0,0
0,0,0,0,0,0,0,0,0
112447,84,1,4,1,3,0,0,0
0,0,0,0,0,0,0,0,0
0,0,0,0,0,0,0,0,0
0,0,0,0,0,0,0,0,0
10150,74,2,4,4,0,0,0,0
0,0,0,0,0,0,0,0,0
0,0,0,0,0,0,0,0,0
0,0,0,0,0,0,0,0,0
0,0,0,0,0,0,0,0,0
47933,76,2,1,1,0,3,1,0
0,0,0,0,0,0,0,0,0
243756,115,4,6,6,0,3,1,0
93109,453,5,58,52,6,14,1,0
144901,62,4,3,3,0,2,1,0
135994,42,4,1,1,0,2,0,0
0,0,0,0,0,0,0,0,0
84868,79,1,8,0,8,0,1,0
61200,94,0,11,10,1,0,0,0
214997,437,1,39,10,29,18,1,0
0,0,0,0,0,0,0,0,0
0,0,0,0,0,0,0,0,0
0,0,0,0,0,0,0,0,0
0,0,0,0,0,0,0,0,0
0,0,0,0,0,0,0,0,0
0,0,0,0,0,0,0,0,0
0,0,0,0,0,0,0,0,0
0,0,0,0,0,0,0,0,0
718061,480,5,33,9,24,5,0,0
0,0,0,0,0,0,0,0,0
7338,23,1,0,0,0,0,0,0
15451,217,1,3,2,1,2,0,0
15451,217,1,3,2,1,2,0,0
15450,217,1,3,2,1,2,0,0
0,0,0,0,0,0,0,0,0
415,7,1,0,0,0,0,0,0
389,7,1,0,0,0,0,0,0
293,6,1,0,0,0,0,0,0
0,0,0,0,0,0,0,0,0
0,0,0,0,0,0,0,0,0
0,0,0,0,0,0,0,0,0
138519,704,4,158,143,15,2,0,0
0,0,0,0,0,0,0,0,0
0,0,0,0,0,0,0,0,0
0,0,0,0,0,0,0,0,0
0,0,0,0,0,0,0,0,0
0,0,0,0,0,0,0,0,0
49866,711,4,163,0,163,3,1,0
538,12,1,0,0,0,0,0,0
0,0,0,0,0,0,0,0,0
0,0,0,0,0,0,0,0,0
69721,45,2,0,0,0,0,0,0
0,0,0,0,0,0,0,0,0
0,0,0,0,0,0,0,0,0
69721,45,2,0,0,0,0,0,0
0,0,0,0,0,0,0,0,0
69721,45,2,0,0,0,0,0,0
0,0,0,0,0,0,0,0,0
381255,112,4,5,5,0,0,0,0
9697,85,4,6,6,0,0,1,0
51479,135,1,14,14,0,0,1,0
4953,61,5,9,7,2,0,0,0
4957,61,5,9,7,2,0,0,0
4949,61,5,9,7,2,0,0,0
4947,61,5,9,7,2,0,0,0
4949,61,5,9,7,2,0,0,0
4952,61,5,9,7,2,0,0,0
4950,61,5,9,7,2,0,0,0
4947,61,5,9,7,2,0,0,0
4953,61,5,9,7,2,0,0,0
4949,61,5,9,7,2,0,0,0
4950,61,5,9,7,2,0,0,0
4950,61,5,9,7,2,0,0,0
4947,61,5,9,7,2,0,0,0
4950,61,5,9,7,2,0,0,0
62291,50,3,0,0,0,1,0,0
4950,61,5,9,7,2,0,0,0
0,0,0,0,0,0,0,0,0
0,0,0,0,0,0,0,0,0
0,0,0,0,0,0,0,0,0
0,0,0,0,0,0,0,0,0
0,0,0,0,0,0,0,0,0
538,12,1,0,0,0,0,0,0
538,12,1,0,0,0,0,0,0
538,12,1,0,0,0,0,0,0
538,12,1,0,0,0,0,0,0
0,0,0,0,0,0,0,0,0
0,0,0,0,0,0,0,0,0
0,0,0,0,0,0,0,0,0
0,0,0,0,0,0,0,0,0
0,0,0,0,0,0,0,0,0
0,0,0,0,0,0,0,0,0
708848,541,0,4,0,4,2,1,1
0,0,0,0,0,0,0,0,0
0,0,0,0,0,0,0,0,0
0,0,0,0,0,0,0,0,0
369012,913,5,70,44,26,12,1,0
241708,1052,1,109,105,4,15,1,0
368926,912,5,70,44,26,12,1,0
0,0,0,0,0,0,0,0,0
0,0,0,0,0,0,0,0,0
245086,769,4,74,17,57,8,1,0
0,0,0,0,0,0,0,0,0
0,0,0,0,0,0,0,0,0
0,0,0,0,0,0,0,0,0
89945,205,4,0,0,0,1,0,0
90448,205,4,0,0,0,1,0,0
0,0,0,0,0,0,0,0,0
0,0,0,0,0,0,0,0,0
0,0,0,0,0,0,0,0,0
681,37,0,6,6,0,0,0,0
59300,734,3,125,96,29,2,0,0
679828,2022,4,458,38,420,0,0,0
4644,39,1,0,0,0,0,0,0
0,0,0,0,0,0,0,0,0
0,0,0,0,0,0,0,0,0
667268,4196,5,1191,756,435,10,0,0
135994,42,4,1,1,0,2,0,0
0,0,0,0,0,0,0,0,0
0,0,0,0,0,0,0,0,0
709322,541,0,4,0,4,2,1,1
0,0,0,0,0,0,0,0,0
46710,203,2,1,1,0,1,1,0
0,0,0,0,0,0,0,0,0
46050,159,2,2,1,1,0,1,0
31096,167,5,10,4,6,1,0,0
0,0,0,0,0,0,0,0,0
2867,42,2,2,1,1,0,1,0
0,0,0,0,0,0,0,0,0
1959,33,0,0,0,0,2,0,0
0,0,0,0,0,0,0,0,0
11000,82,0,7,6,1,0,1,0
51521,135,1,14,14,0,0,1,0
705387,541,0,4,4,0,2,1,1
4676,30,2,1,0,1,0,0,0
600373,60,0,1,1,0,0,1,0
0,0,0,0,0,0,0,0,0
0,0,0,0,0,0,0,0,0
0,0,0,0,0,0,0,0,0
0,0,0,0,0,0,0,0,0
179434,79,1,8,0,8,1,1,0
484162,103,0,7,0,7,1,0,0
194111,261,7,6,6,0,0,1,0
0,0,0,0,0,0,0,0,0
0,0,0,0,0,0,0,0,0
0,0,0,0,0,0,0,0,0
0,0,0,0,0,0,0,0,0
19608,145,1,3,3,0,21,0,0
0,0,0,0,0,0,0,0,0
0,0,0,0,0,0,0,0,0
10864,97,2,0,0,0,0,0,0
290019,202,4,5,1,4,0,1,0
0,0,0,0,0,0,0,0,0
16482,115,3,10,10,0,3,0,0
16482,115,3,10,10,0,3,0,0
3137,23,2,1,0,1,0,0,0
2705,21,2,1,0,1,0,0,0
0,0,0,0,0,0,0,0,0
0,0,0,0,0,0,0,0,0
0,0,0,0,0,0,0,0,0
573306,631,4,36,10,26,2,1,0
573306,631,4,36,10,26,2,1,0
0,0,0,0,0,0,0,0,0
0,0,0,0,0,0,0,0,0
2847,42,2,2,1,1,0,1,0
0,0,0,0,0,0,0,0,0
0,0,0,0,0,0,0,0,0
116,4,0,0,0,0,0,0,0
0,0,0,0,0,0,0,0,0
0,0,0,0,0,0,0,0,0
62291,50,3,0,0,0,1,0,0
0,0,0,0,0,0,0,0,0
0,0,0,0,0,0,0,0,0
0,0,0,0,0,0,0,0,0
80994,1041,0,29,29,0,5,1,0
50188,1033,0,29,29,0,5,1,0
0,0,0,0,0,0,0,0,0
842295,7077,7,34,26,8,10,0,0
63624,210,2,9,6,3,4,1,0
0,0,0,0,0,0,0,0,0
0,0,0,0,0,0,0,0,0
0,0,0,0,0,0,0,0,0
21681,389,3,47,4,43,1,0,0
0,0,0,0,0,0,0,0,0
0,0,0,0,0,0,0,0,0
5177,48,3,0,0,0,0,0,0
0,0,0,0,0,0,0,0,0
0,0,0,0,0,0,0,0,0
72283,401,1,39,37,2,0,0,0
0,0,0,0,0,0,0,0,0
0,0,0,0,0,0,0,0,0
0,0,0,0,0,0,0,0,0
0,0,0,0,0,0,0,0,0
0,0,0,0,0,0,0,0,0
7352,125,0,21,21,0,0,1,0
11714,81,0,6,6,0,0,1,0
0,0,0,0,0,0,0,0,0
643409,72,3,2,1,1,2,1,0
3358,61,1,7,7,0,0,1,0
0,0,0,0,0,0,0,0,0
103664,132,4,4,1,3,1,1,0
0,0,0,0,0,0,0,0,0
0,0,0,0,0,0,0,0,0
704854,541,0,4,4,0,2,1,1
116,4,0,0,0,0,0,0,0
0,0,0,0,0,0,0,0,0
0,0,0,0,0,0,0,0,0
0,0,0,0,0,0,0,0,0
0,0,0,0,0,0,0,0,0
79989,195,0,3,3,0,4,0,0
10624,20,1,0,0,0,0,0,0
10624,20,1,0,0,0,0,0,0
0,0,0,0,0,0,0,0,0
0,0,0,0,0,0,0,0,0
379727,67,0,5,2,3,1,0,0
379727,67,0,5,2,3,1,0,0
0,0,0,0,0,0,0,0,0
62168,49,3,0,0,0,1,0,0
0,0,0,0,0,0,0,0,0
62279,50,3,0,0,0,1,0,0
0,0,0,0,0,0,0,0,0
0,0,0,0,0,0,0,0,0
90862,207,4,0,0,0,1,0,0
0,0,0,0,0,0,0,0,0
0,0,0,0,0,0,0,0,0
3993,96,0,0,0,0,0,1,0
62291,50,3,0,0,0,1,0,0
0,0,0,0,0,0,0,0,0
0,0,0,0,0,0,0,0,0
0,0,0,0,0,0,0,0,0
0,0,0,0,0,0,0,0,0
62291,50,3,0,0,0,1,0,0
0,0,0,0,0,0,0,0,0
0,0,0,0,0,0,0,0,0
0,0,0,0,0,0,0,0,0
3177,45,0,0,0,0,0,0,0
15838,68,2,2,0,2,0,0,0
15838,68,2,2,0,2,0,0,0
39,3,0,0,0,0,0,0,0
88,3,0,0,0,0,0,0,0
0,0,0,0,0,0,0,0,0
0,0,0,0,0,0,0,0,0
0,0,0,0,0,0,0,0,0
0,0,0,0,0,0,0,0,0
0,0,0,0,0,0,0,0,0
0,0,0,0,0,0,0,0,0
0,0,0,0,0,0,0,0,0
0,0,0,0,0,0,0,0,0
0,0,0,0,0,0,0,0,0
0,0,0,0,0,0,0,0,0
0,0,0,0,0,0,0,0,0
61921,298,1,6,4,2,0,0,0
0,0,0,0,0,0,0,0,0
0,0,0,0,0,0,0,0,0
0,0,0,0,0,0,0,0,0
0,0,0,0,0,0,0,0,0
0,0,0,0,0,0,0,0,0
0,0,0,0,0,0,0,0,0
0,0,0,0,0,0,0,0,0
0,0,0,0,0,0,0,0,0
0,0,0,0,0,0,0,0,0
0,0,0,0,0,0,0,0,0
2705,21,2,1,0,1,0,0,0
0,0,0,0,0,0,0,0,0
0,0,0,0,0,0,0,0,0
0,0,0,0,0,0,0,0,0
0,0,0,0,0,0,0,0,0
0,0,0,0,0,0,0,0,0
0,0,0,0,0,0,0,0,0
0,0,0,0,0,0,0,0,0
0,0,0,0,0,0,0,0,0
0,0,0,0,0,0,0,0,0
0,0,0,0,0,0,0,0,0
0,0,0,0,0,0,0,0,0
125904,2024,0,229,229,0,0,1,0
125904,2024,0,229,229,0,0,1,0
0,0,0,0,0,0,0,0,0
0,0,0,0,0,0,0,0,0
0,0,0,0,0,0,0,0,0
0,0,0,0,0,0,0,0,0
0,0,0,0,0,0,0,0,0
0,0,0,0,0,0,0,0,0
0,0,0,0,0,0,0,0,0
0,0,0,0,0,0,0,0,0
0,0,0,0,0,0,0,0,0
0,0,0,0,0,0,0,0,0
0,0,0,0,0,0,0,0,0
0,0,0,0,0,0,0,0,0
0,0,0,0,0,0,0,0,0
0,0,0,0,0,0,0,0,0
0,0,0,0,0,0,0,0,0
0,0,0,0,0,0,0,0,0
0,0,0,0,0,0,0,0,0
0,0,0,0,0,0,0,0,0
0,0,0,0,0,0,0,0,0
0,0,0,0,0,0,0,0,0
0,0,0,0,0,0,0,0,0
0,0,0,0,0,0,0,0,0
0,0,0,0,0,0,0,0,0
0,0,0,0,0,0,0,0,0
0,0,0,0,0,0,0,0,0
0,0,0,0,0,0,0,0,0
59074,752,0,233,1,232,0,1,0
59074,752,0,233,1,232,0,1,0
0,0,0,0,0,0,0,0,0
0,0,0,0,0,0,0,0,0
0,0,0,0,0,0,0,0,0
0,0,0,0,0,0,0,0,0
0,0,0,0,0,0,0,0,0
0,0,0,0,0,0,0,0,0
0,0,0,0,0,0,0,0,0
0,0,0,0,0,0,0,0,0
0,0,0,0,0,0,0,0,0
0,0,0,0,0,0,0,0,0
0,0,0,0,0,0,0,0,0
64369,236,0,46,25,21,0,1,1
67102,238,0,46,25,21,0,1,1
0,0,0,0,0,0,0,0,0
525687,69,4,4,4,0,3,1,0
525687,69,4,4,4,0,3,1,0
0,0,0,0,0,0,0,0,0
0,0,0,0,0,0,0,0,0
0,0,0,0,0,0,0,0,0
0,0,0,0,0,0,0,0,0
0,0,0,0,0,0,0,0,0
0,0,0,0,0,0,0,0,0
0,0,0,0,0,0,0,0,0
0,0,0,0,0,0,0,0,0
0,0,0,0,0,0,0,0,0
0,0,0,0,0,0,0,0,0
0,0,0,0,0,0,0,0,0
0,0,0,0,0,0,0,0,0
0,0,0,0,0,0,0,0,0
0,0,0,0,0,0,0,0,0
125904,2024,0,229,229,0,0,1,0
125904,2024,0,229,229,0,0,1,0
1672,27,0,1,0,1,0,0,0
1672,27,0,1,0,1,0,0,0
0,0,0,0,0,0,0,0,0
0,0,0,0,0,0,0,0,0
0,0,0,0,0,0,0,0,0
0,0,0,0,0,0,0,0,0
4971,92,2,1,0,1,0,0,0
4971,92,2,1,0,1,0,0,0
0,0,0,0,0,0,0,0,0
0,0,0,0,0,0,0,0,0
0,0,0,0,0,0,0,0,0
0,0,0,0,0,0,0,0,0
2705,21,2,1,0,1,0,0,0
0,0,0,0,0,0,0,0,0
705101,541,0,4,4,0,2,1,1
0,0,0,0,0,0,0,0,0
0,0,0,0,0,0,0,0,0
2705,21,2,1,0,1,0,0,0
0,0,0,0,0,0,0,0,0
0,0,0,0,0,0,0,0,0
0,0,0,0,0,0,0,0,0
0,0,0,0,0,0,0,0,0
0,0,0,0,0,0,0,0,0
0,0,0,0,0,0,0,0,0
0,0,0,0,0,0,0,0,0
0,0,0,0,0,0,0,0,0
0,0,0,0,0,0,0,0,0
655867,28,1,0,0,0,0,0,0
0,0,0,0,0,0,0,0,0
0,0,0,0,0,0,0,0,0
0,0,0,0,0,0,0,0,0
0,0,0,0,0,0,0,0,0
0,0,0,0,0,0,0,0,0
0,0,0,0,0,0,0,0,0
0,0,0,0,0,0,0,0,0
0,0,0,0,0,0,0,0,0
0,0,0,0,0,0,0,0,0
0,0,0,0,0,0,0,0,0
0,0,0,0,0,0,0,0,0
0,0,0,0,0,0,0,0,0
0,0,0,0,0,0,0,0,0
0,0,0,0,0,0,0,0,0
0,0,0,0,0,0,0,0,0
0,0,0,0,0,0,0,0,0
0,0,0,0,0,0,0,0,0
0,0,0,0,0,0,0,0,0
0,0,0,0,0,0,0,0,0
0,0,0,0,0,0,0,0,0
0,0,0,0,0,0,0,0,0
0,0,0,0,0,0,0,0,0
0,0,0,0,0,0,0,0,0
0,0,0,0,0,0,0,0,0
0,0,0,0,0,0,0,0,0
0,0,0,0,0,0,0,0,0
0,0,0,0,0,0,0,0,0
0,0,0,0,0,0,0,0,0
0,0,0,0,0,0,0,0,0
0,0,0,0,0,0,0,0,0
0,0,0,0,0,0,0,0,0
0,0,0,0,0,0,0,0,0
0,0,0,0,0,0,0,0,0
0,0,0,0,0,0,0,0,0
0,0,0,0,0,0,0,0,0
0,0,0,0,0,0,0,0,0
0,0,0,0,0,0,0,0,0
0,0,0,0,0,0,0,0,0
0,0,0,0,0,0,0,0,0
0,0,0,0,0,0,0,0,0
0,0,0,0,0,0,0,0,0
0,0,0,0,0,0,0,0,0
0,0,0,0,0,0,0,0,0
0,0,0,0,0,0,0,0,0
0,0,0,0,0,0,0,0,0
0,0,0,0,0,0,0,0,0
0,0,0,0,0,0,0,0,0
0,0,0,0,0,0,0,0,0
0,0,0,0,0,0,0,0,0
0,0,0,0,0,0,0,0,0
0,0,0,0,0,0,0,0,0
0,0,0,0,0,0,0,0,0
0,0,0,0,0,0,0,0,0
0,0,0,0,0,0,0,0,0
0,0,0,0,0,0,0,0,0
0,0,0,0,0,0,0,0,0
0,0,0,0,0,0,0,0,0
0,0,0,0,0,0,0,0,0
0,0,0,0,0,0,0,0,0
0,0,0,0,0,0,0,0,0
0,0,0,0,0,0,0,0,0
0,0,0,0,0,0,0,0,0
0,0,0,0,0,0,0,0,0
0,0,0,0,0,0,0,0,0
0,0,0,0,0,0,0,0,0
0,0,0,0,0,0,0,0,0
0,0,0,0,0,0,0,0,0
0,0,0,0,0,0,0,0,0
0,0,0,0,0,0,0,0,0
0,0,0,0,0,0,0,0,0
0,0,0,0,0,0,0,0,0
0,0,0,0,0,0,0,0,0
0,0,0,0,0,0,0,0,0
0,0,0,0,0,0,0,0,0
0,0,0,0,0,0,0,0,0
0,0,0,0,0,0,0,0,0
0,0,0,0,0,0,0,0,0
0,0,0,0,0,0,0,0,0
0,0,0,0,0,0,0,0,0
0,0,0,0,0,0,0,0,0
0,0,0,0,0,0,0,0,0
0,0,0,0,0,0,0,0,0
0,0,0,0,0,0,0,0,0
0,0,0,0,0,0,0,0,0
0,0,0,0,0,0,0,0,0
0,0,0,0,0,0,0,0,0
0,0,0,0,0,0,0,0,0
0,0,0,0,0,0,0,0,0
0,0,0,0,0,0,0,0,0
0,0,0,0,0,0,0,0,0
0,0,0,0,0,0,0,0,0
0,0,0,0,0,0,0,0,0
0,0,0,0,0,0,0,0,0
4706,21,0,0,0,0,0,0,0
0,0,0,0,0,0,0,0,0
0,0,0,0,0,0,0,0,0
0,0,0,0,0,0,0,0,0
0,0,0,0,0,0,0,0,0
0,0,0,0,0,0,0,0,0
0,0,0,0,0,0,0,0,0
0,0,0,0,0,0,0,0,0
0,0,0,0,0,0,0,0,0
0,0,0,0,0,0,0,0,0
0,0,0,0,0,0,0,0,0
0,0,0,0,0,0,0,0,0
0,0,0,0,0,0,0,0,0
0,0,0,0,0,0,0,0,0
0,0,0,0,0,0,0,0,0
0,0,0,0,0,0,0,0,0
0,0,0,0,0,0,0,0,0
0,0,0,0,0,0,0,0,0
0,0,0,0,0,0,0,0,0
0,0,0,0,0,0,0,0,0
0,0,0,0,0,0,0,0,0
0,0,0,0,0,0,0,0,0
0,0,0,0,0,0,0,0,0
0,0,0,0,0,0,0,0,0
0,0,0,0,0,0,0,0,0
0,0,0,0,0,0,0,0,0
331705,58,4,3,3,0,2,1,0
0,0,0,0,0,0,0,0,0
0,0,0,0,0,0,0,0,0
0,0,0,0,0,0,0,0,0
0,0,0,0,0,0,0,0,0
0,0,0,0,0,0,0,0,0
0,0,0,0,0,0,0,0,0
0,0,0,0,0,0,0,0,0
0,0,0,0,0,0,0,0,0
0,0,0,0,0,0,0,0,0
0,0,0,0,0,0,0,0,0
0,0,0,0,0,0,0,0,0
0,0,0,0,0,0,0,0,0
0,0,0,0,0,0,0,0,0
0,0,0,0,0,0,0,0,0
0,0,0,0,0,0,0,0,0
0,0,0,0,0,0,0,0,0
0,0,0,0,0,0,0,0,0
0,0,0,0,0,0,0,0,0
0,0,0,0,0,0,0,0,0
0,0,0,0,0,0,0,0,0
0,0,0,0,0,0,0,0,0
0,0,0,0,0,0,0,0,0
0,0,0,0,0,0,0,0,0
0,0,0,0,0,0,0,0,0
0,0,0,0,0,0,0,0,0
0,0,0,0,0,0,0,0,0
0,0,0,0,0,0,0,0,0
0,0,0,0,0,0,0,0,0
0,0,0,0,0,0,0,0,0
0,0,0,0,0,0,0,0,0
0,0,0,0,0,0,0,0,0
0,0,0,0,0,0,0,0,0
0,0,0,0,0,0,0,0,0
0,0,0,0,0,0,0,0,0
0,0,0,0,0,0,0,0,0
0,0,0,0,0,0,0,0,0
0,0,0,0,0,0,0,0,0
0,0,0,0,0,0,0,0,0
0,0,0,0,0,0,0,0,0
27858,78,3,0,0,0,3,0,0
0,0,0,0,0,0,0,0,0
3778,44,0,2,0,2,1,0,0
0,0,0,0,0,0,0,0,0
0,0,0,0,0,0,0,0,0
0,0,0,0,0,0,0,0,0
0,0,0,0,0,0,0,0,0
0,0,0,0,0,0,0,0,0
0,0,0,0,0,0,0,0,0
0,0,0,0,0,0,0,0,0
0,0,0,0,0,0,0,0,0
0,0,0,0,0,0,0,0,0
0,0,0,0,0,0,0,0,0
557249,43,4,1,1,0,2,0,0
0,0,0,0,0,0,0,0,0
0,0,0,0,0,0,0,0,0
0,0,0,0,0,0,0,0,0
0,0,0,0,0,0,0,0,0
0,0,0,0,0,0,0,0,0
0,0,0,0,0,0,0,0,0
0,0,0,0,0,0,0,0,0
0,0,0,0,0,0,0,0,0
557249,43,4,1,1,0,2,0,0
0,0,0,0,0,0,0,0,0
655867,28,1,0,0,0,0,0,0
113355,422,1,19,6,13,0,0,0
655867,28,1,0,0,0,0,0,0
0,0,0,0,0,0,0,0,0
93074,238,1,16,6,10,0,0,0
93074,238,1,16,6,10,0,0,0
0,0,0,0,0,0,0,0,0
0,0,0,0,0,0,0,0,0
171074,419,7,36,28,8,8,0,0
0,0,0,0,0,0,0,0,0
0,0,0,0,0,0,0,0,0
0,0,0,0,0,0,0,0,0
0,0,0,0,0,0,0,0,0
0,0,0,0,0,0,0,0,0
0,0,0,0,0,0,0,0,0
184141,84,3,0,0,0,3,0,0
184141,84,3,0,0,0,3,0,0
0,0,0,0,0,0,0,0,0
0,0,0,0,0,0,0,0,0
0,0,0,0,0,0,0,0,0
0,0,0,0,0,0,0,0,0
0,0,0,0,0,0,0,0,0
0,0,0,0,0,0,0,0,0
0,0,0,0,0,0,0,0,0
0,0,0,0,0,0,0,0,0
0,0,0,0,0,0,0,0,0
0,0,0,0,0,0,0,0,0
5045,24,3,0,0,0,0,0,0
5045,24,3,0,0,0,0,0,0
0,0,0,0,0,0,0,0,0
0,0,0,0,0,0,0,0,0
0,0,0,0,0,0,0,0,0
0,0,0,0,0,0,0,0,0
5046,24,3,0,0,0,0,0,0
0,0,0,0,0,0,0,0,0
171073,419,7,36,28,8,8,0,0
0,0,0,0,0,0,0,0,0
0,0,0,0,0,0,0,0,0
0,0,0,0,0,0,0,0,0
0,0,0,0,0,0,0,0,0
0,0,0,0,0,0,0,0,0
0,0,0,0,0,0,0,0,0
0,0,0,0,0,0,0,0,0
0,0,0,0,0,0,0,0,0
0,0,0,0,0,0,0,0,0
0,0,0,0,0,0,0,0,0
0,0,0,0,0,0,0,0,0
0,0,0,0,0,0,0,0,0
0,0,0,0,0,0,0,0,0
0,0,0,0,0,0,0,0,0
0,0,0,0,0,0,0,0,0
0,0,0,0,0,0,0,0,0
0,0,0,0,0,0,0,0,0
0,0,0,0,0,0,0,0,0
0,0,0,0,0,0,0,0,0
0,0,0,0,0,0,0,0,0
5045,24,3,0,0,0,0,0,0
5045,24,3,0,0,0,0,0,0
0,0,0,0,0,0,0,0,0
0,0,0,0,0,0,0,0,0
0,0,0,0,0,0,0,0,0
0,0,0,0,0,0,0,0,0
0,0,0,0,0,0,0,0,0
680484,2024,4,458,38,420,0,0,0
0,0,0,0,0,0,0,0,0
0,0,0,0,0,0,0,0,0
0,0,0,0,0,0,0,0,0
0,0,0,0,0,0,0,0,0
0,0,0,0,0,0,0,0,0
0,0,0,0,0,0,0,0,0
0,0,0,0,0,0,0,0,0
0,0,0,0,0,0,0,0,0
0,0,0,0,0,0,0,0,0
47635,75,2,1,1,0,3,1,0
0,0,0,0,0,0,0,0,0
47933,76,2,1,1,0,3,1,0
0,0,0,0,0,0,0,0,0
0,0,0,0,0,0,0,0,0
0,0,0,0,0,0,0,0,0
0,0,0,0,0,0,0,0,0
2201,23,0,1,0,1,0,0,1
0,0,0,0,0,0,0,0,0
0,0,0,0,0,0,0,0,0
0,0,0,0,0,0,0,0,0
0,0,0,0,0,0,0,0,0
672636,538,0,4,4,0,2,1,1
0,0,0,0,0,0,0,0,0
0,0,0,0,0,0,0,0,0
0,0,0,0,0,0,0,0,0
0,0,0,0,0,0,0,0,0
0,0,0,0,0,0,0,0,0
0,0,0,0,0,0,0,0,0
0,0,0,0,0,0,0,0,0
0,0,0,0,0,0,0,0,0
0,0,0,0,0,0,0,0,0
0,0,0,0,0,0,0,0,0
0,0,0,0,0,0,0,0,0
0,0,0,0,0,0,0,0,0
0,0,0,0,0,0,0,0,0
0,0,0,0,0,0,0,0,0
0,0,0,0,0,0,0,0,0
0,0,0,0,0,0,0,0,0
0,0,0,0,0,0,0,0,0
0,0,0,0,0,0,0,0,0
62893,49,3,0,0,0,0,0,0
0,0,0,0,0,0,0,0,0
0,0,0,0,0,0,0,0,0
0,0,0,0,0,0,0,0,0
0,0,0,0,0,0,0,0,0
0,0,0,0,0,0,0,0,0
0,0,0,0,0,0,0,0,0
3192,37,2,4,0,4,0,0,0
0,0,0,0,0,0,0,0,0
0,0,0,0,0,0,0,0,0
0,0,0,0,0,0,0,0,0
0,0,0,0,0,0,0,0,0
0,0,0,0,0,0,0,0,0
0,0,0,0,0,0,0,0,0
0,0,0,0,0,0,0,0,0
2601555,81,4,4,4,0,4,1,0
0,0,0,0,0,0,0,0,0
0,0,0,0,0,0,0,0,0
672108,538,0,4,4,0,2,1,1
0,0,0,0,0,0,0,0,0
0,0,0,0,0,0,0,0,0
0,0,0,0,0,0,0,0,0
0,0,0,0,0,0,0,0,0
0,0,0,0,0,0,0,0,0
0,0,0,0,0,0,0,0,0
0,0,0,0,0,0,0,0,0
0,0,0,0,0,0,0,0,0
0,0,0,0,0,0,0,0,0
0,0,0,0,0,0,0,0,0
0,0,0,0,0,0,0,0,0
0,0,0,0,0,0,0,0,0
0,0,0,0,0,0,0,0,0
0,0,0,0,0,0,0,0,0
0,0,0,0,0,0,0,0,0
0,0,0,0,0,0,0,0,0
0,0,0,0,0,0,0,0,0
0,0,0,0,0,0,0,0,0
0,0,0,0,0,0,0,0,0
0,0,0,0,0,0,0,0,0
0,0,0,0,0,0,0,0,0
0,0,0,0,0,0,0,0,0
0,0,0,0,0,0,0,0,0
0,0,0,0,0,0,0,0,0
0,0,0,0,0,0,0,0,0
0,0,0,0,0,0,0,0,0
132872,58,4,5,5,0,2,1,0
0,0,0,0,0,0,0,0,0
0,0,0,0,0,0,0,0,0
0,0,0,0,0,0,0,0,0
0,0,0,0,0,0,0,0,0
0,0,0,0,0,0,0,0,0
0,0,0,0,0,0,0,0,0
0,0,0,0,0,0,0,0,0
0,0,0,0,0,0,0,0,0
0,0,0,0,0,0,0,0,0
62906,49,3,0,0,0,0,0,0
0,0,0,0,0,0,0,0,0
0,0,0,0,0,0,0,0,0
0,0,0,0,0,0,0,0,0
0,0,0,0,0,0,0,0,0
0,0,0,0,0,0,0,0,0
19137,149,1,5,5,0,0,0,0
0,0,0,0,0,0,0,0,0
0,0,0,0,0,0,0,0,0
38733,128,2,5,2,3,1,1,0
0,0,0,0,0,0,0,0,0
40024,126,1,1,1,0,0,1,0
0,0,0,0,0,0,0,0,0
0,0,0,0,0,0,0,0,0
0,0,0,0,0,0,0,0,0
0,0,0,0,0,0,0,0,0
0,0,0,0,0,0,0,0,0
0,0,0,0,0,0,0,0,0
0,0,0,0,0,0,0,0,0
60511,215,2,9,5,4,2,1,0
0,0,0,0,0,0,0,0,0
0,0,0,0,0,0,0,0,0
0,0,0,0,0,0,0,0,0
0,0,0,0,0,0,0,0,0
8115,58,4,7,1,6,0,0,0
0,0,0,0,0,0,0,0,0
0,0,0,0,0,0,0,0,0
0,0,0,0,0,0,0,0,0
0,0,0,0,0,0,0,0,0
0,0,0,0,0,0,0,0,0
0,0,0,0,0,0,0,0,0
0,0,0,0,0,0,0,0,0
0,0,0,0,0,0,0,0,0
0,0,0,0,0,0,0,0,0
0,0,0,0,0,0,0,0,0
0,0,0,0,0,0,0,0,0
0,0,0,0,0,0,0,0,0
0,0,0,0,0,0,0,0,0
0,0,0,0,0,0,0,0,0
0,0,0,0,0,0,0,0,0
0,0,0,0,0,0,0,0,0
0,0,0,0,0,0,0,0,0
0,0,0,0,0,0,0,0,0
0,0,0,0,0,0,0,0,0
66774,240,2,3,2,1,2,1,0
0,0,0,0,0,0,0,0,0
62894,49,3,0,0,0,0,0,0
0,0,0,0,0,0,0,0,0
62894,49,3,0,0,0,0,0,0
0,0,0,0,0,0,0,0,0
62906,49,3,0,0,0,0,0,0
0,0,0,0,0,0,0,0,0
0,0,0,0,0,0,0,0,0
0,0,0,0,0,0,0,0,0
672030,538,0,4,4,0,2,1,1
0,0,0,0,0,0,0,0,0
0,0,0,0,0,0,0,0,0
0,0,0,0,0,0,0,0,0
0,0,0,0,0,0,0,0,0
0,0,0,0,0,0,0,0,0
0,0,0,0,0,0,0,0,0
0,0,0,0,0,0,0,0,0
153661,1169,10,163,137,26,0,1,0
0,0,0,0,0,0,0,0,0
0,0,0,0,0,0,0,0,0
62905,49,3,0,0,0,0,0,0
0,0,0,0,0,0,0,0,0
0,0,0,0,0,0,0,0,0
0,0,0,0,0,0,0,0,0
0,0,0,0,0,0,0,0,0
0,0,0,0,0,0,0,0,0
0,0,0,0,0,0,0,0,0
0,0,0,0,0,0,0,0,0
0,0,0,0,0,0,0,0,0
0,0,0,0,0,0,0,0,0
0,0,0,0,0,0,0,0,0
0,0,0,0,0,0,0,0,0
0,0,0,0,0,0,0,0,0
0,0,0,0,0,0,0,0,0
0,0,0,0,0,0,0,0,0
0,0,0,0,0,0,0,0,0
0,0,0,0,0,0,0,0,0
0,0,0,0,0,0,0,0,0
0,0,0,0,0,0,0,0,0
17640,77,1,3,0,3,2,1,0
0,0,0,0,0,0,0,0,0
0,0,0,0,0,0,0,0,0
0,0,0,0,0,0,0,0,0
0,0,0,0,0,0,0,0,0
0,0,0,0,0,0,0,0,0
879568,16,0,0,0,0,0,0,0
62906,49,3,0,0,0,0,0,0
0,0,0,0,0,0,0,0,0
0,0,0,0,0,0,0,0,0
0,0,0,0,0,0,0,0,0
0,0,0,0,0,0,0,0,0
0,0,0,0,0,0,0,0,0
0,0,0,0,0,0,0,0,0
0,0,0,0,0,0,0,0,0
0,0,0,0,0,0,0,0,0
0,0,0,0,0,0,0,0,0
0,0,0,0,0,0,0,0,0
34287,59,2,0,0,0,0,0,0
0,0,0,0,0,0,0,0,0
0,0,0,0,0,0,0,0,0
0,0,0,0,0,0,0,0,0
0,0,0,0,0,0,0,0,0
0,0,0,0,0,0,0,0,0
0,0,0,0,0,0,0,0,0
155024,1293,0,249,241,8,2,1,0
0,0,0,0,0,0,0,0,0
11570,70,6,7,6,1,0,0,0
0,0,0,0,0,0,0,0,0
0,0,0,0,0,0,0,0,0
0,0,0,0,0,0,0,0,0
0,0,0,0,0,0,0,0,0
0,0,0,0,0,0,0,0,0
0,0,0,0,0,0,0,0,0
0,0,0,0,0,0,0,0,0
0,0,0,0,0,0,0,0,0
0,0,0,0,0,0,0,0,0
0,0,0,0,0,0,0,0,0
0,0,0,0,0,0,0,0,0
0,0,0,0,0,0,0,0,0
0,0,0,0,0,0,0,0,0
0,0,0,0,0,0,0,0,0
0,0,0,0,0,0,0,0,0
0,0,0,0,0,0,0,0,0
0,0,0,0,0,0,0,0,0
0,0,0,0,0,0,0,0,0
0,0,0,0,0,0,0,0,0
0,0,0,0,0,0,0,0,0
0,0,0,0,0,0,0,0,0
0,0,0,0,0,0,0,0,0
0,0,0,0,0,0,0,0,0
0,0,0,0,0,0,0,0,0
0,0,0,0,0,0,0,0,0
0,0,0,0,0,0,0,0,0
0,0,0,0,0,0,0,0,0
0,0,0,0,0,0,0,0,0
0,0,0,0,0,0,0,0,0
0,0,0,0,0,0,0,0,0
0,0,0,0,0,0,0,0,0
0,0,0,0,0,0,0,0,0
0,0,0,0,0,0,0,0,0
0,0,0,0,0,0,0,0,0
0,0,0,0,0,0,0,0,0
0,0,0,0,0,0,0,0,0
0,0,0,0,0,0,0,0,0
0,0,0,0,0,0,0,0,0
0,0,0,0,0,0,0,0,0
0,0,0,0,0,0,0,0,0
0,0,0,0,0,0,0,0,0
0,0,0,0,0,0,0,0,0
0,0,0,0,0,0,0,0,0
0,0,0,0,0,0,0,0,0
0,0,0,0,0,0,0,0,0
0,0,0,0,0,0,0,0,0
0,0,0,0,0,0,0,0,0
0,0,0,0,0,0,0,0,0
0,0,0,0,0,0,0,0,0
915333,704,0,28,18,10,2,1,0
915325,704,0,28,18,10,2,1,0
0,0,0,0,0,0,0,0,0
0,0,0,0,0,0,0,0,0
0,0,0,0,0,0,0,0,0
0,0,0,0,0,0,0,0,0
0,0,0,0,0,0,0,0,0
0,0,0,0,0,0,0,0,0
0,0,0,0,0,0,0,0,0
0,0,0,0,0,0,0,0,0
0,0,0,0,0,0,0,0,0
0,0,0,0,0,0,0,0,0
0,0,0,0,0,0,0,0,0
0,0,0,0,0,0,0,0,0
0,0,0,0,0,0,0,0,0
0,0,0,0,0,0,0,0,0
0,0,0,0,0,0,0,0,0
0,0,0,0,0,0,0,0,0
0,0,0,0,0,0,0,0,0
0,0,0,0,0,0,0,0,0
0,0,0,0,0,0,0,0,0
0,0,0,0,0,0,0,0,0
0,0,0,0,0,0,0,0,0
0,0,0,0,0,0,0,0,0
0,0,0,0,0,0,0,0,0
0,0,0,0,0,0,0,0,0
0,0,0,0,0,0,0,0,0
0,0,0,0,0,0,0,0,0
0,0,0,0,0,0,0,0,0
0,0,0,0,0,0,0,0,0
0,0,0,0,0,0,0,0,0
0,0,0,0,0,0,0,0,0
0,0,0,0,0,0,0,0,0
0,0,0,0,0,0,0,0,0
0,0,0,0,0,0,0,0,0
0,0,0,0,0,0,0,0,0
0,0,0,0,0,0,0,0,0
0,0,0,0,0,0,0,0,0
0,0,0,0,0,0,0,0,0
0,0,0,0,0,0,0,0,0
338027,43,4,1,1,0,2,0,0
338027,43,4,1,1,0,2,0,0
0,0,0,0,0,0,0,0,0
0,0,0,0,0,0,0,0,0
0,0,0,0,0,0,0,0,0
0,0,0,0,0,0,0,0,0
0,0,0,0,0,0,0,0,0
0,0,0,0,0,0,0,0,0
0,0,0,0,0,0,0,0,0
0,0,0,0,0,0,0,0,0
0,0,0,0,0,0,0,0,0
0,0,0,0,0,0,0,0,0
0,0,0,0,0,0,0,0,0
0,0,0,0,0,0,0,0,0
0,0,0,0,0,0,0,0,0
0,0,0,0,0,0,0,0,0
0,0,0,0,0,0,0,0,0
0,0,0,0,0,0,0,0,0
0,0,0,0,0,0,0,0,0
0,0,0,0,0,0,0,0,0
0,0,0,0,0,0,0,0,0
0,0,0,0,0,0,0,0,0
0,0,0,0,0,0,0,0,0
0,0,0,0,0,0,0,0,0
0,0,0,0,0,0,0,0,0
0,0,0,0,0,0,0,0,0
0,0,0,0,0,0,0,0,0
0,0,0,0,0,0,0,0,0
0,0,0,0,0,0,0,0,0
0,0,0,0,0,0,0,0,0
0,0,0,0,0,0,0,0,0
25086,67,2,1,1,0,2,0,0
0,0,0,0,0,0,0,0,0
0,0,0,0,0,0,0,0,0
0,0,0,0,0,0,0,0,0
33622,46,2,0,0,0,2,0,0
33622,46,2,0,0,0,2,0,0
0,0,0,0,0,0,0,0,0
0,0,0,0,0,0,0,0,0
0,0,0,0,0,0,0,0,0
0,0,0,0,0,0,0,0,0
0,0,0,0,0,0,0,0,0
0,0,0,0,0,0,0,0,0
0,0,0,0,0,0,0,0,0
25086,67,2,1,1,0,2,0,0
0,0,0,0,0,0,0,0,0
0,0,0,0,0,0,0,0,0
0,0,0,0,0,0,0,0,0
0,0,0,0,0,0,0,0,0
56516,190,8,6,0,6,1,1,0
0,0,0,0,0,0,0,0,0
25086,67,2,1,1,0,2,0,0
25086,67,2,1,1,0,2,0,0
144391,42,4,1,1,0,2,0,0
0,0,0,0,0,0,0,0,0
0,0,0,0,0,0,0,0,0
0,0,0,0,0,0,0,0,0
0,0,0,0,0,0,0,0,0
0,0,0,0,0,0,0,0,0
0,0,0,0,0,0,0,0,0
0,0,0,0,0,0,0,0,0
0,0,0,0,0,0,0,0,0
0,0,0,0,0,0,0,0,0
0,0,0,0,0,0,0,0,0
0,0,0,0,0,0,0,0,0
0,0,0,0,0,0,0,0,0
0,0,0,0,0,0,0,0,0
0,0,0,0,0,0,0,0,0
0,0,0,0,0,0,0,0,0
0,0,0,0,0,0,0,0,0
0,0,0,0,0,0,0,0,0
0,0,0,0,0,0,0,0,0
0,0,0,0,0,0,0,0,0
0,0,0,0,0,0,0,0,0
0,0,0,0,0,0,0,0,0
5055,24,3,0,0,0,0,0,0
5055,24,3,0,0,0,0,0,0
5055,24,3,0,0,0,0,0,0
0,0,0,0,0,0,0,0,0
0,0,0,0,0,0,0,0,0
5055,24,3,0,0,0,0,0,0
0,0,0,0,0,0,0,0,0
13130,29,1,0,0,0,3,0,0
0,0,0,0,0,0,0,0,0
0,0,0,0,0,0,0,0,0
0,0,0,0,0,0,0,0,0
0,0,0,0,0,0,0,0,0
0,0,0,0,0,0,0,0,0
0,0,0,0,0,0,0,0,0
13130,29,1,0,0,0,3,0,0
0,0,0,0,0,0,0,0,0
0,0,0,0,0,0,0,0,0
13130,29,1,0,0,0,3,0,0
13130,29,1,0,0,0,3,0,0
0,0,0,0,0,0,0,0,0
0,0,0,0,0,0,0,0,0
0,0,0,0,0,0,0,0,0
0,0,0,0,0,0,0,0,0
13154,86,0,3,3,0,0,0,0
0,0,0,0,0,0,0,0,0
0,0,0,0,0,0,0,0,0
0,0,0,0,0,0,0,0,0
0,0,0,0,0,0,0,0,0
0,0,0,0,0,0,0,0,0
0,0,0,0,0,0,0,0,0
0,0,0,0,0,0,0,0,0
0,0,0,0,0,0,0,0,0
0,0,0,0,0,0,0,0,0
0,0,0,0,0,0,0,0,0
0,0,0,0,0,0,0,0,0
144439,59,4,3,3,0,2,1,0
0,0,0,0,0,0,0,0,0
0,0,0,0,0,0,0,0,0
0,0,0,0,0,0,0,0,0
0,0,0,0,0,0,0,0,0
0,0,0,0,0,0,0,0,0
0,0,0,0,0,0,0,0,0
0,0,0,0,0,0,0,0,0
0,0,0,0,0,0,0,0,0
0,0,0,0,0,0,0,0,0
0,0,0,0,0,0,0,0,0
0,0,0,0,0,0,0,0,0
8402,52,3,0,0,0,4,0,0
8402,52,3,0,0,0,4,0,0
0,0,0,0,0,0,0,0,0
0,0,0,0,0,0,0,0,0
0,0,0,0,0,0,0,0,0
0,0,0,0,0,0,0,0,0
0,0,0,0,0,0,0,0,0
0,0,0,0,0,0,0,0,0
0,0,0,0,0,0,0,0,0
0,0,0,0,0,0,0,0,0
0,0,0,0,0,0,0,0,0
16042,72,4,0,0,0,0,1,0
5048,24,3,0,0,0,0,0,0
106165,64,4,0,0,0,2,0,0
0,0,0,0,0,0,0,0,0
0,0,0,0,0,0,0,0,0
0,0,0,0,0,0,0,0,0
0,0,0,0,0,0,0,0,0
0,0,0,0,0,0,0,0,0
106165,64,4,0,0,0,2,0,0
0,0,0,0,0,0,0,0,0
0,0,0,0,0,0,0,0,0
0,0,0,0,0,0,0,0,0
5048,24,3,0,0,0,0,0,0
0,0,0,0,0,0,0,0,0
0,0,0,0,0,0,0,0,0
0,0,0,0,0,0,0,0,0
27860,78,3,0,0,0,3,0,0
0,0,0,0,0,0,0,0,0
0,0,0,0,0,0,0,0,0
0,0,0,0,0,0,0,0,0
0,0,0,0,0,0,0,0,0
0,0,0,0,0,0,0,0,0
0,0,0,0,0,0,0,0,0
0,0,0,0,0,0,0,0,0
8402,52,3,0,0,0,4,0,0
0,0,0,0,0,0,0,0,0
0,0,0,0,0,0,0,0,0
0,0,0,0,0,0,0,0,0
0,0,0,0,0,0,0,0,0
0,0,0,0,0,0,0,0,0
0,0,0,0,0,0,0,0,0
0,0,0,0,0,0,0,0,0
0,0,0,0,0,0,0,0,0
0,0,0,0,0,0,0,0,0
0,0,0,0,0,0,0,0,0
0,0,0,0,0,0,0,0,0
0,0,0,0,0,0,0,0,0
0,0,0,0,0,0,0,0,0
0,0,0,0,0,0,0,0,0
0,0,0,0,0,0,0,0,0
8402,52,3,0,0,0,4,0,0
0,0,0,0,0,0,0,0,0
0,0,0,0,0,0,0,0,0
0,0,0,0,0,0,0,0,0
0,0,0,0,0,0,0,0,0
0,0,0,0,0,0,0,0,0
0,0,0,0,0,0,0,0,0
0,0,0,0,0,0,0,0,0
0,0,0,0,0,0,0,0,0
0,0,0,0,0,0,0,0,0
0,0,0,0,0,0,0,0,0
0,0,0,0,0,0,0,0,0
16042,72,4,0,0,0,0,1,0
0,0,0,0,0,0,0,0,0
0,0,0,0,0,0,0,0,0
5048,24,3,0,0,0,0,0,0
5048,24,3,0,0,0,0,0,0
0,0,0,0,0,0,0,0,0
0,0,0,0,0,0,0,0,0
0,0,0,0,0,0,0,0,0
0,0,0,0,0,0,0,0,0
0,0,0,0,0,0,0,0,0
0,0,0,0,0,0,0,0,0
0,0,0,0,0,0,0,0,0
0,0,0,0,0,0,0,0,0
0,0,0,0,0,0,0,0,0
0,0,0,0,0,0,0,0,0
0,0,0,0,0,0,0,0,0
0,0,0,0,0,0,0,0,0
0,0,0,0,0,0,0,0,0
0,0,0,0,0,0,0,0,0
0,0,0,0,0,0,0,0,0
0,0,0,0,0,0,0,0,0
0,0,0,0,0,0,0,0,0
0,0,0,0,0,0,0,0,0
0,0,0,0,0,0,0,0,0
0,0,0,0,0,0,0,0,0
0,0,0,0,0,0,0,0,0
23880,221,0,52,3,49,1,1,0
0,0,0,0,0,0,0,0,0
0,0,0,0,0,0,0,0,0
28595,47,4,0,0,0,0,0,0
0,0,0,0,0,0,0,0,0
0,0,0,0,0,0,0,0,0
0,0,0,0,0,0,0,0,0
62918,48,3,0,0,0,0,0,0
0,0,0,0,0,0,0,0,0
0,0,0,0,0,0,0,0,0
0,0,0,0,0,0,0,0,0
0,0,0,0,0,0,0,0,0
0,0,0,0,0,0,0,0,0
0,0,0,0,0,0,0,0,0
0,0,0,0,0,0,0,0,0
0,0,0,0,0,0,0,0,0
0,0,0,0,0,0,0,0,0
0,0,0,0,0,0,0,0,0
0,0,0,0,0,0,0,0,0
0,0,0,0,0,0,0,0,0
10790,79,0,4,4,0,0,0,0
0,0,0,0,0,0,0,0,0
10790,79,0,4,4,0,0,0,0
10790,79,0,4,4,0,0,0,0
0,0,0,0,0,0,0,0,0
48013,76,2,1,1,0,3,1,0
0,0,0,0,0,0,0,0,0
96467,133,4,26,18,8,2,1,0
0,0,0,0,0,0,0,0,0
0,0,0,0,0,0,0,0,0
0,0,0,0,0,0,0,0,0
0,0,0,0,0,0,0,0,0
1059922,101,4,5,5,0,3,1,0
1059922,101,4,5,5,0,3,1,0
93109,453,5,58,52,6,14,1,0
0,0,0,0,0,0,0,0,0
0,0,0,0,0,0,0,0,0
0,0,0,0,0,0,0,0,0
84868,79,1,8,0,8,0,1,0
0,0,0,0,0,0,0,0,0
0,0,0,0,0,0,0,0,0
0,0,0,0,0,0,0,0,0
0,0,0,0,0,0,0,0,0
0,0,0,0,0,0,0,0,0
0,0,0,0,0,0,0,0,0
721146,2773,7,670,12,658,1,1,0
0,0,0,0,0,0,0,0,0
0,0,0,0,0,0,0,0,0
0,0,0,0,0,0,0,0,0
0,0,0,0,0,0,0,0,0
0,0,0,0,0,0,0,0,0
0,0,0,0,0,0,0,0,0
0,0,0,0,0,0,0,0,0
0,0,0,0,0,0,0,0,0
5920,30,0,6,0,6,0,0,0
0,0,0,0,0,0,0,0,0
0,0,0,0,0,0,0,0,0
0,0,0,0,0,0,0,0,0
0,0,0,0,0,0,0,0,0
0,0,0,0,0,0,0,0,0
0,0,0,0,0,0,0,0,0
0,0,0,0,0,0,0,0,0
0,0,0,0,0,0,0,0,0
0,0,0,0,0,0,0,0,0
0,0,0,0,0,0,0,0,0
0,0,0,0,0,0,0,0,0
0,0,0,0,0,0,0,0,0
774121,85,0,1,0,1,1,1,0
0,0,0,0,0,0,0,0,0
0,0,0,0,0,0,0,0,0
0,0,0,0,0,0,0,0,0
0,0,0,0,0,0,0,0,0
0,0,0,0,0,0,0,0,0
0,0,0,0,0,0,0,0,0
0,0,0,0,0,0,0,0,0
0,0,0,0,0,0,0,0,0
0,0,0,0,0,0,0,0,0
0,0,0,0,0,0,0,0,0
0,0,0,0,0,0,0,0,0
0,0,0,0,0,0,0,0,0
0,0,0,0,0,0,0,0,0
0,0,0,0,0,0,0,0,0
0,0,0,0,0,0,0,0,0
0,0,0,0,0,0,0,0,0
0,0,0,0,0,0,0,0,0
15451,217,1,3,2,1,2,0,0
0,0,0,0,0,0,0,0,0
0,0,0,0,0,0,0,0,0
0,0,0,0,0,0,0,0,0
0,0,0,0,0,0,0,0,0
15450,217,1,3,2,1,2,0,0
0,0,0,0,0,0,0,0,0
0,0,0,0,0,0,0,0,0
0,0,0,0,0,0,0,0,0
0,0,0,0,0,0,0,0,0
0,0,0,0,0,0,0,0,0
0,0,0,0,0,0,0,0,0
0,0,0,0,0,0,0,0,0
0,0,0,0,0,0,0,0,0
0,0,0,0,0,0,0,0,0
0,0,0,0,0,0,0,0,0
0,0,0,0,0,0,0,0,0
0,0,0,0,0,0,0,0,0
0,0,0,0,0,0,0,0,0
0,0,0,0,0,0,0,0,0
0,0,0,0,0,0,0,0,0
0,0,0,0,0,0,0,0,0
0,0,0,0,0,0,0,0,0
0,0,0,0,0,0,0,0,0
0,0,0,0,0,0,0,0,0
0,0,0,0,0,0,0,0,0
0,0,0,0,0,0,0,0,0
0,0,0,0,0,0,0,0,0
0,0,0,0,0,0,0,0,0
0,0,0,0,0,0,0,0,0
0,0,0,0,0,0,0,0,0
0,0,0,0,0,0,0,0,0
0,0,0,0,0,0,0,0,0
0,0,0,0,0,0,0,0,0
0,0,0,0,0,0,0,0,0
0,0,0,0,0,0,0,0,0
0,0,0,0,0,0,0,0,0
0,0,0,0,0,0,0,0,0
0,0,0,0,0,0,0,0,0
0,0,0,0,0,0,0,0,0
0,0,0,0,0,0,0,0,0
0,0,0,0,0,0,0,0,0
0,0,0,0,0,0,0,0,0
0,0,0,0,0,0,0,0,0
0,0,0,0,0,0,0,0,0
0,0,0,0,0,0,0,0,0
0,0,0,0,0,0,0,0,0
0,0,0,0,0,0,0,0,0
23199,56,0,9,4,5,0,0,0
0,0,0,0,0,0,0,0,0
0,0,0,0,0,0,0,0,0
0,0,0,0,0,0,0,0,0
0,0,0,0,0,0,0,0,0
0,0,0,0,0,0,0,0,0
0,0,0,0,0,0,0,0,0
0,0,0,0,0,0,0,0,0
0,0,0,0,0,0,0,0,0
0,0,0,0,0,0,0,0,0
0,0,0,0,0,0,0,0,0
0,0,0,0,0,0,0,0,0
0,0,0,0,0,0,0,0,0
0,0,0,0,0,0,0,0,0
0,0,0,0,0,0,0,0,0
0,0,0,0,0,0,0,0,0
1011,19,1,0,0,0,0,0,0
0,0,0,0,0,0,0,0,0
0,0,0,0,0,0,0,0,0
0,0,0,0,0,0,0,0,0
0,0,0,0,0,0,0,0,0
0,0,0,0,0,0,0,0,0
0,0,0,0,0,0,0,0,0
0,0,0,0,0,0,0,0,0
0,0,0,0,0,0,0,0,0
123333,92,5,0,0,0,0,0,0
0,0,0,0,0,0,0,0,0
0,0,0,0,0,0,0,0,0
0,0,0,0,0,0,0,0,0
0,0,0,0,0,0,0,0,0
0,0,0,0,0,0,0,0,0
0,0,0,0,0,0,0,0,0
77746,101,1,4,2,2,0,0,0
0,0,0,0,0,0,0,0,0
0,0,0,0,0,0,0,0,0
0,0,0,0,0,0,0,0,0
0,0,0,0,0,0,0,0,0
0,0,0,0,0,0,0,0,0
0,0,0,0,0,0,0,0,0
0,0,0,0,0,0,0,0,0
0,0,0,0,0,0,0,0,0
0,0,0,0,0,0,0,0,0
0,0,0,0,0,0,0,0,0
0,0,0,0,0,0,0,0,0
0,0,0,0,0,0,0,0,0
0,0,0,0,0,0,0,0,0
0,0,0,0,0,0,0,0,0
0,0,0,0,0,0,0,0,0
0,0,0,0,0,0,0,0,0
677305,538,0,4,0,4,2,1,1
0,0,0,0,0,0,0,0,0
0,0,0,0,0,0,0,0,0
189415,961,15,96,81,15,1,1,0
0,0,0,0,0,0,0,0,0
0,0,0,0,0,0,0,0,0
0,0,0,0,0,0,0,0,0
0,0,0,0,0,0,0,0,0
0,0,0,0,0,0,0,0,0
90194,209,4,0,0,0,1,0,0
0,0,0,0,0,0,0,0,0
91486,214,4,0,0,0,1,0,0
0,0,0,0,0,0,0,0,0
91185,209,4,0,0,0,1,0,0
91390,212,4,0,0,0,1,0,0
0,0,0,0,0,0,0,0,0
0,0,0,0,0,0,0,0,0
0,0,0,0,0,0,0,0,0
0,0,0,0,0,0,0,0,0
0,0,0,0,0,0,0,0,0
0,0,0,0,0,0,0,0,0
0,0,0,0,0,0,0,0,0
62918,48,3,0,0,0,0,0,0
0,0,0,0,0,0,0,0,0
0,0,0,0,0,0,0,0,0
0,0,0,0,0,0,0,0,0
0,0,0,0,0,0,0,0,0
0,0,0,0,0,0,0,0,0
0,0,0,0,0,0,0,0,0
0,0,0,0,0,0,0,0,0
0,0,0,0,0,0,0,0,0
0,0,0,0,0,0,0,0,0
0,0,0,0,0,0,0,0,0
0,0,0,0,0,0,0,0,0
0,0,0,0,0,0,0,0,0
0,0,0,0,0,0,0,0,0
0,0,0,0,0,0,0,0,0
0,0,0,0,0,0,0,0,0
0,0,0,0,0,0,0,0,0
0,0,0,0,0,0,0,0,0
0,0,0,0,0,0,0,0,0
0,0,0,0,0,0,0,0,0
0,0,0,0,0,0,0,0,0
0,0,0,0,0,0,0,0,0
0,0,0,0,0,0,0,0,0
0,0,0,0,0,0,0,0,0
0,0,0,0,0,0,0,0,0
0,0,0,0,0,0,0,0,0
0,0,0,0,0,0,0,0,0
0,0,0,0,0,0,0,0,0
0,0,0,0,0,0,0,0,0
0,0,0,0,0,0,0,0,0
0,0,0,0,0,0,0,0,0
0,0,0,0,0,0,0,0,0
0,0,0,0,0,0,0,0,0
0,0,0,0,0,0,0,0,0
0,0,0,0,0,0,0,0,0
0,0,0,0,0,0,0,0,0
192584,1001,12,130,26,104,2,1,0
92138,209,4,0,0,0,1,0,0
13443,45,0,9,9,0,0,1,0
0,0,0,0,0,0,0,0,0
0,0,0,0,0,0,0,0,0
0,0,0,0,0,0,0,0,0
0,0,0,0,0,0,0,0,0
0,0,0,0,0,0,0,0,0
0,0,0,0,0,0,0,0,0
0,0,0,0,0,0,0,0,0
0,0,0,0,0,0,0,0,0
0,0,0,0,0,0,0,0,0
0,0,0,0,0,0,0,0,0
0,0,0,0,0,0,0,0,0
0,0,0,0,0,0,0,0,0
0,0,0,0,0,0,0,0,0
0,0,0,0,0,0,0,0,0
0,0,0,0,0,0,0,0,0
0,0,0,0,0,0,0,0,0
0,0,0,0,0,0,0,0,0
0,0,0,0,0,0,0,0,0
0,0,0,0,0,0,0,0,0
0,0,0,0,0,0,0,0,0
90895,211,4,0,0,0,1,0,0
0,0,0,0,0,0,0,0,0
0,0,0,0,0,0,0,0,0
0,0,0,0,0,0,0,0,0
0,0,0,0,0,0,0,0,0
0,0,0,0,0,0,0,0,0
0,0,0,0,0,0,0,0,0
0,0,0,0,0,0,0,0,0
0,0,0,0,0,0,0,0,0
0,0,0,0,0,0,0,0,0
38733,128,2,5,2,3,1,1,0
0,0,0,0,0,0,0,0,0
48017,76,2,1,1,0,3,1,0
0,0,0,0,0,0,0,0,0
0,0,0,0,0,0,0,0,0
0,0,0,0,0,0,0,0,0
0,0,0,0,0,0,0,0,0
0,0,0,0,0,0,0,0,0
0,0,0,0,0,0,0,0,0
0,0,0,0,0,0,0,0,0
0,0,0,0,0,0,0,0,0
0,0,0,0,0,0,0,0,0
0,0,0,0,0,0,0,0,0
0,0,0,0,0,0,0,0,0
0,0,0,0,0,0,0,0,0
0,0,0,0,0,0,0,0,0
0,0,0,0,0,0,0,0,0
0,0,0,0,0,0,0,0,0
672574,538,0,4,4,0,2,1,1
0,0,0,0,0,0,0,0,0
0,0,0,0,0,0,0,0,0
0,0,0,0,0,0,0,0,0
0,0,0,0,0,0,0,0,0
0,0,0,0,0,0,0,0,0
0,0,0,0,0,0,0,0,0
0,0,0,0,0,0,0,0,0
0,0,0,0,0,0,0,0,0
0,0,0,0,0,0,0,0,0
62918,48,3,0,0,0,0,0,0
62918,48,3,0,0,0,0,0,0
62918,48,3,0,0,0,0,0,0
62918,48,3,0,0,0,0,0,0
0,0,0,0,0,0,0,0,0
0,0,0,0,0,0,0,0,0
0,0,0,0,0,0,0,0,0
0,0,0,0,0,0,0,0,0
0,0,0,0,0,0,0,0,0
0,0,0,0,0,0,0,0,0
0,0,0,0,0,0,0,0,0
16465,279,3,5,4,1,1,0,0
0,0,0,0,0,0,0,0,0
0,0,0,0,0,0,0,0,0
0,0,0,0,0,0,0,0,0
0,0,0,0,0,0,0,0,0
0,0,0,0,0,0,0,0,0
0,0,0,0,0,0,0,0,0
0,0,0,0,0,0,0,0,0
9538,28,1,2,2,0,0,0,0
0,0,0,0,0,0,0,0,0
0,0,0,0,0,0,0,0,0
0,0,0,0,0,0,0,0,0
0,0,0,0,0,0,0,0,0
0,0,0,0,0,0,0,0,0
0,0,0,0,0,0,0,0,0
0,0,0,0,0,0,0,0,0
0,0,0,0,0,0,0,0,0
0,0,0,0,0,0,0,0,0
0,0,0,0,0,0,0,0,0
0,0,0,0,0,0,0,0,0
0,0,0,0,0,0,0,0,0
0,0,0,0,0,0,0,0,0
0,0,0,0,0,0,0,0,0
0,0,0,0,0,0,0,0,0
0,0,0,0,0,0,0,0,0
0,0,0,0,0,0,0,0,0
0,0,0,0,0,0,0,0,0
0,0,0,0,0,0,0,0,0
0,0,0,0,0,0,0,0,0
0,0,0,0,0,0,0,0,0
0,0,0,0,0,0,0,0,0
0,0,0,0,0,0,0,0,0
0,0,0,0,0,0,0,0,0
0,0,0,0,0,0,0,0,0
0,0,0,0,0,0,0,0,0
0,0,0,0,0,0,0,0,0
0,0,0,0,0,0,0,0,0
0,0,0,0,0,0,0,0,0
0,0,0,0,0,0,0,0,0
0,0,0,0,0,0,0,0,0
0,0,0,0,0,0,0,0,0
0,0,0,0,0,0,0,0,0
0,0,0,0,0,0,0,0,0
0,0,0,0,0,0,0,0,0
0,0,0,0,0,0,0,0,0
0,0,0,0,0,0,0,0,0
0,0,0,0,0,0,0,0,0
0,0,0,0,0,0,0,0,0
0,0,0,0,0,0,0,0,0
0,0,0,0,0,0,0,0,0
0,0,0,0,0,0,0,0,0
247925,665,9,98,24,74,9,1,0
0,0,0,0,0,0,0,0,0
0,0,0,0,0,0,0,0,0
0,0,0,0,0,0,0,0,0
0,0,0,0,0,0,0,0,0
0,0,0,0,0,0,0,0,0
0,0,0,0,0,0,0,0,0
0,0,0,0,0,0,0,0,0
0,0,0,0,0,0,0,0,0
0,0,0,0,0,0,0,0,0
0,0,0,0,0,0,0,0,0
0,0,0,0,0,0,0,0,0
0,0,0,0,0,0,0,0,0
5098,39,5,1,1,0,0,0,0
0,0,0,0,0,0,0,0,0
0,0,0,0,0,0,0,0,0
0,0,0,0,0,0,0,0,0
2572,20,1,1,0,1,0,0,0
2673,21,2,1,0,1,0,0,0
2673,21,2,1,0,1,0,0,0
2673,21,2,1,0,1,0,0,0
2673,21,2,1,0,1,0,0,0
2673,21,2,1,0,1,0,0,0
0,0,0,0,0,0,0,0,0
2458,50,1,5,5,0,0,1,0
0,0,0,0,0,0,0,0,0
0,0,0,0,0,0,0,0,0
0,0,0,0,0,0,0,0,0
0,0,0,0,0,0,0,0,0
0,0,0,0,0,0,0,0,0
0,0,0,0,0,0,0,0,0
0,0,0,0,0,0,0,0,0
0,0,0,0,0,0,0,0,0
0,0,0,0,0,0,0,0,0
0,0,0,0,0,0,0,0,0
0,0,0,0,0,0,0,0,0
0,0,0,0,0,0,0,0,0
0,0,0,0,0,0,0,0,0
0,0,0,0,0,0,0,0,0
0,0,0,0,0,0,0,0,0
0,0,0,0,0,0,0,0,0
46330,206,5,34,28,6,0,0,0
61142,43,4,0,0,0,1,0,0
0,0,0,0,0,0,0,0,0
0,0,0,0,0,0,0,0,0
0,0,0,0,0,0,0,0,0
0,0,0,0,0,0,0,0,0
0,0,0,0,0,0,0,0,0
0,0,0,0,0,0,0,0,0
0,0,0,0,0,0,0,0,0
0,0,0,0,0,0,0,0,0
0,0,0,0,0,0,0,0,0
0,0,0,0,0,0,0,0,0
0,0,0,0,0,0,0,0,0
0,0,0,0,0,0,0,0,0
0,0,0,0,0,0,0,0,0
0,0,0,0,0,0,0,0,0
0,0,0,0,0,0,0,0,0
0,0,0,0,0,0,0,0,0
0,0,0,0,0,0,0,0,0
0,0,0,0,0,0,0,0,0
0,0,0,0,0,0,0,0,0
0,0,0,0,0,0,0,0,0
0,0,0,0,0,0,0,0,0
0,0,0,0,0,0,0,0,0
8965,51,2,0,0,0,2,0,0
0,0,0,0,0,0,0,0,0
9494,80,1,0,0,0,0,0,0
0,0,0,0,0,0,0,0,0
0,0,0,0,0,0,0,0,0
0,0,0,0,0,0,0,0,0
0,0,0,0,0,0,0,0,0
0,0,0,0,0,0,0,0,0
0,0,0,0,0,0,0,0,0
0,0,0,0,0,0,0,0,0
0,0,0,0,0,0,0,0,0
0,0,0,0,0,0,0,0,0
0,0,0,0,0,0,0,0,0
0,0,0,0,0,0,0,0,0
0,0,0,0,0,0,0,0,0
0,0,0,0,0,0,0,0,0
0,0,0,0,0,0,0,0,0
0,0,0,0,0,0,0,0,0
0,0,0,0,0,0,0,0,0
0,0,0,0,0,0,0,0,0
0,0,0,0,0,0,0,0,0
0,0,0,0,0,0,0,0,0
0,0,0,0,0,0,0,0,0
0,0,0,0,0,0,0,0,0
0,0,0,0,0,0,0,0,0
0,0,0,0,0,0,0,0,0
0,0,0,0,0,0,0,0,0
0,0,0,0,0,0,0,0,0
0,0,0,0,0,0,0,0,0
0,0,0,0,0,0,0,0,0
0,0,0,0,0,0,0,0,0
0,0,0,0,0,0,0,0,0
0,0,0,0,0,0,0,0,0
0,0,0,0,0,0,0,0,0
0,0,0,0,0,0,0,0,0
0,0,0,0,0,0,0,0,0
0,0,0,0,0,0,0,0,0
0,0,0,0,0,0,0,0,0
0,0,0,0,0,0,0,0,0
0,0,0,0,0,0,0,0,0
36096,167,2,5,4,1,18,0,0
0,0,0,0,0,0,0,0,0
0,0,0,0,0,0,0,0,0
0,0,0,0,0,0,0,0,0
0,0,0,0,0,0,0,0,0
0,0,0,0,0,0,0,0,0
0,0,0,0,0,0,0,0,0
0,0,0,0,0,0,0,0,0
0,0,0,0,0,0,0,0,0
0,0,0,0,0,0,0,0,0
0,0,0,0,0,0,0,0,0
0,0,0,0,0,0,0,0,0
0,0,0,0,0,0,0,0,0
0,0,0,0,0,0,0,0,0
0,0,0,0,0,0,0,0,0
0,0,0,0,0,0,0,0,0
0,0,0,0,0,0,0,0,0
0,0,0,0,0,0,0,0,0
0,0,0,0,0,0,0,0,0
0,0,0,0,0,0,0,0,0
0,0,0,0,0,0,0,0,0
0,0,0,0,0,0,0,0,0
0,0,0,0,0,0,0,0,0
0,0,0,0,0,0,0,0,0
0,0,0,0,0,0,0,0,0
0,0,0,0,0,0,0,0,0
0,0,0,0,0,0,0,0,0
0,0,0,0,0,0,0,0,0
0,0,0,0,0,0,0,0,0
0,0,0,0,0,0,0,0,0
0,0,0,0,0,0,0,0,0
0,0,0,0,0,0,0,0,0
0,0,0,0,0,0,0,0,0
0,0,0,0,0,0,0,0,0
0,0,0,0,0,0,0,0,0
0,0,0,0,0,0,0,0,0
0,0,0,0,0,0,0,0,0
0,0,0,0,0,0,0,0,0
0,0,0,0,0,0,0,0,0
0,0,0,0,0,0,0,0,0
0,0,0,0,0,0,0,0,0
0,0,0,0,0,0,0,0,0
0,0,0,0,0,0,0,0,0
0,0,0,0,0,0,0,0,0
0,0,0,0,0,0,0,0,0
0,0,0,0,0,0,0,0,0
0,0,0,0,0,0,0,0,0
0,0,0,0,0,0,0,0,0
0,0,0,0,0,0,0,0,0
0,0,0,0,0,0,0,0,0
0,0,0,0,0,0,0,0,0
0,0,0,0,0,0,0,0,0
0,0,0,0,0,0,0,0,0
0,0,0,0,0,0,0,0,0
0,0,0,0,0,0,0,0,0
0,0,0,0,0,0,0,0,0
0,0,0,0,0,0,0,0,0
0,0,0,0,0,0,0,0,0
0,0,0,0,0,0,0,0,0
0,0,0,0,0,0,0,0,0
0,0,0,0,0,0,0,0,0
145933,1051,2,153,21,132,3,0,0
0,0,0,0,0,0,0,0,0
0,0,0,0,0,0,0,0,0
0,0,0,0,0,0,0,0,0
0,0,0,0,0,0,0,0,0
65779,100,0,12,11,1,0,0,0
0,0,0,0,0,0,0,0,0
0,0,0,0,0,0,0,0,0
62053,48,3,0,0,0,0,0,0
0,0,0,0,0,0,0,0,0
0,0,0,0,0,0,0,0,0
0,0,0,0,0,0,0,0,0
105969,949,7,227,35,192,7,1,0
0,0,0,0,0,0,0,0,0
0,0,0,0,0,0,0,0,0
0,0,0,0,0,0,0,0,0
0,0,0,0,0,0,0,0,0
0,0,0,0,0,0,0,0,0
0,0,0,0,0,0,0,0,0
0,0,0,0,0,0,0,0,0
0,0,0,0,0,0,0,0,0
0,0,0,0,0,0,0,0,0
0,0,0,0,0,0,0,0,0
0,0,0,0,0,0,0,0,0
0,0,0,0,0,0,0,0,0
0,0,0,0,0,0,0,0,0
0,0,0,0,0,0,0,0,0
0,0,0,0,0,0,0,0,0
0,0,0,0,0,0,0,0,0
0,0,0,0,0,0,0,0,0
0,0,0,0,0,0,0,0,0
0,0,0,0,0,0,0,0,0
0,0,0,0,0,0,0,0,0
0,0,0,0,0,0,0,0,0
0,0,0,0,0,0,0,0,0
0,0,0,0,0,0,0,0,0
0,0,0,0,0,0,0,0,0
0,0,0,0,0,0,0,0,0
222254,92,1,4,1,3,0,0,0
0,0,0,0,0,0,0,0,0
0,0,0,0,0,0,0,0,0
0,0,0,0,0,0,0,0,0
0,0,0,0,0,0,0,0,0
0,0,0,0,0,0,0,0,0
0,0,0,0,0,0,0,0,0
0,0,0,0,0,0,0,0,0
0,0,0,0,0,0,0,0,0
0,0,0,0,0,0,0,0,0
0,0,0,0,0,0,0,0,0
0,0,0,0,0,0,0,0,0
0,0,0,0,0,0,0,0,0
0,0,0,0,0,0,0,0,0
0,0,0,0,0,0,0,0,0
0,0,0,0,0,0,0,0,0
0,0,0,0,0,0,0,0,0
0,0,0,0,0,0,0,0,0
0,0,0,0,0,0,0,0,0
12199,51,3,0,0,0,2,0,0
12199,51,3,0,0,0,2,0,0
0,0,0,0,0,0,0,0,0
0,0,0,0,0,0,0,0,0
12199,51,3,0,0,0,2,0,0
12199,51,3,0,0,0,2,0,0
0,0,0,0,0,0,0,0,0
0,0,0,0,0,0,0,0,0
12199,51,3,0,0,0,2,0,0
245156,207,4,47,45,2,0,1,0
0,0,0,0,0,0,0,0,0
0,0,0,0,0,0,0,0,0
245156,207,4,47,45,2,0,1,0
245156,207,4,47,45,2,0,1,0
0,0,0,0,0,0,0,0,0
0,0,0,0,0,0,0,0,0
0,0,0,0,0,0,0,0,0
0,0,0,0,0,0,0,0,0
245156,207,4,47,45,2,0,1,0
577507,60,4,3,3,0,2,1,0
577507,60,4,3,3,0,2,1,0
245156,207,4,47,45,2,0,1,0
0,0,0,0,0,0,0,0,0
0,0,0,0,0,0,0,0,0
577347,60,4,3,3,0,2,1,0
577347,60,4,3,3,0,2,1,0
0,0,0,0,0,0,0,0,0
0,0,0,0,0,0,0,0,0
0,0,0,0,0,0,0,0,0
136005,42,4,1,1,0,2,0,0
136005,42,4,1,1,0,2,0,0
0,0,0,0,0,0,0,0,0
0,0,0,0,0,0,0,0,0
0,0,0,0,0,0,0,0,0
0,0,0,0,0,0,0,0,0
0,0,0,0,0,0,0,0,0
0,0,0,0,0,0,0,0,0
19143,103,4,6,6,0,3,0,0
19143,103,4,6,6,0,3,0,0
19143,103,4,6,6,0,3,0,0
0,0,0,0,0,0,0,0,0
0,0,0,0,0,0,0,0,0
577347,60,4,3,3,0,2,1,0
577347,60,4,3,3,0,2,1,0
0,0,0,0,0,0,0,0,0
0,0,0,0,0,0,0,0,0
0,0,0,0,0,0,0,0,0
0,0,0,0,0,0,0,0,0
0,0,0,0,0,0,0,0,0
577347,60,4,3,3,0,2,1,0
577347,60,4,3,3,0,2,1,0
0,0,0,0,0,0,0,0,0
0,0,0,0,0,0,0,0,0
0,0,0,0,0,0,0,0,0
0,0,0,0,0,0,0,0,0
577347,60,4,3,3,0,2,1,0
0,0,0,0,0,0,0,0,0
0,0,0,0,0,0,0,0,0
0,0,0,0,0,0,0,0,0
0,0,0,0,0,0,0,0,0
577507,60,4,3,3,0,2,1,0
577507,60,4,3,3,0,2,1,0
0,0,0,0,0,0,0,0,0
136005,42,4,1,1,0,2,0,0
0,0,0,0,0,0,0,0,0
0,0,0,0,0,0,0,0,0
0,0,0,0,0,0,0,0,0
0,0,0,0,0,0,0,0,0
0,0,0,0,0,0,0,0,0
0,0,0,0,0,0,0,0,0
0,0,0,0,0,0,0,0,0
0,0,0,0,0,0,0,0,0
0,0,0,0,0,0,0,0,0
0,0,0,0,0,0,0,0,0
0,0,0,0,0,0,0,0,0
0,0,0,0,0,0,0,0,0
0,0,0,0,0,0,0,0,0
0,0,0,0,0,0,0,0,0
0,0,0,0,0,0,0,0,0
0,0,0,0,0,0,0,0,0
0,0,0,0,0,0,0,0,0
0,0,0,0,0,0,0,0,0
0,0,0,0,0,0,0,0,0
0,0,0,0,0,0,0,0,0
0,0,0,0,0,0,0,0,0
0,0,0,0,0,0,0,0,0
0,0,0,0,0,0,0,0,0
0,0,0,0,0,0,0,0,0
0,0,0,0,0,0,0,0,0
0,0,0,0,0,0,0,0,0
0,0,0,0,0,0,0,0,0
0,0,0,0,0,0,0,0,0
0,0,0,0,0,0,0,0,0
0,0,0,0,0,0,0,0,0
0,0,0,0,0,0,0,0,0
0,0,0,0,0,0,0,0,0
337630,58,1,6,3,3,0,0,0
0,0,0,0,0,0,0,0,0
0,0,0,0,0,0,0,0,0
0,0,0,0,0,0,0,0,0
0,0,0,0,0,0,0,0,0
0,0,0,0,0,0,0,0,0
0,0,0,0,0,0,0,0,0
0,0,0,0,0,0,0,0,0
0,0,0,0,0,0,0,0,0
0,0,0,0,0,0,0,0,0
0,0,0,0,0,0,0,0,0
135972,42,4,1,1,0,2,0,0
0,0,0,0,0,0,0,0,0
0,0,0,0,0,0,0,0,0
361,6,0,0,0,0,0,0,0
0,0,0,0,0,0,0,0,0
0,0,0,0,0,0,0,0,0
0,0,0,0,0,0,0,0,0
0,0,0,0,0,0,0,0,0
6818,50,0,2,2,0,0,1,0
0,0,0,0,0,0,0,0,0
0,0,0,0,0,0,0,0,0
0,0,0,0,0,0,0,0,0
840,26,0,0,0,0,0,0,0
0,0,0,0,0,0,0,0,0
0,0,0,0,0,0,0,0,0
0,0,0,0,0,0,0,0,0
0,0,0,0,0,0,0,0,0
0,0,0,0,0,0,0,0,0
0,0,0,0,0,0,0,0,0
0,0,0,0,0,0,0,0,0
0,0,0,0,0,0,0,0,0
0,0,0,0,0,0,0,0,0
0,0,0,0,0,0,0,0,0
0,0,0,0,0,0,0,0,0
0,0,0,0,0,0,0,0,0
0,0,0,0,0,0,0,0,0
0,0,0,0,0,0,0,0,0
0,0,0,0,0,0,0,0,0
0,0,0,0,0,0,0,0,0
0,0,0,0,0,0,0,0,0
0,0,0,0,0,0,0,0,0
0,0,0,0,0,0,0,0,0
0,0,0,0,0,0,0,0,0
0,0,0,0,0,0,0,0,0
0,0,0,0,0,0,0,0,0
105976,949,7,227,40,187,7,1,0
0,0,0,0,0,0,0,0,0
0,0,0,0,0,0,0,0,0
0,0,0,0,0,0,0,0,0
0,0,0,0,0,0,0,0,0
0,0,0,0,0,0,0,0,0
0,0,0,0,0,0,0,0,0
0,0,0,0,0,0,0,0,0
0,0,0,0,0,0,0,0,0
0,0,0,0,0,0,0,0,0
0,0,0,0,0,0,0,0,0
0,0,0,0,0,0,0,0,0
0,0,0,0,0,0,0,0,0
0,0,0,0,0,0,0,0,0
0,0,0,0,0,0,0,0,0
0,0,0,0,0,0,0,0,0
0,0,0,0,0,0,0,0,0
0,0,0,0,0,0,0,0,0
0,0,0,0,0,0,0,0,0
0,0,0,0,0,0,0,0,0
0,0,0,0,0,0,0,0,0
0,0,0,0,0,0,0,0,0
0,0,0,0,0,0,0,0,0
0,0,0,0,0,0,0,0,0
0,0,0,0,0,0,0,0,0
0,0,0,0,0,0,0,0,0
0,0,0,0,0,0,0,0,0
0,0,0,0,0,0,0,0,0
52446,212,2,7,4,3,1,1,0
0,0,0,0,0,0,0,0,0
0,0,0,0,0,0,0,0,0
0,0,0,0,0,0,0,0,0
0,0,0,0,0,0,0,0,0
0,0,0,0,0,0,0,0,0
0,0,0,0,0,0,0,0,0
0,0,0,0,0,0,0,0,0
0,0,0,0,0,0,0,0,0
0,0,0,0,0,0,0,0,0
0,0,0,0,0,0,0,0,0
0,0,0,0,0,0,0,0,0
0,0,0,0,0,0,0,0,0
0,0,0,0,0,0,0,0,0
0,0,0,0,0,0,0,0,0
0,0,0,0,0,0,0,0,0
0,0,0,0,0,0,0,0,0
0,0,0,0,0,0,0,0,0
171466,419,7,36,28,8,8,0,0
0,0,0,0,0,0,0,0,0
0,0,0,0,0,0,0,0,0
0,0,0,0,0,0,0,0,0
0,0,0,0,0,0,0,0,0
0,0,0,0,0,0,0,0,0
0,0,0,0,0,0,0,0,0
0,0,0,0,0,0,0,0,0
0,0,0,0,0,0,0,0,0
0,0,0,0,0,0,0,0,0
0,0,0,0,0,0,0,0,0
0,0,0,0,0,0,0,0,0
0,0,0,0,0,0,0,0,0
0,0,0,0,0,0,0,0,0
105971,949,7,227,32,195,7,1,0
0,0,0,0,0,0,0,0,0
0,0,0,0,0,0,0,0,0
0,0,0,0,0,0,0,0,0
0,0,0,0,0,0,0,0,0
0,0,0,0,0,0,0,0,0
0,0,0,0,0,0,0,0,0
0,0,0,0,0,0,0,0,0
0,0,0,0,0,0,0,0,0
0,0,0,0,0,0,0,0,0
0,0,0,0,0,0,0,0,0
0,0,0,0,0,0,0,0,0
0,0,0,0,0,0,0,0,0
0,0,0,0,0,0,0,0,0
0,0,0,0,0,0,0,0,0
0,0,0,0,0,0,0,0,0
0,0,0,0,0,0,0,0,0
0,0,0,0,0,0,0,0,0
0,0,0,0,0,0,0,0,0
0,0,0,0,0,0,0,0,0
91404,211,4,0,0,0,1,0,0
93542,211,4,0,0,0,1,0,0
90516,209,4,0,0,0,1,0,0
91036,209,4,0,0,0,1,0,0
90494,211,4,0,0,0,1,0,0
92452,211,5,0,0,0,1,0,0
90630,209,4,0,0,0,1,0,0
0,0,0,0,0,0,0,0,0
90414,209,4,0,0,0,1,0,0
91250,209,4,0,0,0,1,0,0
90668,211,4,0,0,0,1,0,0
91763,211,4,0,0,0,1,0,0
90740,209,4,0,0,0,1,0,0
90657,209,4,0,0,0,1,0,0
94140,220,5,0,0,0,4,0,0
90807,209,4,0,0,0,1,0,0
91247,209,4,0,0,0,1,0,0
0,0,0,0,0,0,0,0,0
91346,211,4,0,0,0,1,0,0
0,0,0,0,0,0,0,0,0
91166,211,4,0,0,0,1,0,0
94319,220,5,0,0,0,4,0,0
91372,211,4,0,0,0,1,0,0
0,0,0,0,0,0,0,0,0
91547,211,4,0,0,0,1,0,0
0,0,0,0,0,0,0,0,0
0,0,0,0,0,0,0,0,0
0,0,0,0,0,0,0,0,0
0,0,0,0,0,0,0,0,0
90743,211,4,0,0,0,1,0,0
0,0,0,0,0,0,0,0,0
91472,211,4,0,0,0,1,0,0
91646,211,4,0,0,0,1,0,0
0,0,0,0,0,0,0,0,0
0,0,0,0,0,0,0,0,0
90599,209,4,0,0,0,1,0,0
0,0,0,0,0,0,0,0,0
90051,209,4,0,0,0,1,0,0
0,0,0,0,0,0,0,0,0
90465,209,4,0,0,0,1,0,0
0,0,0,0,0,0,0,0,0
90479,209,4,0,0,0,1,0,0
90469,209,4,0,0,0,1,0,0
90475,209,4,0,0,0,1,0,0
0,0,0,0,0,0,0,0,0
90327,211,4,0,0,0,1,0,0
0,0,0,0,0,0,0,0,0
90136,211,4,0,0,0,1,0,0
91569,211,4,0,0,0,1,0,0
90454,209,4,0,0,0,1,0,0
90977,209,4,0,0,0,1,0,0
91098,211,4,0,0,0,1,0,0
0,0,0,0,0,0,0,0,0
0,0,0,0,0,0,0,0,0
91237,211,4,0,0,0,1,0,0
91382,211,4,0,0,0,1,0,0
90930,209,4,0,0,0,1,0,0
91049,209,4,0,0,0,1,0,0
0,0,0,0,0,0,0,0,0
90574,209,4,0,0,0,1,0,0
0,0,0,0,0,0,0,0,0
0,0,0,0,0,0,0,0,0
0,0,0,0,0,0,0,0,0
91069,211,4,0,0,0,1,0,0
0,0,0,0,0,0,0,0,0
91124,211,4,0,0,0,1,0,0
90398,209,4,0,0,0,1,0,0
90828,211,4,0,0,0,1,0,0
90999,211,4,0,0,0,1,0,0
90971,211,4,0,0,0,1,0,0
0,0,0,0,0,0,0,0,0
0,0,0,0,0,0,0,0,0
0,0,0,0,0,0,0,0,0
0,0,0,0,0,0,0,0,0
0,0,0,0,0,0,0,0,0
0,0,0,0,0,0,0,0,0
0,0,0,0,0,0,0,0,0
90727,209,4,0,0,0,1,0,0
0,0,0,0,0,0,0,0,0
0,0,0,0,0,0,0,0,0
0,0,0,0,0,0,0,0,0
0,0,0,0,0,0,0,0,0
0,0,0,0,0,0,0,0,0
0,0,0,0,0,0,0,0,0
0,0,0,0,0,0,0,0,0
0,0,0,0,0,0,0,0,0
0,0,0,0,0,0,0,0,0
0,0,0,0,0,0,0,0,0
0,0,0,0,0,0,0,0,0
0,0,0,0,0,0,0,0,0
0,0,0,0,0,0,0,0,0
0,0,0,0,0,0,0,0,0
0,0,0,0,0,0,0,0,0
0,0,0,0,0,0,0,0,0
0,0,0,0,0,0,0,0,0
0,0,0,0,0,0,0,0,0
0,0,0,0,0,0,0,0,0
0,0,0,0,0,0,0,0,0
0,0,0,0,0,0,0,0,0
0,0,0,0,0,0,0,0,0
0,0,0,0,0,0,0,0,0
0,0,0,0,0,0,0,0,0
0,0,0,0,0,0,0,0,0
91918,211,4,0,0,0,1,0,0
90760,211,4,0,0,0,1,0,0
92018,211,4,0,0,0,1,0,0
0,0,0,0,0,0,0,0,0
91887,211,4,0,0,0,1,0,0
92611,212,4,0,0,0,1,0,0
0,0,0,0,0,0,0,0,0
92257,211,4,0,0,0,1,0,0
0,0,0,0,0,0,0,0,0
0,0,0,0,0,0,0,0,0
0,0,0,0,0,0,0,0,0
90853,211,4,0,0,0,1,0,0
0,0,0,0,0,0,0,0,0
91619,211,4,0,0,0,1,0,0
91014,209,4,0,0,0,1,0,0
91999,212,4,0,0,0,1,0,0
91692,211,4,0,0,0,1,0,0
0,0,0,0,0,0,0,0,0
91285,211,4,0,0,0,1,0,0
92385,212,4,0,0,0,1,0,0
92071,212,4,0,0,0,1,0,0
91711,211,4,0,0,0,1,0,0
92003,211,4,0,0,0,1,0,0
92106,212,4,0,0,0,1,0,0
0,0,0,0,0,0,0,0,0
91727,209,4,0,0,0,1,0,0
0,0,0,0,0,0,0,0,0
92153,212,4,0,0,0,1,0,0
91308,211,4,0,0,0,1,0,0
0,0,0,0,0,0,0,0,0
0,0,0,0,0,0,0,0,0
0,0,0,0,0,0,0,0,0
90445,209,4,0,0,0,1,0,0
0,0,0,0,0,0,0,0,0
91569,211,4,0,0,0,1,0,0
0,0,0,0,0,0,0,0,0
0,0,0,0,0,0,0,0,0
0,0,0,0,0,0,0,0,0
0,0,0,0,0,0,0,0,0
0,0,0,0,0,0,0,0,0
0,0,0,0,0,0,0,0,0
90778,211,4,0,0,0,1,0,0
0,0,0,0,0,0,0,0,0
90770,211,4,0,0,0,1,0,0
0,0,0,0,0,0,0,0,0
0,0,0,0,0,0,0,0,0
92799,211,4,0,0,0,1,0,0
0,0,0,0,0,0,0,0,0
0,0,0,0,0,0,0,0,0
90929,209,4,0,0,0,1,0,0
0,0,0,0,0,0,0,0,0
0,0,0,0,0,0,0,0,0
91450,211,4,0,0,0,1,0,0
0,0,0,0,0,0,0,0,0
0,0,0,0,0,0,0,0,0
3766,44,0,2,0,2,1,0,0
90779,211,4,0,0,0,1,0,0
0,0,0,0,0,0,0,0,0
91299,211,4,0,0,0,1,0,0
90637,211,4,0,0,0,1,0,0
0,0,0,0,0,0,0,0,0
0,0,0,0,0,0,0,0,0
0,0,0,0,0,0,0,0,0
91560,212,4,0,0,0,1,0,0
0,0,0,0,0,0,0,0,0
0,0,0,0,0,0,0,0,0
0,0,0,0,0,0,0,0,0
0,0,0,0,0,0,0,0,0
0,0,0,0,0,0,0,0,0
0,0,0,0,0,0,0,0,0
0,0,0,0,0,0,0,0,0
501184,2060,4,245,13,232,18,1,0
0,0,0,0,0,0,0,0,0
0,0,0,0,0,0,0,0,0
0,0,0,0,0,0,0,0,0
90897,211,4,0,0,0,1,0,0
90531,209,4,0,0,0,1,0,0
0,0,0,0,0,0,0,0,0
0,0,0,0,0,0,0,0,0
0,0,0,0,0,0,0,0,0
0,0,0,0,0,0,0,0,0
0,0,0,0,0,0,0,0,0
0,0,0,0,0,0,0,0,0
0,0,0,0,0,0,0,0,0
0,0,0,0,0,0,0,0,0
0,0,0,0,0,0,0,0,0
0,0,0,0,0,0,0,0,0
0,0,0,0,0,0,0,0,0
0,0,0,0,0,0,0,0,0
0,0,0,0,0,0,0,0,0
0,0,0,0,0,0,0,0,0
16244,57,0,2,1,1,0,1,0
0,0,0,0,0,0,0,0,0
0,0,0,0,0,0,0,0,0
70700,88,0,1,0,1,0,0,0
0,0,0,0,0,0,0,0,0
0,0,0,0,0,0,0,0,0
0,0,0,0,0,0,0,0,0
0,0,0,0,0,0,0,0,0
0,0,0,0,0,0,0,0,0
0,0,0,0,0,0,0,0,0
9495,42,1,1,1,0,0,0,0
0,0,0,0,0,0,0,0,0
0,0,0,0,0,0,0,0,0
0,0,0,0,0,0,0,0,0
0,0,0,0,0,0,0,0,0
0,0,0,0,0,0,0,0,0
0,0,0,0,0,0,0,0,0
0,0,0,0,0,0,0,0,0
0,0,0,0,0,0,0,0,0
0,0,0,0,0,0,0,0,0
0,0,0,0,0,0,0,0,0
0,0,0,0,0,0,0,0,0
0,0,0,0,0,0,0,0,0
0,0,0,0,0,0,0,0,0
0,0,0,0,0,0,0,0,0
0,0,0,0,0,0,0,0,0
0,0,0,0,0,0,0,0,0
0,0,0,0,0,0,0,0,0
0,0,0,0,0,0,0,0,0
0,0,0,0,0,0,0,0,0
0,0,0,0,0,0,0,0,0
0,0,0,0,0,0,0,0,0
0,0,0,0,0,0,0,0,0
0,0,0,0,0,0,0,0,0
0,0,0,0,0,0,0,0,0
0,0,0,0,0,0,0,0,0
0,0,0,0,0,0,0,0,0
0,0,0,0,0,0,0,0,0
0,0,0,0,0,0,0,0,0
0,0,0,0,0,0,0,0,0
0,0,0,0,0,0,0,0,0
0,0,0,0,0,0,0,0,0
0,0,0,0,0,0,0,0,0
0,0,0,0,0,0,0,0,0
0,0,0,0,0,0,0,0,0
0,0,0,0,0,0,0,0,0
0,0,0,0,0,0,0,0,0
0,0,0,0,0,0,0,0,0
0,0,0,0,0,0,0,0,0
0,0,0,0,0,0,0,0,0
0,0,0,0,0,0,0,0,0
0,0,0,0,0,0,0,0,0
0,0,0,0,0,0,0,0,0
0,0,0,0,0,0,0,0,0
0,0,0,0,0,0,0,0,0
0,0,0,0,0,0,0,0,0
0,0,0,0,0,0,0,0,0
0,0,0,0,0,0,0,0,0
0,0,0,0,0,0,0,0,0
0,0,0,0,0,0,0,0,0
0,0,0,0,0,0,0,0,0
0,0,0,0,0,0,0,0,0
0,0,0,0,0,0,0,0,0
0,0,0,0,0,0,0,0,0
0,0,0,0,0,0,0,0,0
0,0,0,0,0,0,0,0,0
0,0,0,0,0,0,0,0,0
0,0,0,0,0,0,0,0,0
0,0,0,0,0,0,0,0,0
0,0,0,0,0,0,0,0,0
0,0,0,0,0,0,0,0,0
0,0,0,0,0,0,0,0,0
0,0,0,0,0,0,0,0,0
0,0,0,0,0,0,0,0,0
0,0,0,0,0,0,0,0,0
0,0,0,0,0,0,0,0,0
0,0,0,0,0,0,0,0,0
0,0,0,0,0,0,0,0,0
0,0,0,0,0,0,0,0,0
0,0,0,0,0,0,0,0,0
0,0,0,0,0,0,0,0,0
0,0,0,0,0,0,0,0,0
0,0,0,0,0,0,0,0,0
0,0,0,0,0,0,0,0,0
0,0,0,0,0,0,0,0,0
0,0,0,0,0,0,0,0,0
0,0,0,0,0,0,0,0,0
0,0,0,0,0,0,0,0,0
0,0,0,0,0,0,0,0,0
0,0,0,0,0,0,0,0,0
0,0,0,0,0,0,0,0,0
0,0,0,0,0,0,0,0,0
0,0,0,0,0,0,0,0,0
0,0,0,0,0,0,0,0,0
0,0,0,0,0,0,0,0,0
0,0,0,0,0,0,0,0,0
0,0,0,0,0,0,0,0,0
0,0,0,0,0,0,0,0,0
0,0,0,0,0,0,0,0,0
124881,204,2,50,49,1,0,1,0
0,0,0,0,0,0,0,0,0
0,0,0,0,0,0,0,0,0
0,0,0,0,0,0,0,0,0
0,0,0,0,0,0,0,0,0
124881,204,2,50,49,1,0,1,0
0,0,0,0,0,0,0,0,0
0,0,0,0,0,0,0,0,0
0,0,0,0,0,0,0,0,0
0,0,0,0,0,0,0,0,0
0,0,0,0,0,0,0,0,0
0,0,0,0,0,0,0,0,0
125190,204,2,50,49,1,0,1,0
546109,160,1,9,9,0,4,1,0
0,0,0,0,0,0,0,0,0
422672,63,6,1,1,0,2,0,0
422672,63,6,1,1,0,2,0,0
0,0,0,0,0,0,0,0,0
125190,204,2,50,49,1,0,1,0
0,0,0,0,0,0,0,0,0
0,0,0,0,0,0,0,0,0
0,0,0,0,0,0,0,0,0
422672,63,6,1,1,0,2,0,0
422672,63,6,1,1,0,2,0,0
422672,63,6,1,1,0,2,0,0
422672,63,6,1,1,0,2,0,0
422672,63,6,1,1,0,2,0,0
0,0,0,0,0,0,0,0,0
546117,160,1,9,9,0,4,1,0
0,0,0,0,0,0,0,0,0
546109,160,1,9,9,0,4,1,0
0,0,0,0,0,0,0,0,0
0,0,0,0,0,0,0,0,0
0,0,0,0,0,0,0,0,0
0,0,0,0,0,0,0,0,0
0,0,0,0,0,0,0,0,0
0,0,0,0,0,0,0,0,0
0,0,0,0,0,0,0,0,0
0,0,0,0,0,0,0,0,0
0,0,0,0,0,0,0,0,0
0,0,0,0,0,0,0,0,0
0,0,0,0,0,0,0,0,0
0,0,0,0,0,0,0,0,0
0,0,0,0,0,0,0,0,0
0,0,0,0,0,0,0,0,0
0,0,0,0,0,0,0,0,0
0,0,0,0,0,0,0,0,0
0,0,0,0,0,0,0,0,0
0,0,0,0,0,0,0,0,0
0,0,0,0,0,0,0,0,0
0,0,0,0,0,0,0,0,0
0,0,0,0,0,0,0,0,0
0,0,0,0,0,0,0,0,0
0,0,0,0,0,0,0,0,0
0,0,0,0,0,0,0,0,0
0,0,0,0,0,0,0,0,0
0,0,0,0,0,0,0,0,0
0,0,0,0,0,0,0,0,0
0,0,0,0,0,0,0,0,0
0,0,0,0,0,0,0,0,0
0,0,0,0,0,0,0,0,0
0,0,0,0,0,0,0,0,0
0,0,0,0,0,0,0,0,0
0,0,0,0,0,0,0,0,0
0,0,0,0,0,0,0,0,0
0,0,0,0,0,0,0,0,0
0,0,0,0,0,0,0,0,0
0,0,0,0,0,0,0,0,0
0,0,0,0,0,0,0,0,0
0,0,0,0,0,0,0,0,0
0,0,0,0,0,0,0,0,0
0,0,0,0,0,0,0,0,0
0,0,0,0,0,0,0,0,0
0,0,0,0,0,0,0,0,0
0,0,0,0,0,0,0,0,0
0,0,0,0,0,0,0,0,0
0,0,0,0,0,0,0,0,0
0,0,0,0,0,0,0,0,0
0,0,0,0,0,0,0,0,0
0,0,0,0,0,0,0,0,0
0,0,0,0,0,0,0,0,0
0,0,0,0,0,0,0,0,0
0,0,0,0,0,0,0,0,0
0,0,0,0,0,0,0,0,0
0,0,0,0,0,0,0,0,0
0,0,0,0,0,0,0,0,0
0,0,0,0,0,0,0,0,0
0,0,0,0,0,0,0,0,0
0,0,0,0,0,0,0,0,0
0,0,0,0,0,0,0,0,0
0,0,0,0,0,0,0,0,0
0,0,0,0,0,0,0,0,0
0,0,0,0,0,0,0,0,0
0,0,0,0,0,0,0,0,0
0,0,0,0,0,0,0,0,0
0,0,0,0,0,0,0,0,0
0,0,0,0,0,0,0,0,0
0,0,0,0,0,0,0,0,0
0,0,0,0,0,0,0,0,0
0,0,0,0,0,0,0,0,0
0,0,0,0,0,0,0,0,0
0,0,0,0,0,0,0,0,0
0,0,0,0,0,0,0,0,0
0,0,0,0,0,0,0,0,0
0,0,0,0,0,0,0,0,0
0,0,0,0,0,0,0,0,0
0,0,0,0,0,0,0,0,0
0,0,0,0,0,0,0,0,0
0,0,0,0,0,0,0,0,0
0,0,0,0,0,0,0,0,0
51328,53,3,0,0,0,0,1,0
51328,53,3,0,0,0,0,1,0
0,0,0,0,0,0,0,0,0
0,0,0,0,0,0,0,0,0
0,0,0,0,0,0,0,0,0
0,0,0,0,0,0,0,0,0
327251,60,4,3,3,0,2,1,0
327251,60,4,3,3,0,2,1,0
0,0,0,0,0,0,0,0,0
0,0,0,0,0,0,0,0,0
0,0,0,0,0,0,0,0,0
0,0,0,0,0,0,0,0,0
0,0,0,0,0,0,0,0,0
0,0,0,0,0,0,0,0,0
0,0,0,0,0,0,0,0,0
0,0,0,0,0,0,0,0,0
0,0,0,0,0,0,0,0,0
0,0,0,0,0,0,0,0,0
0,0,0,0,0,0,0,0,0
0,0,0,0,0,0,0,0,0
0,0,0,0,0,0,0,0,0
0,0,0,0,0,0,0,0,0
0,0,0,0,0,0,0,0,0
0,0,0,0,0,0,0,0,0
0,0,0,0,0,0,0,0,0
0,0,0,0,0,0,0,0,0
0,0,0,0,0,0,0,0,0
0,0,0,0,0,0,0,0,0
0,0,0,0,0,0,0,0,0
0,0,0,0,0,0,0,0,0
0,0,0,0,0,0,0,0,0
0,0,0,0,0,0,0,0,0
0,0,0,0,0,0,0,0,0
0,0,0,0,0,0,0,0,0
0,0,0,0,0,0,0,0,0
0,0,0,0,0,0,0,0,0
0,0,0,0,0,0,0,0,0
0,0,0,0,0,0,0,0,0
0,0,0,0,0,0,0,0,0
0,0,0,0,0,0,0,0,0
0,0,0,0,0,0,0,0,0
0,0,0,0,0,0,0,0,0
0,0,0,0,0,0,0,0,0
0,0,0,0,0,0,0,0,0
0,0,0,0,0,0,0,0,0
0,0,0,0,0,0,0,0,0
0,0,0,0,0,0,0,0,0
0,0,0,0,0,0,0,0,0
0,0,0,0,0,0,0,0,0
0,0,0,0,0,0,0,0,0
0,0,0,0,0,0,0,0,0
0,0,0,0,0,0,0,0,0
0,0,0,0,0,0,0,0,0
0,0,0,0,0,0,0,0,0
101798,151,4,4,4,0,2,1,0
0,0,0,0,0,0,0,0,0
0,0,0,0,0,0,0,0,0
0,0,0,0,0,0,0,0,0
0,0,0,0,0,0,0,0,0
0,0,0,0,0,0,0,0,0
0,0,0,0,0,0,0,0,0
0,0,0,0,0,0,0,0,0
0,0,0,0,0,0,0,0,0
0,0,0,0,0,0,0,0,0
0,0,0,0,0,0,0,0,0
0,0,0,0,0,0,0,0,0
0,0,0,0,0,0,0,0,0
0,0,0,0,0,0,0,0,0
0,0,0,0,0,0,0,0,0
0,0,0,0,0,0,0,0,0
0,0,0,0,0,0,0,0,0
0,0,0,0,0,0,0,0,0
0,0,0,0,0,0,0,0,0
0,0,0,0,0,0,0,0,0
0,0,0,0,0,0,0,0,0
0,0,0,0,0,0,0,0,0
0,0,0,0,0,0,0,0,0
0,0,0,0,0,0,0,0,0
0,0,0,0,0,0,0,0,0
0,0,0,0,0,0,0,0,0
0,0,0,0,0,0,0,0,0
0,0,0,0,0,0,0,0,0
0,0,0,0,0,0,0,0,0
0,0,0,0,0,0,0,0,0
0,0,0,0,0,0,0,0,0
0,0,0,0,0,0,0,0,0
0,0,0,0,0,0,0,0,0
0,0,0,0,0,0,0,0,0
0,0,0,0,0,0,0,0,0
0,0,0,0,0,0,0,0,0
0,0,0,0,0,0,0,0,0
0,0,0,0,0,0,0,0,0
0,0,0,0,0,0,0,0,0
327251,60,4,3,3,0,2,1,0
327251,60,4,3,3,0,2,1,0
327251,60,4,3,3,0,2,1,0
327251,60,4,3,3,0,2,1,0
327251,60,4,3,3,0,2,1,0
0,0,0,0,0,0,0,0,0
0,0,0,0,0,0,0,0,0
0,0,0,0,0,0,0,0,0
51328,53,3,0,0,0,0,1,0
0,0,0,0,0,0,0,0,0
51328,53,3,0,0,0,0,1,0
0,0,0,0,0,0,0,0,0
0,0,0,0,0,0,0,0,0
51328,53,3,0,0,0,0,1,0
0,0,0,0,0,0,0,0,0
0,0,0,0,0,0,0,0,0
0,0,0,0,0,0,0,0,0
0,0,0,0,0,0,0,0,0
0,0,0,0,0,0,0,0,0
0,0,0,0,0,0,0,0,0
0,0,0,0,0,0,0,0,0
0,0,0,0,0,0,0,0,0
0,0,0,0,0,0,0,0,0
332533,60,4,3,3,0,2,1,0
332533,60,4,3,3,0,2,1,0
0,0,0,0,0,0,0,0,0
0,0,0,0,0,0,0,0,0
0,0,0,0,0,0,0,0,0
0,0,0,0,0,0,0,0,0
0,0,0,0,0,0,0,0,0
0,0,0,0,0,0,0,0,0
0,0,0,0,0,0,0,0,0
0,0,0,0,0,0,0,0,0
0,0,0,0,0,0,0,0,0
0,0,0,0,0,0,0,0,0
0,0,0,0,0,0,0,0,0
0,0,0,0,0,0,0,0,0
0,0,0,0,0,0,0,0,0
0,0,0,0,0,0,0,0,0
0,0,0,0,0,0,0,0,0
0,0,0,0,0,0,0,0,0
0,0,0,0,0,0,0,0,0
0,0,0,0,0,0,0,0,0
0,0,0,0,0,0,0,0,0
0,0,0,0,0,0,0,0,0
0,0,0,0,0,0,0,0,0
0,0,0,0,0,0,0,0,0
0,0,0,0,0,0,0,0,0
0,0,0,0,0,0,0,0,0
32579,111,3,13,3,10,0,0,0
32579,111,3,13,3,10,0,0,0
0,0,0,0,0,0,0,0,0
0,0,0,0,0,0,0,0,0
0,0,0,0,0,0,0,0,0
0,0,0,0,0,0,0,0,0
0,0,0,0,0,0,0,0,0
0,0,0,0,0,0,0,0,0
0,0,0,0,0,0,0,0,0
0,0,0,0,0,0,0,0,0
0,0,0,0,0,0,0,0,0
0,0,0,0,0,0,0,0,0
0,0,0,0,0,0,0,0,0
0,0,0,0,0,0,0,0,0
0,0,0,0,0,0,0,0,0
0,0,0,0,0,0,0,0,0
0,0,0,0,0,0,0,0,0
0,0,0,0,0,0,0,0,0
0,0,0,0,0,0,0,0,0
0,0,0,0,0,0,0,0,0
0,0,0,0,0,0,0,0,0
0,0,0,0,0,0,0,0,0
0,0,0,0,0,0,0,0,0
0,0,0,0,0,0,0,0,0
0,0,0,0,0,0,0,0,0
0,0,0,0,0,0,0,0,0
0,0,0,0,0,0,0,0,0
0,0,0,0,0,0,0,0,0
0,0,0,0,0,0,0,0,0
0,0,0,0,0,0,0,0,0
0,0,0,0,0,0,0,0,0
0,0,0,0,0,0,0,0,0
0,0,0,0,0,0,0,0,0
0,0,0,0,0,0,0,0,0
136979,69,3,2,1,1,2,1,0
17640,77,1,3,0,3,2,1,0
84271,28,2,0,0,0,0,0,0
0,0,0,0,0,0,0,0,0
0,0,0,0,0,0,0,0,0
0,0,0,0,0,0,0,0,0
0,0,0,0,0,0,0,0,0
0,0,0,0,0,0,0,0,0
0,0,0,0,0,0,0,0,0
0,0,0,0,0,0,0,0,0
0,0,0,0,0,0,0,0,0
0,0,0,0,0,0,0,0,0
0,0,0,0,0,0,0,0,0
0,0,0,0,0,0,0,0,0
48009,76,2,1,1,0,3,1,0
11911,56,0,2,1,1,0,0,0
271496,265,1,7,2,5,0,1,0
0,0,0,0,0,0,0,0,0
0,0,0,0,0,0,0,0,0
0,0,0,0,0,0,0,0,0
0,0,0,0,0,0,0,0,0
0,0,0,0,0,0,0,0,0
0,0,0,0,0,0,0,0,0
0,0,0,0,0,0,0,0,0
0,0,0,0,0,0,0,0,0
0,0,0,0,0,0,0,0,0
0,0,0,0,0,0,0,0,0
0,0,0,0,0,0,0,0,0
0,0,0,0,0,0,0,0,0
0,0,0,0,0,0,0,0,0
0,0,0,0,0,0,0,0,0
423,7,1,0,0,0,0,0,0
0,0,0,0,0,0,0,0,0
0,0,0,0,0,0,0,0,0
0,0,0,0,0,0,0,0,0
0,0,0,0,0,0,0,0,0
0,0,0,0,0,0,0,0,0
0,0,0,0,0,0,0,0,0
0,0,0,0,0,0,0,0,0
0,0,0,0,0,0,0,0,0
0,0,0,0,0,0,0,0,0
0,0,0,0,0,0,0,0,0
0,0,0,0,0,0,0,0,0
0,0,0,0,0,0,0,0,0
0,0,0,0,0,0,0,0,0
0,0,0,0,0,0,0,0,0
0,0,0,0,0,0,0,0,0
0,0,0,0,0,0,0,0,0
0,0,0,0,0,0,0,0,0
0,0,0,0,0,0,0,0,0
0,0,0,0,0,0,0,0,0
0,0,0,0,0,0,0,0,0
0,0,0,0,0,0,0,0,0
0,0,0,0,0,0,0,0,0
0,0,0,0,0,0,0,0,0
0,0,0,0,0,0,0,0,0
0,0,0,0,0,0,0,0,0
0,0,0,0,0,0,0,0,0
0,0,0,0,0,0,0,0,0
0,0,0,0,0,0,0,0,0
0,0,0,0,0,0,0,0,0
0,0,0,0,0,0,0,0,0
635476,155,1,5,3,2,3,1,0
0,0,0,0,0,0,0,0,0
0,0,0,0,0,0,0,0,0
0,0,0,0,0,0,0,0,0
0,0,0,0,0,0,0,0,0
90606,209,4,0,0,0,1,0,0
0,0,0,0,0,0,0,0,0
0,0,0,0,0,0,0,0,0
0,0,0,0,0,0,0,0,0
0,0,0,0,0,0,0,0,0
0,0,0,0,0,0,0,0,0
0,0,0,0,0,0,0,0,0
0,0,0,0,0,0,0,0,0
0,0,0,0,0,0,0,0,0
0,0,0,0,0,0,0,0,0
0,0,0,0,0,0,0,0,0
0,0,0,0,0,0,0,0,0
0,0,0,0,0,0,0,0,0
61703,290,1,6,4,2,0,0,0
0,0,0,0,0,0,0,0,0
0,0,0,0,0,0,0,0,0
0,0,0,0,0,0,0,0,0
0,0,0,0,0,0,0,0,0
0,0,0,0,0,0,0,0,0
0,0,0,0,0,0,0,0,0
0,0,0,0,0,0,0,0,0
0,0,0,0,0,0,0,0,0
0,0,0,0,0,0,0,0,0
0,0,0,0,0,0,0,0,0
0,0,0,0,0,0,0,0,0
0,0,0,0,0,0,0,0,0
0,0,0,0,0,0,0,0,0
0,0,0,0,0,0,0,0,0
0,0,0,0,0,0,0,0,0
0,0,0,0,0,0,0,0,0
0,0,0,0,0,0,0,0,0
0,0,0,0,0,0,0,0,0
0,0,0,0,0,0,0,0,0
0,0,0,0,0,0,0,0,0
0,0,0,0,0,0,0,0,0
0,0,0,0,0,0,0,0,0
0,0,0,0,0,0,0,0,0
0,0,0,0,0,0,0,0,0
0,0,0,0,0,0,0,0,0
100671,211,4,0,0,0,1,0,0
0,0,0,0,0,0,0,0,0
0,0,0,0,0,0,0,0,0
0,0,0,0,0,0,0,0,0
0,0,0,0,0,0,0,0,0
0,0,0,0,0,0,0,0,0
0,0,0,0,0,0,0,0,0
0,0,0,0,0,0,0,0,0
0,0,0,0,0,0,0,0,0
241815,104,4,5,5,0,2,1,0
0,0,0,0,0,0,0,0,0
0,0,0,0,0,0,0,0,0
0,0,0,0,0,0,0,0,0
0,0,0,0,0,0,0,0,0
0,0,0,0,0,0,0,0,0
0,0,0,0,0,0,0,0,0
0,0,0,0,0,0,0,0,0
0,0,0,0,0,0,0,0,0
0,0,0,0,0,0,0,0,0
0,0,0,0,0,0,0,0,0
0,0,0,0,0,0,0,0,0
0,0,0,0,0,0,0,0,0
0,0,0,0,0,0,0,0,0
0,0,0,0,0,0,0,0,0
0,0,0,0,0,0,0,0,0
0,0,0,0,0,0,0,0,0
0,0,0,0,0,0,0,0,0
0,0,0,0,0,0,0,0,0
0,0,0,0,0,0,0,0,0
0,0,0,0,0,0,0,0,0
0,0,0,0,0,0,0,0,0
0,0,0,0,0,0,0,0,0
0,0,0,0,0,0,0,0,0
0,0,0,0,0,0,0,0,0
0,0,0,0,0,0,0,0,0
0,0,0,0,0,0,0,0,0
0,0,0,0,0,0,0,0,0
0,0,0,0,0,0,0,0,0
0,0,0,0,0,0,0,0,0
0,0,0,0,0,0,0,0,0
159167,686,10,92,86,6,2,1,0
0,0,0,0,0,0,0,0,0
0,0,0,0,0,0,0,0,0
0,0,0,0,0,0,0,0,0
0,0,0,0,0,0,0,0,0
0,0,0,0,0,0,0,0,0
0,0,0,0,0,0,0,0,0
0,0,0,0,0,0,0,0,0
0,0,0,0,0,0,0,0,0
0,0,0,0,0,0,0,0,0
0,0,0,0,0,0,0,0,0
0,0,0,0,0,0,0,0,0
0,0,0,0,0,0,0,0,0
0,0,0,0,0,0,0,0,0
0,0,0,0,0,0,0,0,0
0,0,0,0,0,0,0,0,0
0,0,0,0,0,0,0,0,0
0,0,0,0,0,0,0,0,0
0,0,0,0,0,0,0,0,0
0,0,0,0,0,0,0,0,0
0,0,0,0,0,0,0,0,0
281446,178,4,1,1,0,0,1,0
0,0,0,0,0,0,0,0,0
0,0,0,0,0,0,0,0,0
0,0,0,0,0,0,0,0,0
0,0,0,0,0,0,0,0,0
0,0,0,0,0,0,0,0,0
0,0,0,0,0,0,0,0,0
0,0,0,0,0,0,0,0,0
0,0,0,0,0,0,0,0,0
0,0,0,0,0,0,0,0,0
0,0,0,0,0,0,0,0,0
0,0,0,0,0,0,0,0,0
0,0,0,0,0,0,0,0,0
0,0,0,0,0,0,0,0,0
0,0,0,0,0,0,0,0,0
0,0,0,0,0,0,0,0,0
0,0,0,0,0,0,0,0,0
0,0,0,0,0,0,0,0,0
0,0,0,0,0,0,0,0,0
0,0,0,0,0,0,0,0,0
0,0,0,0,0,0,0,0,0
0,0,0,0,0,0,0,0,0
0,0,0,0,0,0,0,0,0
0,0,0,0,0,0,0,0,0
0,0,0,0,0,0,0,0,0
0,0,0,0,0,0,0,0,0
0,0,0,0,0,0,0,0,0
0,0,0,0,0,0,0,0,0
0,0,0,0,0,0,0,0,0
0,0,0,0,0,0,0,0,0
0,0,0,0,0,0,0,0,0
0,0,0,0,0,0,0,0,0
0,0,0,0,0,0,0,0,0
0,0,0,0,0,0,0,0,0
0,0,0,0,0,0,0,0,0
0,0,0,0,0,0,0,0,0
0,0,0,0,0,0,0,0,0
0,0,0,0,0,0,0,0,0
0,0,0,0,0,0,0,0,0
0,0,0,0,0,0,0,0,0
0,0,0,0,0,0,0,0,0
0,0,0,0,0,0,0,0,0
0,0,0,0,0,0,0,0,0
0,0,0,0,0,0,0,0,0
125056,204,2,50,49,1,0,1,0
125056,204,2,50,49,1,0,1,0
0,0,0,0,0,0,0,0,0
0,0,0,0,0,0,0,0,0
0,0,0,0,0,0,0,0,0
0,0,0,0,0,0,0,0,0
0,0,0,0,0,0,0,0,0
0,0,0,0,0,0,0,0,0
0,0,0,0,0,0,0,0,0
0,0,0,0,0,0,0,0,0
0,0,0,0,0,0,0,0,0
0,0,0,0,0,0,0,0,0
0,0,0,0,0,0,0,0,0
0,0,0,0,0,0,0,0,0
0,0,0,0,0,0,0,0,0
0,0,0,0,0,0,0,0,0
0,0,0,0,0,0,0,0,0
0,0,0,0,0,0,0,0,0
0,0,0,0,0,0,0,0,0
0,0,0,0,0,0,0,0,0
0,0,0,0,0,0,0,0,0
0,0,0,0,0,0,0,0,0
0,0,0,0,0,0,0,0,0
0,0,0,0,0,0,0,0,0
0,0,0,0,0,0,0,0,0
0,0,0,0,0,0,0,0,0
0,0,0,0,0,0,0,0,0
0,0,0,0,0,0,0,0,0
25086,67,2,1,1,0,2,0,0
0,0,0,0,0,0,0,0,0
0,0,0,0,0,0,0,0,0
0,0,0,0,0,0,0,0,0
0,0,0,0,0,0,0,0,0
0,0,0,0,0,0,0,0,0
0,0,0,0,0,0,0,0,0
0,0,0,0,0,0,0,0,0
9943,33,1,0,0,0,2,0,0
25086,67,2,1,1,0,2,0,0
25086,67,2,1,1,0,2,0,0
0,0,0,0,0,0,0,0,0
0,0,0,0,0,0,0,0,0
0,0,0,0,0,0,0,0,0
3829,44,0,2,0,2,1,0,0
9943,33,1,0,0,0,2,0,0
0,0,0,0,0,0,0,0,0
0,0,0,0,0,0,0,0,0
0,0,0,0,0,0,0,0,0
9943,33,1,0,0,0,2,0,0
9943,33,1,0,0,0,2,0,0
0,0,0,0,0,0,0,0,0
0,0,0,0,0,0,0,0,0
0,0,0,0,0,0,0,0,0
0,0,0,0,0,0,0,0,0
0,0,0,0,0,0,0,0,0
0,0,0,0,0,0,0,0,0
144513,62,4,3,3,0,2,1,0
0,0,0,0,0,0,0,0,0
0,0,0,0,0,0,0,0,0
0,0,0,0,0,0,0,0,0
144513,62,4,3,3,0,2,1,0
144513,62,4,3,3,0,2,1,0
0,0,0,0,0,0,0,0,0
0,0,0,0,0,0,0,0,0
144513,62,4,3,3,0,2,1,0
0,0,0,0,0,0,0,0,0
0,0,0,0,0,0,0,0,0
0,0,0,0,0,0,0,0,0
0,0,0,0,0,0,0,0,0
0,0,0,0,0,0,0,0,0
0,0,0,0,0,0,0,0,0
0,0,0,0,0,0,0,0,0
0,0,0,0,0,0,0,0,0
243644,152,4,4,4,0,1,1,0
0,0,0,0,0,0,0,0,0
243687,152,4,4,4,0,1,1,0
243687,152,4,4,4,0,1,1,0
243687,152,4,4,4,0,1,1,0
0,0,0,0,0,0,0,0,0
0,0,0,0,0,0,0,0,0
0,0,0,0,0,0,0,0,0
0,0,0,0,0,0,0,0,0
0,0,0,0,0,0,0,0,0
1431171,84,4,4,4,0,4,1,0
1519539,86,4,4,4,0,4,1,0
0,0,0,0,0,0,0,0,0
0,0,0,0,0,0,0,0,0
1519539,86,4,4,4,0,4,1,0
1431153,85,4,4,4,0,4,1,0
1519383,85,4,4,4,0,4,1,0
1519539,86,4,4,4,0,4,1,0
1519383,85,4,4,4,0,4,1,0
1431153,85,4,4,4,0,4,1,0
1430997,84,4,4,4,0,4,1,0
0,0,0,0,0,0,0,0,0
1431015,83,4,4,4,0,4,1,0
1430997,84,4,4,4,0,4,1,0
0,0,0,0,0,0,0,0,0
0,0,0,0,0,0,0,0,0
0,0,0,0,0,0,0,0,0
0,0,0,0,0,0,0,0,0
0,0,0,0,0,0,0,0,0
0,0,0,0,0,0,0,0,0
0,0,0,0,0,0,0,0,0
0,0,0,0,0,0,0,0,0
0,0,0,0,0,0,0,0,0
0,0,0,0,0,0,0,0,0
0,0,0,0,0,0,0,0,0
0,0,0,0,0,0,0,0,0
0,0,0,0,0,0,0,0,0
0,0,0,0,0,0,0,0,0
0,0,0,0,0,0,0,0,0
0,0,0,0,0,0,0,0,0
0,0,0,0,0,0,0,0,0
0,0,0,0,0,0,0,0,0
3835,44,0,2,0,2,1,0,0
0,0,0,0,0,0,0,0,0
0,0,0,0,0,0,0,0,0
0,0,0,0,0,0,0,0,0
0,0,0,0,0,0,0,0,0
25087,67,2,1,1,0,2,0,0
0,0,0,0,0,0,0,0,0
0,0,0,0,0,0,0,0,0
0,0,0,0,0,0,0,0,0
0,0,0,0,0,0,0,0,0
0,0,0,0,0,0,0,0,0
25087,67,2,1,1,0,2,0,0
0,0,0,0,0,0,0,0,0
0,0,0,0,0,0,0,0,0
0,0,0,0,0,0,0,0,0
0,0,0,0,0,0,0,0,0
0,0,0,0,0,0,0,0,0
0,0,0,0,0,0,0,0,0
0,0,0,0,0,0,0,0,0
0,0,0,0,0,0,0,0,0
0,0,0,0,0,0,0,0,0
0,0,0,0,0,0,0,0,0
0,0,0,0,0,0,0,0,0
0,0,0,0,0,0,0,0,0
0,0,0,0,0,0,0,0,0
0,0,0,0,0,0,0,0,0
0,0,0,0,0,0,0,0,0
0,0,0,0,0,0,0,0,0
0,0,0,0,0,0,0,0,0
0,0,0,0,0,0,0,0,0
0,0,0,0,0,0,0,0,0
0,0,0,0,0,0,0,0,0
0,0,0,0,0,0,0,0,0
51332,53,3,0,0,0,0,1,0
51332,53,3,0,0,0,0,1,0
0,0,0,0,0,0,0,0,0
0,0,0,0,0,0,0,0,0
0,0,0,0,0,0,0,0,0
0,0,0,0,0,0,0,0,0
0,0,0,0,0,0,0,0,0
0,0,0,0,0,0,0,0,0
0,0,0,0,0,0,0,0,0
0,0,0,0,0,0,0,0,0
0,0,0,0,0,0,0,0,0
0,0,0,0,0,0,0,0,0
0,0,0,0,0,0,0,0,0
0,0,0,0,0,0,0,0,0
0,0,0,0,0,0,0,0,0
0,0,0,0,0,0,0,0,0
0,0,0,0,0,0,0,0,0
0,0,0,0,0,0,0,0,0
0,0,0,0,0,0,0,0,0
0,0,0,0,0,0,0,0,0
0,0,0,0,0,0,0,0,0
0,0,0,0,0,0,0,0,0
0,0,0,0,0,0,0,0,0
0,0,0,0,0,0,0,0,0
0,0,0,0,0,0,0,0,0
0,0,0,0,0,0,0,0,0
0,0,0,0,0,0,0,0,0
0,0,0,0,0,0,0,0,0
0,0,0,0,0,0,0,0,0
0,0,0,0,0,0,0,0,0
0,0,0,0,0,0,0,0,0
7909,93,3,0,0,0,0,0,0
0,0,0,0,0,0,0,0,0
0,0,0,0,0,0,0,0,0
0,0,0,0,0,0,0,0,0
0,0,0,0,0,0,0,0,0
0,0,0,0,0,0,0,0,0
0,0,0,0,0,0,0,0,0
0,0,0,0,0,0,0,0,0
0,0,0,0,0,0,0,0,0
0,0,0,0,0,0,0,0,0
0,0,0,0,0,0,0,0,0
0,0,0,0,0,0,0,0,0
0,0,0,0,0,0,0,0,0
0,0,0,0,0,0,0,0,0
0,0,0,0,0,0,0,0,0
0,0,0,0,0,0,0,0,0
0,0,0,0,0,0,0,0,0
0,0,0,0,0,0,0,0,0
0,0,0,0,0,0,0,0,0
35872,272,7,43,15,28,2,1,0
0,0,0,0,0,0,0,0,0
30048,51,2,0,0,0,2,0,0
36585,221,2,49,3,46,0,1,0
0,0,0,0,0,0,0,0,0
0,0,0,0,0,0,0,0,0
0,0,0,0,0,0,0,0,0
160893,54,3,0,0,0,0,0,0
0,0,0,0,0,0,0,0,0
0,0,0,0,0,0,0,0,0
0,0,0,0,0,0,0,0,0
0,0,0,0,0,0,0,0,0
0,0,0,0,0,0,0,0,0
62444,49,3,0,0,0,0,0,0
0,0,0,0,0,0,0,0,0
0,0,0,0,0,0,0,0,0
77782,101,1,4,2,2,0,0,0
0,0,0,0,0,0,0,0,0
0,0,0,0,0,0,0,0,0
0,0,0,0,0,0,0,0,0
0,0,0,0,0,0,0,0,0
0,0,0,0,0,0,0,0,0
47618,75,2,1,1,0,3,1,0
0,0,0,0,0,0,0,0,0
0,0,0,0,0,0,0,0,0
102664,76,4,6,6,0,5,1,0
0,0,0,0,0,0,0,0,0
0,0,0,0,0,0,0,0,0
0,0,0,0,0,0,0,0,0
0,0,0,0,0,0,0,0,0
0,0,0,0,0,0,0,0,0
0,0,0,0,0,0,0,0,0
0,0,0,0,0,0,0,0,0
0,0,0,0,0,0,0,0,0
0,0,0,0,0,0,0,0,0
0,0,0,0,0,0,0,0,0
0,0,0,0,0,0,0,0,0
0,0,0,0,0,0,0,0,0
0,0,0,0,0,0,0,0,0
0,0,0,0,0,0,0,0,0
0,0,0,0,0,0,0,0,0
0,0,0,0,0,0,0,0,0
0,0,0,0,0,0,0,0,0
0,0,0,0,0,0,0,0,0
0,0,0,0,0,0,0,0,0
0,0,0,0,0,0,0,0,0
0,0,0,0,0,0,0,0,0
0,0,0,0,0,0,0,0,0
0,0,0,0,0,0,0,0,0
94776,54,0,0,0,0,0,0,0
0,0,0,0,0,0,0,0,0
0,0,0,0,0,0,0,0,0
0,0,0,0,0,0,0,0,0
0,0,0,0,0,0,0,0,0
0,0,0,0,0,0,0,0,0
0,0,0,0,0,0,0,0,0
0,0,0,0,0,0,0,0,0
0,0,0,0,0,0,0,0,0
0,0,0,0,0,0,0,0,0
0,0,0,0,0,0,0,0,0
0,0,0,0,0,0,0,0,0
0,0,0,0,0,0,0,0,0
0,0,0,0,0,0,0,0,0
0,0,0,0,0,0,0,0,0
0,0,0,0,0,0,0,0,0
0,0,0,0,0,0,0,0,0
0,0,0,0,0,0,0,0,0
0,0,0,0,0,0,0,0,0
0,0,0,0,0,0,0,0,0
0,0,0,0,0,0,0,0,0
0,0,0,0,0,0,0,0,0
0,0,0,0,0,0,0,0,0
0,0,0,0,0,0,0,0,0
0,0,0,0,0,0,0,0,0
0,0,0,0,0,0,0,0,0
0,0,0,0,0,0,0,0,0
0,0,0,0,0,0,0,0,0
112483,84,1,4,1,3,0,0,0
0,0,0,0,0,0,0,0,0
0,0,0,0,0,0,0,0,0
0,0,0,0,0,0,0,0,0
0,0,0,0,0,0,0,0,0
0,0,0,0,0,0,0,0,0
0,0,0,0,0,0,0,0,0
0,0,0,0,0,0,0,0,0
0,0,0,0,0,0,0,0,0
0,0,0,0,0,0,0,0,0
0,0,0,0,0,0,0,0,0
0,0,0,0,0,0,0,0,0
0,0,0,0,0,0,0,0,0
0,0,0,0,0,0,0,0,0
0,0,0,0,0,0,0,0,0
0,0,0,0,0,0,0,0,0
0,0,0,0,0,0,0,0,0
0,0,0,0,0,0,0,0,0
0,0,0,0,0,0,0,0,0
0,0,0,0,0,0,0,0,0
0,0,0,0,0,0,0,0,0
0,0,0,0,0,0,0,0,0
0,0,0,0,0,0,0,0,0
263222,52,0,4,3,1,0,1,0
263222,52,0,4,3,1,0,1,0
263144,52,0,4,3,1,0,1,0
0,0,0,0,0,0,0,0,0
0,0,0,0,0,0,0,0,0
0,0,0,0,0,0,0,0,0
0,0,0,0,0,0,0,0,0
3168,39,0,6,3,3,0,1,0
0,0,0,0,0,0,0,0,0
0,0,0,0,0,0,0,0,0
0,0,0,0,0,0,0,0,0
0,0,0,0,0,0,0,0,0
0,0,0,0,0,0,0,0,0
0,0,0,0,0,0,0,0,0
0,0,0,0,0,0,0,0,0
0,0,0,0,0,0,0,0,0
0,0,0,0,0,0,0,0,0
58231,904,9,121,63,58,4,1,0
58231,904,9,121,63,58,4,1,0
0,0,0,0,0,0,0,0,0
0,0,0,0,0,0,0,0,0
0,0,0,0,0,0,0,0,0
0,0,0,0,0,0,0,0,0
0,0,0,0,0,0,0,0,0
0,0,0,0,0,0,0,0,0
0,0,0,0,0,0,0,0,0
0,0,0,0,0,0,0,0,0
0,0,0,0,0,0,0,0,0
27677,293,2,19,13,6,0,0,0
0,0,0,0,0,0,0,0,0
0,0,0,0,0,0,0,0,0
0,0,0,0,0,0,0,0,0
0,0,0,0,0,0,0,0,0
0,0,0,0,0,0,0,0,0
0,0,0,0,0,0,0,0,0
0,0,0,0,0,0,0,0,0
0,0,0,0,0,0,0,0,0
0,0,0,0,0,0,0,0,0
0,0,0,0,0,0,0,0,0
0,0,0,0,0,0,0,0,0
0,0,0,0,0,0,0,0,0
0,0,0,0,0,0,0,0,0
0,0,0,0,0,0,0,0,0
0,0,0,0,0,0,0,0,0
0,0,0,0,0,0,0,0,0
0,0,0,0,0,0,0,0,0
0,0,0,0,0,0,0,0,0
0,0,0,0,0,0,0,0,0
0,0,0,0,0,0,0,0,0
80520,98,2,1,1,0,0,0,0
62444,49,3,0,0,0,0,0,0
0,0,0,0,0,0,0,0,0
0,0,0,0,0,0,0,0,0
0,0,0,0,0,0,0,0,0
0,0,0,0,0,0,0,0,0
0,0,0,0,0,0,0,0,0
0,0,0,0,0,0,0,0,0
0,0,0,0,0,0,0,0,0
62432,49,3,0,0,0,0,0,0
0,0,0,0,0,0,0,0,0
0,0,0,0,0,0,0,0,0
0,0,0,0,0,0,0,0,0
0,0,0,0,0,0,0,0,0
0,0,0,0,0,0,0,0,0
0,0,0,0,0,0,0,0,0
0,0,0,0,0,0,0,0,0
0,0,0,0,0,0,0,0,0
0,0,0,0,0,0,0,0,0
0,0,0,0,0,0,0,0,0
245397,1285,4,25,20,5,0,1,0
0,0,0,0,0,0,0,0,0
9031,93,1,12,12,0,1,0,0
0,0,0,0,0,0,0,0,0
0,0,0,0,0,0,0,0,0
0,0,0,0,0,0,0,0,0
0,0,0,0,0,0,0,0,0
0,0,0,0,0,0,0,0,0
0,0,0,0,0,0,0,0,0
0,0,0,0,0,0,0,0,0
0,0,0,0,0,0,0,0,0
236743,809,2,24,20,4,36,1,0
0,0,0,0,0,0,0,0,0
0,0,0,0,0,0,0,0,0
0,0,0,0,0,0,0,0,0
0,0,0,0,0,0,0,0,0
138770,259,1,20,7,13,7,1,0
9495,42,1,1,1,0,0,0,0
0,0,0,0,0,0,0,0,0
0,0,0,0,0,0,0,0,0
0,0,0,0,0,0,0,0,0
0,0,0,0,0,0,0,0,0
0,0,0,0,0,0,0,0,0
0,0,0,0,0,0,0,0,0
0,0,0,0,0,0,0,0,0
0,0,0,0,0,0,0,0,0
0,0,0,0,0,0,0,0,0
0,0,0,0,0,0,0,0,0
0,0,0,0,0,0,0,0,0
0,0,0,0,0,0,0,0,0
0,0,0,0,0,0,0,0,0
0,0,0,0,0,0,0,0,0
62444,49,3,0,0,0,0,0,0
0,0,0,0,0,0,0,0,0
0,0,0,0,0,0,0,0,0
150514,194,3,2,1,1,5,0,0
0,0,0,0,0,0,0,0,0
0,0,0,0,0,0,0,0,0
0,0,0,0,0,0,0,0,0
62444,49,3,0,0,0,0,0,0
0,0,0,0,0,0,0,0,0
0,0,0,0,0,0,0,0,0
0,0,0,0,0,0,0,0,0
0,0,0,0,0,0,0,0,0
0,0,0,0,0,0,0,0,0
0,0,0,0,0,0,0,0,0
0,0,0,0,0,0,0,0,0
0,0,0,0,0,0,0,0,0
0,0,0,0,0,0,0,0,0
0,0,0,0,0,0,0,0,0
62432,49,3,0,0,0,0,0,0
0,0,0,0,0,0,0,0,0
0,0,0,0,0,0,0,0,0
0,0,0,0,0,0,0,0,0
0,0,0,0,0,0,0,0,0
0,0,0,0,0,0,0,0,0
0,0,0,0,0,0,0,0,0
0,0,0,0,0,0,0,0,0
0,0,0,0,0,0,0,0,0
0,0,0,0,0,0,0,0,0
0,0,0,0,0,0,0,0,0
0,0,0,0,0,0,0,0,0
0,0,0,0,0,0,0,0,0
0,0,0,0,0,0,0,0,0
0,0,0,0,0,0,0,0,0
0,0,0,0,0,0,0,0,0
0,0,0,0,0,0,0,0,0
0,0,0,0,0,0,0,0,0
0,0,0,0,0,0,0,0,0
0,0,0,0,0,0,0,0,0
0,0,0,0,0,0,0,0,0
0,0,0,0,0,0,0,0,0
0,0,0,0,0,0,0,0,0
0,0,0,0,0,0,0,0,0
0,0,0,0,0,0,0,0,0
0,0,0,0,0,0,0,0,0
0,0,0,0,0,0,0,0,0
89857,610,8,136,136,0,4,1,0
0,0,0,0,0,0,0,0,0
0,0,0,0,0,0,0,0,0
0,0,0,0,0,0,0,0,0
0,0,0,0,0,0,0,0,0
0,0,0,0,0,0,0,0,0
0,0,0,0,0,0,0,0,0
0,0,0,0,0,0,0,0,0
0,0,0,0,0,0,0,0,0
0,0,0,0,0,0,0,0,0
0,0,0,0,0,0,0,0,0
0,0,0,0,0,0,0,0,0
0,0,0,0,0,0,0,0,0
0,0,0,0,0,0,0,0,0
0,0,0,0,0,0,0,0,0
0,0,0,0,0,0,0,0,0
0,0,0,0,0,0,0,0,0
0,0,0,0,0,0,0,0,0
0,0,0,0,0,0,0,0,0
0,0,0,0,0,0,0,0,0
0,0,0,0,0,0,0,0,0
0,0,0,0,0,0,0,0,0
0,0,0,0,0,0,0,0,0
0,0,0,0,0,0,0,0,0
0,0,0,0,0,0,0,0,0
0,0,0,0,0,0,0,0,0
0,0,0,0,0,0,0,0,0
0,0,0,0,0,0,0,0,0
0,0,0,0,0,0,0,0,0
0,0,0,0,0,0,0,0,0
0,0,0,0,0,0,0,0,0
0,0,0,0,0,0,0,0,0
0,0,0,0,0,0,0,0,0
0,0,0,0,0,0,0,0,0
0,0,0,0,0,0,0,0,0
0,0,0,0,0,0,0,0,0
0,0,0,0,0,0,0,0,0
0,0,0,0,0,0,0,0,0
0,0,0,0,0,0,0,0,0
0,0,0,0,0,0,0,0,0
0,0,0,0,0,0,0,0,0
0,0,0,0,0,0,0,0,0
0,0,0,0,0,0,0,0,0
0,0,0,0,0,0,0,0,0
0,0,0,0,0,0,0,0,0
0,0,0,0,0,0,0,0,0
0,0,0,0,0,0,0,0,0
0,0,0,0,0,0,0,0,0
0,0,0,0,0,0,0,0,0
0,0,0,0,0,0,0,0,0
0,0,0,0,0,0,0,0,0
0,0,0,0,0,0,0,0,0
0,0,0,0,0,0,0,0,0
0,0,0,0,0,0,0,0,0
0,0,0,0,0,0,0,0,0
0,0,0,0,0,0,0,0,0
0,0,0,0,0,0,0,0,0
0,0,0,0,0,0,0,0,0
0,0,0,0,0,0,0,0,0
0,0,0,0,0,0,0,0,0
0,0,0,0,0,0,0,0,0
0,0,0,0,0,0,0,0,0
0,0,0,0,0,0,0,0,0
0,0,0,0,0,0,0,0,0
0,0,0,0,0,0,0,0,0
0,0,0,0,0,0,0,0,0
0,0,0,0,0,0,0,0,0
9879,48,0,1,0,1,0,0,0
9879,48,0,1,0,1,0,0,0
0,0,0,0,0,0,0,0,0
0,0,0,0,0,0,0,0,0
0,0,0,0,0,0,0,0,0
0,0,0,0,0,0,0,0,0
0,0,0,0,0,0,0,0,0
0,0,0,0,0,0,0,0,0
0,0,0,0,0,0,0,0,0
672932,541,0,4,4,0,2,1,1
0,0,0,0,0,0,0,0,0
0,0,0,0,0,0,0,0,0
0,0,0,0,0,0,0,0,0
0,0,0,0,0,0,0,0,0
6330,64,2,6,4,2,0,1,0
0,0,0,0,0,0,0,0,0
0,0,0,0,0,0,0,0,0
94270,214,4,0,0,0,1,0,0
0,0,0,0,0,0,0,0,0
0,0,0,0,0,0,0,0,0
0,0,0,0,0,0,0,0,0
0,0,0,0,0,0,0,0,0
0,0,0,0,0,0,0,0,0
0,0,0,0,0,0,0,0,0
0,0,0,0,0,0,0,0,0
0,0,0,0,0,0,0,0,0
0,0,0,0,0,0,0,0,0
0,0,0,0,0,0,0,0,0
0,0,0,0,0,0,0,0,0
0,0,0,0,0,0,0,0,0
0,0,0,0,0,0,0,0,0
0,0,0,0,0,0,0,0,0
0,0,0,0,0,0,0,0,0
0,0,0,0,0,0,0,0,0
0,0,0,0,0,0,0,0,0
0,0,0,0,0,0,0,0,0
0,0,0,0,0,0,0,0,0
0,0,0,0,0,0,0,0,0
0,0,0,0,0,0,0,0,0
0,0,0,0,0,0,0,0,0
0,0,0,0,0,0,0,0,0
0,0,0,0,0,0,0,0,0
0,0,0,0,0,0,0,0,0
0,0,0,0,0,0,0,0,0
0,0,0,0,0,0,0,0,0
0,0,0,0,0,0,0,0,0
0,0,0,0,0,0,0,0,0
0,0,0,0,0,0,0,0,0
0,0,0,0,0,0,0,0,0
0,0,0,0,0,0,0,0,0
0,0,0,0,0,0,0,0,0
0,0,0,0,0,0,0,0,0
0,0,0,0,0,0,0,0,0
0,0,0,0,0,0,0,0,0
0,0,0,0,0,0,0,0,0
0,0,0,0,0,0,0,0,0
0,0,0,0,0,0,0,0,0
0,0,0,0,0,0,0,0,0
0,0,0,0,0,0,0,0,0
0,0,0,0,0,0,0,0,0
0,0,0,0,0,0,0,0,0
0,0,0,0,0,0,0,0,0
0,0,0,0,0,0,0,0,0
0,0,0,0,0,0,0,0,0
0,0,0,0,0,0,0,0,0
0,0,0,0,0,0,0,0,0
0,0,0,0,0,0,0,0,0
0,0,0,0,0,0,0,0,0
0,0,0,0,0,0,0,0,0
0,0,0,0,0,0,0,0,0
0,0,0,0,0,0,0,0,0
0,0,0,0,0,0,0,0,0
0,0,0,0,0,0,0,0,0
0,0,0,0,0,0,0,0,0
0,0,0,0,0,0,0,0,0
0,0,0,0,0,0,0,0,0
0,0,0,0,0,0,0,0,0
0,0,0,0,0,0,0,0,0
0,0,0,0,0,0,0,0,0
0,0,0,0,0,0,0,0,0
0,0,0,0,0,0,0,0,0
0,0,0,0,0,0,0,0,0
0,0,0,0,0,0,0,0,0
0,0,0,0,0,0,0,0,0
0,0,0,0,0,0,0,0,0
0,0,0,0,0,0,0,0,0
0,0,0,0,0,0,0,0,0
0,0,0,0,0,0,0,0,0
0,0,0,0,0,0,0,0,0
0,0,0,0,0,0,0,0,0
0,0,0,0,0,0,0,0,0
0,0,0,0,0,0,0,0,0
0,0,0,0,0,0,0,0,0
0,0,0,0,0,0,0,0,0
0,0,0,0,0,0,0,0,0
0,0,0,0,0,0,0,0,0
0,0,0,0,0,0,0,0,0
0,0,0,0,0,0,0,0,0
0,0,0,0,0,0,0,0,0
0,0,0,0,0,0,0,0,0
0,0,0,0,0,0,0,0,0
0,0,0,0,0,0,0,0,0
0,0,0,0,0,0,0,0,0
0,0,0,0,0,0,0,0,0
0,0,0,0,0,0,0,0,0
0,0,0,0,0,0,0,0,0
0,0,0,0,0,0,0,0,0
0,0,0,0,0,0,0,0,0
0,0,0,0,0,0,0,0,0
0,0,0,0,0,0,0,0,0
0,0,0,0,0,0,0,0,0
0,0,0,0,0,0,0,0,0
0,0,0,0,0,0,0,0,0
0,0,0,0,0,0,0,0,0
0,0,0,0,0,0,0,0,0
0,0,0,0,0,0,0,0,0
0,0,0,0,0,0,0,0,0
0,0,0,0,0,0,0,0,0
0,0,0,0,0,0,0,0,0
0,0,0,0,0,0,0,0,0
0,0,0,0,0,0,0,0,0
0,0,0,0,0,0,0,0,0
0,0,0,0,0,0,0,0,0
0,0,0,0,0,0,0,0,0
0,0,0,0,0,0,0,0,0
0,0,0,0,0,0,0,0,0
0,0,0,0,0,0,0,0,0
0,0,0,0,0,0,0,0,0
0,0,0,0,0,0,0,0,0
0,0,0,0,0,0,0,0,0
0,0,0,0,0,0,0,0,0
0,0,0,0,0,0,0,0,0
0,0,0,0,0,0,0,0,0
0,0,0,0,0,0,0,0,0
0,0,0,0,0,0,0,0,0
0,0,0,0,0,0,0,0,0
0,0,0,0,0,0,0,0,0
0,0,0,0,0,0,0,0,0
0,0,0,0,0,0,0,0,0
0,0,0,0,0,0,0,0,0
0,0,0,0,0,0,0,0,0
0,0,0,0,0,0,0,0,0
0,0,0,0,0,0,0,0,0
0,0,0,0,0,0,0,0,0
0,0,0,0,0,0,0,0,0
0,0,0,0,0,0,0,0,0
0,0,0,0,0,0,0,0,0
178959,39,3,0,0,0,2,0,0
178959,39,3,0,0,0,2,0,0
0,0,0,0,0,0,0,0,0
0,0,0,0,0,0,0,0,0
27852,78,3,0,0,0,3,0,0
0,0,0,0,0,0,0,0,0
0,0,0,0,0,0,0,0,0
0,0,0,0,0,0,0,0,0
0,0,0,0,0,0,0,0,0
0,0,0,0,0,0,0,0,0
0,0,0,0,0,0,0,0,0
0,0,0,0,0,0,0,0,0
0,0,0,0,0,0,0,0,0
0,0,0,0,0,0,0,0,0
0,0,0,0,0,0,0,0,0
0,0,0,0,0,0,0,0,0
0,0,0,0,0,0,0,0,0
0,0,0,0,0,0,0,0,0
0,0,0,0,0,0,0,0,0
104697,737,2,180,15,165,1,0,0
104027,731,2,179,14,165,1,0,0
200794,1711,2,298,32,266,2,1,0
200794,1711,2,298,32,266,2,1,0
0,0,0,0,0,0,0,0,0
0,0,0,0,0,0,0,0,0
0,0,0,0,0,0,0,0,0
0,0,0,0,0,0,0,0,0
200648,1710,2,298,32,266,2,1,0
104618,736,2,180,15,165,1,0,0
0,0,0,0,0,0,0,0,0
0,0,0,0,0,0,0,0,0
0,0,0,0,0,0,0,0,0
0,0,0,0,0,0,0,0,0
0,0,0,0,0,0,0,0,0
0,0,0,0,0,0,0,0,0
0,0,0,0,0,0,0,0,0
200794,1711,2,298,32,266,2,1,0
0,0,0,0,0,0,0,0,0
0,0,0,0,0,0,0,0,0
0,0,0,0,0,0,0,0,0
0,0,0,0,0,0,0,0,0
0,0,0,0,0,0,0,0,0
0,0,0,0,0,0,0,0,0
0,0,0,0,0,0,0,0,0
0,0,0,0,0,0,0,0,0
0,0,0,0,0,0,0,0,0
0,0,0,0,0,0,0,0,0
0,0,0,0,0,0,0,0,0
17678,210,1,51,50,1,0,1,0
0,0,0,0,0,0,0,0,0
0,0,0,0,0,0,0,0,0
0,0,0,0,0,0,0,0,0
17678,210,1,51,50,1,0,1,0
0,0,0,0,0,0,0,0,0
0,0,0,0,0,0,0,0,0
0,0,0,0,0,0,0,0,0
0,0,0,0,0,0,0,0,0
0,0,0,0,0,0,0,0,0
0,0,0,0,0,0,0,0,0
0,0,0,0,0,0,0,0,0
0,0,0,0,0,0,0,0,0
0,0,0,0,0,0,0,0,0
0,0,0,0,0,0,0,0,0
0,0,0,0,0,0,0,0,0
0,0,0,0,0,0,0,0,0
0,0,0,0,0,0,0,0,0
0,0,0,0,0,0,0,0,0
0,0,0,0,0,0,0,0,0
0,0,0,0,0,0,0,0,0
0,0,0,0,0,0,0,0,0
0,0,0,0,0,0,0,0,0
0,0,0,0,0,0,0,0,0
0,0,0,0,0,0,0,0,0
0,0,0,0,0,0,0,0,0
0,0,0,0,0,0,0,0,0
0,0,0,0,0,0,0,0,0
0,0,0,0,0,0,0,0,0
0,0,0,0,0,0,0,0,0
0,0,0,0,0,0,0,0,0
0,0,0,0,0,0,0,0,0
0,0,0,0,0,0,0,0,0
0,0,0,0,0,0,0,0,0
0,0,0,0,0,0,0,0,0
0,0,0,0,0,0,0,0,0
0,0,0,0,0,0,0,0,0
0,0,0,0,0,0,0,0,0
0,0,0,0,0,0,0,0,0
0,0,0,0,0,0,0,0,0
0,0,0,0,0,0,0,0,0
0,0,0,0,0,0,0,0,0
96449,211,4,0,0,0,1,0,0
0,0,0,0,0,0,0,0,0
0,0,0,0,0,0,0,0,0
0,0,0,0,0,0,0,0,0
0,0,0,0,0,0,0,0,0
0,0,0,0,0,0,0,0,0
0,0,0,0,0,0,0,0,0
0,0,0,0,0,0,0,0,0
0,0,0,0,0,0,0,0,0
0,0,0,0,0,0,0,0,0
0,0,0,0,0,0,0,0,0
0,0,0,0,0,0,0,0,0
0,0,0,0,0,0,0,0,0
0,0,0,0,0,0,0,0,0
0,0,0,0,0,0,0,0,0
0,0,0,0,0,0,0,0,0
0,0,0,0,0,0,0,0,0
0,0,0,0,0,0,0,0,0
0,0,0,0,0,0,0,0,0
0,0,0,0,0,0,0,0,0
0,0,0,0,0,0,0,0,0
0,0,0,0,0,0,0,0,0
0,0,0,0,0,0,0,0,0
0,0,0,0,0,0,0,0,0
0,0,0,0,0,0,0,0,0
0,0,0,0,0,0,0,0,0
0,0,0,0,0,0,0,0,0
0,0,0,0,0,0,0,0,0
0,0,0,0,0,0,0,0,0
0,0,0,0,0,0,0,0,0
0,0,0,0,0,0,0,0,0
0,0,0,0,0,0,0,0,0
0,0,0,0,0,0,0,0,0
0,0,0,0,0,0,0,0,0
0,0,0,0,0,0,0,0,0
0,0,0,0,0,0,0,0,0
0,0,0,0,0,0,0,0,0
0,0,0,0,0,0,0,0,0
0,0,0,0,0,0,0,0,0
0,0,0,0,0,0,0,0,0
0,0,0,0,0,0,0,0,0
0,0,0,0,0,0,0,0,0
0,0,0,0,0,0,0,0,0
0,0,0,0,0,0,0,0,0
0,0,0,0,0,0,0,0,0
0,0,0,0,0,0,0,0,0
0,0,0,0,0,0,0,0,0
0,0,0,0,0,0,0,0,0
0,0,0,0,0,0,0,0,0
0,0,0,0,0,0,0,0,0
0,0,0,0,0,0,0,0,0
0,0,0,0,0,0,0,0,0
0,0,0,0,0,0,0,0,0
0,0,0,0,0,0,0,0,0
0,0,0,0,0,0,0,0,0
0,0,0,0,0,0,0,0,0
0,0,0,0,0,0,0,0,0
0,0,0,0,0,0,0,0,0
0,0,0,0,0,0,0,0,0
0,0,0,0,0,0,0,0,0
0,0,0,0,0,0,0,0,0
0,0,0,0,0,0,0,0,0
0,0,0,0,0,0,0,0,0
0,0,0,0,0,0,0,0,0
0,0,0,0,0,0,0,0,0
0,0,0,0,0,0,0,0,0
0,0,0,0,0,0,0,0,0
0,0,0,0,0,0,0,0,0
0,0,0,0,0,0,0,0,0
0,0,0,0,0,0,0,0,0
0,0,0,0,0,0,0,0,0
0,0,0,0,0,0,0,0,0
0,0,0,0,0,0,0,0,0
0,0,0,0,0,0,0,0,0
0,0,0,0,0,0,0,0,0
0,0,0,0,0,0,0,0,0
0,0,0,0,0,0,0,0,0
0,0,0,0,0,0,0,0,0
0,0,0,0,0,0,0,0,0
0,0,0,0,0,0,0,0,0
0,0,0,0,0,0,0,0,0
0,0,0,0,0,0,0,0,0
0,0,0,0,0,0,0,0,0
0,0,0,0,0,0,0,0,0
0,0,0,0,0,0,0,0,0
0,0,0,0,0,0,0,0,0
0,0,0,0,0,0,0,0,0
0,0,0,0,0,0,0,0,0
0,0,0,0,0,0,0,0,0
0,0,0,0,0,0,0,0,0
0,0,0,0,0,0,0,0,0
0,0,0,0,0,0,0,0,0
0,0,0,0,0,0,0,0,0
0,0,0,0,0,0,0,0,0
0,0,0,0,0,0,0,0,0
0,0,0,0,0,0,0,0,0
0,0,0,0,0,0,0,0,0
77718,101,1,4,2,2,0,0,0
112467,84,1,4,1,3,0,0,0
0,0,0,0,0,0,0,0,0
0,0,0,0,0,0,0,0,0
0,0,0,0,0,0,0,0,0
0,0,0,0,0,0,0,0,0
0,0,0,0,0,0,0,0,0
0,0,0,0,0,0,0,0,0
1059955,101,4,5,5,0,3,1,0
0,0,0,0,0,0,0,0,0
0,0,0,0,0,0,0,0,0
0,0,0,0,0,0,0,0,0
548087,328,4,12,9,3,0,1,0
0,0,0,0,0,0,0,0,0
0,0,0,0,0,0,0,0,0
0,0,0,0,0,0,0,0,0
0,0,0,0,0,0,0,0,0
0,0,0,0,0,0,0,0,0
0,0,0,0,0,0,0,0,0
0,0,0,0,0,0,0,0,0
0,0,0,0,0,0,0,0,0
0,0,0,0,0,0,0,0,0
0,0,0,0,0,0,0,0,0
0,0,0,0,0,0,0,0,0
0,0,0,0,0,0,0,0,0
0,0,0,0,0,0,0,0,0
0,0,0,0,0,0,0,0,0
0,0,0,0,0,0,0,0,0
0,0,0,0,0,0,0,0,0
0,0,0,0,0,0,0,0,0
0,0,0,0,0,0,0,0,0
0,0,0,0,0,0,0,0,0
0,0,0,0,0,0,0,0,0
0,0,0,0,0,0,0,0,0
0,0,0,0,0,0,0,0,0
0,0,0,0,0,0,0,0,0
0,0,0,0,0,0,0,0,0
0,0,0,0,0,0,0,0,0
10961,69,5,10,10,0,0,0,0
0,0,0,0,0,0,0,0,0
0,0,0,0,0,0,0,0,0
0,0,0,0,0,0,0,0,0
0,0,0,0,0,0,0,0,0
0,0,0,0,0,0,0,0,0
0,0,0,0,0,0,0,0,0
0,0,0,0,0,0,0,0,0
0,0,0,0,0,0,0,0,0
0,0,0,0,0,0,0,0,0
0,0,0,0,0,0,0,0,0
104827,928,6,226,57,169,7,1,0
0,0,0,0,0,0,0,0,0
0,0,0,0,0,0,0,0,0
0,0,0,0,0,0,0,0,0
0,0,0,0,0,0,0,0,0
0,0,0,0,0,0,0,0,0
0,0,0,0,0,0,0,0,0
0,0,0,0,0,0,0,0,0
0,0,0,0,0,0,0,0,0
0,0,0,0,0,0,0,0,0
0,0,0,0,0,0,0,0,0
0,0,0,0,0,0,0,0,0
0,0,0,0,0,0,0,0,0
0,0,0,0,0,0,0,0,0
0,0,0,0,0,0,0,0,0
0,0,0,0,0,0,0,0,0
0,0,0,0,0,0,0,0,0
0,0,0,0,0,0,0,0,0
0,0,0,0,0,0,0,0,0
0,0,0,0,0,0,0,0,0
0,0,0,0,0,0,0,0,0
0,0,0,0,0,0,0,0,0
0,0,0,0,0,0,0,0,0
0,0,0,0,0,0,0,0,0
0,0,0,0,0,0,0,0,0
0,0,0,0,0,0,0,0,0
0,0,0,0,0,0,0,0,0
0,0,0,0,0,0,0,0,0
0,0,0,0,0,0,0,0,0
0,0,0,0,0,0,0,0,0
0,0,0,0,0,0,0,0,0
0,0,0,0,0,0,0,0,0
0,0,0,0,0,0,0,0,0
0,0,0,0,0,0,0,0,0
0,0,0,0,0,0,0,0,0
0,0,0,0,0,0,0,0,0
0,0,0,0,0,0,0,0,0
36352,201,6,16,13,3,1,0,0
0,0,0,0,0,0,0,0,0
0,0,0,0,0,0,0,0,0
90743,209,4,0,0,0,1,0,0
0,0,0,0,0,0,0,0,0
0,0,0,0,0,0,0,0,0
92611,220,5,0,0,0,4,0,0
0,0,0,0,0,0,0,0,0
0,0,0,0,0,0,0,0,0
91397,209,4,0,0,0,1,0,0
0,0,0,0,0,0,0,0,0
0,0,0,0,0,0,0,0,0
0,0,0,0,0,0,0,0,0
0,0,0,0,0,0,0,0,0
0,0,0,0,0,0,0,0,0
39857,125,1,1,1,0,0,1,0
0,0,0,0,0,0,0,0,0
0,0,0,0,0,0,0,0,0
0,0,0,0,0,0,0,0,0
0,0,0,0,0,0,0,0,0
22745,280,4,27,25,2,3,1,0
0,0,0,0,0,0,0,0,0
126935,365,5,1,0,1,5,0,0
0,0,0,0,0,0,0,0,0
138263,256,1,20,7,13,7,1,0
0,0,0,0,0,0,0,0,0
0,0,0,0,0,0,0,0,0
0,0,0,0,0,0,0,0,0
0,0,0,0,0,0,0,0,0
10908,77,2,6,5,1,0,0,0
0,0,0,0,0,0,0,0,0
0,0,0,0,0,0,0,0,0
672145,541,0,4,4,0,2,1,1
50193,136,7,16,14,2,1,0,0
0,0,0,0,0,0,0,0,0
0,0,0,0,0,0,0,0,0
0,0,0,0,0,0,0,0,0
0,0,0,0,0,0,0,0,0
0,0,0,0,0,0,0,0,0
0,0,0,0,0,0,0,0,0
7365,20,1,1,1,0,0,0,0
0,0,0,0,0,0,0,0,0
0,0,0,0,0,0,0,0,0
0,0,0,0,0,0,0,0,0
0,0,0,0,0,0,0,0,0
0,0,0,0,0,0,0,0,0
0,0,0,0,0,0,0,0,0
0,0,0,0,0,0,0,0,0
0,0,0,0,0,0,0,0,0
0,0,0,0,0,0,0,0,0
0,0,0,0,0,0,0,0,0
0,0,0,0,0,0,0,0,0
0,0,0,0,0,0,0,0,0
0,0,0,0,0,0,0,0,0
0,0,0,0,0,0,0,0,0
0,0,0,0,0,0,0,0,0
62308,46,3,0,0,0,0,0,0
0,0,0,0,0,0,0,0,0
0,0,0,0,0,0,0,0,0
0,0,0,0,0,0,0,0,0
0,0,0,0,0,0,0,0,0
0,0,0,0,0,0,0,0,0
0,0,0,0,0,0,0,0,0
62828,49,3,0,0,0,0,0,0
0,0,0,0,0,0,0,0,0
28220,43,0,0,0,0,0,1,0
0,0,0,0,0,0,0,0,0
0,0,0,0,0,0,0,0,0
0,0,0,0,0,0,0,0,0
62815,49,3,0,0,0,0,0,0
0,0,0,0,0,0,0,0,0
62816,49,3,0,0,0,0,0,0
0,0,0,0,0,0,0,0,0
0,0,0,0,0,0,0,0,0
0,0,0,0,0,0,0,0,0
0,0,0,0,0,0,0,0,0
0,0,0,0,0,0,0,0,0
0,0,0,0,0,0,0,0,0
0,0,0,0,0,0,0,0,0
0,0,0,0,0,0,0,0,0
0,0,0,0,0,0,0,0,0
0,0,0,0,0,0,0,0,0
0,0,0,0,0,0,0,0,0
0,0,0,0,0,0,0,0,0
670489,527,0,4,4,0,2,1,1
0,0,0,0,0,0,0,0,0
0,0,0,0,0,0,0,0,0
0,0,0,0,0,0,0,0,0
0,0,0,0,0,0,0,0,0
0,0,0,0,0,0,0,0,0
0,0,0,0,0,0,0,0,0
0,0,0,0,0,0,0,0,0
0,0,0,0,0,0,0,0,0
0,0,0,0,0,0,0,0,0
0,0,0,0,0,0,0,0,0
0,0,0,0,0,0,0,0,0
0,0,0,0,0,0,0,0,0
0,0,0,0,0,0,0,0,0
0,0,0,0,0,0,0,0,0
0,0,0,0,0,0,0,0,0
0,0,0,0,0,0,0,0,0
0,0,0,0,0,0,0,0,0
0,0,0,0,0,0,0,0,0
0,0,0,0,0,0,0,0,0
62816,49,3,0,0,0,0,0,0
0,0,0,0,0,0,0,0,0
0,0,0,0,0,0,0,0,0
0,0,0,0,0,0,0,0,0
0,0,0,0,0,0,0,0,0
7021,30,0,3,0,3,0,1,0
0,0,0,0,0,0,0,0,0
34441,146,5,6,4,2,1,0,0
0,0,0,0,0,0,0,0,0
0,0,0,0,0,0,0,0,0
0,0,0,0,0,0,0,0,0
0,0,0,0,0,0,0,0,0
0,0,0,0,0,0,0,0,0
0,0,0,0,0,0,0,0,0
0,0,0,0,0,0,0,0,0
0,0,0,0,0,0,0,0,0
0,0,0,0,0,0,0,0,0
0,0,0,0,0,0,0,0,0
0,0,0,0,0,0,0,0,0
89857,610,8,136,136,0,4,1,0
0,0,0,0,0,0,0,0,0
0,0,0,0,0,0,0,0,0
0,0,0,0,0,0,0,0,0
0,0,0,0,0,0,0,0,0
0,0,0,0,0,0,0,0,0
0,0,0,0,0,0,0,0,0
0,0,0,0,0,0,0,0,0
0,0,0,0,0,0,0,0,0
0,0,0,0,0,0,0,0,0
0,0,0,0,0,0,0,0,0
0,0,0,0,0,0,0,0,0
0,0,0,0,0,0,0,0,0
0,0,0,0,0,0,0,0,0
0,0,0,0,0,0,0,0,0
0,0,0,0,0,0,0,0,0
0,0,0,0,0,0,0,0,0
2474,43,0,1,1,0,0,0,0
0,0,0,0,0,0,0,0,0
0,0,0,0,0,0,0,0,0
0,0,0,0,0,0,0,0,0
0,0,0,0,0,0,0,0,0
0,0,0,0,0,0,0,0,0
0,0,0,0,0,0,0,0,0
0,0,0,0,0,0,0,0,0
0,0,0,0,0,0,0,0,0
0,0,0,0,0,0,0,0,0
136307,390,8,26,24,2,31,1,0
0,0,0,0,0,0,0,0,0
0,0,0,0,0,0,0,0,0
0,0,0,0,0,0,0,0,0
0,0,0,0,0,0,0,0,0
0,0,0,0,0,0,0,0,0
0,0,0,0,0,0,0,0,0
0,0,0,0,0,0,0,0,0
0,0,0,0,0,0,0,0,0
0,0,0,0,0,0,0,0,0
0,0,0,0,0,0,0,0,0
0,0,0,0,0,0,0,0,0
0,0,0,0,0,0,0,0,0
0,0,0,0,0,0,0,0,0
0,0,0,0,0,0,0,0,0
0,0,0,0,0,0,0,0,0
0,0,0,0,0,0,0,0,0
0,0,0,0,0,0,0,0,0
0,0,0,0,0,0,0,0,0
0,0,0,0,0,0,0,0,0
0,0,0,0,0,0,0,0,0
0,0,0,0,0,0,0,0,0
0,0,0,0,0,0,0,0,0
0,0,0,0,0,0,0,0,0
0,0,0,0,0,0,0,0,0
0,0,0,0,0,0,0,0,0
0,0,0,0,0,0,0,0,0
0,0,0,0,0,0,0,0,0
0,0,0,0,0,0,0,0,0
0,0,0,0,0,0,0,0,0
0,0,0,0,0,0,0,0,0
0,0,0,0,0,0,0,0,0
0,0,0,0,0,0,0,0,0
0,0,0,0,0,0,0,0,0
0,0,0,0,0,0,0,0,0
0,0,0,0,0,0,0,0,0
0,0,0,0,0,0,0,0,0
0,0,0,0,0,0,0,0,0
0,0,0,0,0,0,0,0,0
0,0,0,0,0,0,0,0,0
0,0,0,0,0,0,0,0,0
0,0,0,0,0,0,0,0,0
0,0,0,0,0,0,0,0,0
0,0,0,0,0,0,0,0,0
0,0,0,0,0,0,0,0,0
0,0,0,0,0,0,0,0,0
0,0,0,0,0,0,0,0,0
0,0,0,0,0,0,0,0,0
0,0,0,0,0,0,0,0,0
0,0,0,0,0,0,0,0,0
0,0,0,0,0,0,0,0,0
0,0,0,0,0,0,0,0,0
0,0,0,0,0,0,0,0,0
0,0,0,0,0,0,0,0,0
0,0,0,0,0,0,0,0,0
0,0,0,0,0,0,0,0,0
0,0,0,0,0,0,0,0,0
0,0,0,0,0,0,0,0,0
0,0,0,0,0,0,0,0,0
0,0,0,0,0,0,0,0,0
1780,22,2,1,0,1,0,0,0
0,0,0,0,0,0,0,0,0
8320,146,0,15,15,0,5,1,0
0,0,0,0,0,0,0,0,0
0,0,0,0,0,0,0,0,0
0,0,0,0,0,0,0,0,0
0,0,0,0,0,0,0,0,0
0,0,0,0,0,0,0,0,0
0,0,0,0,0,0,0,0,0
0,0,0,0,0,0,0,0,0
0,0,0,0,0,0,0,0,0
16655,63,4,9,9,0,2,0,0
16655,63,4,9,9,0,2,0,0
16655,63,4,9,9,0,2,0,0
16655,63,4,9,9,0,2,0,0
0,0,0,0,0,0,0,0,0
16655,63,4,9,9,0,2,0,0
0,0,0,0,0,0,0,0,0
0,0,0,0,0,0,0,0,0
0,0,0,0,0,0,0,0,0
0,0,0,0,0,0,0,0,0
0,0,0,0,0,0,0,0,0
0,0,0,0,0,0,0,0,0
0,0,0,0,0,0,0,0,0
0,0,0,0,0,0,0,0,0
0,0,0,0,0,0,0,0,0
0,0,0,0,0,0,0,0,0
0,0,0,0,0,0,0,0,0
43457,30,0,0,0,0,0,0,0
43457,30,0,0,0,0,0,0,0
43457,30,0,0,0,0,0,0,0
43457,30,0,0,0,0,0,0,0
0,0,0,0,0,0,0,0,0
27868,78,3,0,0,0,3,0,0
136019,42,4,1,1,0,2,0,0
0,0,0,0,0,0,0,0,0
136019,42,4,1,1,0,2,0,0
136019,42,4,1,1,0,2,0,0
0,0,0,0,0,0,0,0,0
136019,42,4,1,1,0,2,0,0
0,0,0,0,0,0,0,0,0
0,0,0,0,0,0,0,0,0
0,0,0,0,0,0,0,0,0
0,0,0,0,0,0,0,0,0
0,0,0,0,0,0,0,0,0
0,0,0,0,0,0,0,0,0
144747,62,4,3,3,0,2,1,0
0,0,0,0,0,0,0,0,0
0,0,0,0,0,0,0,0,0
0,0,0,0,0,0,0,0,0
0,0,0,0,0,0,0,0,0
0,0,0,0,0,0,0,0,0
144747,62,4,3,3,0,2,1,0
0,0,0,0,0,0,0,0,0
0,0,0,0,0,0,0,0,0
0,0,0,0,0,0,0,0,0
144747,62,4,3,3,0,2,1,0
0,0,0,0,0,0,0,0,0
0,0,0,0,0,0,0,0,0
0,0,0,0,0,0,0,0,0
0,0,0,0,0,0,0,0,0
0,0,0,0,0,0,0,0,0
285356,75,4,4,4,0,4,1,0
285356,75,4,4,4,0,4,1,0
285356,75,4,4,4,0,4,1,0
196988,73,4,4,4,0,4,1,0
0,0,0,0,0,0,0,0,0
0,0,0,0,0,0,0,0,0
0,0,0,0,0,0,0,0,0
98956,66,4,0,0,0,2,1,0
98956,66,4,0,0,0,2,1,0
0,0,0,0,0,0,0,0,0
98956,66,4,0,0,0,2,1,0
98956,66,4,0,0,0,2,1,0
98956,66,4,0,0,0,2,1,0
98956,66,4,0,0,0,2,1,0
0,0,0,0,0,0,0,0,0
98956,66,4,0,0,0,2,1,0
0,0,0,0,0,0,0,0,0
0,0,0,0,0,0,0,0,0
0,0,0,0,0,0,0,0,0
0,0,0,0,0,0,0,0,0
0,0,0,0,0,0,0,0,0
0,0,0,0,0,0,0,0,0
0,0,0,0,0,0,0,0,0
243731,152,4,4,4,0,1,1,0
0,0,0,0,0,0,0,0,0
0,0,0,0,0,0,0,0,0
0,0,0,0,0,0,0,0,0
0,0,0,0,0,0,0,0,0
0,0,0,0,0,0,0,0,0
0,0,0,0,0,0,0,0,0
0,0,0,0,0,0,0,0,0
0,0,0,0,0,0,0,0,0
0,0,0,0,0,0,0,0,0
0,0,0,0,0,0,0,0,0
0,0,0,0,0,0,0,0,0
0,0,0,0,0,0,0,0,0
243774,152,4,4,4,0,1,1,0
0,0,0,0,0,0,0,0,0
243731,152,4,4,4,0,1,1,0
0,0,0,0,0,0,0,0,0
0,0,0,0,0,0,0,0,0
0,0,0,0,0,0,0,0,0
0,0,0,0,0,0,0,0,0
0,0,0,0,0,0,0,0,0
243731,152,4,4,4,0,1,1,0
0,0,0,0,0,0,0,0,0
0,0,0,0,0,0,0,0,0
0,0,0,0,0,0,0,0,0
0,0,0,0,0,0,0,0,0
0,0,0,0,0,0,0,0,0
0,0,0,0,0,0,0,0,0
0,0,0,0,0,0,0,0,0
0,0,0,0,0,0,0,0,0
0,0,0,0,0,0,0,0,0
0,0,0,0,0,0,0,0,0
0,0,0,0,0,0,0,0,0
0,0,0,0,0,0,0,0,0
0,0,0,0,0,0,0,0,0
0,0,0,0,0,0,0,0,0
0,0,0,0,0,0,0,0,0
0,0,0,0,0,0,0,0,0
0,0,0,0,0,0,0,0,0
0,0,0,0,0,0,0,0,0
0,0,0,0,0,0,0,0,0
0,0,0,0,0,0,0,0,0
0,0,0,0,0,0,0,0,0
0,0,0,0,0,0,0,0,0
39199,128,2,4,2,2,1,1,0
0,0,0,0,0,0,0,0,0
0,0,0,0,0,0,0,0,0
0,0,0,0,0,0,0,0,0
0,0,0,0,0,0,0,0,0
0,0,0,0,0,0,0,0,0
0,0,0,0,0,0,0,0,0
0,0,0,0,0,0,0,0,0
0,0,0,0,0,0,0,0,0
0,0,0,0,0,0,0,0,0
0,0,0,0,0,0,0,0,0
0,0,0,0,0,0,0,0,0
0,0,0,0,0,0,0,0,0
0,0,0,0,0,0,0,0,0
0,0,0,0,0,0,0,0,0
0,0,0,0,0,0,0,0,0
0,0,0,0,0,0,0,0,0
0,0,0,0,0,0,0,0,0
0,0,0,0,0,0,0,0,0
0,0,0,0,0,0,0,0,0
0,0,0,0,0,0,0,0,0
0,0,0,0,0,0,0,0,0
0,0,0,0,0,0,0,0,0
0,0,0,0,0,0,0,0,0
0,0,0,0,0,0,0,0,0
0,0,0,0,0,0,0,0,0
0,0,0,0,0,0,0,0,0
0,0,0,0,0,0,0,0,0
0,0,0,0,0,0,0,0,0
0,0,0,0,0,0,0,0,0
0,0,0,0,0,0,0,0,0
0,0,0,0,0,0,0,0,0
0,0,0,0,0,0,0,0,0
104825,928,6,226,29,197,7,1,0
0,0,0,0,0,0,0,0,0
0,0,0,0,0,0,0,0,0
0,0,0,0,0,0,0,0,0
0,0,0,0,0,0,0,0,0
122949,91,5,0,0,0,0,0,0
28052,97,0,2,0,2,2,0,0
0,0,0,0,0,0,0,0,0
0,0,0,0,0,0,0,0,0
0,0,0,0,0,0,0,0,0
0,0,0,0,0,0,0,0,0
0,0,0,0,0,0,0,0,0
0,0,0,0,0,0,0,0,0
0,0,0,0,0,0,0,0,0
0,0,0,0,0,0,0,0,0
0,0,0,0,0,0,0,0,0
0,0,0,0,0,0,0,0,0
0,0,0,0,0,0,0,0,0
0,0,0,0,0,0,0,0,0
0,0,0,0,0,0,0,0,0
0,0,0,0,0,0,0,0,0
0,0,0,0,0,0,0,0,0
11595,149,4,0,0,0,0,0,0
36426,48,1,0,0,0,0,0,0
36426,48,1,0,0,0,0,0,0
0,0,0,0,0,0,0,0,0
0,0,0,0,0,0,0,0,0
0,0,0,0,0,0,0,0,0
0,0,0,0,0,0,0,0,0
0,0,0,0,0,0,0,0,0
2673,21,2,1,0,1,0,0,0
2673,21,2,1,0,1,0,0,0
0,0,0,0,0,0,0,0,0
677849,541,0,4,0,4,2,1,1
0,0,0,0,0,0,0,0,0
94586,211,4,0,0,0,1,0,0
0,0,0,0,0,0,0,0,0
0,0,0,0,0,0,0,0,0
91783,211,4,0,0,0,1,0,0
92739,211,4,0,0,0,1,0,0
91316,209,4,0,0,0,1,0,0
91648,211,4,0,0,0,1,0,0
91067,211,4,0,0,0,1,0,0
0,0,0,0,0,0,0,0,0
0,0,0,0,0,0,0,0,0
91537,211,4,0,0,0,1,0,0
0,0,0,0,0,0,0,0,0
91303,211,4,0,0,0,1,0,0
92311,211,4,0,0,0,1,0,0
0,0,0,0,0,0,0,0,0
93384,214,4,0,0,0,1,0,0
0,0,0,0,0,0,0,0,0
91543,211,4,0,0,0,1,0,0
91290,211,4,0,0,0,1,0,0
91563,211,4,0,0,0,1,0,0
0,0,0,0,0,0,0,0,0
0,0,0,0,0,0,0,0,0
90991,209,4,0,0,0,1,0,0
0,0,0,0,0,0,0,0,0
0,0,0,0,0,0,0,0,0
91076,211,4,0,0,0,1,0,0
0,0,0,0,0,0,0,0,0
0,0,0,0,0,0,0,0,0
90854,211,4,0,0,0,1,0,0
92102,214,4,0,0,0,1,0,0
91539,211,4,0,0,0,1,0,0
91599,209,4,0,0,0,1,0,0
0,0,0,0,0,0,0,0,0
0,0,0,0,0,0,0,0,0
91189,211,4,0,0,0,1,0,0
91351,211,4,0,0,0,1,0,0
0,0,0,0,0,0,0,0,0
0,0,0,0,0,0,0,0,0
91401,211,4,0,0,0,1,0,0
0,0,0,0,0,0,0,0,0
91475,211,4,0,0,0,1,0,0
91175,211,4,0,0,0,1,0,0
0,0,0,0,0,0,0,0,0
91558,211,4,0,0,0,1,0,0
0,0,0,0,0,0,0,0,0
0,0,0,0,0,0,0,0,0
0,0,0,0,0,0,0,0,0
0,0,0,0,0,0,0,0,0
0,0,0,0,0,0,0,0,0
0,0,0,0,0,0,0,0,0
0,0,0,0,0,0,0,0,0
0,0,0,0,0,0,0,0,0
91323,211,4,0,0,0,1,0,0
91486,211,4,0,0,0,1,0,0
0,0,0,0,0,0,0,0,0
0,0,0,0,0,0,0,0,0
90933,211,4,0,0,0,1,0,0
91303,211,4,0,0,0,1,0,0
0,0,0,0,0,0,0,0,0
0,0,0,0,0,0,0,0,0
0,0,0,0,0,0,0,0,0
0,0,0,0,0,0,0,0,0
0,0,0,0,0,0,0,0,0
2673,21,2,1,0,1,0,0,0
0,0,0,0,0,0,0,0,0
0,0,0,0,0,0,0,0,0
0,0,0,0,0,0,0,0,0
0,0,0,0,0,0,0,0,0
0,0,0,0,0,0,0,0,0
0,0,0,0,0,0,0,0,0
215613,163,0,25,5,20,0,1,0
0,0,0,0,0,0,0,0,0
0,0,0,0,0,0,0,0,0
0,0,0,0,0,0,0,0,0
0,0,0,0,0,0,0,0,0
0,0,0,0,0,0,0,0,0
0,0,0,0,0,0,0,0,0
0,0,0,0,0,0,0,0,0
0,0,0,0,0,0,0,0,0
0,0,0,0,0,0,0,0,0
0,0,0,0,0,0,0,0,0
354191,799,4,83,78,5,2,1,0
0,0,0,0,0,0,0,0,0
0,0,0,0,0,0,0,0,0
0,0,0,0,0,0,0,0,0
0,0,0,0,0,0,0,0,0
0,0,0,0,0,0,0,0,0
0,0,0,0,0,0,0,0,0
0,0,0,0,0,0,0,0,0
40016,126,1,1,1,0,0,1,0
0,0,0,0,0,0,0,0,0
1059868,101,4,5,5,0,3,1,0
240112,102,4,5,5,0,3,1,0
84860,79,1,8,0,8,0,1,0
469,9,4,0,0,0,0,0,0
0,0,0,0,0,0,0,0,0
0,0,0,0,0,0,0,0,0
0,0,0,0,0,0,0,0,0
0,0,0,0,0,0,0,0,0
0,0,0,0,0,0,0,0,0
0,0,0,0,0,0,0,0,0
0,0,0,0,0,0,0,0,0
0,0,0,0,0,0,0,0,0
27127,311,4,2,0,2,7,1,0
0,0,0,0,0,0,0,0,0
0,0,0,0,0,0,0,0,0
0,0,0,0,0,0,0,0,0
0,0,0,0,0,0,0,0,0
0,0,0,0,0,0,0,0,0
0,0,0,0,0,0,0,0,0
0,0,0,0,0,0,0,0,0
0,0,0,0,0,0,0,0,0
0,0,0,0,0,0,0,0,0
0,0,0,0,0,0,0,0,0
0,0,0,0,0,0,0,0,0
0,0,0,0,0,0,0,0,0
0,0,0,0,0,0,0,0,0
0,0,0,0,0,0,0,0,0
0,0,0,0,0,0,0,0,0
0,0,0,0,0,0,0,0,0
0,0,0,0,0,0,0,0,0
0,0,0,0,0,0,0,0,0
0,0,0,0,0,0,0,0,0
0,0,0,0,0,0,0,0,0
0,0,0,0,0,0,0,0,0
0,0,0,0,0,0,0,0,0
0,0,0,0,0,0,0,0,0
0,0,0,0,0,0,0,0,0
0,0,0,0,0,0,0,0,0
0,0,0,0,0,0,0,0,0
0,0,0,0,0,0,0,0,0
0,0,0,0,0,0,0,0,0
0,0,0,0,0,0,0,0,0
0,0,0,0,0,0,0,0,0
0,0,0,0,0,0,0,0,0
0,0,0,0,0,0,0,0,0
0,0,0,0,0,0,0,0,0
0,0,0,0,0,0,0,0,0
0,0,0,0,0,0,0,0,0
0,0,0,0,0,0,0,0,0
0,0,0,0,0,0,0,0,0
0,0,0,0,0,0,0,0,0
0,0,0,0,0,0,0,0,0
0,0,0,0,0,0,0,0,0
0,0,0,0,0,0,0,0,0
0,0,0,0,0,0,0,0,0
670139,541,0,4,4,0,2,1,1
0,0,0,0,0,0,0,0,0
0,0,0,0,0,0,0,0,0
0,0,0,0,0,0,0,0,0
0,0,0,0,0,0,0,0,0
0,0,0,0,0,0,0,0,0
0,0,0,0,0,0,0,0,0
0,0,0,0,0,0,0,0,0
0,0,0,0,0,0,0,0,0
0,0,0,0,0,0,0,0,0
674073,542,0,4,4,0,2,1,1
63678,49,3,0,0,0,0,0,0
0,0,0,0,0,0,0,0,0
0,0,0,0,0,0,0,0,0
0,0,0,0,0,0,0,0,0
212842,503,9,24,0,24,7,1,0
0,0,0,0,0,0,0,0,0
0,0,0,0,0,0,0,0,0
0,0,0,0,0,0,0,0,0
0,0,0,0,0,0,0,0,0
0,0,0,0,0,0,0,0,0
0,0,0,0,0,0,0,0,0
0,0,0,0,0,0,0,0,0
63679,49,3,0,0,0,0,0,0
0,0,0,0,0,0,0,0,0
0,0,0,0,0,0,0,0,0
0,0,0,0,0,0,0,0,0
0,0,0,0,0,0,0,0,0
0,0,0,0,0,0,0,0,0
0,0,0,0,0,0,0,0,0
0,0,0,0,0,0,0,0,0
0,0,0,0,0,0,0,0,0
224052,1346,20,158,127,31,16,0,0
224053,1346,20,158,127,31,16,0,0
224271,1346,20,158,127,31,16,0,0
0,0,0,0,0,0,0,0,0
0,0,0,0,0,0,0,0,0
0,0,0,0,0,0,0,0,0
0,0,0,0,0,0,0,0,0
0,0,0,0,0,0,0,0,0
0,0,0,0,0,0,0,0,0
0,0,0,0,0,0,0,0,0
0,0,0,0,0,0,0,0,0
0,0,0,0,0,0,0,0,0
0,0,0,0,0,0,0,0,0
27127,311,4,2,0,2,7,1,0
27127,311,4,2,0,2,7,1,0
27127,311,4,2,0,2,7,1,0
0,0,0,0,0,0,0,0,0
39199,128,2,4,2,2,1,1,0
0,0,0,0,0,0,0,0,0
0,0,0,0,0,0,0,0,0
0,0,0,0,0,0,0,0,0
0,0,0,0,0,0,0,0,0
0,0,0,0,0,0,0,0,0
0,0,0,0,0,0,0,0,0
0,0,0,0,0,0,0,0,0
0,0,0,0,0,0,0,0,0
0,0,0,0,0,0,0,0,0
0,0,0,0,0,0,0,0,0
0,0,0,0,0,0,0,0,0
0,0,0,0,0,0,0,0,0
34482,217,0,51,3,48,1,1,0
0,0,0,0,0,0,0,0,0
0,0,0,0,0,0,0,0,0
0,0,0,0,0,0,0,0,0
0,0,0,0,0,0,0,0,0
0,0,0,0,0,0,0,0,0
0,0,0,0,0,0,0,0,0
0,0,0,0,0,0,0,0,0
0,0,0,0,0,0,0,0,0
242360,1309,10,93,89,4,1,1,0
0,0,0,0,0,0,0,0,0
0,0,0,0,0,0,0,0,0
0,0,0,0,0,0,0,0,0
93330,220,5,0,0,0,4,0,0
0,0,0,0,0,0,0,0,0
0,0,0,0,0,0,0,0,0
0,0,0,0,0,0,0,0,0
0,0,0,0,0,0,0,0,0
0,0,0,0,0,0,0,0,0
22883,223,3,24,24,0,0,1,0
0,0,0,0,0,0,0,0,0
0,0,0,0,0,0,0,0,0
0,0,0,0,0,0,0,0,0
0,0,0,0,0,0,0,0,0
16132,186,5,14,8,6,0,1,0
0,0,0,0,0,0,0,0,0
0,0,0,0,0,0,0,0,0
0,0,0,0,0,0,0,0,0
0,0,0,0,0,0,0,0,0
0,0,0,0,0,0,0,0,0
0,0,0,0,0,0,0,0,0
0,0,0,0,0,0,0,0,0
0,0,0,0,0,0,0,0,0
0,0,0,0,0,0,0,0,0
0,0,0,0,0,0,0,0,0
0,0,0,0,0,0,0,0,0
0,0,0,0,0,0,0,0,0
0,0,0,0,0,0,0,0,0
0,0,0,0,0,0,0,0,0
0,0,0,0,0,0,0,0,0
0,0,0,0,0,0,0,0,0
0,0,0,0,0,0,0,0,0
0,0,0,0,0,0,0,0,0
0,0,0,0,0,0,0,0,0
0,0,0,0,0,0,0,0,0
0,0,0,0,0,0,0,0,0
0,0,0,0,0,0,0,0,0
0,0,0,0,0,0,0,0,0
0,0,0,0,0,0,0,0,0
0,0,0,0,0,0,0,0,0
0,0,0,0,0,0,0,0,0
0,0,0,0,0,0,0,0,0
0,0,0,0,0,0,0,0,0
0,0,0,0,0,0,0,0,0
0,0,0,0,0,0,0,0,0
0,0,0,0,0,0,0,0,0
0,0,0,0,0,0,0,0,0
0,0,0,0,0,0,0,0,0
0,0,0,0,0,0,0,0,0
0,0,0,0,0,0,0,0,0
0,0,0,0,0,0,0,0,0
0,0,0,0,0,0,0,0,0
0,0,0,0,0,0,0,0,0
0,0,0,0,0,0,0,0,0
0,0,0,0,0,0,0,0,0
0,0,0,0,0,0,0,0,0
0,0,0,0,0,0,0,0,0
0,0,0,0,0,0,0,0,0
0,0,0,0,0,0,0,0,0
0,0,0,0,0,0,0,0,0
0,0,0,0,0,0,0,0,0
0,0,0,0,0,0,0,0,0
0,0,0,0,0,0,0,0,0
0,0,0,0,0,0,0,0,0
0,0,0,0,0,0,0,0,0
0,0,0,0,0,0,0,0,0
0,0,0,0,0,0,0,0,0
0,0,0,0,0,0,0,0,0
11764,52,3,0,0,0,2,0,0
1263,25,1,0,0,0,0,0,0
1263,25,1,0,0,0,0,0,0
0,0,0,0,0,0,0,0,0
0,0,0,0,0,0,0,0,0
6330,64,2,6,4,2,0,1,0
0,0,0,0,0,0,0,0,0
3306,29,1,1,1,0,0,0,0
0,0,0,0,0,0,0,0,0
0,0,0,0,0,0,0,0,0
0,0,0,0,0,0,0,0,0
2673,21,2,1,0,1,0,0,0
0,0,0,0,0,0,0,0,0
0,0,0,0,0,0,0,0,0
20183,53,3,0,0,0,0,0,0
20183,53,3,0,0,0,0,0,0
243830,152,4,4,4,0,1,1,0
243830,152,4,4,4,0,1,1,0
0,0,0,0,0,0,0,0,0
0,0,0,0,0,0,0,0,0
0,0,0,0,0,0,0,0,0
0,0,0,0,0,0,0,0,0
243849,152,4,4,4,0,1,1,0
243830,152,4,4,4,0,1,1,0
0,0,0,0,0,0,0,0,0
0,0,0,0,0,0,0,0,0
0,0,0,0,0,0,0,0,0
0,0,0,0,0,0,0,0,0
0,0,0,0,0,0,0,0,0
243830,152,4,4,4,0,1,1,0
0,0,0,0,0,0,0,0,0
0,0,0,0,0,0,0,0,0
0,0,0,0,0,0,0,0,0
0,0,0,0,0,0,0,0,0
0,0,0,0,0,0,0,0,0
0,0,0,0,0,0,0,0,0
0,0,0,0,0,0,0,0,0
0,0,0,0,0,0,0,0,0
0,0,0,0,0,0,0,0,0
0,0,0,0,0,0,0,0,0
0,0,0,0,0,0,0,0,0
0,0,0,0,0,0,0,0,0
94045,58,4,2,0,2,2,1,0
94045,58,4,2,0,2,2,1,0
0,0,0,0,0,0,0,0,0
0,0,0,0,0,0,0,0,0
31629,69,6,1,0,1,0,1,0
0,0,0,0,0,0,0,0,0
31629,69,6,1,0,1,0,1,0
0,0,0,0,0,0,0,0,0
0,0,0,0,0,0,0,0,0
94045,58,4,2,0,2,2,1,0
94045,58,4,2,0,2,2,1,0
94045,58,4,2,0,2,2,1,0
94045,58,4,2,0,2,2,1,0
94045,58,4,2,0,2,2,1,0
0,0,0,0,0,0,0,0,0
0,0,0,0,0,0,0,0,0
0,0,0,0,0,0,0,0,0
0,0,0,0,0,0,0,0,0
0,0,0,0,0,0,0,0,0
0,0,0,0,0,0,0,0,0
0,0,0,0,0,0,0,0,0
0,0,0,0,0,0,0,0,0
0,0,0,0,0,0,0,0,0
0,0,0,0,0,0,0,0,0
36534,51,2,0,0,0,2,0,0
0,0,0,0,0,0,0,0,0
79379,587,4,31,29,2,3,1,0
0,0,0,0,0,0,0,0,0
0,0,0,0,0,0,0,0,0
0,0,0,0,0,0,0,0,0
0,0,0,0,0,0,0,0,0
40941,54,4,1,1,0,2,1,0
0,0,0,0,0,0,0,0,0
0,0,0,0,0,0,0,0,0
0,0,0,0,0,0,0,0,0
35929,39,1,0,0,0,0,1,0
0,0,0,0,0,0,0,0,0
0,0,0,0,0,0,0,0,0
93109,453,5,58,52,6,14,1,0
0,0,0,0,0,0,0,0,0
10737,46,2,0,0,0,0,0,0
0,0,0,0,0,0,0,0,0
89036,48,4,0,0,0,0,0,0
672415,541,0,4,4,0,2,1,1
0,0,0,0,0,0,0,0,0
0,0,0,0,0,0,0,0,0
0,0,0,0,0,0,0,0,0
0,0,0,0,0,0,0,0,0
0,0,0,0,0,0,0,0,0
0,0,0,0,0,0,0,0,0
0,0,0,0,0,0,0,0,0
0,0,0,0,0,0,0,0,0
0,0,0,0,0,0,0,0,0
0,0,0,0,0,0,0,0,0
0,0,0,0,0,0,0,0,0
0,0,0,0,0,0,0,0,0
0,0,0,0,0,0,0,0,0
0,0,0,0,0,0,0,0,0
0,0,0,0,0,0,0,0,0
0,0,0,0,0,0,0,0,0
0,0,0,0,0,0,0,0,0
0,0,0,0,0,0,0,0,0
0,0,0,0,0,0,0,0,0
0,0,0,0,0,0,0,0,0
0,0,0,0,0,0,0,0,0
0,0,0,0,0,0,0,0,0
0,0,0,0,0,0,0,0,0
0,0,0,0,0,0,0,0,0
0,0,0,0,0,0,0,0,0
0,0,0,0,0,0,0,0,0
0,0,0,0,0,0,0,0,0
121597,943,3,133,121,12,1,0,0
0,0,0,0,0,0,0,0,0
0,0,0,0,0,0,0,0,0
0,0,0,0,0,0,0,0,0
0,0,0,0,0,0,0,0,0
0,0,0,0,0,0,0,0,0
0,0,0,0,0,0,0,0,0
0,0,0,0,0,0,0,0,0
0,0,0,0,0,0,0,0,0
0,0,0,0,0,0,0,0,0
0,0,0,0,0,0,0,0,0
0,0,0,0,0,0,0,0,0
0,0,0,0,0,0,0,0,0
0,0,0,0,0,0,0,0,0
0,0,0,0,0,0,0,0,0
0,0,0,0,0,0,0,0,0
0,0,0,0,0,0,0,0,0
0,0,0,0,0,0,0,0,0
0,0,0,0,0,0,0,0,0
0,0,0,0,0,0,0,0,0
0,0,0,0,0,0,0,0,0
0,0,0,0,0,0,0,0,0
0,0,0,0,0,0,0,0,0
2673,21,2,1,0,1,0,0,0
0,0,0,0,0,0,0,0,0
0,0,0,0,0,0,0,0,0
0,0,0,0,0,0,0,0,0
0,0,0,0,0,0,0,0,0
0,0,0,0,0,0,0,0,0
0,0,0,0,0,0,0,0,0
0,0,0,0,0,0,0,0,0
0,0,0,0,0,0,0,0,0
0,0,0,0,0,0,0,0,0
0,0,0,0,0,0,0,0,0
0,0,0,0,0,0,0,0,0
28506,168,5,8,8,0,7,1,0
0,0,0,0,0,0,0,0,0
0,0,0,0,0,0,0,0,0
0,0,0,0,0,0,0,0,0
8998,93,6,20,20,0,1,1,0
0,0,0,0,0,0,0,0,0
0,0,0,0,0,0,0,0,0
90944,212,4,0,0,0,1,0,0
90797,211,4,0,0,0,1,0,0
0,0,0,0,0,0,0,0,0
0,0,0,0,0,0,0,0,0
0,0,0,0,0,0,0,0,0
0,0,0,0,0,0,0,0,0
0,0,0,0,0,0,0,0,0
0,0,0,0,0,0,0,0,0
0,0,0,0,0,0,0,0,0
0,0,0,0,0,0,0,0,0
0,0,0,0,0,0,0,0,0
0,0,0,0,0,0,0,0,0
0,0,0,0,0,0,0,0,0
0,0,0,0,0,0,0,0,0
0,0,0,0,0,0,0,0,0
0,0,0,0,0,0,0,0,0
0,0,0,0,0,0,0,0,0
0,0,0,0,0,0,0,0,0
0,0,0,0,0,0,0,0,0
0,0,0,0,0,0,0,0,0
0,0,0,0,0,0,0,0,0
136957,393,8,27,24,3,31,1,0
0,0,0,0,0,0,0,0,0
3201668,55,2,1,1,0,0,1,0
0,0,0,0,0,0,0,0,0
0,0,0,0,0,0,0,0,0
0,0,0,0,0,0,0,0,0
0,0,0,0,0,0,0,0,0
0,0,0,0,0,0,0,0,0
0,0,0,0,0,0,0,0,0
0,0,0,0,0,0,0,0,0
0,0,0,0,0,0,0,0,0
0,0,0,0,0,0,0,0,0
63679,49,3,0,0,0,0,0,0
0,0,0,0,0,0,0,0,0
0,0,0,0,0,0,0,0,0
0,0,0,0,0,0,0,0,0
0,0,0,0,0,0,0,0,0
0,0,0,0,0,0,0,0,0
0,0,0,0,0,0,0,0,0
0,0,0,0,0,0,0,0,0
0,0,0,0,0,0,0,0,0
63679,49,3,0,0,0,0,0,0
0,0,0,0,0,0,0,0,0
0,0,0,0,0,0,0,0,0
20331,38,0,3,1,2,0,1,0
0,0,0,0,0,0,0,0,0
0,0,0,0,0,0,0,0,0
0,0,0,0,0,0,0,0,0
0,0,0,0,0,0,0,0,0
0,0,0,0,0,0,0,0,0
0,0,0,0,0,0,0,0,0
0,0,0,0,0,0,0,0,0
63679,49,3,0,0,0,0,0,0
0,0,0,0,0,0,0,0,0
0,0,0,0,0,0,0,0,0
0,0,0,0,0,0,0,0,0
0,0,0,0,0,0,0,0,0
0,0,0,0,0,0,0,0,0
0,0,0,0,0,0,0,0,0
0,0,0,0,0,0,0,0,0
0,0,0,0,0,0,0,0,0
0,0,0,0,0,0,0,0,0
0,0,0,0,0,0,0,0,0
0,0,0,0,0,0,0,0,0
0,0,0,0,0,0,0,0,0
0,0,0,0,0,0,0,0,0
0,0,0,0,0,0,0,0,0
0,0,0,0,0,0,0,0,0
0,0,0,0,0,0,0,0,0
0,0,0,0,0,0,0,0,0
0,0,0,0,0,0,0,0,0
0,0,0,0,0,0,0,0,0
0,0,0,0,0,0,0,0,0
0,0,0,0,0,0,0,0,0
0,0,0,0,0,0,0,0,0
0,0,0,0,0,0,0,0,0
0,0,0,0,0,0,0,0,0
0,0,0,0,0,0,0,0,0
0,0,0,0,0,0,0,0,0
0,0,0,0,0,0,0,0,0
0,0,0,0,0,0,0,0,0
0,0,0,0,0,0,0,0,0
0,0,0,0,0,0,0,0,0
0,0,0,0,0,0,0,0,0
0,0,0,0,0,0,0,0,0
743,38,0,6,6,0,0,0,0
0,0,0,0,0,0,0,0,0
0,0,0,0,0,0,0,0,0
0,0,0,0,0,0,0,0,0
0,0,0,0,0,0,0,0,0
0,0,0,0,0,0,0,0,0
0,0,0,0,0,0,0,0,0
0,0,0,0,0,0,0,0,0
0,0,0,0,0,0,0,0,0
0,0,0,0,0,0,0,0,0
0,0,0,0,0,0,0,0,0
0,0,0,0,0,0,0,0,0
0,0,0,0,0,0,0,0,0
0,0,0,0,0,0,0,0,0
0,0,0,0,0,0,0,0,0
0,0,0,0,0,0,0,0,0
0,0,0,0,0,0,0,0,0
0,0,0,0,0,0,0,0,0
0,0,0,0,0,0,0,0,0
0,0,0,0,0,0,0,0,0
0,0,0,0,0,0,0,0,0
0,0,0,0,0,0,0,0,0
0,0,0,0,0,0,0,0,0
0,0,0,0,0,0,0,0,0
0,0,0,0,0,0,0,0,0
0,0,0,0,0,0,0,0,0
0,0,0,0,0,0,0,0,0
0,0,0,0,0,0,0,0,0
0,0,0,0,0,0,0,0,0
0,0,0,0,0,0,0,0,0
0,0,0,0,0,0,0,0,0
0,0,0,0,0,0,0,0,0
0,0,0,0,0,0,0,0,0
0,0,0,0,0,0,0,0,0
0,0,0,0,0,0,0,0,0
0,0,0,0,0,0,0,0,0
0,0,0,0,0,0,0,0,0
0,0,0,0,0,0,0,0,0
0,0,0,0,0,0,0,0,0
0,0,0,0,0,0,0,0,0
0,0,0,0,0,0,0,0,0
0,0,0,0,0,0,0,0,0
0,0,0,0,0,0,0,0,0
0,0,0,0,0,0,0,0,0
0,0,0,0,0,0,0,0,0
0,0,0,0,0,0,0,0,0
0,0,0,0,0,0,0,0,0
0,0,0,0,0,0,0,0,0
0,0,0,0,0,0,0,0,0
0,0,0,0,0,0,0,0,0
0,0,0,0,0,0,0,0,0
0,0,0,0,0,0,0,0,0
0,0,0,0,0,0,0,0,0
0,0,0,0,0,0,0,0,0
0,0,0,0,0,0,0,0,0
0,0,0,0,0,0,0,0,0
0,0,0,0,0,0,0,0,0
0,0,0,0,0,0,0,0,0
0,0,0,0,0,0,0,0,0
0,0,0,0,0,0,0,0,0
0,0,0,0,0,0,0,0,0
0,0,0,0,0,0,0,0,0
0,0,0,0,0,0,0,0,0
0,0,0,0,0,0,0,0,0
0,0,0,0,0,0,0,0,0
0,0,0,0,0,0,0,0,0
0,0,0,0,0,0,0,0,0
0,0,0,0,0,0,0,0,0
0,0,0,0,0,0,0,0,0
0,0,0,0,0,0,0,0,0
0,0,0,0,0,0,0,0,0
0,0,0,0,0,0,0,0,0
0,0,0,0,0,0,0,0,0
0,0,0,0,0,0,0,0,0
0,0,0,0,0,0,0,0,0
0,0,0,0,0,0,0,0,0
0,0,0,0,0,0,0,0,0
0,0,0,0,0,0,0,0,0
0,0,0,0,0,0,0,0,0
0,0,0,0,0,0,0,0,0
0,0,0,0,0,0,0,0,0
0,0,0,0,0,0,0,0,0
0,0,0,0,0,0,0,0,0
0,0,0,0,0,0,0,0,0
0,0,0,0,0,0,0,0,0
0,0,0,0,0,0,0,0,0
0,0,0,0,0,0,0,0,0
0,0,0,0,0,0,0,0,0
2673,21,2,1,0,1,0,0,0
0,0,0,0,0,0,0,0,0
26847,33,1,0,0,0,1,1,0
0,0,0,0,0,0,0,0,0
26847,33,1,0,0,0,1,1,0
26847,33,1,0,0,0,1,1,0
26847,33,1,0,0,0,1,1,0
26847,33,1,0,0,0,1,1,0
0,0,0,0,0,0,0,0,0
0,0,0,0,0,0,0,0,0
0,0,0,0,0,0,0,0,0
0,0,0,0,0,0,0,0,0
0,0,0,0,0,0,0,0,0
0,0,0,0,0,0,0,0,0
1261665,111,2,6,6,0,1,0,0
1261665,111,2,6,6,0,1,0,0
0,0,0,0,0,0,0,0,0
1261665,111,2,6,6,0,1,0,0
1261665,111,2,6,6,0,1,0,0
1261665,111,2,6,6,0,1,0,0
1261665,111,2,6,6,0,1,0,0
0,0,0,0,0,0,0,0,0
0,0,0,0,0,0,0,0,0
1261665,111,2,6,6,0,1,0,0
0,0,0,0,0,0,0,0,0
0,0,0,0,0,0,0,0,0
0,0,0,0,0,0,0,0,0
0,0,0,0,0,0,0,0,0
0,0,0,0,0,0,0,0,0
0,0,0,0,0,0,0,0,0
0,0,0,0,0,0,0,0,0
0,0,0,0,0,0,0,0,0
0,0,0,0,0,0,0,0,0
9231,37,4,0,0,0,2,0,0
0,0,0,0,0,0,0,0,0
0,0,0,0,0,0,0,0,0
0,0,0,0,0,0,0,0,0
0,0,0,0,0,0,0,0,0
0,0,0,0,0,0,0,0,0
0,0,0,0,0,0,0,0,0
25094,67,2,1,1,0,2,0,0
0,0,0,0,0,0,0,0,0
0,0,0,0,0,0,0,0,0
0,0,0,0,0,0,0,0,0
0,0,0,0,0,0,0,0,0
0,0,0,0,0,0,0,0,0
27859,78,3,0,0,0,3,0,0
0,0,0,0,0,0,0,0,0
0,0,0,0,0,0,0,0,0
0,0,0,0,0,0,0,0,0
0,0,0,0,0,0,0,0,0
0,0,0,0,0,0,0,0,0
0,0,0,0,0,0,0,0,0
0,0,0,0,0,0,0,0,0
0,0,0,0,0,0,0,0,0
0,0,0,0,0,0,0,0,0
0,0,0,0,0,0,0,0,0
0,0,0,0,0,0,0,0,0
25094,67,2,1,1,0,2,0,0
0,0,0,0,0,0,0,0,0
0,0,0,0,0,0,0,0,0
0,0,0,0,0,0,0,0,0
0,0,0,0,0,0,0,0,0
10416,39,1,0,0,0,1,0,0
10416,39,1,0,0,0,1,0,0
0,0,0,0,0,0,0,0,0
10416,39,1,0,0,0,1,0,0
10416,39,1,0,0,0,1,0,0
10416,39,1,0,0,0,1,0,0
10416,39,1,0,0,0,1,0,0
10416,39,1,0,0,0,1,0,0
0,0,0,0,0,0,0,0,0
0,0,0,0,0,0,0,0,0
0,0,0,0,0,0,0,0,0
0,0,0,0,0,0,0,0,0
0,0,0,0,0,0,0,0,0
0,0,0,0,0,0,0,0,0
0,0,0,0,0,0,0,0,0
0,0,0,0,0,0,0,0,0
0,0,0,0,0,0,0,0,0
0,0,0,0,0,0,0,0,0
0,0,0,0,0,0,0,0,0
0,0,0,0,0,0,0,0,0
0,0,0,0,0,0,0,0,0
0,0,0,0,0,0,0,0,0
0,0,0,0,0,0,0,0,0
0,0,0,0,0,0,0,0,0
0,0,0,0,0,0,0,0,0
0,0,0,0,0,0,0,0,0
0,0,0,0,0,0,0,0,0
0,0,0,0,0,0,0,0,0
0,0,0,0,0,0,0,0,0
125220,204,2,50,49,1,0,1,0
0,0,0,0,0,0,0,0,0
0,0,0,0,0,0,0,0,0
28520,47,4,0,0,0,0,0,0
58904,900,4,163,2,161,3,1,0
0,0,0,0,0,0,0,0,0
0,0,0,0,0,0,0,0,0
0,0,0,0,0,0,0,0,0
0,0,0,0,0,0,0,0,0
0,0,0,0,0,0,0,0,0
77738,101,1,4,2,2,0,0,0
0,0,0,0,0,0,0,0,0
0,0,0,0,0,0,0,0,0
0,0,0,0,0,0,0,0,0
0,0,0,0,0,0,0,0,0
193723,261,7,6,6,0,0,1,0
0,0,0,0,0,0,0,0,0
0,0,0,0,0,0,0,0,0
0,0,0,0,0,0,0,0,0
0,0,0,0,0,0,0,0,0
0,0,0,0,0,0,0,0,0
40012,126,1,1,1,0,0,1,0
0,0,0,0,0,0,0,0,0
0,0,0,0,0,0,0,0,0
0,0,0,0,0,0,0,0,0
0,0,0,0,0,0,0,0,0
0,0,0,0,0,0,0,0,0
97728,209,4,0,0,0,1,0,0
0,0,0,0,0,0,0,0,0
0,0,0,0,0,0,0,0,0
0,0,0,0,0,0,0,0,0
0,0,0,0,0,0,0,0,0
0,0,0,0,0,0,0,0,0
0,0,0,0,0,0,0,0,0
0,0,0,0,0,0,0,0,0
0,0,0,0,0,0,0,0,0
36136,224,7,34,33,1,1,1,0
2704,18,1,0,0,0,0,0,0
0,0,0,0,0,0,0,0,0
0,0,0,0,0,0,0,0,0
0,0,0,0,0,0,0,0,0
0,0,0,0,0,0,0,0,0
0,0,0,0,0,0,0,0,0
0,0,0,0,0,0,0,0,0
0,0,0,0,0,0,0,0,0
0,0,0,0,0,0,0,0,0
0,0,0,0,0,0,0,0,0
0,0,0,0,0,0,0,0,0
0,0,0,0,0,0,0,0,0
0,0,0,0,0,0,0,0,0
0,0,0,0,0,0,0,0,0
0,0,0,0,0,0,0,0,0
104831,928,6,226,77,149,7,1,0
0,0,0,0,0,0,0,0,0
104830,928,6,226,30,196,7,1,0
0,0,0,0,0,0,0,0,0
0,0,0,0,0,0,0,0,0
0,0,0,0,0,0,0,0,0
0,0,0,0,0,0,0,0,0
0,0,0,0,0,0,0,0,0
0,0,0,0,0,0,0,0,0
0,0,0,0,0,0,0,0,0
0,0,0,0,0,0,0,0,0
0,0,0,0,0,0,0,0,0
0,0,0,0,0,0,0,0,0
0,0,0,0,0,0,0,0,0
0,0,0,0,0,0,0,0,0
0,0,0,0,0,0,0,0,0
0,0,0,0,0,0,0,0,0
0,0,0,0,0,0,0,0,0
0,0,0,0,0,0,0,0,0
0,0,0,0,0,0,0,0,0
0,0,0,0,0,0,0,0,0
0,0,0,0,0,0,0,0,0
0,0,0,0,0,0,0,0,0
0,0,0,0,0,0,0,0,0
0,0,0,0,0,0,0,0,0
0,0,0,0,0,0,0,0,0
0,0,0,0,0,0,0,0,0
0,0,0,0,0,0,0,0,0
0,0,0,0,0,0,0,0,0
0,0,0,0,0,0,0,0,0
0,0,0,0,0,0,0,0,0
0,0,0,0,0,0,0,0,0
0,0,0,0,0,0,0,0,0
0,0,0,0,0,0,0,0,0
0,0,0,0,0,0,0,0,0
63568,48,3,0,0,0,0,0,0
0,0,0,0,0,0,0,0,0
0,0,0,0,0,0,0,0,0
0,0,0,0,0,0,0,0,0
0,0,0,0,0,0,0,0,0
0,0,0,0,0,0,0,0,0
0,0,0,0,0,0,0,0,0
0,0,0,0,0,0,0,0,0
0,0,0,0,0,0,0,0,0
0,0,0,0,0,0,0,0,0
0,0,0,0,0,0,0,0,0
0,0,0,0,0,0,0,0,0
0,0,0,0,0,0,0,0,0
0,0,0,0,0,0,0,0,0
0,0,0,0,0,0,0,0,0
3943,28,1,2,2,0,0,0,0
63678,49,3,0,0,0,0,0,0
63667,49,3,0,0,0,0,0,0
0,0,0,0,0,0,0,0,0
63667,49,3,0,0,0,0,0,0
0,0,0,0,0,0,0,0,0
307759,354,4,13,0,13,0,1,0
0,0,0,0,0,0,0,0,0
0,0,0,0,0,0,0,0,0
0,0,0,0,0,0,0,0,0
0,0,0,0,0,0,0,0,0
0,0,0,0,0,0,0,0,0
0,0,0,0,0,0,0,0,0
0,0,0,0,0,0,0,0,0
0,0,0,0,0,0,0,0,0
0,0,0,0,0,0,0,0,0
0,0,0,0,0,0,0,0,0
0,0,0,0,0,0,0,0,0
0,0,0,0,0,0,0,0,0
0,0,0,0,0,0,0,0,0
0,0,0,0,0,0,0,0,0
0,0,0,0,0,0,0,0,0
0,0,0,0,0,0,0,0,0
0,0,0,0,0,0,0,0,0
0,0,0,0,0,0,0,0,0
674437,542,0,4,4,0,2,1,1
0,0,0,0,0,0,0,0,0
0,0,0,0,0,0,0,0,0
90955,211,4,0,0,0,1,0,0
0,0,0,0,0,0,0,0,0
0,0,0,0,0,0,0,0,0
0,0,0,0,0,0,0,0,0
0,0,0,0,0,0,0,0,0
0,0,0,0,0,0,0,0,0
0,0,0,0,0,0,0,0,0
0,0,0,0,0,0,0,0,0
0,0,0,0,0,0,0,0,0
0,0,0,0,0,0,0,0,0
0,0,0,0,0,0,0,0,0
0,0,0,0,0,0,0,0,0
0,0,0,0,0,0,0,0,0
0,0,0,0,0,0,0,0,0
0,0,0,0,0,0,0,0,0
0,0,0,0,0,0,0,0,0
0,0,0,0,0,0,0,0,0
0,0,0,0,0,0,0,0,0
9269,78,1,0,0,0,0,0,0
0,0,0,0,0,0,0,0,0
0,0,0,0,0,0,0,0,0
0,0,0,0,0,0,0,0,0
0,0,0,0,0,0,0,0,0
0,0,0,0,0,0,0,0,0
0,0,0,0,0,0,0,0,0
2084,37,2,1,0,1,0,0,0
0,0,0,0,0,0,0,0,0
0,0,0,0,0,0,0,0,0
0,0,0,0,0,0,0,0,0
0,0,0,0,0,0,0,0,0
0,0,0,0,0,0,0,0,0
0,0,0,0,0,0,0,0,0
0,0,0,0,0,0,0,0,0
0,0,0,0,0,0,0,0,0
0,0,0,0,0,0,0,0,0
0,0,0,0,0,0,0,0,0
47917,76,2,1,1,0,3,1,0
0,0,0,0,0,0,0,0,0
0,0,0,0,0,0,0,0,0
0,0,0,0,0,0,0,0,0
0,0,0,0,0,0,0,0,0
2673,21,2,1,0,1,0,0,0
0,0,0,0,0,0,0,0,0
0,0,0,0,0,0,0,0,0
0,0,0,0,0,0,0,0,0
0,0,0,0,0,0,0,0,0
0,0,0,0,0,0,0,0,0
0,0,0,0,0,0,0,0,0
0,0,0,0,0,0,0,0,0
0,0,0,0,0,0,0,0,0
0,0,0,0,0,0,0,0,0
0,0,0,0,0,0,0,0,0
92817,220,5,0,0,0,4,0,0
91376,212,4,0,0,0,1,0,0
0,0,0,0,0,0,0,0,0
0,0,0,0,0,0,0,0,0
0,0,0,0,0,0,0,0,0
0,0,0,0,0,0,0,0,0
0,0,0,0,0,0,0,0,0
0,0,0,0,0,0,0,0,0
0,0,0,0,0,0,0,0,0
0,0,0,0,0,0,0,0,0
0,0,0,0,0,0,0,0,0
0,0,0,0,0,0,0,0,0
0,0,0,0,0,0,0,0,0
0,0,0,0,0,0,0,0,0
0,0,0,0,0,0,0,0,0
0,0,0,0,0,0,0,0,0
0,0,0,0,0,0,0,0,0
0,0,0,0,0,0,0,0,0
0,0,0,0,0,0,0,0,0
0,0,0,0,0,0,0,0,0
0,0,0,0,0,0,0,0,0
0,0,0,0,0,0,0,0,0
0,0,0,0,0,0,0,0,0
0,0,0,0,0,0,0,0,0
0,0,0,0,0,0,0,0,0
0,0,0,0,0,0,0,0,0
0,0,0,0,0,0,0,0,0
9665,82,1,0,0,0,0,0,0
0,0,0,0,0,0,0,0,0
0,0,0,0,0,0,0,0,0
46706,549,3,120,117,3,8,0,0
91074,211,4,0,0,0,1,0,0
91074,211,4,0,0,0,1,0,0
0,0,0,0,0,0,0,0,0
0,0,0,0,0,0,0,0,0
0,0,0,0,0,0,0,0,0
0,0,0,0,0,0,0,0,0
0,0,0,0,0,0,0,0,0
0,0,0,0,0,0,0,0,0
0,0,0,0,0,0,0,0,0
0,0,0,0,0,0,0,0,0
0,0,0,0,0,0,0,0,0
0,0,0,0,0,0,0,0,0
0,0,0,0,0,0,0,0,0
0,0,0,0,0,0,0,0,0
0,0,0,0,0,0,0,0,0
0,0,0,0,0,0,0,0,0
0,0,0,0,0,0,0,0,0
0,0,0,0,0,0,0,0,0
0,0,0,0,0,0,0,0,0
63679,49,3,0,0,0,0,0,0
63159,46,3,0,0,0,0,0,0
63679,49,3,0,0,0,0,0,0
0,0,0,0,0,0,0,0,0
0,0,0,0,0,0,0,0,0
0,0,0,0,0,0,0,0,0
0,0,0,0,0,0,0,0,0
0,0,0,0,0,0,0,0,0
0,0,0,0,0,0,0,0,0
0,0,0,0,0,0,0,0,0
0,0,0,0,0,0,0,0,0
0,0,0,0,0,0,0,0,0
0,0,0,0,0,0,0,0,0
0,0,0,0,0,0,0,0,0
0,0,0,0,0,0,0,0,0
0,0,0,0,0,0,0,0,0
0,0,0,0,0,0,0,0,0
0,0,0,0,0,0,0,0,0
0,0,0,0,0,0,0,0,0
63679,49,3,0,0,0,0,0,0
0,0,0,0,0,0,0,0,0
0,0,0,0,0,0,0,0,0
0,0,0,0,0,0,0,0,0
0,0,0,0,0,0,0,0,0
0,0,0,0,0,0,0,0,0
0,0,0,0,0,0,0,0,0
0,0,0,0,0,0,0,0,0
138224,393,8,26,24,2,29,1,0
0,0,0,0,0,0,0,0,0
0,0,0,0,0,0,0,0,0
0,0,0,0,0,0,0,0,0
0,0,0,0,0,0,0,0,0
0,0,0,0,0,0,0,0,0
0,0,0,0,0,0,0,0,0
0,0,0,0,0,0,0,0,0
0,0,0,0,0,0,0,0,0
0,0,0,0,0,0,0,0,0
0,0,0,0,0,0,0,0,0
0,0,0,0,0,0,0,0,0
0,0,0,0,0,0,0,0,0
0,0,0,0,0,0,0,0,0
0,0,0,0,0,0,0,0,0
0,0,0,0,0,0,0,0,0
0,0,0,0,0,0,0,0,0
0,0,0,0,0,0,0,0,0
0,0,0,0,0,0,0,0,0
0,0,0,0,0,0,0,0,0
0,0,0,0,0,0,0,0,0
0,0,0,0,0,0,0,0,0
0,0,0,0,0,0,0,0,0
0,0,0,0,0,0,0,0,0
0,0,0,0,0,0,0,0,0
10847,148,7,25,25,0,0,1,0
0,0,0,0,0,0,0,0,0
0,0,0,0,0,0,0,0,0
0,0,0,0,0,0,0,0,0
0,0,0,0,0,0,0,0,0
0,0,0,0,0,0,0,0,0
0,0,0,0,0,0,0,0,0
0,0,0,0,0,0,0,0,0
0,0,0,0,0,0,0,0,0
0,0,0,0,0,0,0,0,0
0,0,0,0,0,0,0,0,0
0,0,0,0,0,0,0,0,0
0,0,0,0,0,0,0,0,0
0,0,0,0,0,0,0,0,0
0,0,0,0,0,0,0,0,0
0,0,0,0,0,0,0,0,0
0,0,0,0,0,0,0,0,0
0,0,0,0,0,0,0,0,0
0,0,0,0,0,0,0,0,0
0,0,0,0,0,0,0,0,0
0,0,0,0,0,0,0,0,0
0,0,0,0,0,0,0,0,0
0,0,0,0,0,0,0,0,0
0,0,0,0,0,0,0,0,0
0,0,0,0,0,0,0,0,0
0,0,0,0,0,0,0,0,0
0,0,0,0,0,0,0,0,0
0,0,0,0,0,0,0,0,0
0,0,0,0,0,0,0,0,0
0,0,0,0,0,0,0,0,0
205163,1063,1,259,221,38,3,0,0
88615,915,1,257,225,32,3,0,0
0,0,0,0,0,0,0,0,0
0,0,0,0,0,0,0,0,0
0,0,0,0,0,0,0,0,0
0,0,0,0,0,0,0,0,0
0,0,0,0,0,0,0,0,0
0,0,0,0,0,0,0,0,0
0,0,0,0,0,0,0,0,0
88615,915,1,257,221,36,3,0,0
205163,1063,1,259,226,33,3,0,0
0,0,0,0,0,0,0,0,0
0,0,0,0,0,0,0,0,0
0,0,0,0,0,0,0,0,0
0,0,0,0,0,0,0,0,0
0,0,0,0,0,0,0,0,0
0,0,0,0,0,0,0,0,0
0,0,0,0,0,0,0,0,0
0,0,0,0,0,0,0,0,0
0,0,0,0,0,0,0,0,0
0,0,0,0,0,0,0,0,0
0,0,0,0,0,0,0,0,0
0,0,0,0,0,0,0,0,0
0,0,0,0,0,0,0,0,0
0,0,0,0,0,0,0,0,0
0,0,0,0,0,0,0,0,0
0,0,0,0,0,0,0,0,0
0,0,0,0,0,0,0,0,0
0,0,0,0,0,0,0,0,0
0,0,0,0,0,0,0,0,0
0,0,0,0,0,0,0,0,0
0,0,0,0,0,0,0,0,0
0,0,0,0,0,0,0,0,0
0,0,0,0,0,0,0,0,0
0,0,0,0,0,0,0,0,0
0,0,0,0,0,0,0,0,0
0,0,0,0,0,0,0,0,0
0,0,0,0,0,0,0,0,0
0,0,0,0,0,0,0,0,0
0,0,0,0,0,0,0,0,0
0,0,0,0,0,0,0,0,0
0,0,0,0,0,0,0,0,0
0,0,0,0,0,0,0,0,0
0,0,0,0,0,0,0,0,0
0,0,0,0,0,0,0,0,0
0,0,0,0,0,0,0,0,0
0,0,0,0,0,0,0,0,0
0,0,0,0,0,0,0,0,0
77778,101,1,4,2,2,0,0,0
0,0,0,0,0,0,0,0,0
11764,52,3,0,0,0,2,0,0
0,0,0,0,0,0,0,0,0
536095,181,4,1,1,0,0,1,0
36364,50,2,0,0,0,2,0,0
36364,50,2,0,0,0,2,0,0
36364,50,2,0,0,0,2,0,0
0,0,0,0,0,0,0,0,0
0,0,0,0,0,0,0,0,0
0,0,0,0,0,0,0,0,0
0,0,0,0,0,0,0,0,0
0,0,0,0,0,0,0,0,0
0,0,0,0,0,0,0,0,0
36364,50,2,0,0,0,2,0,0
0,0,0,0,0,0,0,0,0
0,0,0,0,0,0,0,0,0
0,0,0,0,0,0,0,0,0
36364,50,2,0,0,0,2,0,0
16600,63,4,9,9,0,2,0,0
16600,63,4,9,9,0,2,0,0
0,0,0,0,0,0,0,0,0
0,0,0,0,0,0,0,0,0
7162,49,4,0,0,0,0,1,0
0,0,0,0,0,0,0,0,0
0,0,0,0,0,0,0,0,0
0,0,0,0,0,0,0,0,0
0,0,0,0,0,0,0,0,0
0,0,0,0,0,0,0,0,0
0,0,0,0,0,0,0,0,0
0,0,0,0,0,0,0,0,0
36372,50,2,0,0,0,2,0,0
36372,50,2,0,0,0,2,0,0
0,0,0,0,0,0,0,0,0
0,0,0,0,0,0,0,0,0
0,0,0,0,0,0,0,0,0
0,0,0,0,0,0,0,0,0
36372,50,2,0,0,0,2,0,0
36372,50,2,0,0,0,2,0,0
0,0,0,0,0,0,0,0,0
0,0,0,0,0,0,0,0,0
0,0,0,0,0,0,0,0,0
0,0,0,0,0,0,0,0,0
0,0,0,0,0,0,0,0,0
0,0,0,0,0,0,0,0,0
0,0,0,0,0,0,0,0,0
0,0,0,0,0,0,0,0,0
0,0,0,0,0,0,0,0,0
0,0,0,0,0,0,0,0,0
0,0,0,0,0,0,0,0,0
39171,479,0,80,24,56,0,0,0
0,0,0,0,0,0,0,0,0
35929,39,1,0,0,0,0,1,0
0,0,0,0,0,0,0,0,0
0,0,0,0,0,0,0,0,0
0,0,0,0,0,0,0,0,0
0,0,0,0,0,0,0,0,0
0,0,0,0,0,0,0,0,0
0,0,0,0,0,0,0,0,0
0,0,0,0,0,0,0,0,0
0,0,0,0,0,0,0,0,0
0,0,0,0,0,0,0,0,0
0,0,0,0,0,0,0,0,0
0,0,0,0,0,0,0,0,0
0,0,0,0,0,0,0,0,0
0,0,0,0,0,0,0,0,0
0,0,0,0,0,0,0,0,0
0,0,0,0,0,0,0,0,0
0,0,0,0,0,0,0,0,0
0,0,0,0,0,0,0,0,0
0,0,0,0,0,0,0,0,0
0,0,0,0,0,0,0,0,0
0,0,0,0,0,0,0,0,0
0,0,0,0,0,0,0,0,0
77822,101,1,4,2,2,0,0,0
0,0,0,0,0,0,0,0,0
0,0,0,0,0,0,0,0,0
0,0,0,0,0,0,0,0,0
0,0,0,0,0,0,0,0,0
0,0,0,0,0,0,0,0,0
0,0,0,0,0,0,0,0,0
0,0,0,0,0,0,0,0,0
0,0,0,0,0,0,0,0,0
2673,21,2,1,0,1,0,0,0
2673,21,2,1,0,1,0,0,0
2673,21,2,1,0,1,0,0,0
2673,21,2,1,0,1,0,0,0
2673,21,2,1,0,1,0,0,0
0,0,0,0,0,0,0,0,0
274802,180,4,1,1,0,0,1,0
0,0,0,0,0,0,0,0,0
0,0,0,0,0,0,0,0,0
0,0,0,0,0,0,0,0,0
0,0,0,0,0,0,0,0,0
0,0,0,0,0,0,0,0,0
21168,35,0,3,1,2,0,0,0
0,0,0,0,0,0,0,0,0
0,0,0,0,0,0,0,0,0
0,0,0,0,0,0,0,0,0
0,0,0,0,0,0,0,0,0
2852,42,2,2,1,1,0,1,0
0,0,0,0,0,0,0,0,0
0,0,0,0,0,0,0,0,0
0,0,0,0,0,0,0,0,0
0,0,0,0,0,0,0,0,0
0,0,0,0,0,0,0,0,0
0,0,0,0,0,0,0,0,0
0,0,0,0,0,0,0,0,0
0,0,0,0,0,0,0,0,0
0,0,0,0,0,0,0,0,0
0,0,0,0,0,0,0,0,0
0,0,0,0,0,0,0,0,0
90809,211,4,0,0,0,1,0,0
91082,209,4,0,0,0,1,0,0
91486,211,4,0,0,0,1,0,0
90988,211,4,0,0,0,1,0,0
90974,211,4,0,0,0,1,0,0
91406,211,4,0,0,0,1,0,0
91788,214,4,0,0,0,1,0,0
90513,209,4,0,0,0,1,0,0
0,0,0,0,0,0,0,0,0
0,0,0,0,0,0,0,0,0
0,0,0,0,0,0,0,0,0
91413,211,4,0,0,0,1,0,0
0,0,0,0,0,0,0,0,0
90850,209,4,0,0,0,1,0,0
91141,211,4,0,0,0,1,0,0
91448,211,4,0,0,0,1,0,0
92038,211,4,0,0,0,1,0,0
0,0,0,0,0,0,0,0,0
90780,211,4,0,0,0,1,0,0
0,0,0,0,0,0,0,0,0
0,0,0,0,0,0,0,0,0
91249,209,4,0,0,0,1,0,0
0,0,0,0,0,0,0,0,0
91348,211,4,0,0,0,1,0,0
0,0,0,0,0,0,0,0,0
0,0,0,0,0,0,0,0,0
0,0,0,0,0,0,0,0,0
0,0,0,0,0,0,0,0,0
0,0,0,0,0,0,0,0,0
0,0,0,0,0,0,0,0,0
0,0,0,0,0,0,0,0,0
0,0,0,0,0,0,0,0,0
0,0,0,0,0,0,0,0,0
0,0,0,0,0,0,0,0,0
0,0,0,0,0,0,0,0,0
0,0,0,0,0,0,0,0,0
4547,35,0,2,0,2,0,0,0
0,0,0,0,0,0,0,0,0
0,0,0,0,0,0,0,0,0
0,0,0,0,0,0,0,0,0
0,0,0,0,0,0,0,0,0
34341,62,2,0,0,0,0,0,0
0,0,0,0,0,0,0,0,0
0,0,0,0,0,0,0,0,0
0,0,0,0,0,0,0,0,0
674592,556,0,4,4,0,2,1,1
0,0,0,0,0,0,0,0,0
0,0,0,0,0,0,0,0,0
0,0,0,0,0,0,0,0,0
0,0,0,0,0,0,0,0,0
0,0,0,0,0,0,0,0,0
0,0,0,0,0,0,0,0,0
0,0,0,0,0,0,0,0,0
0,0,0,0,0,0,0,0,0
0,0,0,0,0,0,0,0,0
0,0,0,0,0,0,0,0,0
0,0,0,0,0,0,0,0,0
0,0,0,0,0,0,0,0,0
0,0,0,0,0,0,0,0,0
0,0,0,0,0,0,0,0,0
0,0,0,0,0,0,0,0,0
31629,69,6,1,0,1,0,1,0
31629,69,6,1,0,1,0,1,0
0,0,0,0,0,0,0,0,0
31629,69,6,1,0,1,0,1,0
31629,69,6,1,0,1,0,1,0
0,0,0,0,0,0,0,0,0
0,0,0,0,0,0,0,0,0
0,0,0,0,0,0,0,0,0
0,0,0,0,0,0,0,0,0
0,0,0,0,0,0,0,0,0
31629,69,6,1,0,1,0,1,0
0,0,0,0,0,0,0,0,0
0,0,0,0,0,0,0,0,0
0,0,0,0,0,0,0,0,0
0,0,0,0,0,0,0,0,0
0,0,0,0,0,0,0,0,0
0,0,0,0,0,0,0,0,0
0,0,0,0,0,0,0,0,0
0,0,0,0,0,0,0,0,0
0,0,0,0,0,0,0,0,0
0,0,0,0,0,0,0,0,0
0,0,0,0,0,0,0,0,0
0,0,0,0,0,0,0,0,0
0,0,0,0,0,0,0,0,0
0,0,0,0,0,0,0,0,0
0,0,0,0,0,0,0,0,0
71026,51,2,0,0,0,2,0,0
71026,51,2,0,0,0,2,0,0
71026,51,2,0,0,0,2,0,0
71026,51,2,0,0,0,2,0,0
0,0,0,0,0,0,0,0,0
71026,51,2,0,0,0,2,0,0
0,0,0,0,0,0,0,0,0
0,0,0,0,0,0,0,0,0
0,0,0,0,0,0,0,0,0
277565,179,4,1,1,0,0,1,0
0,0,0,0,0,0,0,0,0
0,0,0,0,0,0,0,0,0
0,0,0,0,0,0,0,0,0
50716,64,2,0,0,0,2,0,0
0,0,0,0,0,0,0,0,0
0,0,0,0,0,0,0,0,0
0,0,0,0,0,0,0,0,0
0,0,0,0,0,0,0,0,0
0,0,0,0,0,0,0,0,0
0,0,0,0,0,0,0,0,0
0,0,0,0,0,0,0,0,0
0,0,0,0,0,0,0,0,0
0,0,0,0,0,0,0,0,0
0,0,0,0,0,0,0,0,0
0,0,0,0,0,0,0,0,0
0,0,0,0,0,0,0,0,0
0,0,0,0,0,0,0,0,0
0,0,0,0,0,0,0,0,0
0,0,0,0,0,0,0,0,0
0,0,0,0,0,0,0,0,0
0,0,0,0,0,0,0,0,0
0,0,0,0,0,0,0,0,0
0,0,0,0,0,0,0,0,0
0,0,0,0,0,0,0,0,0
0,0,0,0,0,0,0,0,0
0,0,0,0,0,0,0,0,0
0,0,0,0,0,0,0,0,0
0,0,0,0,0,0,0,0,0
0,0,0,0,0,0,0,0,0
0,0,0,0,0,0,0,0,0
0,0,0,0,0,0,0,0,0
0,0,0,0,0,0,0,0,0
0,0,0,0,0,0,0,0,0
0,0,0,0,0,0,0,0,0
0,0,0,0,0,0,0,0,0
0,0,0,0,0,0,0,0,0
0,0,0,0,0,0,0,0,0
0,0,0,0,0,0,0,0,0
0,0,0,0,0,0,0,0,0
0,0,0,0,0,0,0,0,0
0,0,0,0,0,0,0,0,0
0,0,0,0,0,0,0,0,0
0,0,0,0,0,0,0,0,0
0,0,0,0,0,0,0,0,0
0,0,0,0,0,0,0,0,0
0,0,0,0,0,0,0,0,0
0,0,0,0,0,0,0,0,0
0,0,0,0,0,0,0,0,0
0,0,0,0,0,0,0,0,0
0,0,0,0,0,0,0,0,0
0,0,0,0,0,0,0,0,0
0,0,0,0,0,0,0,0,0
0,0,0,0,0,0,0,0,0
0,0,0,0,0,0,0,0,0
0,0,0,0,0,0,0,0,0
0,0,0,0,0,0,0,0,0
0,0,0,0,0,0,0,0,0
0,0,0,0,0,0,0,0,0
0,0,0,0,0,0,0,0,0
0,0,0,0,0,0,0,0,0
0,0,0,0,0,0,0,0,0
0,0,0,0,0,0,0,0,0
0,0,0,0,0,0,0,0,0
0,0,0,0,0,0,0,0,0
7106,92,3,4,3,1,0,0,0
0,0,0,0,0,0,0,0,0
0,0,0,0,0,0,0,0,0
3158,39,0,6,3,3,0,1,0
7105,92,3,4,3,1,0,0,0
0,0,0,0,0,0,0,0,0
0,0,0,0,0,0,0,0,0
0,0,0,0,0,0,0,0,0
9037,53,0,1,1,0,0,1,0
0,0,0,0,0,0,0,0,0
0,0,0,0,0,0,0,0,0
0,0,0,0,0,0,0,0,0
104833,928,6,226,30,196,7,1,0
0,0,0,0,0,0,0,0,0
0,0,0,0,0,0,0,0,0
0,0,0,0,0,0,0,0,0
77822,101,1,4,2,2,0,0,0
0,0,0,0,0,0,0,0,0
0,0,0,0,0,0,0,0,0
0,0,0,0,0,0,0,0,0
905278,94,1,4,1,3,0,0,0
141244,64,5,1,1,0,1,0,0
0,0,0,0,0,0,0,0,0
0,0,0,0,0,0,0,0,0
0,0,0,0,0,0,0,0,0
0,0,0,0,0,0,0,0,0
0,0,0,0,0,0,0,0,0
0,0,0,0,0,0,0,0,0
0,0,0,0,0,0,0,0,0
0,0,0,0,0,0,0,0,0
0,0,0,0,0,0,0,0,0
0,0,0,0,0,0,0,0,0
0,0,0,0,0,0,0,0,0
0,0,0,0,0,0,0,0,0
0,0,0,0,0,0,0,0,0
0,0,0,0,0,0,0,0,0
0,0,0,0,0,0,0,0,0
0,0,0,0,0,0,0,0,0
0,0,0,0,0,0,0,0,0
33869,170,6,8,5,3,1,0,0
0,0,0,0,0,0,0,0,0
0,0,0,0,0,0,0,0,0
0,0,0,0,0,0,0,0,0
0,0,0,0,0,0,0,0,0
0,0,0,0,0,0,0,0,0
0,0,0,0,0,0,0,0,0
0,0,0,0,0,0,0,0,0
0,0,0,0,0,0,0,0,0
0,0,0,0,0,0,0,0,0
0,0,0,0,0,0,0,0,0
0,0,0,0,0,0,0,0,0
0,0,0,0,0,0,0,0,0
0,0,0,0,0,0,0,0,0
0,0,0,0,0,0,0,0,0
0,0,0,0,0,0,0,0,0
0,0,0,0,0,0,0,0,0
0,0,0,0,0,0,0,0,0
0,0,0,0,0,0,0,0,0
0,0,0,0,0,0,0,0,0
0,0,0,0,0,0,0,0,0
0,0,0,0,0,0,0,0,0
0,0,0,0,0,0,0,0,0
0,0,0,0,0,0,0,0,0
0,0,0,0,0,0,0,0,0
0,0,0,0,0,0,0,0,0
0,0,0,0,0,0,0,0,0
0,0,0,0,0,0,0,0,0
0,0,0,0,0,0,0,0,0
0,0,0,0,0,0,0,0,0
0,0,0,0,0,0,0,0,0
0,0,0,0,0,0,0,0,0
0,0,0,0,0,0,0,0,0
0,0,0,0,0,0,0,0,0
118698,132,3,3,2,1,0,1,0
0,0,0,0,0,0,0,0,0
0,0,0,0,0,0,0,0,0
0,0,0,0,0,0,0,0,0
2673,21,2,1,0,1,0,0,0
2673,21,2,1,0,1,0,0,0
2673,21,2,1,0,1,0,0,0
2673,21,2,1,0,1,0,0,0
2673,21,2,1,0,1,0,0,0
2673,21,2,1,0,1,0,0,0
0,0,0,0,0,0,0,0,0
0,0,0,0,0,0,0,0,0
91355,211,4,0,0,0,1,0,0
91419,209,4,0,0,0,1,0,0
91035,211,4,0,0,0,1,0,0
0,0,0,0,0,0,0,0,0
0,0,0,0,0,0,0,0,0
48612,145,3,6,3,3,2,0,0
0,0,0,0,0,0,0,0,0
0,0,0,0,0,0,0,0,0
0,0,0,0,0,0,0,0,0
0,0,0,0,0,0,0,0,0
0,0,0,0,0,0,0,0,0
0,0,0,0,0,0,0,0,0
0,0,0,0,0,0,0,0,0
0,0,0,0,0,0,0,0,0
0,0,0,0,0,0,0,0,0
0,0,0,0,0,0,0,0,0
0,0,0,0,0,0,0,0,0
0,0,0,0,0,0,0,0,0
0,0,0,0,0,0,0,0,0
16288,89,0,15,2,13,0,1,0
42864,152,3,7,2,5,2,1,0
16292,89,0,15,2,13,0,1,0
0,0,0,0,0,0,0,0,0
0,0,0,0,0,0,0,0,0
0,0,0,0,0,0,0,0,0
0,0,0,0,0,0,0,0,0
0,0,0,0,0,0,0,0,0
0,0,0,0,0,0,0,0,0
0,0,0,0,0,0,0,0,0
0,0,0,0,0,0,0,0,0
0,0,0,0,0,0,0,0,0
0,0,0,0,0,0,0,0,0
0,0,0,0,0,0,0,0,0
0,0,0,0,0,0,0,0,0
0,0,0,0,0,0,0,0,0
0,0,0,0,0,0,0,0,0
9082,79,1,0,0,0,0,0,0
0,0,0,0,0,0,0,0,0
0,0,0,0,0,0,0,0,0
0,0,0,0,0,0,0,0,0
0,0,0,0,0,0,0,0,0
0,0,0,0,0,0,0,0,0
0,0,0,0,0,0,0,0,0
0,0,0,0,0,0,0,0,0
0,0,0,0,0,0,0,0,0
0,0,0,0,0,0,0,0,0
0,0,0,0,0,0,0,0,0
0,0,0,0,0,0,0,0,0
0,0,0,0,0,0,0,0,0
0,0,0,0,0,0,0,0,0
0,0,0,0,0,0,0,0,0
0,0,0,0,0,0,0,0,0
0,0,0,0,0,0,0,0,0
0,0,0,0,0,0,0,0,0
0,0,0,0,0,0,0,0,0
0,0,0,0,0,0,0,0,0
0,0,0,0,0,0,0,0,0
0,0,0,0,0,0,0,0,0
0,0,0,0,0,0,0,0,0
0,0,0,0,0,0,0,0,0
0,0,0,0,0,0,0,0,0
0,0,0,0,0,0,0,0,0
0,0,0,0,0,0,0,0,0
0,0,0,0,0,0,0,0,0
0,0,0,0,0,0,0,0,0
0,0,0,0,0,0,0,0,0
0,0,0,0,0,0,0,0,0
0,0,0,0,0,0,0,0,0
0,0,0,0,0,0,0,0,0
0,0,0,0,0,0,0,0,0
0,0,0,0,0,0,0,0,0
0,0,0,0,0,0,0,0,0
0,0,0,0,0,0,0,0,0
0,0,0,0,0,0,0,0,0
0,0,0,0,0,0,0,0,0
0,0,0,0,0,0,0,0,0
0,0,0,0,0,0,0,0,0
0,0,0,0,0,0,0,0,0
0,0,0,0,0,0,0,0,0
0,0,0,0,0,0,0,0,0
0,0,0,0,0,0,0,0,0
0,0,0,0,0,0,0,0,0
0,0,0,0,0,0,0,0,0
0,0,0,0,0,0,0,0,0
0,0,0,0,0,0,0,0,0
0,0,0,0,0,0,0,0,0
0,0,0,0,0,0,0,0,0
0,0,0,0,0,0,0,0,0
0,0,0,0,0,0,0,0,0
0,0,0,0,0,0,0,0,0
0,0,0,0,0,0,0,0,0
0,0,0,0,0,0,0,0,0
0,0,0,0,0,0,0,0,0
0,0,0,0,0,0,0,0,0
0,0,0,0,0,0,0,0,0
0,0,0,0,0,0,0,0,0
0,0,0,0,0,0,0,0,0
0,0,0,0,0,0,0,0,0
0,0,0,0,0,0,0,0,0
0,0,0,0,0,0,0,0,0
0,0,0,0,0,0,0,0,0
0,0,0,0,0,0,0,0,0
0,0,0,0,0,0,0,0,0
0,0,0,0,0,0,0,0,0
22883,223,3,24,24,0,0,1,0
677867,542,0,4,0,4,2,1,1
63767,50,3,0,0,0,0,0,0
0,0,0,0,0,0,0,0,0
0,0,0,0,0,0,0,0,0
9403,31,1,0,0,0,1,0,0
0,0,0,0,0,0,0,0,0
32102,163,4,17,16,1,4,0,0
32102,163,4,17,16,1,4,0,0
32102,163,4,17,16,1,4,0,0
32102,163,4,17,16,1,4,0,0
0,0,0,0,0,0,0,0,0
0,0,0,0,0,0,0,0,0
32102,163,4,17,16,1,4,0,0
28551,47,4,0,0,0,0,0,0
0,0,0,0,0,0,0,0,0
0,0,0,0,0,0,0,0,0
0,0,0,0,0,0,0,0,0
9627,112,2,4,4,0,2,0,0
0,0,0,0,0,0,0,0,0
9627,112,2,4,4,0,2,0,0
9627,112,2,4,4,0,2,0,0
9627,112,2,4,4,0,2,0,0
0,0,0,0,0,0,0,0,0
0,0,0,0,0,0,0,0,0
9627,112,2,4,4,0,2,0,0
0,0,0,0,0,0,0,0,0
0,0,0,0,0,0,0,0,0
0,0,0,0,0,0,0,0,0
0,0,0,0,0,0,0,0,0
0,0,0,0,0,0,0,0,0
0,0,0,0,0,0,0,0,0
0,0,0,0,0,0,0,0,0
0,0,0,0,0,0,0,0,0
3788,44,0,2,0,2,1,0,0
0,0,0,0,0,0,0,0,0
0,0,0,0,0,0,0,0,0
0,0,0,0,0,0,0,0,0
0,0,0,0,0,0,0,0,0
0,0,0,0,0,0,0,0,0
63767,50,3,0,0,0,0,0,0
0,0,0,0,0,0,0,0,0
0,0,0,0,0,0,0,0,0
655873,28,1,0,0,0,0,0,0
655873,28,1,0,0,0,0,0,0
0,0,0,0,0,0,0,0,0
0,0,0,0,0,0,0,0,0
0,0,0,0,0,0,0,0,0
0,0,0,0,0,0,0,0,0
0,0,0,0,0,0,0,0,0
327172,68,4,3,3,0,2,1,0
327172,68,4,3,3,0,2,1,0
0,0,0,0,0,0,0,0,0
0,0,0,0,0,0,0,0,0
0,0,0,0,0,0,0,0,0
0,0,0,0,0,0,0,0,0
0,0,0,0,0,0,0,0,0
327172,68,4,3,3,0,2,1,0
327172,68,4,3,3,0,2,1,0
0,0,0,0,0,0,0,0,0
0,0,0,0,0,0,0,0,0
0,0,0,0,0,0,0,0,0
0,0,0,0,0,0,0,0,0
327172,68,4,3,3,0,2,1,0
327172,68,4,3,3,0,2,1,0
0,0,0,0,0,0,0,0,0
0,0,0,0,0,0,0,0,0
0,0,0,0,0,0,0,0,0
0,0,0,0,0,0,0,0,0
0,0,0,0,0,0,0,0,0
0,0,0,0,0,0,0,0,0
0,0,0,0,0,0,0,0,0
0,0,0,0,0,0,0,0,0
0,0,0,0,0,0,0,0,0
0,0,0,0,0,0,0,0,0
327172,68,4,3,3,0,2,1,0
0,0,0,0,0,0,0,0,0
0,0,0,0,0,0,0,0,0
0,0,0,0,0,0,0,0,0
0,0,0,0,0,0,0,0,0
28052,97,0,2,0,2,2,0,0
30048,51,2,0,0,0,2,0,0
0,0,0,0,0,0,0,0,0
0,0,0,0,0,0,0,0,0
0,0,0,0,0,0,0,0,0
0,0,0,0,0,0,0,0,0
0,0,0,0,0,0,0,0,0
121452,48,4,0,0,0,0,0,0
0,0,0,0,0,0,0,0,0
0,0,0,0,0,0,0,0,0
0,0,0,0,0,0,0,0,0
0,0,0,0,0,0,0,0,0
0,0,0,0,0,0,0,0,0
0,0,0,0,0,0,0,0,0
0,0,0,0,0,0,0,0,0
0,0,0,0,0,0,0,0,0
0,0,0,0,0,0,0,0,0
0,0,0,0,0,0,0,0,0
0,0,0,0,0,0,0,0,0
0,0,0,0,0,0,0,0,0
679756,557,0,4,0,4,2,1,1
0,0,0,0,0,0,0,0,0
0,0,0,0,0,0,0,0,0
0,0,0,0,0,0,0,0,0
48612,145,3,6,3,3,2,0,0
0,0,0,0,0,0,0,0,0
0,0,0,0,0,0,0,0,0
0,0,0,0,0,0,0,0,0
0,0,0,0,0,0,0,0,0
0,0,0,0,0,0,0,0,0
0,0,0,0,0,0,0,0,0
0,0,0,0,0,0,0,0,0
0,0,0,0,0,0,0,0,0
0,0,0,0,0,0,0,0,0
0,0,0,0,0,0,0,0,0
0,0,0,0,0,0,0,0,0
0,0,0,0,0,0,0,0,0
0,0,0,0,0,0,0,0,0
0,0,0,0,0,0,0,0,0
19676,66,0,1,0,1,2,1,0
11061,78,0,6,2,4,0,1,0
0,0,0,0,0,0,0,0,0
15730,87,0,0,0,0,0,0,0
9550,28,1,2,1,1,0,0,0
9550,28,1,2,2,0,0,0,0
103558,593,9,72,67,5,0,1,0
0,0,0,0,0,0,0,0,0
19777,71,0,3,2,1,1,0,0
0,0,0,0,0,0,0,0,0
0,0,0,0,0,0,0,0,0
0,0,0,0,0,0,0,0,0
676393,557,0,4,4,0,2,1,1
0,0,0,0,0,0,0,0,0
91929,211,4,0,0,0,1,0,0
90318,211,4,0,0,0,1,0,0
93194,211,4,0,0,0,1,0,0
0,0,0,0,0,0,0,0,0
91084,211,4,0,0,0,1,0,0
0,0,0,0,0,0,0,0,0
0,0,0,0,0,0,0,0,0
0,0,0,0,0,0,0,0,0
0,0,0,0,0,0,0,0,0
0,0,0,0,0,0,0,0,0
0,0,0,0,0,0,0,0,0
0,0,0,0,0,0,0,0,0
0,0,0,0,0,0,0,0,0
0,0,0,0,0,0,0,0,0
0,0,0,0,0,0,0,0,0
8182,146,0,15,15,0,5,1,0
0,0,0,0,0,0,0,0,0
0,0,0,0,0,0,0,0,0
0,0,0,0,0,0,0,0,0
0,0,0,0,0,0,0,0,0
0,0,0,0,0,0,0,0,0
0,0,0,0,0,0,0,0,0
0,0,0,0,0,0,0,0,0
0,0,0,0,0,0,0,0,0
4675780,266,4,6,6,0,1,1,0
9394,31,1,0,0,0,1,0,0
77738,101,1,4,2,2,0,0,0
0,0,0,0,0,0,0,0,0
39945,127,2,5,2,3,1,1,0
60489,276,12,13,12,1,0,0,0
60489,276,12,13,2,11,0,0,0
0,0,0,0,0,0,0,0,0
0,0,0,0,0,0,0,0,0
0,0,0,0,0,0,0,0,0
0,0,0,0,0,0,0,0,0
0,0,0,0,0,0,0,0,0
0,0,0,0,0,0,0,0,0
0,0,0,0,0,0,0,0,0
63785,50,3,0,0,0,0,0,0
0,0,0,0,0,0,0,0,0
0,0,0,0,0,0,0,0,0
0,0,0,0,0,0,0,0,0
0,0,0,0,0,0,0,0,0
0,0,0,0,0,0,0,0,0
0,0,0,0,0,0,0,0,0
2219,30,2,1,0,1,0,0,0
0,0,0,0,0,0,0,0,0
0,0,0,0,0,0,0,0,0
444363,59,2,5,4,1,3,1,0
0,0,0,0,0,0,0,0,0
0,0,0,0,0,0,0,0,0
0,0,0,0,0,0,0,0,0
0,0,0,0,0,0,0,0,0
0,0,0,0,0,0,0,0,0
0,0,0,0,0,0,0,0,0
0,0,0,0,0,0,0,0,0
0,0,0,0,0,0,0,0,0
0,0,0,0,0,0,0,0,0
61181,301,1,6,4,2,0,0,0
0,0,0,0,0,0,0,0,0
0,0,0,0,0,0,0,0,0
0,0,0,0,0,0,0,0,0
0,0,0,0,0,0,0,0,0
0,0,0,0,0,0,0,0,0
0,0,0,0,0,0,0,0,0
0,0,0,0,0,0,0,0,0
0,0,0,0,0,0,0,0,0
0,0,0,0,0,0,0,0,0
0,0,0,0,0,0,0,0,0
0,0,0,0,0,0,0,0,0
0,0,0,0,0,0,0,0,0
121237,710,4,103,99,4,2,1,0
0,0,0,0,0,0,0,0,0
0,0,0,0,0,0,0,0,0
0,0,0,0,0,0,0,0,0
0,0,0,0,0,0,0,0,0
0,0,0,0,0,0,0,0,0
0,0,0,0,0,0,0,0,0
0,0,0,0,0,0,0,0,0
0,0,0,0,0,0,0,0,0
0,0,0,0,0,0,0,0,0
0,0,0,0,0,0,0,0,0
0,0,0,0,0,0,0,0,0
77822,101,1,4,2,2,0,0,0
0,0,0,0,0,0,0,0,0
0,0,0,0,0,0,0,0,0
0,0,0,0,0,0,0,0,0
0,0,0,0,0,0,0,0,0
0,0,0,0,0,0,0,0,0
0,0,0,0,0,0,0,0,0
0,0,0,0,0,0,0,0,0
0,0,0,0,0,0,0,0,0
0,0,0,0,0,0,0,0,0
0,0,0,0,0,0,0,0,0
0,0,0,0,0,0,0,0,0
0,0,0,0,0,0,0,0,0
0,0,0,0,0,0,0,0,0
0,0,0,0,0,0,0,0,0
0,0,0,0,0,0,0,0,0
0,0,0,0,0,0,0,0,0
0,0,0,0,0,0,0,0,0
0,0,0,0,0,0,0,0,0
0,0,0,0,0,0,0,0,0
0,0,0,0,0,0,0,0,0
0,0,0,0,0,0,0,0,0
0,0,0,0,0,0,0,0,0
0,0,0,0,0,0,0,0,0
0,0,0,0,0,0,0,0,0
0,0,0,0,0,0,0,0,0
0,0,0,0,0,0,0,0,0
205163,1063,1,259,220,39,3,0,0
88615,915,1,257,221,36,3,0,0
0,0,0,0,0,0,0,0,0
0,0,0,0,0,0,0,0,0
0,0,0,0,0,0,0,0,0
88615,915,1,257,220,37,3,0,0
88133,913,1,257,220,37,2,0,0
0,0,0,0,0,0,0,0,0
0,0,0,0,0,0,0,0,0
0,0,0,0,0,0,0,0,0
0,0,0,0,0,0,0,0,0
0,0,0,0,0,0,0,0,0
0,0,0,0,0,0,0,0,0
0,0,0,0,0,0,0,0,0
0,0,0,0,0,0,0,0,0
0,0,0,0,0,0,0,0,0
0,0,0,0,0,0,0,0,0
0,0,0,0,0,0,0,0,0
0,0,0,0,0,0,0,0,0
0,0,0,0,0,0,0,0,0
34403,50,2,0,0,0,2,0,0
0,0,0,0,0,0,0,0,0
0,0,0,0,0,0,0,0,0
0,0,0,0,0,0,0,0,0
16744,33,1,0,0,0,1,0,0
0,0,0,0,0,0,0,0,0
77222,42,4,1,1,0,2,0,0
34403,50,2,0,0,0,2,0,0
0,0,0,0,0,0,0,0,0
0,0,0,0,0,0,0,0,0
0,0,0,0,0,0,0,0,0
144513,62,4,3,3,0,2,1,0
77222,42,4,1,1,0,2,0,0
0,0,0,0,0,0,0,0,0
60453,82,4,6,6,0,5,0,0
16744,33,1,0,0,0,1,0,0
124953,204,2,50,49,1,0,1,0
60453,82,4,6,6,0,5,0,0
2742761,5,0,0,0,0,0,0,0
124953,204,2,50,49,1,0,1,0
60453,82,4,6,6,0,5,0,0
60453,82,4,6,6,0,5,0,0
0,0,0,0,0,0,0,0,0
0,0,0,0,0,0,0,0,0
2742761,5,0,0,0,0,0,0,0
0,0,0,0,0,0,0,0,0
337892,43,4,1,1,0,2,0,0
0,0,0,0,0,0,0,0,0
0,0,0,0,0,0,0,0,0
0,0,0,0,0,0,0,0,0
337892,43,4,1,1,0,2,0,0
0,0,0,0,0,0,0,0,0
0,0,0,0,0,0,0,0,0
0,0,0,0,0,0,0,0,0
0,0,0,0,0,0,0,0,0
60453,82,4,6,6,0,5,0,0
0,0,0,0,0,0,0,0,0
0,0,0,0,0,0,0,0,0
0,0,0,0,0,0,0,0,0
0,0,0,0,0,0,0,0,0
0,0,0,0,0,0,0,0,0
0,0,0,0,0,0,0,0,0
0,0,0,0,0,0,0,0,0
0,0,0,0,0,0,0,0,0
0,0,0,0,0,0,0,0,0
0,0,0,0,0,0,0,0,0
0,0,0,0,0,0,0,0,0
0,0,0,0,0,0,0,0,0
0,0,0,0,0,0,0,0,0
0,0,0,0,0,0,0,0,0
0,0,0,0,0,0,0,0,0
0,0,0,0,0,0,0,0,0
0,0,0,0,0,0,0,0,0
0,0,0,0,0,0,0,0,0
0,0,0,0,0,0,0,0,0
0,0,0,0,0,0,0,0,0
0,0,0,0,0,0,0,0,0
0,0,0,0,0,0,0,0,0
0,0,0,0,0,0,0,0,0
0,0,0,0,0,0,0,0,0
0,0,0,0,0,0,0,0,0
0,0,0,0,0,0,0,0,0
0,0,0,0,0,0,0,0,0
0,0,0,0,0,0,0,0,0
0,0,0,0,0,0,0,0,0
0,0,0,0,0,0,0,0,0
0,0,0,0,0,0,0,0,0
0,0,0,0,0,0,0,0,0
0,0,0,0,0,0,0,0,0
0,0,0,0,0,0,0,0,0
0,0,0,0,0,0,0,0,0
0,0,0,0,0,0,0,0,0
0,0,0,0,0,0,0,0,0
0,0,0,0,0,0,0,0,0
0,0,0,0,0,0,0,0,0
0,0,0,0,0,0,0,0,0
0,0,0,0,0,0,0,0,0
0,0,0,0,0,0,0,0,0
0,0,0,0,0,0,0,0,0
0,0,0,0,0,0,0,0,0
0,0,0,0,0,0,0,0,0
0,0,0,0,0,0,0,0,0
0,0,0,0,0,0,0,0,0
0,0,0,0,0,0,0,0,0
0,0,0,0,0,0,0,0,0
0,0,0,0,0,0,0,0,0
0,0,0,0,0,0,0,0,0
0,0,0,0,0,0,0,0,0
0,0,0,0,0,0,0,0,0
0,0,0,0,0,0,0,0,0
0,0,0,0,0,0,0,0,0
0,0,0,0,0,0,0,0,0
0,0,0,0,0,0,0,0,0
0,0,0,0,0,0,0,0,0
0,0,0,0,0,0,0,0,0
0,0,0,0,0,0,0,0,0
0,0,0,0,0,0,0,0,0
0,0,0,0,0,0,0,0,0
0,0,0,0,0,0,0,0,0
0,0,0,0,0,0,0,0,0
0,0,0,0,0,0,0,0,0
0,0,0,0,0,0,0,0,0
0,0,0,0,0,0,0,0,0
0,0,0,0,0,0,0,0,0
0,0,0,0,0,0,0,0,0
0,0,0,0,0,0,0,0,0
0,0,0,0,0,0,0,0,0
0,0,0,0,0,0,0,0,0
0,0,0,0,0,0,0,0,0
0,0,0,0,0,0,0,0,0
0,0,0,0,0,0,0,0,0
0,0,0,0,0,0,0,0,0
0,0,0,0,0,0,0,0,0
0,0,0,0,0,0,0,0,0
0,0,0,0,0,0,0,0,0
0,0,0,0,0,0,0,0,0
0,0,0,0,0,0,0,0,0
0,0,0,0,0,0,0,0,0
0,0,0,0,0,0,0,0,0
0,0,0,0,0,0,0,0,0
0,0,0,0,0,0,0,0,0
0,0,0,0,0,0,0,0,0
0,0,0,0,0,0,0,0,0
0,0,0,0,0,0,0,0,0
0,0,0,0,0,0,0,0,0
0,0,0,0,0,0,0,0,0
0,0,0,0,0,0,0,0,0
0,0,0,0,0,0,0,0,0
307313,252,4,3,3,0,0,1,0
77738,101,1,4,2,2,0,0,0
77774,101,1,4,2,2,0,0,0
0,0,0,0,0,0,0,0,0
0,0,0,0,0,0,0,0,0
0,0,0,0,0,0,0,0,0
3776,44,0,2,0,2,1,0,0
0,0,0,0,0,0,0,0,0
0,0,0,0,0,0,0,0,0
0,0,0,0,0,0,0,0,0
0,0,0,0,0,0,0,0,0
0,0,0,0,0,0,0,0,0
0,0,0,0,0,0,0,0,0
0,0,0,0,0,0,0,0,0
0,0,0,0,0,0,0,0,0
0,0,0,0,0,0,0,0,0
0,0,0,0,0,0,0,0,0
0,0,0,0,0,0,0,0,0
0,0,0,0,0,0,0,0,0
0,0,0,0,0,0,0,0,0
0,0,0,0,0,0,0,0,0
0,0,0,0,0,0,0,0,0
0,0,0,0,0,0,0,0,0
0,0,0,0,0,0,0,0,0
16295,89,0,15,1,14,0,1,0
0,0,0,0,0,0,0,0,0
0,0,0,0,0,0,0,0,0
0,0,0,0,0,0,0,0,0
0,0,0,0,0,0,0,0,0
0,0,0,0,0,0,0,0,0
0,0,0,0,0,0,0,0,0
0,0,0,0,0,0,0,0,0
0,0,0,0,0,0,0,0,0
0,0,0,0,0,0,0,0,0
0,0,0,0,0,0,0,0,0
0,0,0,0,0,0,0,0,0
0,0,0,0,0,0,0,0,0
0,0,0,0,0,0,0,0,0
0,0,0,0,0,0,0,0,0
0,0,0,0,0,0,0,0,0
0,0,0,0,0,0,0,0,0
0,0,0,0,0,0,0,0,0
0,0,0,0,0,0,0,0,0
104596,927,6,226,50,176,6,1,0
0,0,0,0,0,0,0,0,0
0,0,0,0,0,0,0,0,0
0,0,0,0,0,0,0,0,0
0,0,0,0,0,0,0,0,0
0,0,0,0,0,0,0,0,0
0,0,0,0,0,0,0,0,0
0,0,0,0,0,0,0,0,0
0,0,0,0,0,0,0,0,0
0,0,0,0,0,0,0,0,0
0,0,0,0,0,0,0,0,0
11059,78,0,6,2,4,0,1,0
0,0,0,0,0,0,0,0,0
0,0,0,0,0,0,0,0,0
0,0,0,0,0,0,0,0,0
0,0,0,0,0,0,0,0,0
3201725,55,2,1,1,0,0,1,0
0,0,0,0,0,0,0,0,0
0,0,0,0,0,0,0,0,0
0,0,0,0,0,0,0,0,0
0,0,0,0,0,0,0,0,0
90919,209,4,0,0,0,1,0,0
91490,211,4,0,0,0,1,0,0
0,0,0,0,0,0,0,0,0
0,0,0,0,0,0,0,0,0
0,0,0,0,0,0,0,0,0
17250,89,1,0,0,0,2,0,0
0,0,0,0,0,0,0,0,0
0,0,0,0,0,0,0,0,0
0,0,0,0,0,0,0,0,0
0,0,0,0,0,0,0,0,0
0,0,0,0,0,0,0,0,0
0,0,0,0,0,0,0,0,0
63785,50,3,0,0,0,0,0,0
0,0,0,0,0,0,0,0,0
0,0,0,0,0,0,0,0,0
0,0,0,0,0,0,0,0,0
0,0,0,0,0,0,0,0,0
0,0,0,0,0,0,0,0,0
0,0,0,0,0,0,0,0,0
0,0,0,0,0,0,0,0,0
0,0,0,0,0,0,0,0,0
0,0,0,0,0,0,0,0,0
0,0,0,0,0,0,0,0,0
0,0,0,0,0,0,0,0,0
0,0,0,0,0,0,0,0,0
671949,542,0,4,4,0,2,1,1
9537,28,1,2,2,0,0,0,0
9537,28,1,2,1,1,0,0,0
0,0,0,0,0,0,0,0,0
0,0,0,0,0,0,0,0,0
0,0,0,0,0,0,0,0,0
0,0,0,0,0,0,0,0,0
0,0,0,0,0,0,0,0,0
0,0,0,0,0,0,0,0,0
0,0,0,0,0,0,0,0,0
0,0,0,0,0,0,0,0,0
132237,306,8,26,1,25,16,1,0
94543,60,1,3,3,0,0,1,0
0,0,0,0,0,0,0,0,0
0,0,0,0,0,0,0,0,0
0,0,0,0,0,0,0,0,0
0,0,0,0,0,0,0,0,0
0,0,0,0,0,0,0,0,0
0,0,0,0,0,0,0,0,0
0,0,0,0,0,0,0,0,0
0,0,0,0,0,0,0,0,0
0,0,0,0,0,0,0,0,0
0,0,0,0,0,0,0,0,0
674186,556,0,4,4,0,2,1,1
0,0,0,0,0,0,0,0,0
0,0,0,0,0,0,0,0,0
0,0,0,0,0,0,0,0,0
0,0,0,0,0,0,0,0,0
2673,21,2,1,0,1,0,0,0
0,0,0,0,0,0,0,0,0
0,0,0,0,0,0,0,0,0
0,0,0,0,0,0,0,0,0
213002,475,3,3,0,3,2,0,0
0,0,0,0,0,0,0,0,0
0,0,0,0,0,0,0,0,0
123843,1595,3,210,173,37,10,1,0
0,0,0,0,0,0,0,0,0
0,0,0,0,0,0,0,0,0
0,0,0,0,0,0,0,0,0
0,0,0,0,0,0,0,0,0
0,0,0,0,0,0,0,0,0
0,0,0,0,0,0,0,0,0
0,0,0,0,0,0,0,0,0
0,0,0,0,0,0,0,0,0
0,0,0,0,0,0,0,0,0
0,0,0,0,0,0,0,0,0
0,0,0,0,0,0,0,0,0
0,0,0,0,0,0,0,0,0
0,0,0,0,0,0,0,0,0
132261,306,8,26,24,2,16,1,0
0,0,0,0,0,0,0,0,0
0,0,0,0,0,0,0,0,0
0,0,0,0,0,0,0,0,0
63772,50,3,0,0,0,0,0,0
0,0,0,0,0,0,0,0,0
0,0,0,0,0,0,0,0,0
0,0,0,0,0,0,0,0,0
0,0,0,0,0,0,0,0,0
0,0,0,0,0,0,0,0,0
0,0,0,0,0,0,0,0,0
0,0,0,0,0,0,0,0,0
0,0,0,0,0,0,0,0,0
91326,213,4,0,0,0,1,0,0
88940,211,4,0,0,0,1,0,0
91540,211,4,0,0,0,1,0,0
0,0,0,0,0,0,0,0,0
0,0,0,0,0,0,0,0,0
144513,62,4,3,3,0,2,1,0
0,0,0,0,0,0,0,0,0
0,0,0,0,0,0,0,0,0
0,0,0,0,0,0,0,0,0
0,0,0,0,0,0,0,0,0
0,0,0,0,0,0,0,0,0
0,0,0,0,0,0,0,0,0
0,0,0,0,0,0,0,0,0
0,0,0,0,0,0,0,0,0
0,0,0,0,0,0,0,0,0
0,0,0,0,0,0,0,0,0
0,0,0,0,0,0,0,0,0
0,0,0,0,0,0,0,0,0
0,0,0,0,0,0,0,0,0
0,0,0,0,0,0,0,0,0
0,0,0,0,0,0,0,0,0
0,0,0,0,0,0,0,0,0
0,0,0,0,0,0,0,0,0
78765,728,9,54,49,5,1,1,0
0,0,0,0,0,0,0,0,0
0,0,0,0,0,0,0,0,0
0,0,0,0,0,0,0,0,0
0,0,0,0,0,0,0,0,0
0,0,0,0,0,0,0,0,0
0,0,0,0,0,0,0,0,0
0,0,0,0,0,0,0,0,0
0,0,0,0,0,0,0,0,0
0,0,0,0,0,0,0,0,0
0,0,0,0,0,0,0,0,0
0,0,0,0,0,0,0,0,0
0,0,0,0,0,0,0,0,0
0,0,0,0,0,0,0,0,0
0,0,0,0,0,0,0,0,0
8173,146,0,15,15,0,5,1,0
162681,218,4,26,19,7,2,1,0
0,0,0,0,0,0,0,0,0
0,0,0,0,0,0,0,0,0
0,0,0,0,0,0,0,0,0
0,0,0,0,0,0,0,0,0
0,0,0,0,0,0,0,0,0
0,0,0,0,0,0,0,0,0
0,0,0,0,0,0,0,0,0
0,0,0,0,0,0,0,0,0
0,0,0,0,0,0,0,0,0
0,0,0,0,0,0,0,0,0
0,0,0,0,0,0,0,0,0
0,0,0,0,0,0,0,0,0
0,0,0,0,0,0,0,0,0
0,0,0,0,0,0,0,0,0
0,0,0,0,0,0,0,0,0
0,0,0,0,0,0,0,0,0
0,0,0,0,0,0,0,0,0
0,0,0,0,0,0,0,0,0
0,0,0,0,0,0,0,0,0
0,0,0,0,0,0,0,0,0
0,0,0,0,0,0,0,0,0
19976,213,2,48,47,1,2,1,0
0,0,0,0,0,0,0,0,0
0,0,0,0,0,0,0,0,0
0,0,0,0,0,0,0,0,0
0,0,0,0,0,0,0,0,0
0,0,0,0,0,0,0,0,0
0,0,0,0,0,0,0,0,0
0,0,0,0,0,0,0,0,0
0,0,0,0,0,0,0,0,0
33097,177,1,35,35,0,2,0,0
0,0,0,0,0,0,0,0,0
0,0,0,0,0,0,0,0,0
0,0,0,0,0,0,0,0,0
0,0,0,0,0,0,0,0,0
0,0,0,0,0,0,0,0,0
0,0,0,0,0,0,0,0,0
0,0,0,0,0,0,0,0,0
0,0,0,0,0,0,0,0,0
0,0,0,0,0,0,0,0,0
0,0,0,0,0,0,0,0,0
0,0,0,0,0,0,0,0,0
0,0,0,0,0,0,0,0,0
0,0,0,0,0,0,0,0,0
0,0,0,0,0,0,0,0,0
0,0,0,0,0,0,0,0,0
0,0,0,0,0,0,0,0,0
0,0,0,0,0,0,0,0,0
0,0,0,0,0,0,0,0,0
0,0,0,0,0,0,0,0,0
3345,18,0,0,0,0,3,0,0
3362,18,0,0,0,0,3,0,0
0,0,0,0,0,0,0,0,0
0,0,0,0,0,0,0,0,0
0,0,0,0,0,0,0,0,0
0,0,0,0,0,0,0,0,0
0,0,0,0,0,0,0,0,0
0,0,0,0,0,0,0,0,0
0,0,0,0,0,0,0,0,0
0,0,0,0,0,0,0,0,0
0,0,0,0,0,0,0,0,0
34412,50,2,0,0,0,2,0,0
34412,50,2,0,0,0,2,0,0
33583,46,2,0,0,0,2,0,0
33583,46,2,0,0,0,2,0,0
0,0,0,0,0,0,0,0,0
0,0,0,0,0,0,0,0,0
34412,50,2,0,0,0,2,0,0
34412,50,2,0,0,0,2,0,0
0,0,0,0,0,0,0,0,0
33583,46,2,0,0,0,2,0,0
33583,46,2,0,0,0,2,0,0
0,0,0,0,0,0,0,0,0
0,0,0,0,0,0,0,0,0
33583,46,2,0,0,0,2,0,0
33583,46,2,0,0,0,2,0,0
0,0,0,0,0,0,0,0,0
0,0,0,0,0,0,0,0,0
0,0,0,0,0,0,0,0,0
33583,46,2,0,0,0,2,0,0
0,0,0,0,0,0,0,0,0
0,0,0,0,0,0,0,0,0
36413,50,2,0,0,0,2,0,0
36413,50,2,0,0,0,2,0,0
134437,59,4,3,3,0,2,1,0
134437,59,4,3,3,0,2,1,0
46069,57,4,3,3,0,2,0,0
46069,57,4,3,3,0,2,0,0
134437,59,4,3,3,0,2,1,0
0,0,0,0,0,0,0,0,0
16605,63,4,9,9,0,2,0,0
16605,63,4,9,9,0,2,0,0
0,0,0,0,0,0,0,0,0
0,0,0,0,0,0,0,0,0
0,0,0,0,0,0,0,0,0
0,0,0,0,0,0,0,0,0
16605,63,4,9,9,0,2,0,0
0,0,0,0,0,0,0,0,0
0,0,0,0,0,0,0,0,0
0,0,0,0,0,0,0,0,0
0,0,0,0,0,0,0,0,0
102468,28,2,0,0,0,0,0,0
0,0,0,0,0,0,0,0,0
0,0,0,0,0,0,0,0,0
0,0,0,0,0,0,0,0,0
102468,28,2,0,0,0,0,0,0
0,0,0,0,0,0,0,0,0
0,0,0,0,0,0,0,0,0
0,0,0,0,0,0,0,0,0
9198,61,2,5,5,0,2,0,0
9198,61,2,5,5,0,2,0,0
144440,59,4,3,3,0,2,1,0
144440,59,4,3,3,0,2,1,0
9198,61,2,5,5,0,2,0,0
144440,59,4,3,3,0,2,1,0
332523,60,4,3,3,0,2,1,0
332523,60,4,3,3,0,2,1,0
0,0,0,0,0,0,0,0,0
144440,59,4,3,3,0,2,1,0
0,0,0,0,0,0,0,0,0
0,0,0,0,0,0,0,0,0
0,0,0,0,0,0,0,0,0
332523,60,4,3,3,0,2,1,0
0,0,0,0,0,0,0,0,0
0,0,0,0,0,0,0,0,0
0,0,0,0,0,0,0,0,0
332523,60,4,3,3,0,2,1,0
0,0,0,0,0,0,0,0,0
327196,60,4,3,3,0,2,1,0
327196,60,4,3,3,0,2,1,0
0,0,0,0,0,0,0,0,0
0,0,0,0,0,0,0,0,0
0,0,0,0,0,0,0,0,0
0,0,0,0,0,0,0,0,0
0,0,0,0,0,0,0,0,0
0,0,0,0,0,0,0,0,0
0,0,0,0,0,0,0,0,0
0,0,0,0,0,0,0,0,0
0,0,0,0,0,0,0,0,0
0,0,0,0,0,0,0,0,0
0,0,0,0,0,0,0,0,0
0,0,0,0,0,0,0,0,0
0,0,0,0,0,0,0,0,0
0,0,0,0,0,0,0,0,0
0,0,0,0,0,0,0,0,0
0,0,0,0,0,0,0,0,0
0,0,0,0,0,0,0,0,0
0,0,0,0,0,0,0,0,0
0,0,0,0,0,0,0,0,0
0,0,0,0,0,0,0,0,0
0,0,0,0,0,0,0,0,0
0,0,0,0,0,0,0,0,0
0,0,0,0,0,0,0,0,0
0,0,0,0,0,0,0,0,0
0,0,0,0,0,0,0,0,0
0,0,0,0,0,0,0,0,0
0,0,0,0,0,0,0,0,0
0,0,0,0,0,0,0,0,0
0,0,0,0,0,0,0,0,0
0,0,0,0,0,0,0,0,0
0,0,0,0,0,0,0,0,0
0,0,0,0,0,0,0,0,0
0,0,0,0,0,0,0,0,0
0,0,0,0,0,0,0,0,0
0,0,0,0,0,0,0,0,0
0,0,0,0,0,0,0,0,0
90214,135,3,21,1,20,3,0,0
90214,135,3,21,1,20,3,0,0
0,0,0,0,0,0,0,0,0
0,0,0,0,0,0,0,0,0
0,0,0,0,0,0,0,0,0
0,0,0,0,0,0,0,0,0
0,0,0,0,0,0,0,0,0
0,0,0,0,0,0,0,0,0
0,0,0,0,0,0,0,0,0
0,0,0,0,0,0,0,0,0
8411,52,3,0,0,0,4,0,0
8411,52,3,0,0,0,4,0,0
0,0,0,0,0,0,0,0,0
10906,56,3,0,0,0,2,0,0
10906,56,3,0,0,0,2,0,0
0,0,0,0,0,0,0,0,0
0,0,0,0,0,0,0,0,0
0,0,0,0,0,0,0,0,0
0,0,0,0,0,0,0,0,0
0,0,0,0,0,0,0,0,0
90214,135,3,21,1,20,3,0,0
90214,135,3,21,1,20,3,0,0
8411,52,3,0,0,0,4,0,0
10906,56,3,0,0,0,2,0,0
90214,135,3,21,1,20,3,0,0
8411,52,3,0,0,0,4,0,0
8411,52,3,0,0,0,4,0,0
0,0,0,0,0,0,0,0,0
0,0,0,0,0,0,0,0,0
10906,56,3,0,0,0,2,0,0
0,0,0,0,0,0,0,0,0
0,0,0,0,0,0,0,0,0
0,0,0,0,0,0,0,0,0
0,0,0,0,0,0,0,0,0
0,0,0,0,0,0,0,0,0
0,0,0,0,0,0,0,0,0
0,0,0,0,0,0,0,0,0
0,0,0,0,0,0,0,0,0
0,0,0,0,0,0,0,0,0
0,0,0,0,0,0,0,0,0
0,0,0,0,0,0,0,0,0
0,0,0,0,0,0,0,0,0
11001,82,0,7,6,1,0,1,0
27754,145,5,5,1,4,1,0,0
0,0,0,0,0,0,0,0,0
0,0,0,0,0,0,0,0,0
0,0,0,0,0,0,0,0,0
0,0,0,0,0,0,0,0,0
2741,39,0,0,0,0,0,0,0
38039,13,0,0,0,0,0,0,0
0,0,0,0,0,0,0,0,0
0,0,0,0,0,0,0,0,0
7430,57,4,1,1,0,0,1,0
0,0,0,0,0,0,0,0,0
0,0,0,0,0,0,0,0,0
0,0,0,0,0,0,0,0,0
0,0,0,0,0,0,0,0,0
192232,807,4,119,5,114,8,1,0
0,0,0,0,0,0,0,0,0
0,0,0,0,0,0,0,0,0
0,0,0,0,0,0,0,0,0
0,0,0,0,0,0,0,0,0
0,0,0,0,0,0,0,0,0
0,0,0,0,0,0,0,0,0
0,0,0,0,0,0,0,0,0
0,0,0,0,0,0,0,0,0
0,0,0,0,0,0,0,0,0
0,0,0,0,0,0,0,0,0
0,0,0,0,0,0,0,0,0
0,0,0,0,0,0,0,0,0
0,0,0,0,0,0,0,0,0
0,0,0,0,0,0,0,0,0
0,0,0,0,0,0,0,0,0
0,0,0,0,0,0,0,0,0
0,0,0,0,0,0,0,0,0
0,0,0,0,0,0,0,0,0
0,0,0,0,0,0,0,0,0
0,0,0,0,0,0,0,0,0
0,0,0,0,0,0,0,0,0
0,0,0,0,0,0,0,0,0
0,0,0,0,0,0,0,0,0
0,0,0,0,0,0,0,0,0
0,0,0,0,0,0,0,0,0
0,0,0,0,0,0,0,0,0
0,0,0,0,0,0,0,0,0
118590,900,6,223,33,190,7,1,0
0,0,0,0,0,0,0,0,0
0,0,0,0,0,0,0,0,0
0,0,0,0,0,0,0,0,0
0,0,0,0,0,0,0,0,0
0,0,0,0,0,0,0,0,0
0,0,0,0,0,0,0,0,0
0,0,0,0,0,0,0,0,0
0,0,0,0,0,0,0,0,0
0,0,0,0,0,0,0,0,0
0,0,0,0,0,0,0,0,0
0,0,0,0,0,0,0,0,0
0,0,0,0,0,0,0,0,0
0,0,0,0,0,0,0,0,0
0,0,0,0,0,0,0,0,0
0,0,0,0,0,0,0,0,0
0,0,0,0,0,0,0,0,0
0,0,0,0,0,0,0,0,0
0,0,0,0,0,0,0,0,0
0,0,0,0,0,0,0,0,0
0,0,0,0,0,0,0,0,0
0,0,0,0,0,0,0,0,0
0,0,0,0,0,0,0,0,0
0,0,0,0,0,0,0,0,0
118590,900,6,223,149,74,7,1,0
118590,900,6,223,49,174,7,1,0
0,0,0,0,0,0,0,0,0
0,0,0,0,0,0,0,0,0
0,0,0,0,0,0,0,0,0
0,0,0,0,0,0,0,0,0
0,0,0,0,0,0,0,0,0
0,0,0,0,0,0,0,0,0
0,0,0,0,0,0,0,0,0
118590,900,6,223,34,189,7,1,0
0,0,0,0,0,0,0,0,0
0,0,0,0,0,0,0,0,0
0,0,0,0,0,0,0,0,0
0,0,0,0,0,0,0,0,0
0,0,0,0,0,0,0,0,0
3874,10,0,0,0,0,0,0,0
0,0,0,0,0,0,0,0,0
0,0,0,0,0,0,0,0,0
0,0,0,0,0,0,0,0,0
0,0,0,0,0,0,0,0,0
118588,900,6,223,29,194,7,1,0
0,0,0,0,0,0,0,0,0
0,0,0,0,0,0,0,0,0
0,0,0,0,0,0,0,0,0
0,0,0,0,0,0,0,0,0
0,0,0,0,0,0,0,0,0
0,0,0,0,0,0,0,0,0
118590,900,6,223,29,194,7,1,0
0,0,0,0,0,0,0,0,0
0,0,0,0,0,0,0,0,0
0,0,0,0,0,0,0,0,0
0,0,0,0,0,0,0,0,0
0,0,0,0,0,0,0,0,0
0,0,0,0,0,0,0,0,0
0,0,0,0,0,0,0,0,0
0,0,0,0,0,0,0,0,0
0,0,0,0,0,0,0,0,0
0,0,0,0,0,0,0,0,0
0,0,0,0,0,0,0,0,0
0,0,0,0,0,0,0,0,0
0,0,0,0,0,0,0,0,0
0,0,0,0,0,0,0,0,0
58911,900,4,163,2,161,3,1,0
59106,901,4,163,2,161,3,1,0
59106,901,4,163,2,161,3,1,0
0,0,0,0,0,0,0,0,0
59106,901,4,163,2,161,3,1,0
59106,901,4,163,2,161,3,1,0
58904,900,4,163,2,161,3,1,0
58904,900,4,163,2,161,3,1,0
58709,899,4,163,2,161,3,1,0
59106,901,4,163,2,161,3,1,0
58904,900,4,163,2,161,3,1,0
58904,900,4,163,2,161,3,1,0
58904,900,4,163,2,161,3,1,0
0,0,0,0,0,0,0,0,0
0,0,0,0,0,0,0,0,0
0,0,0,0,0,0,0,0,0
0,0,0,0,0,0,0,0,0
0,0,0,0,0,0,0,0,0
0,0,0,0,0,0,0,0,0
0,0,0,0,0,0,0,0,0
0,0,0,0,0,0,0,0,0
0,0,0,0,0,0,0,0,0
0,0,0,0,0,0,0,0,0
0,0,0,0,0,0,0,0,0
0,0,0,0,0,0,0,0,0
64861,50,3,0,0,0,0,0,0
0,0,0,0,0,0,0,0,0
0,0,0,0,0,0,0,0,0
0,0,0,0,0,0,0,0,0
0,0,0,0,0,0,0,0,0
0,0,0,0,0,0,0,0,0
0,0,0,0,0,0,0,0,0
0,0,0,0,0,0,0,0,0
0,0,0,0,0,0,0,0,0
0,0,0,0,0,0,0,0,0
0,0,0,0,0,0,0,0,0
0,0,0,0,0,0,0,0,0
0,0,0,0,0,0,0,0,0
0,0,0,0,0,0,0,0,0
0,0,0,0,0,0,0,0,0
0,0,0,0,0,0,0,0,0
0,0,0,0,0,0,0,0,0
0,0,0,0,0,0,0,0,0
0,0,0,0,0,0,0,0,0
0,0,0,0,0,0,0,0,0
0,0,0,0,0,0,0,0,0
64849,50,3,0,0,0,0,0,0
64849,50,3,0,0,0,0,0,0
0,0,0,0,0,0,0,0,0
10209,65,0,3,2,1,0,0,0
118466,899,6,223,49,174,6,1,0
2673,21,2,1,0,1,0,0,0
0,0,0,0,0,0,0,0,0
0,0,0,0,0,0,0,0,0
23291,225,3,24,24,0,0,1,0
0,0,0,0,0,0,0,0,0
10879,148,7,25,25,0,0,1,0
0,0,0,0,0,0,0,0,0
2673,21,2,1,0,1,0,0,0
0,0,0,0,0,0,0,0,0
0,0,0,0,0,0,0,0,0
0,0,0,0,0,0,0,0,0
0,0,0,0,0,0,0,0,0
0,0,0,0,0,0,0,0,0
0,0,0,0,0,0,0,0,0
2673,21,2,1,0,1,0,0,0
0,0,0,0,0,0,0,0,0
10395,85,1,0,0,0,0,0,0
0,0,0,0,0,0,0,0,0
64849,50,3,0,0,0,0,0,0
0,0,0,0,0,0,0,0,0
0,0,0,0,0,0,0,0,0
0,0,0,0,0,0,0,0,0
0,0,0,0,0,0,0,0,0
0,0,0,0,0,0,0,0,0
0,0,0,0,0,0,0,0,0
0,0,0,0,0,0,0,0,0
90889,209,4,0,0,0,1,0,0
0,0,0,0,0,0,0,0,0
0,0,0,0,0,0,0,0,0
90650,211,4,0,0,0,1,0,0
0,0,0,0,0,0,0,0,0
0,0,0,0,0,0,0,0,0
23291,225,3,24,24,0,0,1,0
91586,211,4,0,0,0,1,0,0
0,0,0,0,0,0,0,0,0
19672,32,0,1,1,0,0,1,0
0,0,0,0,0,0,0,0,0
0,0,0,0,0,0,0,0,0
0,0,0,0,0,0,0,0,0
0,0,0,0,0,0,0,0,0
0,0,0,0,0,0,0,0,0
0,0,0,0,0,0,0,0,0
0,0,0,0,0,0,0,0,0
0,0,0,0,0,0,0,0,0
0,0,0,0,0,0,0,0,0
0,0,0,0,0,0,0,0,0
2673,21,2,1,0,1,0,0,0
0,0,0,0,0,0,0,0,0
0,0,0,0,0,0,0,0,0
91792,209,4,0,0,0,1,0,0
144220,769,2,38,31,7,11,0,0
64848,50,3,0,0,0,0,0,0
0,0,0,0,0,0,0,0,0
0,0,0,0,0,0,0,0,0
92437,211,4,0,0,0,1,0,0
0,0,0,0,0,0,0,0,0
0,0,0,0,0,0,0,0,0
0,0,0,0,0,0,0,0,0
0,0,0,0,0,0,0,0,0
0,0,0,0,0,0,0,0,0
0,0,0,0,0,0,0,0,0
2673,21,2,1,0,1,0,0,0
0,0,0,0,0,0,0,0,0
0,0,0,0,0,0,0,0,0
0,0,0,0,0,0,0,0,0
0,0,0,0,0,0,0,0,0
2673,21,2,1,0,1,0,0,0
2673,21,2,1,0,1,0,0,0
2673,21,2,1,0,1,0,0,0
0,0,0,0,0,0,0,0,0
0,0,0,0,0,0,0,0,0
64706,49,3,0,0,0,0,0,0
0,0,0,0,0,0,0,0,0
64861,50,3,0,0,0,0,0,0
22538,101,1,9,2,7,0,0,0
64849,50,3,0,0,0,0,0,0
0,0,0,0,0,0,0,0,0
73740,86,1,5,1,4,0,0,0
47036,203,2,1,1,0,1,0,0
0,0,0,0,0,0,0,0,0
0,0,0,0,0,0,0,0,0
0,0,0,0,0,0,0,0,0
0,0,0,0,0,0,0,0,0
0,0,0,0,0,0,0,0,0
0,0,0,0,0,0,0,0,0
102538,642,2,13,4,9,7,1,0
0,0,0,0,0,0,0,0,0
0,0,0,0,0,0,0,0,0
0,0,0,0,0,0,0,0,0
0,0,0,0,0,0,0,0,0
0,0,0,0,0,0,0,0,0
0,0,0,0,0,0,0,0,0
0,0,0,0,0,0,0,0,0
0,0,0,0,0,0,0,0,0
0,0,0,0,0,0,0,0,0
0,0,0,0,0,0,0,0,0
0,0,0,0,0,0,0,0,0
0,0,0,0,0,0,0,0,0
0,0,0,0,0,0,0,0,0
0,0,0,0,0,0,0,0,0
94915,634,8,43,12,31,0,1,0
0,0,0,0,0,0,0,0,0
0,0,0,0,0,0,0,0,0
0,0,0,0,0,0,0,0,0
0,0,0,0,0,0,0,0,0
0,0,0,0,0,0,0,0,0
0,0,0,0,0,0,0,0,0
0,0,0,0,0,0,0,0,0
0,0,0,0,0,0,0,0,0
23291,225,3,24,24,0,0,1,0
0,0,0,0,0,0,0,0,0
0,0,0,0,0,0,0,0,0
0,0,0,0,0,0,0,0,0
0,0,0,0,0,0,0,0,0
0,0,0,0,0,0,0,0,0
0,0,0,0,0,0,0,0,0
0,0,0,0,0,0,0,0,0
0,0,0,0,0,0,0,0,0
2673,21,2,1,0,1,0,0,0
0,0,0,0,0,0,0,0,0
0,0,0,0,0,0,0,0,0
0,0,0,0,0,0,0,0,0
0,0,0,0,0,0,0,0,0
0,0,0,0,0,0,0,0,0
0,0,0,0,0,0,0,0,0
0,0,0,0,0,0,0,0,0
0,0,0,0,0,0,0,0,0
0,0,0,0,0,0,0,0,0
0,0,0,0,0,0,0,0,0
21340,338,5,18,15,3,0,1,0
21347,338,5,18,15,3,0,1,0
0,0,0,0,0,0,0,0,0
0,0,0,0,0,0,0,0,0
0,0,0,0,0,0,0,0,0
0,0,0,0,0,0,0,0,0
0,0,0,0,0,0,0,0,0
0,0,0,0,0,0,0,0,0
0,0,0,0,0,0,0,0,0
0,0,0,0,0,0,0,0,0
0,0,0,0,0,0,0,0,0
0,0,0,0,0,0,0,0,0
0,0,0,0,0,0,0,0,0
0,0,0,0,0,0,0,0,0
0,0,0,0,0,0,0,0,0
0,0,0,0,0,0,0,0,0
64849,50,3,0,0,0,0,0,0
0,0,0,0,0,0,0,0,0
0,0,0,0,0,0,0,0,0
0,0,0,0,0,0,0,0,0
28621,47,4,0,0,0,0,0,0
0,0,0,0,0,0,0,0,0
0,0,0,0,0,0,0,0,0
0,0,0,0,0,0,0,0,0
0,0,0,0,0,0,0,0,0
0,0,0,0,0,0,0,0,0
0,0,0,0,0,0,0,0,0
0,0,0,0,0,0,0,0,0
0,0,0,0,0,0,0,0,0
0,0,0,0,0,0,0,0,0
0,0,0,0,0,0,0,0,0
10884,61,6,0,0,0,4,1,0
0,0,0,0,0,0,0,0,0
0,0,0,0,0,0,0,0,0
0,0,0,0,0,0,0,0,0
0,0,0,0,0,0,0,0,0
0,0,0,0,0,0,0,0,0
0,0,0,0,0,0,0,0,0
0,0,0,0,0,0,0,0,0
0,0,0,0,0,0,0,0,0
98837,42,4,1,1,0,2,0,0
0,0,0,0,0,0,0,0,0
0,0,0,0,0,0,0,0,0
0,0,0,0,0,0,0,0,0
0,0,0,0,0,0,0,0,0
0,0,0,0,0,0,0,0,0
0,0,0,0,0,0,0,0,0
0,0,0,0,0,0,0,0,0
0,0,0,0,0,0,0,0,0
0,0,0,0,0,0,0,0,0
0,0,0,0,0,0,0,0,0
0,0,0,0,0,0,0,0,0
0,0,0,0,0,0,0,0,0
0,0,0,0,0,0,0,0,0
0,0,0,0,0,0,0,0,0
0,0,0,0,0,0,0,0,0
0,0,0,0,0,0,0,0,0
0,0,0,0,0,0,0,0,0
0,0,0,0,0,0,0,0,0
0,0,0,0,0,0,0,0,0
0,0,0,0,0,0,0,0,0
0,0,0,0,0,0,0,0,0
0,0,0,0,0,0,0,0,0
79841,336,8,22,14,8,1,0,0
64849,50,3,0,0,0,0,0,0
0,0,0,0,0,0,0,0,0
0,0,0,0,0,0,0,0,0
0,0,0,0,0,0,0,0,0
0,0,0,0,0,0,0,0,0
36426,48,1,0,0,0,0,0,0
0,0,0,0,0,0,0,0,0
0,0,0,0,0,0,0,0,0
0,0,0,0,0,0,0,0,0
0,0,0,0,0,0,0,0,0
0,0,0,0,0,0,0,0,0
0,0,0,0,0,0,0,0,0
0,0,0,0,0,0,0,0,0
0,0,0,0,0,0,0,0,0
0,0,0,0,0,0,0,0,0
0,0,0,0,0,0,0,0,0
112495,84,1,4,1,3,0,0,0
265588,510,4,49,33,16,7,1,0
0,0,0,0,0,0,0,0,0
0,0,0,0,0,0,0,0,0
0,0,0,0,0,0,0,0,0
0,0,0,0,0,0,0,0,0
68533,343,1,8,2,6,0,0,0
3189,39,0,6,3,3,0,1,0
233271,64,4,3,3,0,2,1,0
0,0,0,0,0,0,0,0,0
0,0,0,0,0,0,0,0,0
0,0,0,0,0,0,0,0,0
0,0,0,0,0,0,0,0,0
0,0,0,0,0,0,0,0,0
0,0,0,0,0,0,0,0,0
0,0,0,0,0,0,0,0,0
0,0,0,0,0,0,0,0,0
0,0,0,0,0,0,0,0,0
0,0,0,0,0,0,0,0,0
0,0,0,0,0,0,0,0,0
0,0,0,0,0,0,0,0,0
0,0,0,0,0,0,0,0,0
0,0,0,0,0,0,0,0,0
0,0,0,0,0,0,0,0,0
1153069,351,1,19,14,5,0,1,0
0,0,0,0,0,0,0,0,0
0,0,0,0,0,0,0,0,0
10874,33,1,0,0,0,1,0,0
0,0,0,0,0,0,0,0,0
0,0,0,0,0,0,0,0,0
0,0,0,0,0,0,0,0,0
0,0,0,0,0,0,0,0,0
0,0,0,0,0,0,0,0,0
674144,556,0,4,4,0,2,1,1
0,0,0,0,0,0,0,0,0
0,0,0,0,0,0,0,0,0
137003,69,3,2,1,1,2,1,0
0,0,0,0,0,0,0,0,0
675037,557,0,4,4,0,2,1,1
0,0,0,0,0,0,0,0,0
0,0,0,0,0,0,0,0,0
0,0,0,0,0,0,0,0,0
0,0,0,0,0,0,0,0,0
91066,211,4,0,0,0,1,0,0
91059,211,4,0,0,0,1,0,0
0,0,0,0,0,0,0,0,0
0,0,0,0,0,0,0,0,0
0,0,0,0,0,0,0,0,0
2673,21,2,1,0,1,0,0,0
0,0,0,0,0,0,0,0,0
0,0,0,0,0,0,0,0,0
671620,556,0,4,4,0,2,1,1
23291,225,3,24,24,0,0,1,0
0,0,0,0,0,0,0,0,0
0,0,0,0,0,0,0,0,0
0,0,0,0,0,0,0,0,0
0,0,0,0,0,0,0,0,0
0,0,0,0,0,0,0,0,0
0,0,0,0,0,0,0,0,0
0,0,0,0,0,0,0,0,0
0,0,0,0,0,0,0,0,0
0,0,0,0,0,0,0,0,0
0,0,0,0,0,0,0,0,0
0,0,0,0,0,0,0,0,0
0,0,0,0,0,0,0,0,0
2673,21,2,1,0,1,0,0,0
2673,21,2,1,0,1,0,0,0
64849,50,3,0,0,0,0,0,0
0,0,0,0,0,0,0,0,0
51316,76,0,1,0,1,0,0,0
4372,63,1,1,1,0,1,1,0
0,0,0,0,0,0,0,0,0
35523,170,6,3,1,2,1,0,0
0,0,0,0,0,0,0,0,0
0,0,0,0,0,0,0,0,0
64861,50,3,0,0,0,0,0,0
0,0,0,0,0,0,0,0,0
0,0,0,0,0,0,0,0,0
23291,225,3,24,24,0,0,1,0
0,0,0,0,0,0,0,0,0
0,0,0,0,0,0,0,0,0
676729,542,0,4,0,4,2,1,1
86514,66,0,9,4,5,5,0,0
0,0,0,0,0,0,0,0,0
0,0,0,0,0,0,0,0,0
0,0,0,0,0,0,0,0,0
0,0,0,0,0,0,0,0,0
0,0,0,0,0,0,0,0,0
0,0,0,0,0,0,0,0,0
0,0,0,0,0,0,0,0,0
0,0,0,0,0,0,0,0,0
0,0,0,0,0,0,0,0,0
0,0,0,0,0,0,0,0,0
0,0,0,0,0,0,0,0,0
0,0,0,0,0,0,0,0,0
0,0,0,0,0,0,0,0,0
0,0,0,0,0,0,0,0,0
0,0,0,0,0,0,0,0,0
32431,26,0,3,1,2,0,0,0
0,0,0,0,0,0,0,0,0
0,0,0,0,0,0,0,0,0
0,0,0,0,0,0,0,0,0
0,0,0,0,0,0,0,0,0
0,0,0,0,0,0,0,0,0
0,0,0,0,0,0,0,0,0
51317,76,0,1,0,1,0,0,0
0,0,0,0,0,0,0,0,0
0,0,0,0,0,0,0,0,0
0,0,0,0,0,0,0,0,0
0,0,0,0,0,0,0,0,0
671288,542,0,4,4,0,2,1,1
0,0,0,0,0,0,0,0,0
0,0,0,0,0,0,0,0,0
0,0,0,0,0,0,0,0,0
11122,76,4,1,1,0,0,1,0
0,0,0,0,0,0,0,0,0
0,0,0,0,0,0,0,0,0
292387,189,4,1,1,0,0,1,0
293883,185,4,1,1,0,0,1,0
0,0,0,0,0,0,0,0,0
0,0,0,0,0,0,0,0,0
0,0,0,0,0,0,0,0,0
0,0,0,0,0,0,0,0,0
0,0,0,0,0,0,0,0,0
0,0,0,0,0,0,0,0,0
0,0,0,0,0,0,0,0,0
0,0,0,0,0,0,0,0,0
0,0,0,0,0,0,0,0,0
0,0,0,0,0,0,0,0,0
0,0,0,0,0,0,0,0,0
62295,200,1,4,3,1,0,1,0
0,0,0,0,0,0,0,0,0
0,0,0,0,0,0,0,0,0
0,0,0,0,0,0,0,0,0
0,0,0,0,0,0,0,0,0
0,0,0,0,0,0,0,0,0
0,0,0,0,0,0,0,0,0
0,0,0,0,0,0,0,0,0
0,0,0,0,0,0,0,0,0
0,0,0,0,0,0,0,0,0
0,0,0,0,0,0,0,0,0
0,0,0,0,0,0,0,0,0
0,0,0,0,0,0,0,0,0
27127,311,4,2,0,2,7,1,0
0,0,0,0,0,0,0,0,0
0,0,0,0,0,0,0,0,0
25051,185,3,21,2,19,0,1,0
0,0,0,0,0,0,0,0,0
0,0,0,0,0,0,0,0,0
0,0,0,0,0,0,0,0,0
0,0,0,0,0,0,0,0,0
0,0,0,0,0,0,0,0,0
0,0,0,0,0,0,0,0,0
0,0,0,0,0,0,0,0,0
0,0,0,0,0,0,0,0,0
0,0,0,0,0,0,0,0,0
0,0,0,0,0,0,0,0,0
0,0,0,0,0,0,0,0,0
0,0,0,0,0,0,0,0,0
0,0,0,0,0,0,0,0,0
0,0,0,0,0,0,0,0,0
43689,296,0,13,0,13,0,1,0
43689,296,0,13,0,13,0,1,0
0,0,0,0,0,0,0,0,0
0,0,0,0,0,0,0,0,0
0,0,0,0,0,0,0,0,0
0,0,0,0,0,0,0,0,0
0,0,0,0,0,0,0,0,0
0,0,0,0,0,0,0,0,0
0,0,0,0,0,0,0,0,0
0,0,0,0,0,0,0,0,0
0,0,0,0,0,0,0,0,0
0,0,0,0,0,0,0,0,0
0,0,0,0,0,0,0,0,0
0,0,0,0,0,0,0,0,0
0,0,0,0,0,0,0,0,0
0,0,0,0,0,0,0,0,0
0,0,0,0,0,0,0,0,0
0,0,0,0,0,0,0,0,0
0,0,0,0,0,0,0,0,0
0,0,0,0,0,0,0,0,0
0,0,0,0,0,0,0,0,0
0,0,0,0,0,0,0,0,0
0,0,0,0,0,0,0,0,0
99959,211,4,0,0,0,1,0,0
0,0,0,0,0,0,0,0,0
0,0,0,0,0,0,0,0,0
0,0,0,0,0,0,0,0,0
0,0,0,0,0,0,0,0,0
0,0,0,0,0,0,0,0,0
0,0,0,0,0,0,0,0,0
10845,33,1,0,0,0,1,0,0
0,0,0,0,0,0,0,0,0
0,0,0,0,0,0,0,0,0
0,0,0,0,0,0,0,0,0
0,0,0,0,0,0,0,0,0
0,0,0,0,0,0,0,0,0
0,0,0,0,0,0,0,0,0
0,0,0,0,0,0,0,0,0
0,0,0,0,0,0,0,0,0
0,0,0,0,0,0,0,0,0
0,0,0,0,0,0,0,0,0
0,0,0,0,0,0,0,0,0
0,0,0,0,0,0,0,0,0
0,0,0,0,0,0,0,0,0
0,0,0,0,0,0,0,0,0
0,0,0,0,0,0,0,0,0
0,0,0,0,0,0,0,0,0
0,0,0,0,0,0,0,0,0
0,0,0,0,0,0,0,0,0
0,0,0,0,0,0,0,0,0
0,0,0,0,0,0,0,0,0
0,0,0,0,0,0,0,0,0
0,0,0,0,0,0,0,0,0
0,0,0,0,0,0,0,0,0
0,0,0,0,0,0,0,0,0
0,0,0,0,0,0,0,0,0
0,0,0,0,0,0,0,0,0
0,0,0,0,0,0,0,0,0
0,0,0,0,0,0,0,0,0
5798520,57,3,1,1,0,2,1,0
0,0,0,0,0,0,0,0,0
0,0,0,0,0,0,0,0,0
0,0,0,0,0,0,0,0,0
0,0,0,0,0,0,0,0,0
0,0,0,0,0,0,0,0,0
0,0,0,0,0,0,0,0,0
0,0,0,0,0,0,0,0,0
5886888,59,3,1,1,0,2,1,0
0,0,0,0,0,0,0,0,0
5886888,59,3,1,1,0,2,1,0
0,0,0,0,0,0,0,0,0
0,0,0,0,0,0,0,0,0
0,0,0,0,0,0,0,0,0
0,0,0,0,0,0,0,0,0
0,0,0,0,0,0,0,0,0
0,0,0,0,0,0,0,0,0
0,0,0,0,0,0,0,0,0
0,0,0,0,0,0,0,0,0
0,0,0,0,0,0,0,0,0
0,0,0,0,0,0,0,0,0
0,0,0,0,0,0,0,0,0
0,0,0,0,0,0,0,0,0
0,0,0,0,0,0,0,0,0
0,0,0,0,0,0,0,0,0
0,0,0,0,0,0,0,0,0
0,0,0,0,0,0,0,0,0
0,0,0,0,0,0,0,0,0
0,0,0,0,0,0,0,0,0
2673,21,2,1,0,1,0,0,0
0,0,0,0,0,0,0,0,0
2673,21,2,1,0,1,0,0,0
0,0,0,0,0,0,0,0,0
0,0,0,0,0,0,0,0,0
0,0,0,0,0,0,0,0,0
0,0,0,0,0,0,0,0,0
7105,92,3,4,3,1,0,0,0
0,0,0,0,0,0,0,0,0
7106,92,3,4,3,1,0,0,0
0,0,0,0,0,0,0,0,0
0,0,0,0,0,0,0,0,0
30048,51,2,0,0,0,2,0,0
0,0,0,0,0,0,0,0,0
36426,48,1,0,0,0,0,0,0
36426,48,1,0,0,0,0,0,0
0,0,0,0,0,0,0,0,0
0,0,0,0,0,0,0,0,0
77774,101,1,4,2,2,0,0,0
0,0,0,0,0,0,0,0,0
0,0,0,0,0,0,0,0,0
0,0,0,0,0,0,0,0,0
0,0,0,0,0,0,0,0,0
0,0,0,0,0,0,0,0,0
0,0,0,0,0,0,0,0,0
0,0,0,0,0,0,0,0,0
0,0,0,0,0,0,0,0,0
0,0,0,0,0,0,0,0,0
0,0,0,0,0,0,0,0,0
0,0,0,0,0,0,0,0,0
689563,74,4,2,1,1,3,1,0
0,0,0,0,0,0,0,0,0
0,0,0,0,0,0,0,0,0
136069,42,4,1,1,0,2,0,0
102681,76,4,6,6,0,5,1,0
13295,39,1,0,0,0,5,0,0
13110,108,1,0,0,0,0,0,0
0,0,0,0,0,0,0,0,0
382661,205,4,1,1,0,0,1,0
0,0,0,0,0,0,0,0,0
0,0,0,0,0,0,0,0,0
3385,41,0,6,0,6,0,0,0
0,0,0,0,0,0,0,0,0
0,0,0,0,0,0,0,0,0
0,0,0,0,0,0,0,0,0
0,0,0,0,0,0,0,0,0
0,0,0,0,0,0,0,0,0
0,0,0,0,0,0,0,0,0
0,0,0,0,0,0,0,0,0
0,0,0,0,0,0,0,0,0
0,0,0,0,0,0,0,0,0
0,0,0,0,0,0,0,0,0
0,0,0,0,0,0,0,0,0
0,0,0,0,0,0,0,0,0
55005,237,4,24,24,0,0,1,0
0,0,0,0,0,0,0,0,0
100019,211,4,0,0,0,1,0,0
0,0,0,0,0,0,0,0,0
0,0,0,0,0,0,0,0,0
0,0,0,0,0,0,0,0,0
0,0,0,0,0,0,0,0,0
0,0,0,0,0,0,0,0,0
0,0,0,0,0,0,0,0,0
0,0,0,0,0,0,0,0,0
72020,47,4,0,0,0,1,0,0
0,0,0,0,0,0,0,0,0
0,0,0,0,0,0,0,0,0
4798,53,1,2,2,0,1,1,0
0,0,0,0,0,0,0,0,0
0,0,0,0,0,0,0,0,0
0,0,0,0,0,0,0,0,0
64849,50,3,0,0,0,0,0,0
64860,50,3,0,0,0,0,0,0
0,0,0,0,0,0,0,0,0
2673,21,2,1,0,1,0,0,0
2673,21,2,1,0,1,0,0,0
2673,21,2,1,0,1,0,0,0
2673,21,2,1,0,1,0,0,0
2673,21,2,1,0,1,0,0,0
2673,21,2,1,0,1,0,0,0
2673,21,2,1,0,1,0,0,0
0,0,0,0,0,0,0,0,0
0,0,0,0,0,0,0,0,0
64861,50,3,0,0,0,0,0,0
0,0,0,0,0,0,0,0,0
0,0,0,0,0,0,0,0,0
0,0,0,0,0,0,0,0,0
0,0,0,0,0,0,0,0,0
0,0,0,0,0,0,0,0,0
0,0,0,0,0,0,0,0,0
2673,21,2,1,0,1,0,0,0
0,0,0,0,0,0,0,0,0
0,0,0,0,0,0,0,0,0
0,0,0,0,0,0,0,0,0
0,0,0,0,0,0,0,0,0
0,0,0,0,0,0,0,0,0
2673,21,2,1,0,1,0,0,0
0,0,0,0,0,0,0,0,0
64849,50,3,0,0,0,0,0,0
28307,160,6,4,2,2,1,0,0
0,0,0,0,0,0,0,0,0
0,0,0,0,0,0,0,0,0
0,0,0,0,0,0,0,0,0
0,0,0,0,0,0,0,0,0
2673,21,2,1,0,1,0,0,0
0,0,0,0,0,0,0,0,0
0,0,0,0,0,0,0,0,0
0,0,0,0,0,0,0,0,0
0,0,0,0,0,0,0,0,0
0,0,0,0,0,0,0,0,0
0,0,0,0,0,0,0,0,0
0,0,0,0,0,0,0,0,0
0,0,0,0,0,0,0,0,0
1834,40,1,0,0,0,0,0,0
0,0,0,0,0,0,0,0,0
134416,314,8,27,24,3,16,1,0
0,0,0,0,0,0,0,0,0
0,0,0,0,0,0,0,0,0
0,0,0,0,0,0,0,0,0
0,0,0,0,0,0,0,0,0
0,0,0,0,0,0,0,0,0
2673,21,2,1,0,1,0,0,0
0,0,0,0,0,0,0,0,0
23291,225,3,24,24,0,0,1,0
2673,21,2,1,0,1,0,0,0
0,0,0,0,0,0,0,0,0
0,0,0,0,0,0,0,0,0
0,0,0,0,0,0,0,0,0
0,0,0,0,0,0,0,0,0
84457,519,4,119,109,10,0,1,0
0,0,0,0,0,0,0,0,0
0,0,0,0,0,0,0,0,0
0,0,0,0,0,0,0,0,0
0,0,0,0,0,0,0,0,0
0,0,0,0,0,0,0,0,0
0,0,0,0,0,0,0,0,0
0,0,0,0,0,0,0,0,0
0,0,0,0,0,0,0,0,0
0,0,0,0,0,0,0,0,0
0,0,0,0,0,0,0,0,0
0,0,0,0,0,0,0,0,0
0,0,0,0,0,0,0,0,0
0,0,0,0,0,0,0,0,0
0,0,0,0,0,0,0,0,0
0,0,0,0,0,0,0,0,0
0,0,0,0,0,0,0,0,0
0,0,0,0,0,0,0,0,0
0,0,0,0,0,0,0,0,0
0,0,0,0,0,0,0,0,0
0,0,0,0,0,0,0,0,0
287837,185,4,1,1,0,0,1,0
0,0,0,0,0,0,0,0,0
0,0,0,0,0,0,0,0,0
297704,196,4,1,1,0,0,1,0
148947,580,16,69,65,4,1,1,0
0,0,0,0,0,0,0,0,0
13080,102,1,14,8,6,1,0,0
13080,102,1,14,8,6,1,0,0
0,0,0,0,0,0,0,0,0
0,0,0,0,0,0,0,0,0
148941,580,16,69,65,4,1,1,0
292537,187,4,1,1,0,0,1,0
0,0,0,0,0,0,0,0,0
23291,225,3,24,24,0,0,1,0
0,0,0,0,0,0,0,0,0
0,0,0,0,0,0,0,0,0
0,0,0,0,0,0,0,0,0
508513,168,4,1,1,0,0,1,0
0,0,0,0,0,0,0,0,0
296235,187,4,1,1,0,0,1,0
0,0,0,0,0,0,0,0,0
0,0,0,0,0,0,0,0,0
0,0,0,0,0,0,0,0,0
0,0,0,0,0,0,0,0,0
0,0,0,0,0,0,0,0,0
0,0,0,0,0,0,0,0,0
12435,142,0,56,52,4,0,0,0
0,0,0,0,0,0,0,0,0
0,0,0,0,0,0,0,0,0
0,0,0,0,0,0,0,0,0
6989,66,1,4,4,0,0,1,0
0,0,0,0,0,0,0,0,0
0,0,0,0,0,0,0,0,0
19612,32,0,1,1,0,0,1,0
0,0,0,0,0,0,0,0,0
0,0,0,0,0,0,0,0,0
0,0,0,0,0,0,0,0,0
0,0,0,0,0,0,0,0,0
27127,311,4,2,0,2,7,1,0
27127,311,4,2,0,2,7,1,0
0,0,0,0,0,0,0,0,0
7007,66,1,4,4,0,0,1,0
0,0,0,0,0,0,0,0,0
0,0,0,0,0,0,0,0,0
36096,167,2,5,4,1,18,0,0
270963,1052,10,129,124,5,18,0,0
0,0,0,0,0,0,0,0,0
0,0,0,0,0,0,0,0,0
0,0,0,0,0,0,0,0,0
0,0,0,0,0,0,0,0,0
0,0,0,0,0,0,0,0,0
0,0,0,0,0,0,0,0,0
0,0,0,0,0,0,0,0,0
0,0,0,0,0,0,0,0,0
0,0,0,0,0,0,0,0,0
0,0,0,0,0,0,0,0,0
0,0,0,0,0,0,0,0,0
0,0,0,0,0,0,0,0,0
0,0,0,0,0,0,0,0,0
0,0,0,0,0,0,0,0,0
0,0,0,0,0,0,0,0,0
0,0,0,0,0,0,0,0,0
0,0,0,0,0,0,0,0,0
0,0,0,0,0,0,0,0,0
0,0,0,0,0,0,0,0,0
0,0,0,0,0,0,0,0,0
0,0,0,0,0,0,0,0,0
0,0,0,0,0,0,0,0,0
0,0,0,0,0,0,0,0,0
0,0,0,0,0,0,0,0,0
0,0,0,0,0,0,0,0,0
0,0,0,0,0,0,0,0,0
0,0,0,0,0,0,0,0,0
0,0,0,0,0,0,0,0,0
0,0,0,0,0,0,0,0,0
0,0,0,0,0,0,0,0,0
0,0,0,0,0,0,0,0,0
0,0,0,0,0,0,0,0,0
0,0,0,0,0,0,0,0,0
0,0,0,0,0,0,0,0,0
0,0,0,0,0,0,0,0,0
0,0,0,0,0,0,0,0,0
0,0,0,0,0,0,0,0,0
0,0,0,0,0,0,0,0,0
0,0,0,0,0,0,0,0,0
263068,66,4,9,9,0,2,0,0
0,0,0,0,0,0,0,0,0
0,0,0,0,0,0,0,0,0
0,0,0,0,0,0,0,0,0
263068,66,4,9,9,0,2,0,0
263068,66,4,9,9,0,2,0,0
0,0,0,0,0,0,0,0,0
0,0,0,0,0,0,0,0,0
0,0,0,0,0,0,0,0,0
28840,171,6,3,1,2,1,0,0
64849,50,3,0,0,0,0,0,0
0,0,0,0,0,0,0,0,0
67304,58,3,1,1,0,4,1,0
0,0,0,0,0,0,0,0,0
0,0,0,0,0,0,0,0,0
0,0,0,0,0,0,0,0,0
0,0,0,0,0,0,0,0,0
0,0,0,0,0,0,0,0,0
0,0,0,0,0,0,0,0,0
0,0,0,0,0,0,0,0,0
0,0,0,0,0,0,0,0,0
0,0,0,0,0,0,0,0,0
0,0,0,0,0,0,0,0,0
0,0,0,0,0,0,0,0,0
0,0,0,0,0,0,0,0,0
0,0,0,0,0,0,0,0,0
0,0,0,0,0,0,0,0,0
0,0,0,0,0,0,0,0,0
0,0,0,0,0,0,0,0,0
0,0,0,0,0,0,0,0,0
0,0,0,0,0,0,0,0,0
0,0,0,0,0,0,0,0,0
0,0,0,0,0,0,0,0,0
0,0,0,0,0,0,0,0,0
0,0,0,0,0,0,0,0,0
0,0,0,0,0,0,0,0,0
0,0,0,0,0,0,0,0,0
0,0,0,0,0,0,0,0,0
0,0,0,0,0,0,0,0,0
0,0,0,0,0,0,0,0,0
0,0,0,0,0,0,0,0,0
0,0,0,0,0,0,0,0,0
0,0,0,0,0,0,0,0,0
1554,25,1,1,1,0,0,0,0
0,0,0,0,0,0,0,0,0
673618,553,0,4,0,4,2,1,1
672880,553,0,4,0,4,2,1,1
5880,231,3,5,5,0,0,0,0
5880,231,3,5,5,0,0,0,0
2541,37,0,2,0,2,0,0,0
0,0,0,0,0,0,0,0,0
0,0,0,0,0,0,0,0,0
0,0,0,0,0,0,0,0,0
38176,288,5,5,4,1,1,0,0
0,0,0,0,0,0,0,0,0
0,0,0,0,0,0,0,0,0
0,0,0,0,0,0,0,0,0
0,0,0,0,0,0,0,0,0
0,0,0,0,0,0,0,0,0
0,0,0,0,0,0,0,0,0
0,0,0,0,0,0,0,0,0
0,0,0,0,0,0,0,0,0
36871,319,10,42,41,1,0,0,0
36871,319,10,42,41,1,0,0,0
0,0,0,0,0,0,0,0,0
0,0,0,0,0,0,0,0,0
0,0,0,0,0,0,0,0,0
0,0,0,0,0,0,0,0,0
0,0,0,0,0,0,0,0,0
0,0,0,0,0,0,0,0,0
0,0,0,0,0,0,0,0,0
0,0,0,0,0,0,0,0,0
0,0,0,0,0,0,0,0,0
64849,50,3,0,0,0,0,0,0
48612,145,3,6,3,3,2,0,0
0,0,0,0,0,0,0,0,0
0,0,0,0,0,0,0,0,0
0,0,0,0,0,0,0,0,0
11091,76,4,1,1,0,0,1,0
0,0,0,0,0,0,0,0,0
0,0,0,0,0,0,0,0,0
0,0,0,0,0,0,0,0,0
0,0,0,0,0,0,0,0,0
0,0,0,0,0,0,0,0,0
0,0,0,0,0,0,0,0,0
0,0,0,0,0,0,0,0,0
0,0,0,0,0,0,0,0,0
0,0,0,0,0,0,0,0,0
0,0,0,0,0,0,0,0,0
0,0,0,0,0,0,0,0,0
0,0,0,0,0,0,0,0,0
0,0,0,0,0,0,0,0,0
0,0,0,0,0,0,0,0,0
0,0,0,0,0,0,0,0,0
0,0,0,0,0,0,0,0,0
0,0,0,0,0,0,0,0,0
12202,51,3,0,0,0,2,0,0
12202,51,3,0,0,0,2,0,0
0,0,0,0,0,0,0,0,0
332534,60,4,3,3,0,2,1,0
0,0,0,0,0,0,0,0,0
332534,60,4,3,3,0,2,1,0
0,0,0,0,0,0,0,0,0
0,0,0,0,0,0,0,0,0
0,0,0,0,0,0,0,0,0
0,0,0,0,0,0,0,0,0
0,0,0,0,0,0,0,0,0
0,0,0,0,0,0,0,0,0
0,0,0,0,0,0,0,0,0
54221,820,2,139,136,3,0,1,0
0,0,0,0,0,0,0,0,0
0,0,0,0,0,0,0,0,0
0,0,0,0,0,0,0,0,0
0,0,0,0,0,0,0,0,0
739872,220,0,50,50,0,3,1,0
64861,50,3,0,0,0,0,0,0
64849,50,3,0,0,0,0,0,0
64849,50,3,0,0,0,0,0,0
64849,50,3,0,0,0,0,0,0
77806,101,1,4,2,2,0,0,0
55887,295,2,2,1,1,1,0,0
0,0,0,0,0,0,0,0,0
9379,80,1,0,0,0,0,0,0
0,0,0,0,0,0,0,0,0
0,0,0,0,0,0,0,0,0
0,0,0,0,0,0,0,0,0
170428,43,3,0,0,0,0,0,0
0,0,0,0,0,0,0,0,0
0,0,0,0,0,0,0,0,0
9698,86,1,0,0,0,0,0,0
0,0,0,0,0,0,0,0,0
91357,211,4,0,0,0,1,0,0
0,0,0,0,0,0,0,0,0
91723,211,4,0,0,0,1,0,0
90934,209,4,0,0,0,1,0,0
92231,211,4,0,0,0,1,0,0
91397,211,4,0,0,0,1,0,0
0,0,0,0,0,0,0,0,0
92073,214,4,0,0,0,1,0,0
91173,211,4,0,0,0,1,0,0
0,0,0,0,0,0,0,0,0
0,0,0,0,0,0,0,0,0
14961,284,2,31,29,2,1,1,0
0,0,0,0,0,0,0,0,0
0,0,0,0,0,0,0,0,0
0,0,0,0,0,0,0,0,0
0,0,0,0,0,0,0,0,0
0,0,0,0,0,0,0,0,0
0,0,0,0,0,0,0,0,0
0,0,0,0,0,0,0,0,0
0,0,0,0,0,0,0,0,0
0,0,0,0,0,0,0,0,0
0,0,0,0,0,0,0,0,0
0,0,0,0,0,0,0,0,0
0,0,0,0,0,0,0,0,0
0,0,0,0,0,0,0,0,0
0,0,0,0,0,0,0,0,0
0,0,0,0,0,0,0,0,0
0,0,0,0,0,0,0,0,0
0,0,0,0,0,0,0,0,0
0,0,0,0,0,0,0,0,0
0,0,0,0,0,0,0,0,0
0,0,0,0,0,0,0,0,0
0,0,0,0,0,0,0,0,0
0,0,0,0,0,0,0,0,0
0,0,0,0,0,0,0,0,0
0,0,0,0,0,0,0,0,0
0,0,0,0,0,0,0,0,0
0,0,0,0,0,0,0,0,0
0,0,0,0,0,0,0,0,0
0,0,0,0,0,0,0,0,0
0,0,0,0,0,0,0,0,0
64849,50,3,0,0,0,0,0,0
0,0,0,0,0,0,0,0,0
0,0,0,0,0,0,0,0,0
0,0,0,0,0,0,0,0,0
0,0,0,0,0,0,0,0,0
0,0,0,0,0,0,0,0,0
0,0,0,0,0,0,0,0,0
0,0,0,0,0,0,0,0,0
14961,284,2,31,29,2,1,1,0
0,0,0,0,0,0,0,0,0
0,0,0,0,0,0,0,0,0
0,0,0,0,0,0,0,0,0
0,0,0,0,0,0,0,0,0
0,0,0,0,0,0,0,0,0
676286,557,0,4,4,0,2,1,1
0,0,0,0,0,0,0,0,0
0,0,0,0,0,0,0,0,0
0,0,0,0,0,0,0,0,0
0,0,0,0,0,0,0,0,0
0,0,0,0,0,0,0,0,0
0,0,0,0,0,0,0,0,0
0,0,0,0,0,0,0,0,0
0,0,0,0,0,0,0,0,0
0,0,0,0,0,0,0,0,0
0,0,0,0,0,0,0,0,0
0,0,0,0,0,0,0,0,0
0,0,0,0,0,0,0,0,0
0,0,0,0,0,0,0,0,0
0,0,0,0,0,0,0,0,0
0,0,0,0,0,0,0,0,0
0,0,0,0,0,0,0,0,0
0,0,0,0,0,0,0,0,0
0,0,0,0,0,0,0,0,0
0,0,0,0,0,0,0,0,0
0,0,0,0,0,0,0,0,0
0,0,0,0,0,0,0,0,0
0,0,0,0,0,0,0,0,0
0,0,0,0,0,0,0,0,0
2673,21,2,1,0,1,0,0,0
0,0,0,0,0,0,0,0,0
0,0,0,0,0,0,0,0,0
0,0,0,0,0,0,0,0,0
9319,55,0,1,1,0,0,0,0
9319,55,0,1,1,0,0,0,0
0,0,0,0,0,0,0,0,0
0,0,0,0,0,0,0,0,0
0,0,0,0,0,0,0,0,0
0,0,0,0,0,0,0,0,0
0,0,0,0,0,0,0,0,0
64860,50,3,0,0,0,0,0,0
0,0,0,0,0,0,0,0,0
0,0,0,0,0,0,0,0,0
0,0,0,0,0,0,0,0,0
0,0,0,0,0,0,0,0,0
0,0,0,0,0,0,0,0,0
0,0,0,0,0,0,0,0,0
0,0,0,0,0,0,0,0,0
0,0,0,0,0,0,0,0,0
0,0,0,0,0,0,0,0,0
0,0,0,0,0,0,0,0,0
0,0,0,0,0,0,0,0,0
0,0,0,0,0,0,0,0,0
0,0,0,0,0,0,0,0,0
0,0,0,0,0,0,0,0,0
0,0,0,0,0,0,0,0,0
0,0,0,0,0,0,0,0,0
0,0,0,0,0,0,0,0,0
0,0,0,0,0,0,0,0,0
0,0,0,0,0,0,0,0,0
135985,42,4,1,1,0,2,0,0
135985,42,4,1,1,0,2,0,0
0,0,0,0,0,0,0,0,0
0,0,0,0,0,0,0,0,0
0,0,0,0,0,0,0,0,0
0,0,0,0,0,0,0,0,0
0,0,0,0,0,0,0,0,0
0,0,0,0,0,0,0,0,0
23491,59,4,3,3,0,2,1,0
0,0,0,0,0,0,0,0,0
0,0,0,0,0,0,0,0,0
0,0,0,0,0,0,0,0,0
0,0,0,0,0,0,0,0,0
0,0,0,0,0,0,0,0,0
0,0,0,0,0,0,0,0,0
0,0,0,0,0,0,0,0,0
0,0,0,0,0,0,0,0,0
0,0,0,0,0,0,0,0,0
0,0,0,0,0,0,0,0,0
0,0,0,0,0,0,0,0,0
0,0,0,0,0,0,0,0,0
0,0,0,0,0,0,0,0,0
0,0,0,0,0,0,0,0,0
0,0,0,0,0,0,0,0,0
0,0,0,0,0,0,0,0,0
0,0,0,0,0,0,0,0,0
0,0,0,0,0,0,0,0,0
0,0,0,0,0,0,0,0,0
0,0,0,0,0,0,0,0,0
0,0,0,0,0,0,0,0,0
0,0,0,0,0,0,0,0,0
0,0,0,0,0,0,0,0,0
0,0,0,0,0,0,0,0,0
0,0,0,0,0,0,0,0,0
0,0,0,0,0,0,0,0,0
0,0,0,0,0,0,0,0,0
0,0,0,0,0,0,0,0,0
0,0,0,0,0,0,0,0,0
0,0,0,0,0,0,0,0,0
0,0,0,0,0,0,0,0,0
0,0,0,0,0,0,0,0,0
0,0,0,0,0,0,0,0,0
0,0,0,0,0,0,0,0,0
0,0,0,0,0,0,0,0,0
0,0,0,0,0,0,0,0,0
0,0,0,0,0,0,0,0,0
0,0,0,0,0,0,0,0,0
0,0,0,0,0,0,0,0,0
0,0,0,0,0,0,0,0,0
0,0,0,0,0,0,0,0,0
0,0,0,0,0,0,0,0,0
0,0,0,0,0,0,0,0,0
0,0,0,0,0,0,0,0,0
0,0,0,0,0,0,0,0,0
0,0,0,0,0,0,0,0,0
0,0,0,0,0,0,0,0,0
0,0,0,0,0,0,0,0,0
0,0,0,0,0,0,0,0,0
0,0,0,0,0,0,0,0,0
0,0,0,0,0,0,0,0,0
0,0,0,0,0,0,0,0,0
0,0,0,0,0,0,0,0,0
0,0,0,0,0,0,0,0,0
0,0,0,0,0,0,0,0,0
0,0,0,0,0,0,0,0,0
0,0,0,0,0,0,0,0,0
0,0,0,0,0,0,0,0,0
0,0,0,0,0,0,0,0,0
0,0,0,0,0,0,0,0,0
0,0,0,0,0,0,0,0,0
0,0,0,0,0,0,0,0,0
0,0,0,0,0,0,0,0,0
0,0,0,0,0,0,0,0,0
0,0,0,0,0,0,0,0,0
0,0,0,0,0,0,0,0,0
0,0,0,0,0,0,0,0,0
0,0,0,0,0,0,0,0,0
0,0,0,0,0,0,0,0,0
0,0,0,0,0,0,0,0,0
0,0,0,0,0,0,0,0,0
0,0,0,0,0,0,0,0,0
0,0,0,0,0,0,0,0,0
0,0,0,0,0,0,0,0,0
0,0,0,0,0,0,0,0,0
0,0,0,0,0,0,0,0,0
0,0,0,0,0,0,0,0,0
0,0,0,0,0,0,0,0,0
0,0,0,0,0,0,0,0,0
0,0,0,0,0,0,0,0,0
0,0,0,0,0,0,0,0,0
0,0,0,0,0,0,0,0,0
0,0,0,0,0,0,0,0,0
0,0,0,0,0,0,0,0,0
0,0,0,0,0,0,0,0,0
0,0,0,0,0,0,0,0,0
0,0,0,0,0,0,0,0,0
0,0,0,0,0,0,0,0,0
0,0,0,0,0,0,0,0,0
0,0,0,0,0,0,0,0,0
0,0,0,0,0,0,0,0,0
0,0,0,0,0,0,0,0,0
0,0,0,0,0,0,0,0,0
0,0,0,0,0,0,0,0,0
0,0,0,0,0,0,0,0,0
0,0,0,0,0,0,0,0,0
0,0,0,0,0,0,0,0,0
9741,61,0,0,0,0,0,0,0
0,0,0,0,0,0,0,0,0
0,0,0,0,0,0,0,0,0
0,0,0,0,0,0,0,0,0
0,0,0,0,0,0,0,0,0
36426,48,1,0,0,0,0,0,0
0,0,0,0,0,0,0,0,0
0,0,0,0,0,0,0,0,0
0,0,0,0,0,0,0,0,0
91544,211,4,0,0,0,1,0,0
0,0,0,0,0,0,0,0,0
0,0,0,0,0,0,0,0,0
0,0,0,0,0,0,0,0,0
0,0,0,0,0,0,0,0,0
0,0,0,0,0,0,0,0,0
284593,38,4,0,0,0,2,1,0
503728,48,2,2,2,0,2,0,0
0,0,0,0,0,0,0,0,0
0,0,0,0,0,0,0,0,0
0,0,0,0,0,0,0,0,0
0,0,0,0,0,0,0,0,0
0,0,0,0,0,0,0,0,0
0,0,0,0,0,0,0,0,0
0,0,0,0,0,0,0,0,0
0,0,0,0,0,0,0,0,0
0,0,0,0,0,0,0,0,0
0,0,0,0,0,0,0,0,0
0,0,0,0,0,0,0,0,0
293,6,1,0,0,0,0,0,0
0,0,0,0,0,0,0,0,0
0,0,0,0,0,0,0,0,0
2673,21,2,1,0,1,0,0,0
0,0,0,0,0,0,0,0,0
0,0,0,0,0,0,0,0,0
64861,50,3,0,0,0,0,0,0
10686,162,7,26,17,9,0,1,0
91442,211,4,0,0,0,1,0,0
91109,211,4,0,0,0,1,0,0
0,0,0,0,0,0,0,0,0
91254,212,4,0,0,0,1,0,0
92568,209,4,0,0,0,1,1,0
90817,211,4,0,0,0,1,0,0
91022,211,4,0,0,0,1,0,0
91151,211,4,0,0,0,1,0,0
91496,211,4,0,0,0,1,0,0
91284,209,4,0,0,0,1,0,0
0,0,0,0,0,0,0,0,0
91756,211,4,0,0,0,1,0,0
92381,214,4,0,0,0,1,0,0
0,0,0,0,0,0,0,0,0
90539,209,4,0,0,0,1,0,0
91234,211,4,0,0,0,1,0,0
91790,214,4,0,0,0,1,0,0
90991,211,4,0,0,0,1,0,0
91641,209,4,0,0,0,1,0,0
91714,214,4,0,0,0,1,0,0
91464,211,4,0,0,0,1,0,0
91503,211,4,0,0,0,1,0,0
91169,209,4,0,0,0,1,0,0
91345,212,4,0,0,0,1,0,0
91298,209,4,0,0,0,1,0,0
91195,211,4,0,0,0,1,0,0
91303,211,4,0,0,0,1,0,0
0,0,0,0,0,0,0,0,0
90915,209,4,0,0,0,1,0,0
90932,211,4,0,0,0,1,0,0
91103,214,4,0,0,0,1,0,0
91050,211,4,0,0,0,1,0,0
91387,211,4,0,0,0,1,0,0
91089,209,4,0,0,0,1,0,0
0,0,0,0,0,0,0,0,0
0,0,0,0,0,0,0,0,0
0,0,0,0,0,0,0,0,0
91372,211,4,0,0,0,1,0,0
92512,211,4,0,0,0,1,0,0
0,0,0,0,0,0,0,0,0
0,0,0,0,0,0,0,0,0
0,0,0,0,0,0,0,0,0
0,0,0,0,0,0,0,0,0
0,0,0,0,0,0,0,0,0
0,0,0,0,0,0,0,0,0
0,0,0,0,0,0,0,0,0
91053,209,4,0,0,0,1,0,0
92215,214,4,0,0,0,1,0,0
0,0,0,0,0,0,0,0,0
0,0,0,0,0,0,0,0,0
0,0,0,0,0,0,0,0,0
0,0,0,0,0,0,0,0,0
91438,209,4,0,0,0,1,0,0
92108,216,4,0,0,0,1,0,0
91472,214,4,0,0,0,1,0,0
90686,209,4,0,0,0,1,0,0
90950,209,4,0,0,0,1,0,0
91713,216,4,0,0,0,1,0,0
91791,214,4,0,0,0,1,0,0
91394,212,4,0,0,0,1,0,0
91607,211,4,0,0,0,1,0,0
91504,214,4,0,0,0,1,0,0
91727,216,4,0,0,0,1,0,0
91473,214,4,0,0,0,1,0,0
91841,216,4,0,0,0,1,0,0
91284,211,4,0,0,0,1,0,0
91647,211,4,0,0,0,1,0,0
91553,211,4,0,0,0,1,0,0
0,0,0,0,0,0,0,0,0
91408,209,4,0,0,0,1,0,0
91771,211,4,0,0,0,1,0,0
92818,211,4,0,0,0,1,0,0
0,0,0,0,0,0,0,0,0
0,0,0,0,0,0,0,0,0
0,0,0,0,0,0,0,0,0
90746,209,4,0,0,0,1,0,0
0,0,0,0,0,0,0,0,0
0,0,0,0,0,0,0,0,0
0,0,0,0,0,0,0,0,0
0,0,0,0,0,0,0,0,0
671572,542,0,4,4,0,2,1,1
0,0,0,0,0,0,0,0,0
91877,211,4,0,0,0,1,0,0
0,0,0,0,0,0,0,0,0
91574,214,4,0,0,0,1,0,0
0,0,0,0,0,0,0,0,0
0,0,0,0,0,0,0,0,0
0,0,0,0,0,0,0,0,0
0,0,0,0,0,0,0,0,0
91258,211,4,0,0,0,1,0,0
0,0,0,0,0,0,0,0,0
91011,209,4,0,0,0,1,0,0
0,0,0,0,0,0,0,0,0
0,0,0,0,0,0,0,0,0
64859,50,3,0,0,0,0,0,0
2673,21,2,1,0,1,0,0,0
0,0,0,0,0,0,0,0,0
0,0,0,0,0,0,0,0,0
0,0,0,0,0,0,0,0,0
8173,146,0,15,15,0,5,1,0
0,0,0,0,0,0,0,0,0
0,0,0,0,0,0,0,0,0
0,0,0,0,0,0,0,0,0
91471,209,4,0,0,0,1,0,0
91682,211,4,0,0,0,1,0,0
91545,211,4,0,0,0,1,0,0
91860,209,4,0,0,0,1,0,0
92569,211,4,0,0,0,1,0,0
90820,209,4,0,0,0,1,0,0
8891,75,1,0,0,0,0,0,0
0,0,0,0,0,0,0,0,0
91607,211,4,0,0,0,1,0,0
91826,214,4,0,0,0,1,0,0
0,0,0,0,0,0,0,0,0
91666,209,4,0,0,0,1,0,0
91817,214,4,0,0,0,1,0,0
0,0,0,0,0,0,0,0,0
0,0,0,0,0,0,0,0,0
0,0,0,0,0,0,0,0,0
409253,575,5,87,46,41,16,0,0
0,0,0,0,0,0,0,0,0
0,0,0,0,0,0,0,0,0
0,0,0,0,0,0,0,0,0
0,0,0,0,0,0,0,0,0
0,0,0,0,0,0,0,0,0
0,0,0,0,0,0,0,0,0
0,0,0,0,0,0,0,0,0
0,0,0,0,0,0,0,0,0
0,0,0,0,0,0,0,0,0
0,0,0,0,0,0,0,0,0
0,0,0,0,0,0,0,0,0
0,0,0,0,0,0,0,0,0
0,0,0,0,0,0,0,0,0
0,0,0,0,0,0,0,0,0
2673,21,2,1,0,1,0,0,0
0,0,0,0,0,0,0,0,0
0,0,0,0,0,0,0,0,0
0,0,0,0,0,0,0,0,0
0,0,0,0,0,0,0,0,0
27127,311,4,2,0,2,7,1,0
0,0,0,0,0,0,0,0,0
0,0,0,0,0,0,0,0,0
0,0,0,0,0,0,0,0,0
0,0,0,0,0,0,0,0,0
0,0,0,0,0,0,0,0,0
162498,218,4,26,18,8,2,1,0
0,0,0,0,0,0,0,0,0
0,0,0,0,0,0,0,0,0
0,0,0,0,0,0,0,0,0
0,0,0,0,0,0,0,0,0
0,0,0,0,0,0,0,0,0
269870,515,4,50,34,16,7,1,0
0,0,0,0,0,0,0,0,0
0,0,0,0,0,0,0,0,0
0,0,0,0,0,0,0,0,0
0,0,0,0,0,0,0,0,0
55005,237,4,24,24,0,0,1,0
0,0,0,0,0,0,0,0,0
0,0,0,0,0,0,0,0,0
196361,145,1,6,0,6,0,0,0
0,0,0,0,0,0,0,0,0
0,0,0,0,0,0,0,0,0
0,0,0,0,0,0,0,0,0
0,0,0,0,0,0,0,0,0
0,0,0,0,0,0,0,0,0
0,0,0,0,0,0,0,0,0
0,0,0,0,0,0,0,0,0
0,0,0,0,0,0,0,0,0
64861,50,3,0,0,0,0,0,0
0,0,0,0,0,0,0,0,0
2673,21,2,1,0,1,0,0,0
0,0,0,0,0,0,0,0,0
0,0,0,0,0,0,0,0,0
120441,967,6,55,38,17,7,1,0
0,0,0,0,0,0,0,0,0
0,0,0,0,0,0,0,0,0
0,0,0,0,0,0,0,0,0
0,0,0,0,0,0,0,0,0
0,0,0,0,0,0,0,0,0
0,0,0,0,0,0,0,0,0
293811,204,6,1,1,0,0,1,0
0,0,0,0,0,0,0,0,0
0,0,0,0,0,0,0,0,0
283403,193,6,1,1,0,0,1,0
12961,142,0,56,51,5,0,0,0
283147,185,4,1,1,0,0,1,0
0,0,0,0,0,0,0,0,0
0,0,0,0,0,0,0,0,0
0,0,0,0,0,0,0,0,0
0,0,0,0,0,0,0,0,0
0,0,0,0,0,0,0,0,0
0,0,0,0,0,0,0,0,0
0,0,0,0,0,0,0,0,0
34482,217,0,51,3,48,1,1,0
5029,71,1,6,6,0,2,0,0
0,0,0,0,0,0,0,0,0
61835,13,0,0,0,0,0,0,0
0,0,0,0,0,0,0,0,0
0,0,0,0,0,0,0,0,0
27127,311,4,2,0,2,7,1,0
0,0,0,0,0,0,0,0,0
0,0,0,0,0,0,0,0,0
0,0,0,0,0,0,0,0,0
0,0,0,0,0,0,0,0,0
0,0,0,0,0,0,0,0,0
0,0,0,0,0,0,0,0,0
0,0,0,0,0,0,0,0,0
0,0,0,0,0,0,0,0,0
0,0,0,0,0,0,0,0,0
0,0,0,0,0,0,0,0,0
0,0,0,0,0,0,0,0,0
0,0,0,0,0,0,0,0,0
0,0,0,0,0,0,0,0,0
0,0,0,0,0,0,0,0,0
0,0,0,0,0,0,0,0,0
0,0,0,0,0,0,0,0,0
0,0,0,0,0,0,0,0,0
0,0,0,0,0,0,0,0,0
8560,41,0,2,2,0,1,0,0
8560,41,0,2,2,0,1,0,0
0,0,0,0,0,0,0,0,0
0,0,0,0,0,0,0,0,0
0,0,0,0,0,0,0,0,0
0,0,0,0,0,0,0,0,0
0,0,0,0,0,0,0,0,0
0,0,0,0,0,0,0,0,0
0,0,0,0,0,0,0,0,0
0,0,0,0,0,0,0,0,0
0,0,0,0,0,0,0,0,0
0,0,0,0,0,0,0,0,0
0,0,0,0,0,0,0,0,0
0,0,0,0,0,0,0,0,0
0,0,0,0,0,0,0,0,0
0,0,0,0,0,0,0,0,0
0,0,0,0,0,0,0,0,0
0,0,0,0,0,0,0,0,0
0,0,0,0,0,0,0,0,0
0,0,0,0,0,0,0,0,0
0,0,0,0,0,0,0,0,0
0,0,0,0,0,0,0,0,0
0,0,0,0,0,0,0,0,0
0,0,0,0,0,0,0,0,0
0,0,0,0,0,0,0,0,0
0,0,0,0,0,0,0,0,0
0,0,0,0,0,0,0,0,0
0,0,0,0,0,0,0,0,0
0,0,0,0,0,0,0,0,0
0,0,0,0,0,0,0,0,0
0,0,0,0,0,0,0,0,0
0,0,0,0,0,0,0,0,0
0,0,0,0,0,0,0,0,0
0,0,0,0,0,0,0,0,0
0,0,0,0,0,0,0,0,0
0,0,0,0,0,0,0,0,0
0,0,0,0,0,0,0,0,0
0,0,0,0,0,0,0,0,0
0,0,0,0,0,0,0,0,0
0,0,0,0,0,0,0,0,0
0,0,0,0,0,0,0,0,0
0,0,0,0,0,0,0,0,0
0,0,0,0,0,0,0,0,0
0,0,0,0,0,0,0,0,0
0,0,0,0,0,0,0,0,0
0,0,0,0,0,0,0,0,0
0,0,0,0,0,0,0,0,0
0,0,0,0,0,0,0,0,0
191475,136,3,21,1,20,3,0,0
191475,136,3,21,1,20,3,0,0
0,0,0,0,0,0,0,0,0
0,0,0,0,0,0,0,0,0
0,0,0,0,0,0,0,0,0
0,0,0,0,0,0,0,0,0
25492,365,1,100,100,0,0,1,0
0,0,0,0,0,0,0,0,0
33854,46,2,0,0,0,2,0,0
0,0,0,0,0,0,0,0,0
0,0,0,0,0,0,0,0,0
3008710,329,1,77,77,0,1,0,0
0,0,0,0,0,0,0,0,0
0,0,0,0,0,0,0,0,0
112491,84,1,4,1,3,0,0,0
0,0,0,0,0,0,0,0,0
186404,127,4,8,8,0,5,1,0
503727,48,2,2,2,0,2,0,0
0,0,0,0,0,0,0,0,0
0,0,0,0,0,0,0,0,0
0,0,0,0,0,0,0,0,0
0,0,0,0,0,0,0,0,0
135124,83,3,4,2,2,0,0,0
0,0,0,0,0,0,0,0,0
0,0,0,0,0,0,0,0,0
0,0,0,0,0,0,0,0,0
0,0,0,0,0,0,0,0,0
0,0,0,0,0,0,0,0,0
0,0,0,0,0,0,0,0,0
0,0,0,0,0,0,0,0,0
0,0,0,0,0,0,0,0,0
0,0,0,0,0,0,0,0,0
165640,383,3,7,4,3,1,0,0
0,0,0,0,0,0,0,0,0
0,0,0,0,0,0,0,0,0
0,0,0,0,0,0,0,0,0
0,0,0,0,0,0,0,0,0
0,0,0,0,0,0,0,0,0
0,0,0,0,0,0,0,0,0
0,0,0,0,0,0,0,0,0
0,0,0,0,0,0,0,0,0
280084,492,4,49,46,3,2,1,0
64861,50,3,0,0,0,0,0,0
64861,50,3,0,0,0,0,0,0
92799,209,4,0,0,0,1,0,0
91644,209,4,0,0,0,1,0,0
91128,211,4,0,0,0,1,0,0
0,0,0,0,0,0,0,0,0
0,0,0,0,0,0,0,0,0
91763,211,4,0,0,0,1,0,0
0,0,0,0,0,0,0,0,0
0,0,0,0,0,0,0,0,0
0,0,0,0,0,0,0,0,0
0,0,0,0,0,0,0,0,0
0,0,0,0,0,0,0,0,0
0,0,0,0,0,0,0,0,0
23373,138,0,17,17,0,4,0,0
0,0,0,0,0,0,0,0,0
0,0,0,0,0,0,0,0,0
2673,21,2,1,0,1,0,0,0
266769,515,4,50,34,16,7,1,0
3813,63,0,0,0,0,0,0,0
0,0,0,0,0,0,0,0,0
0,0,0,0,0,0,0,0,0
0,0,0,0,0,0,0,0,0
64861,50,3,0,0,0,0,0,0
0,0,0,0,0,0,0,0,0
64861,50,3,0,0,0,0,0,0
0,0,0,0,0,0,0,0,0
0,0,0,0,0,0,0,0,0
0,0,0,0,0,0,0,0,0
0,0,0,0,0,0,0,0,0
0,0,0,0,0,0,0,0,0
0,0,0,0,0,0,0,0,0
0,0,0,0,0,0,0,0,0
0,0,0,0,0,0,0,0,0
0,0,0,0,0,0,0,0,0
0,0,0,0,0,0,0,0,0
0,0,0,0,0,0,0,0,0
0,0,0,0,0,0,0,0,0
0,0,0,0,0,0,0,0,0
0,0,0,0,0,0,0,0,0
0,0,0,0,0,0,0,0,0
337630,58,1,6,3,3,0,0,0
0,0,0,0,0,0,0,0,0
8172,146,0,15,15,0,5,1,0
0,0,0,0,0,0,0,0,0
0,0,0,0,0,0,0,0,0
0,0,0,0,0,0,0,0,0
675325,556,0,4,4,0,2,1,1
0,0,0,0,0,0,0,0,0
0,0,0,0,0,0,0,0,0
0,0,0,0,0,0,0,0,0
0,0,0,0,0,0,0,0,0
0,0,0,0,0,0,0,0,0
0,0,0,0,0,0,0,0,0
0,0,0,0,0,0,0,0,0
0,0,0,0,0,0,0,0,0
0,0,0,0,0,0,0,0,0
0,0,0,0,0,0,0,0,0
0,0,0,0,0,0,0,0,0
0,0,0,0,0,0,0,0,0
1254,23,2,2,2,0,0,0,1
0,0,0,0,0,0,0,0,0
2673,21,2,1,0,1,0,0,0
1834,40,1,0,0,0,0,0,0
64861,50,3,0,0,0,0,0,0
2673,21,2,1,0,1,0,0,0
0,0,0,0,0,0,0,0,0
64849,50,3,0,0,0,0,0,0
0,0,0,0,0,0,0,0,0
64861,50,3,0,0,0,0,0,0
2673,21,2,1,0,1,0,0,0
0,0,0,0,0,0,0,0,0
0,0,0,0,0,0,0,0,0
0,0,0,0,0,0,0,0,0
75642,1273,7,82,45,37,14,1,0
64861,50,3,0,0,0,0,0,0
9186,28,1,2,1,1,0,0,0
0,0,0,0,0,0,0,0,0
0,0,0,0,0,0,0,0,0
0,0,0,0,0,0,0,0,0
0,0,0,0,0,0,0,0,0
0,0,0,0,0,0,0,0,0
0,0,0,0,0,0,0,0,0
0,0,0,0,0,0,0,0,0
0,0,0,0,0,0,0,0,0
93088,209,4,0,0,0,1,0,0
91361,209,4,0,0,0,1,0,0
91265,211,4,0,0,0,1,0,0
0,0,0,0,0,0,0,0,0
0,0,0,0,0,0,0,0,0
0,0,0,0,0,0,0,0,0
91391,211,4,0,0,0,1,0,0
91906,214,4,0,0,0,1,0,0
0,0,0,0,0,0,0,0,0
71715,225,2,15,6,9,0,1,0
0,0,0,0,0,0,0,0,0
0,0,0,0,0,0,0,0,0
0,0,0,0,0,0,0,0,0
0,0,0,0,0,0,0,0,0
0,0,0,0,0,0,0,0,0
0,0,0,0,0,0,0,0,0
0,0,0,0,0,0,0,0,0
0,0,0,0,0,0,0,0,0
0,0,0,0,0,0,0,0,0
0,0,0,0,0,0,0,0,0
0,0,0,0,0,0,0,0,0
0,0,0,0,0,0,0,0,0
132484,449,2,130,109,21,4,1,0
0,0,0,0,0,0,0,0,0
23677,228,4,24,24,0,0,1,0
0,0,0,0,0,0,0,0,0
0,0,0,0,0,0,0,0,0
0,0,0,0,0,0,0,0,0
0,0,0,0,0,0,0,0,0
297904,189,4,1,1,0,0,1,0
0,0,0,0,0,0,0,0,0
0,0,0,0,0,0,0,0,0
0,0,0,0,0,0,0,0,0
0,0,0,0,0,0,0,0,0
0,0,0,0,0,0,0,0,0
0,0,0,0,0,0,0,0,0
0,0,0,0,0,0,0,0,0
0,0,0,0,0,0,0,0,0
0,0,0,0,0,0,0,0,0
0,0,0,0,0,0,0,0,0
0,0,0,0,0,0,0,0,0
2663,27,4,6,1,5,0,0,0
0,0,0,0,0,0,0,0,0
0,0,0,0,0,0,0,0,0
0,0,0,0,0,0,0,0,0
0,0,0,0,0,0,0,0,0
0,0,0,0,0,0,0,0,0
0,0,0,0,0,0,0,0,0
0,0,0,0,0,0,0,0,0
0,0,0,0,0,0,0,0,0
0,0,0,0,0,0,0,0,0
0,0,0,0,0,0,0,0,0
10450,44,1,4,4,0,2,0,0
0,0,0,0,0,0,0,0,0
0,0,0,0,0,0,0,0,0
0,0,0,0,0,0,0,0,0
0,0,0,0,0,0,0,0,0
0,0,0,0,0,0,0,0,0
0,0,0,0,0,0,0,0,0
0,0,0,0,0,0,0,0,0
0,0,0,0,0,0,0,0,0
0,0,0,0,0,0,0,0,0
0,0,0,0,0,0,0,0,0
0,0,0,0,0,0,0,0,0
10450,44,1,4,4,0,2,0,0
485270,512,11,27,25,2,1,1,0
0,0,0,0,0,0,0,0,0
0,0,0,0,0,0,0,0,0
0,0,0,0,0,0,0,0,0
0,0,0,0,0,0,0,0,0
0,0,0,0,0,0,0,0,0
91075,209,4,0,0,0,1,0,0
0,0,0,0,0,0,0,0,0
0,0,0,0,0,0,0,0,0
0,0,0,0,0,0,0,0,0
0,0,0,0,0,0,0,0,0
0,0,0,0,0,0,0,0,0
0,0,0,0,0,0,0,0,0
0,0,0,0,0,0,0,0,0
0,0,0,0,0,0,0,0,0
0,0,0,0,0,0,0,0,0
0,0,0,0,0,0,0,0,0
0,0,0,0,0,0,0,0,0
0,0,0,0,0,0,0,0,0
0,0,0,0,0,0,0,0,0
13123,29,1,0,0,0,3,0,0
0,0,0,0,0,0,0,0,0
0,0,0,0,0,0,0,0,0
0,0,0,0,0,0,0,0,0
0,0,0,0,0,0,0,0,0
13123,29,1,0,0,0,3,0,0
0,0,0,0,0,0,0,0,0
13123,29,1,0,0,0,3,0,0
0,0,0,0,0,0,0,0,0
13139,29,1,0,0,0,3,0,0
0,0,0,0,0,0,0,0,0
0,0,0,0,0,0,0,0,0
0,0,0,0,0,0,0,0,0
0,0,0,0,0,0,0,0,0
0,0,0,0,0,0,0,0,0
0,0,0,0,0,0,0,0,0
126154,65,4,9,9,0,2,0,0
126154,65,4,9,9,0,2,0,0
0,0,0,0,0,0,0,0,0
36462,51,2,0,0,0,2,0,0
0,0,0,0,0,0,0,0,0
0,0,0,0,0,0,0,0,0
0,0,0,0,0,0,0,0,0
0,0,0,0,0,0,0,0,0
28268,161,6,4,2,2,1,0,0
64861,50,3,0,0,0,0,0,0
0,0,0,0,0,0,0,0,0
0,0,0,0,0,0,0,0,0
0,0,0,0,0,0,0,0,0
0,0,0,0,0,0,0,0,0
0,0,0,0,0,0,0,0,0
0,0,0,0,0,0,0,0,0
0,0,0,0,0,0,0,0,0
0,0,0,0,0,0,0,0,0
0,0,0,0,0,0,0,0,0
0,0,0,0,0,0,0,0,0
0,0,0,0,0,0,0,0,0
48013,76,2,1,1,0,3,1,0
98539,72,4,2,1,1,2,1,0
0,0,0,0,0,0,0,0,0
5107,30,3,0,0,0,2,0,0
0,0,0,0,0,0,0,0,0
0,0,0,0,0,0,0,0,0
0,0,0,0,0,0,0,0,0
0,0,0,0,0,0,0,0,0
0,0,0,0,0,0,0,0,0
0,0,0,0,0,0,0,0,0
0,0,0,0,0,0,0,0,0
0,0,0,0,0,0,0,0,0
0,0,0,0,0,0,0,0,0
0,0,0,0,0,0,0,0,0
44124,480,1,1,0,1,1,0,0
3385,41,0,6,0,6,0,0,0
0,0,0,0,0,0,0,0,0
0,0,0,0,0,0,0,0,0
0,0,0,0,0,0,0,0,0
0,0,0,0,0,0,0,0,0
0,0,0,0,0,0,0,0,0
0,0,0,0,0,0,0,0,0
0,0,0,0,0,0,0,0,0
0,0,0,0,0,0,0,0,0
0,0,0,0,0,0,0,0,0
0,0,0,0,0,0,0,0,0
0,0,0,0,0,0,0,0,0
0,0,0,0,0,0,0,0,0
0,0,0,0,0,0,0,0,0
0,0,0,0,0,0,0,0,0
0,0,0,0,0,0,0,0,0
0,0,0,0,0,0,0,0,0
0,0,0,0,0,0,0,0,0
0,0,0,0,0,0,0,0,0
0,0,0,0,0,0,0,0,0
0,0,0,0,0,0,0,0,0
0,0,0,0,0,0,0,0,0
0,0,0,0,0,0,0,0,0
0,0,0,0,0,0,0,0,0
0,0,0,0,0,0,0,0,0
0,0,0,0,0,0,0,0,0
9929,57,4,1,1,0,1,0,0
9917,57,4,1,1,0,1,0,0
0,0,0,0,0,0,0,0,0
0,0,0,0,0,0,0,0,0
0,0,0,0,0,0,0,0,0
0,0,0,0,0,0,0,0,0
0,0,0,0,0,0,0,0,0
0,0,0,0,0,0,0,0,0
0,0,0,0,0,0,0,0,0
205291,1064,1,259,220,39,3,0,0
88743,916,1,257,220,37,3,0,0
0,0,0,0,0,0,0,0,0
0,0,0,0,0,0,0,0,0
0,0,0,0,0,0,0,0,0
0,0,0,0,0,0,0,0,0
0,0,0,0,0,0,0,0,0
0,0,0,0,0,0,0,0,0
0,0,0,0,0,0,0,0,0
0,0,0,0,0,0,0,0,0
0,0,0,0,0,0,0,0,0
0,0,0,0,0,0,0,0,0
0,0,0,0,0,0,0,0,0
0,0,0,0,0,0,0,0,0
0,0,0,0,0,0,0,0,0
0,0,0,0,0,0,0,0,0
0,0,0,0,0,0,0,0,0
0,0,0,0,0,0,0,0,0
2673,21,2,1,0,1,0,0,0
0,0,0,0,0,0,0,0,0
0,0,0,0,0,0,0,0,0
0,0,0,0,0,0,0,0,0
0,0,0,0,0,0,0,0,0
64860,50,3,0,0,0,0,0,0
0,0,0,0,0,0,0,0,0
64861,50,3,0,0,0,0,0,0
91274,211,4,0,0,0,1,0,0
91964,211,4,0,0,0,1,0,0
91656,211,4,0,0,0,1,0,0
0,0,0,0,0,0,0,0,0
0,0,0,0,0,0,0,0,0
64861,50,3,0,0,0,0,0,0
0,0,0,0,0,0,0,0,0
0,0,0,0,0,0,0,0,0
0,0,0,0,0,0,0,0,0
0,0,0,0,0,0,0,0,0
0,0,0,0,0,0,0,0,0
0,0,0,0,0,0,0,0,0
0,0,0,0,0,0,0,0,0
0,0,0,0,0,0,0,0,0
0,0,0,0,0,0,0,0,0
0,0,0,0,0,0,0,0,0
0,0,0,0,0,0,0,0,0
0,0,0,0,0,0,0,0,0
0,0,0,0,0,0,0,0,0
0,0,0,0,0,0,0,0,0
0,0,0,0,0,0,0,0,0
0,0,0,0,0,0,0,0,0
0,0,0,0,0,0,0,0,0
673051,557,0,4,4,0,2,1,1
0,0,0,0,0,0,0,0,0
0,0,0,0,0,0,0,0,0
0,0,0,0,0,0,0,0,0
0,0,0,0,0,0,0,0,0
0,0,0,0,0,0,0,0,0
0,0,0,0,0,0,0,0,0
1039220,186,1,17,14,3,0,1,0
0,0,0,0,0,0,0,0,0
0,0,0,0,0,0,0,0,0
0,0,0,0,0,0,0,0,0
0,0,0,0,0,0,0,0,0
0,0,0,0,0,0,0,0,0
0,0,0,0,0,0,0,0,0
0,0,0,0,0,0,0,0,0
118590,900,6,223,32,191,7,1,0
0,0,0,0,0,0,0,0,0
0,0,0,0,0,0,0,0,0
0,0,0,0,0,0,0,0,0
0,0,0,0,0,0,0,0,0
0,0,0,0,0,0,0,0,0
0,0,0,0,0,0,0,0,0
0,0,0,0,0,0,0,0,0
0,0,0,0,0,0,0,0,0
502942,194,4,1,1,0,0,1,0
2673,21,2,1,0,1,0,0,0
2673,21,2,1,0,1,0,0,0
0,0,0,0,0,0,0,0,0
133904,313,8,27,24,3,16,1,0
0,0,0,0,0,0,0,0,0
0,0,0,0,0,0,0,0,0
0,0,0,0,0,0,0,0,0
0,0,0,0,0,0,0,0,0
0,0,0,0,0,0,0,0,0
0,0,0,0,0,0,0,0,0
2673,21,2,1,0,1,0,0,0
0,0,0,0,0,0,0,0,0
0,0,0,0,0,0,0,0,0
0,0,0,0,0,0,0,0,0
0,0,0,0,0,0,0,0,0
0,0,0,0,0,0,0,0,0
56393,49,2,0,0,0,0,1,0
0,0,0,0,0,0,0,0,0
48612,145,3,6,3,3,2,0,0
48612,145,3,6,3,3,2,0,0
0,0,0,0,0,0,0,0,0
0,0,0,0,0,0,0,0,0
0,0,0,0,0,0,0,0,0
4547,35,0,2,0,2,0,0,0
0,0,0,0,0,0,0,0,0
0,0,0,0,0,0,0,0,0
64861,50,3,0,0,0,0,0,0
0,0,0,0,0,0,0,0,0
0,0,0,0,0,0,0,0,0
0,0,0,0,0,0,0,0,0
0,0,0,0,0,0,0,0,0
302365,196,4,1,1,0,0,1,0
0,0,0,0,0,0,0,0,0
0,0,0,0,0,0,0,0,0
0,0,0,0,0,0,0,0,0
23291,225,3,24,24,0,0,1,0
133219,309,8,26,24,2,16,1,0
19623,32,0,1,1,0,0,1,0
0,0,0,0,0,0,0,0,0
0,0,0,0,0,0,0,0,0
0,0,0,0,0,0,0,0,0
0,0,0,0,0,0,0,0,0
0,0,0,0,0,0,0,0,0
0,0,0,0,0,0,0,0,0
0,0,0,0,0,0,0,0,0
0,0,0,0,0,0,0,0,0
0,0,0,0,0,0,0,0,0
0,0,0,0,0,0,0,0,0
0,0,0,0,0,0,0,0,0
0,0,0,0,0,0,0,0,0
0,0,0,0,0,0,0,0,0
0,0,0,0,0,0,0,0,0
0,0,0,0,0,0,0,0,0
0,0,0,0,0,0,0,0,0
0,0,0,0,0,0,0,0,0
64848,50,3,0,0,0,0,0,0
0,0,0,0,0,0,0,0,0
0,0,0,0,0,0,0,0,0
0,0,0,0,0,0,0,0,0
0,0,0,0,0,0,0,0,0
0,0,0,0,0,0,0,0,0
0,0,0,0,0,0,0,0,0
27127,311,4,2,0,2,7,1,0
0,0,0,0,0,0,0,0,0
0,0,0,0,0,0,0,0,0
0,0,0,0,0,0,0,0,0
0,0,0,0,0,0,0,0,0
0,0,0,0,0,0,0,0,0
107961,496,10,36,33,3,1,1,0
0,0,0,0,0,0,0,0,0
0,0,0,0,0,0,0,0,0
0,0,0,0,0,0,0,0,0
0,0,0,0,0,0,0,0,0
0,0,0,0,0,0,0,0,0
0,0,0,0,0,0,0,0,0
0,0,0,0,0,0,0,0,0
0,0,0,0,0,0,0,0,0
0,0,0,0,0,0,0,0,0
0,0,0,0,0,0,0,0,0
2807643,254,2,19,15,4,4,1,0
0,0,0,0,0,0,0,0,0
0,0,0,0,0,0,0,0,0
0,0,0,0,0,0,0,0,0
5262,37,0,0,0,0,0,0,0
5262,37,0,0,0,0,0,0,0
2807643,254,2,19,16,3,4,1,0
0,0,0,0,0,0,0,0,0
0,0,0,0,0,0,0,0,0
5262,37,0,0,0,0,0,0,0
0,0,0,0,0,0,0,0,0
0,0,0,0,0,0,0,0,0
5262,37,0,0,0,0,0,0,0
0,0,0,0,0,0,0,0,0
0,0,0,0,0,0,0,0,0
0,0,0,0,0,0,0,0,0
0,0,0,0,0,0,0,0,0
99850,55,4,0,0,0,3,1,0
0,0,0,0,0,0,0,0,0
0,0,0,0,0,0,0,0,0
0,0,0,0,0,0,0,0,0
0,0,0,0,0,0,0,0,0
0,0,0,0,0,0,0,0,0
98967,66,4,0,0,0,2,1,0
249877,75,0,17,15,2,0,0,0
98965,66,4,0,0,0,2,1,0
254921,159,0,41,39,2,0,0,0
98928,66,4,0,0,0,2,1,0
98928,66,4,0,0,0,2,1,0
0,0,0,0,0,0,0,0,0
0,0,0,0,0,0,0,0,0
0,0,0,0,0,0,0,0,0
254921,159,0,41,39,2,0,0,0
254921,159,0,41,39,2,0,0,0
0,0,0,0,0,0,0,0,0
10599,64,4,0,0,0,2,0,0
249877,75,0,17,15,2,0,0,0
249877,75,0,17,15,2,0,0,0
10597,64,4,0,0,0,2,0,0
98928,66,4,0,0,0,2,1,0
0,0,0,0,0,0,0,0,0
0,0,0,0,0,0,0,0,0
0,0,0,0,0,0,0,0,0
0,0,0,0,0,0,0,0,0
0,0,0,0,0,0,0,0,0
11681,60,5,0,0,0,4,1,0
11681,60,5,0,0,0,4,1,0
11681,60,5,0,0,0,4,1,0
11681,60,5,0,0,0,4,1,0
11681,60,5,0,0,0,4,1,0
11681,60,5,0,0,0,4,1,0
11681,60,5,0,0,0,4,1,0
17713,51,0,1,1,0,0,0,0
17713,51,0,1,1,0,0,0,0
0,0,0,0,0,0,0,0,0
0,0,0,0,0,0,0,0,0
0,0,0,0,0,0,0,0,0
0,0,0,0,0,0,0,0,0
0,0,0,0,0,0,0,0,0
17713,51,0,1,1,0,0,0,0
17713,51,0,1,1,0,0,0,0
45437,642,4,163,26,137,3,1,0
0,0,0,0,0,0,0,0,0
0,0,0,0,0,0,0,0,0
0,0,0,0,0,0,0,0,0
0,0,0,0,0,0,0,0,0
134662,1226,8,203,202,1,6,1,0
0,0,0,0,0,0,0,0,0
0,0,0,0,0,0,0,0,0
0,0,0,0,0,0,0,0,0
9292,61,2,3,3,0,2,0,0
0,0,0,0,0,0,0,0,0
0,0,0,0,0,0,0,0,0
0,0,0,0,0,0,0,0,0
13614,100,0,1,0,1,0,0,0
322783,216,4,2,2,0,0,1,0
0,0,0,0,0,0,0,0,0
28977,45,0,4,1,3,0,0,0
0,0,0,0,0,0,0,0,0
0,0,0,0,0,0,0,0,0
0,0,0,0,0,0,0,0,0
0,0,0,0,0,0,0,0,0
0,0,0,0,0,0,0,0,0
0,0,0,0,0,0,0,0,0
0,0,0,0,0,0,0,0,0
0,0,0,0,0,0,0,0,0
0,0,0,0,0,0,0,0,0
0,0,0,0,0,0,0,0,0
0,0,0,0,0,0,0,0,0
0,0,0,0,0,0,0,0,0
0,0,0,0,0,0,0,0,0
0,0,0,0,0,0,0,0,0
92140,211,4,0,0,0,1,0,0
94242,211,4,0,0,0,1,0,0
94136,209,4,0,0,0,1,0,0
0,0,0,0,0,0,0,0,0
9160,94,1,12,12,0,1,0,0
0,0,0,0,0,0,0,0,0
0,0,0,0,0,0,0,0,0
0,0,0,0,0,0,0,0,0
20772,158,0,1,0,1,0,1,0
20772,158,0,1,0,1,0,1,0
0,0,0,0,0,0,0,0,0
0,0,0,0,0,0,0,0,0
0,0,0,0,0,0,0,0,0
0,0,0,0,0,0,0,0,0
0,0,0,0,0,0,0,0,0
0,0,0,0,0,0,0,0,0
0,0,0,0,0,0,0,0,0
0,0,0,0,0,0,0,0,0
0,0,0,0,0,0,0,0,0
0,0,0,0,0,0,0,0,0
0,0,0,0,0,0,0,0,0
0,0,0,0,0,0,0,0,0
92560,214,4,0,0,0,1,0,0
91643,211,4,0,0,0,1,0,0
3766,44,0,2,0,2,1,0,0
93721,209,4,0,0,0,1,0,0
93230,211,4,0,0,0,1,0,0
0,0,0,0,0,0,0,0,0
0,0,0,0,0,0,0,0,0
139368,393,8,27,24,3,30,1,0
15020,142,0,56,51,5,0,0,0
1032178,107,3,3,2,1,1,1,0
0,0,0,0,0,0,0,0,0
0,0,0,0,0,0,0,0,0
0,0,0,0,0,0,0,0,0
0,0,0,0,0,0,0,0,0
0,0,0,0,0,0,0,0,0
10361,83,1,0,0,0,0,0,0
0,0,0,0,0,0,0,0,0
0,0,0,0,0,0,0,0,0
357908,192,4,3,1,2,0,1,0
0,0,0,0,0,0,0,0,0
48031,224,2,2,1,1,1,0,0
0,0,0,0,0,0,0,0,0
134082,313,8,27,24,3,16,1,0
0,0,0,0,0,0,0,0,0
0,0,0,0,0,0,0,0,0
184559,880,9,70,67,3,0,0,0
64848,50,3,0,0,0,0,0,0
0,0,0,0,0,0,0,0,0
0,0,0,0,0,0,0,0,0
0,0,0,0,0,0,0,0,0
64849,50,3,0,0,0,0,0,0
0,0,0,0,0,0,0,0,0
0,0,0,0,0,0,0,0,0
0,0,0,0,0,0,0,0,0
192380,222,2,57,56,1,2,1,0
266224,514,4,50,34,16,7,1,0
0,0,0,0,0,0,0,0,0
0,0,0,0,0,0,0,0,0
0,0,0,0,0,0,0,0,0
265829,514,4,50,34,16,7,1,0
0,0,0,0,0,0,0,0,0
0,0,0,0,0,0,0,0,0
0,0,0,0,0,0,0,0,0
0,0,0,0,0,0,0,0,0
0,0,0,0,0,0,0,0,0
0,0,0,0,0,0,0,0,0
0,0,0,0,0,0,0,0,0
0,0,0,0,0,0,0,0,0
394243,232,5,6,6,0,0,1,0
11280,112,2,4,4,0,2,0,0
0,0,0,0,0,0,0,0,0
0,0,0,0,0,0,0,0,0
144139,68,2,1,0,1,0,1,0
144139,68,2,1,0,1,0,1,0
0,0,0,0,0,0,0,0,0
0,0,0,0,0,0,0,0,0
0,0,0,0,0,0,0,0,0
192284,222,2,57,56,1,2,1,0
0,0,0,0,0,0,0,0,0
0,0,0,0,0,0,0,0,0
0,0,0,0,0,0,0,0,0
0,0,0,0,0,0,0,0,0
674290,556,0,4,4,0,2,1,1
424,6,0,0,0,0,0,0,0
0,0,0,0,0,0,0,0,0
0,0,0,0,0,0,0,0,0
0,0,0,0,0,0,0,0,0
0,0,0,0,0,0,0,0,0
0,0,0,0,0,0,0,0,0
10387,85,1,0,0,0,0,0,0
35711,171,6,4,2,2,1,0,0
0,0,0,0,0,0,0,0,0
0,0,0,0,0,0,0,0,0
91178,211,4,0,0,0,1,0,0
0,0,0,0,0,0,0,0,0
0,0,0,0,0,0,0,0,0
0,0,0,0,0,0,0,0,0
0,0,0,0,0,0,0,0,0
289670,68,0,5,5,0,0,1,0
310204,283,6,1,1,0,0,1,0
64738,49,3,0,0,0,0,0,0
0,0,0,0,0,0,0,0,0
0,0,0,0,0,0,0,0,0
0,0,0,0,0,0,0,0,0
0,0,0,0,0,0,0,0,0
92136,211,4,0,0,0,1,0,0
56636,289,4,38,1,37,3,1,0
0,0,0,0,0,0,0,0,0
10387,85,1,0,0,0,0,0,0
134403,311,8,26,24,2,16,1,0
306939,200,4,1,1,0,0,1,0
0,0,0,0,0,0,0,0,0
0,0,0,0,0,0,0,0,0
0,0,0,0,0,0,0,0,0
0,0,0,0,0,0,0,0,0
74032,120,6,8,7,1,3,1,0
0,0,0,0,0,0,0,0,0
133563,309,8,26,24,2,16,1,0
0,0,0,0,0,0,0,0,0
0,0,0,0,0,0,0,0,0
0,0,0,0,0,0,0,0,0
0,0,0,0,0,0,0,0,0
291634,197,4,7,4,3,0,1,0
1687488,63,3,1,1,0,4,1,0
0,0,0,0,0,0,0,0,0
0,0,0,0,0,0,0,0,0
296442,185,4,1,1,0,0,1,0
0,0,0,0,0,0,0,0,0
0,0,0,0,0,0,0,0,0
38759,49,2,3,3,0,0,0,0
0,0,0,0,0,0,0,0,0
0,0,0,0,0,0,0,0,0
0,0,0,0,0,0,0,0,0
679061,556,0,4,0,4,2,1,1
0,0,0,0,0,0,0,0,0
0,0,0,0,0,0,0,0,0
2458,50,1,5,5,0,0,1,0
0,0,0,0,0,0,0,0,0
134113,311,8,26,24,2,16,1,0
0,0,0,0,0,0,0,0,0
0,0,0,0,0,0,0,0,0
84457,519,4,119,109,10,0,1,0
0,0,0,0,0,0,0,0,0
0,0,0,0,0,0,0,0,0
0,0,0,0,0,0,0,0,0
0,0,0,0,0,0,0,0,0
0,0,0,0,0,0,0,0,0
0,0,0,0,0,0,0,0,0
0,0,0,0,0,0,0,0,0
57784,764,5,15,13,2,0,1,0
0,0,0,0,0,0,0,0,0
0,0,0,0,0,0,0,0,0
0,0,0,0,0,0,0,0,0
0,0,0,0,0,0,0,0,0
0,0,0,0,0,0,0,0,0
0,0,0,0,0,0,0,0,0
0,0,0,0,0,0,0,0,0
0,0,0,0,0,0,0,0,0
0,0,0,0,0,0,0,0,0
0,0,0,0,0,0,0,0,0
48562,142,3,6,3,3,2,0,0
48562,142,3,6,3,3,2,0,0
0,0,0,0,0,0,0,0,0
0,0,0,0,0,0,0,0,0
0,0,0,0,0,0,0,0,0
39275,43,4,0,0,0,2,0,0
0,0,0,0,0,0,0,0,0
0,0,0,0,0,0,0,0,0
0,0,0,0,0,0,0,0,0
3105,23,2,1,0,1,0,0,0
2673,21,2,1,0,1,0,0,0
2673,21,2,1,0,1,0,0,0
2673,21,2,1,0,1,0,0,0
0,0,0,0,0,0,0,0,0
0,0,0,0,0,0,0,0,0
65183,303,1,6,4,2,0,0,0
4369,27,3,0,0,0,0,0,0
4369,27,3,0,0,0,0,0,0
0,0,0,0,0,0,0,0,0
0,0,0,0,0,0,0,0,0
20771,158,0,1,0,1,0,1,0
20771,158,0,1,0,1,0,1,0
0,0,0,0,0,0,0,0,0
26227,117,3,6,3,3,0,0,0
26496,118,3,6,3,3,0,0,0
0,0,0,0,0,0,0,0,0
0,0,0,0,0,0,0,0,0
0,0,0,0,0,0,0,0,0
0,0,0,0,0,0,0,0,0
0,0,0,0,0,0,0,0,0
0,0,0,0,0,0,0,0,0
0,0,0,0,0,0,0,0,0
16309,89,0,15,1,14,0,1,0
0,0,0,0,0,0,0,0,0
0,0,0,0,0,0,0,0,0
0,0,0,0,0,0,0,0,0
0,0,0,0,0,0,0,0,0
0,0,0,0,0,0,0,0,0
0,0,0,0,0,0,0,0,0
0,0,0,0,0,0,0,0,0
0,0,0,0,0,0,0,0,0
0,0,0,0,0,0,0,0,0
0,0,0,0,0,0,0,0,0
0,0,0,0,0,0,0,0,0
0,0,0,0,0,0,0,0,0
0,0,0,0,0,0,0,0,0
0,0,0,0,0,0,0,0,0
0,0,0,0,0,0,0,0,0
0,0,0,0,0,0,0,0,0
0,0,0,0,0,0,0,0,0
0,0,0,0,0,0,0,0,0
0,0,0,0,0,0,0,0,0
0,0,0,0,0,0,0,0,0
0,0,0,0,0,0,0,0,0
0,0,0,0,0,0,0,0,0
0,0,0,0,0,0,0,0,0
0,0,0,0,0,0,0,0,0
0,0,0,0,0,0,0,0,0
0,0,0,0,0,0,0,0,0
0,0,0,0,0,0,0,0,0
0,0,0,0,0,0,0,0,0
0,0,0,0,0,0,0,0,0
0,0,0,0,0,0,0,0,0
0,0,0,0,0,0,0,0,0
0,0,0,0,0,0,0,0,0
0,0,0,0,0,0,0,0,0
0,0,0,0,0,0,0,0,0
0,0,0,0,0,0,0,0,0
0,0,0,0,0,0,0,0,0
0,0,0,0,0,0,0,0,0
0,0,0,0,0,0,0,0,0
0,0,0,0,0,0,0,0,0
0,0,0,0,0,0,0,0,0
0,0,0,0,0,0,0,0,0
0,0,0,0,0,0,0,0,0
0,0,0,0,0,0,0,0,0
0,0,0,0,0,0,0,0,0
0,0,0,0,0,0,0,0,0
0,0,0,0,0,0,0,0,0
0,0,0,0,0,0,0,0,0
0,0,0,0,0,0,0,0,0
0,0,0,0,0,0,0,0,0
0,0,0,0,0,0,0,0,0
0,0,0,0,0,0,0,0,0
0,0,0,0,0,0,0,0,0
0,0,0,0,0,0,0,0,0
0,0,0,0,0,0,0,0,0
0,0,0,0,0,0,0,0,0
0,0,0,0,0,0,0,0,0
0,0,0,0,0,0,0,0,0
0,0,0,0,0,0,0,0,0
0,0,0,0,0,0,0,0,0
0,0,0,0,0,0,0,0,0
0,0,0,0,0,0,0,0,0
0,0,0,0,0,0,0,0,0
0,0,0,0,0,0,0,0,0
0,0,0,0,0,0,0,0,0
0,0,0,0,0,0,0,0,0
0,0,0,0,0,0,0,0,0
0,0,0,0,0,0,0,0,0
0,0,0,0,0,0,0,0,0
0,0,0,0,0,0,0,0,0
0,0,0,0,0,0,0,0,0
0,0,0,0,0,0,0,0,0
3788,26,0,0,0,0,0,0,0
0,0,0,0,0,0,0,0,0
0,0,0,0,0,0,0,0,0
0,0,0,0,0,0,0,0,0
0,0,0,0,0,0,0,0,0
0,0,0,0,0,0,0,0,0
0,0,0,0,0,0,0,0,0
0,0,0,0,0,0,0,0,0
0,0,0,0,0,0,0,0,0
0,0,0,0,0,0,0,0,0
0,0,0,0,0,0,0,0,0
0,0,0,0,0,0,0,0,0
64861,50,3,0,0,0,0,0,0
0,0,0,0,0,0,0,0,0
676380,557,0,4,4,0,2,1,1
0,0,0,0,0,0,0,0,0
0,0,0,0,0,0,0,0,0
0,0,0,0,0,0,0,0,0
0,0,0,0,0,0,0,0,0
0,0,0,0,0,0,0,0,0
0,0,0,0,0,0,0,0,0
0,0,0,0,0,0,0,0,0
0,0,0,0,0,0,0,0,0
0,0,0,0,0,0,0,0,0
6306,74,2,4,4,0,0,1,0
93296,211,4,0,0,0,1,0,0
0,0,0,0,0,0,0,0,0
0,0,0,0,0,0,0,0,0
0,0,0,0,0,0,0,0,0
0,0,0,0,0,0,0,0,0
0,0,0,0,0,0,0,0,0
0,0,0,0,0,0,0,0,0
0,0,0,0,0,0,0,0,0
0,0,0,0,0,0,0,0,0
0,0,0,0,0,0,0,0,0
0,0,0,0,0,0,0,0,0
0,0,0,0,0,0,0,0,0
0,0,0,0,0,0,0,0,0
0,0,0,0,0,0,0,0,0
0,0,0,0,0,0,0,0,0
0,0,0,0,0,0,0,0,0
0,0,0,0,0,0,0,0,0
0,0,0,0,0,0,0,0,0
0,0,0,0,0,0,0,0,0
0,0,0,0,0,0,0,0,0
0,0,0,0,0,0,0,0,0
0,0,0,0,0,0,0,0,0
0,0,0,0,0,0,0,0,0
0,0,0,0,0,0,0,0,0
0,0,0,0,0,0,0,0,0
0,0,0,0,0,0,0,0,0
0,0,0,0,0,0,0,0,0
0,0,0,0,0,0,0,0,0
0,0,0,0,0,0,0,0,0
2673,21,2,1,0,1,0,0,0
387200,240,5,2,0,2,2,0,0
1350,19,0,2,1,1,0,0,0
2673,21,2,1,0,1,0,0,0
0,0,0,0,0,0,0,0,0
0,0,0,0,0,0,0,0,0
0,0,0,0,0,0,0,0,0
121784,965,1,116,11,105,84,0,0
64849,50,3,0,0,0,0,0,0
64849,50,3,0,0,0,0,0,0
133220,309,8,27,24,3,16,1,0
0,0,0,0,0,0,0,0,0
7690,112,3,32,32,0,0,1,0
0,0,0,0,0,0,0,0,0
0,0,0,0,0,0,0,0,0
0,0,0,0,0,0,0,0,0
133443,309,8,26,24,2,16,1,0
317668,260,4,1,1,0,0,1,0
288383,251,4,1,1,0,0,1,0
0,0,0,0,0,0,0,0,0
0,0,0,0,0,0,0,0,0
0,0,0,0,0,0,0,0,0
138565,394,8,26,24,2,30,1,0
0,0,0,0,0,0,0,0,0
0,0,0,0,0,0,0,0,0
0,0,0,0,0,0,0,0,0
138813,259,1,20,7,13,7,1,0
0,0,0,0,0,0,0,0,0
0,0,0,0,0,0,0,0,0
0,0,0,0,0,0,0,0,0
0,0,0,0,0,0,0,0,0
12682,46,2,0,0,0,2,0,0
0,0,0,0,0,0,0,0,0
0,0,0,0,0,0,0,0,0
0,0,0,0,0,0,0,0,0
0,0,0,0,0,0,0,0,0
0,0,0,0,0,0,0,0,0
0,0,0,0,0,0,0,0,0
305521,189,4,1,1,0,0,1,0
0,0,0,0,0,0,0,0,0
14970,127,3,20,11,9,0,1,0
0,0,0,0,0,0,0,0,0
0,0,0,0,0,0,0,0,0
0,0,0,0,0,0,0,0,0
0,0,0,0,0,0,0,0,0
0,0,0,0,0,0,0,0,0
0,0,0,0,0,0,0,0,0
0,0,0,0,0,0,0,0,0
0,0,0,0,0,0,0,0,0
670365,542,0,4,4,0,2,1,1
0,0,0,0,0,0,0,0,0
0,0,0,0,0,0,0,0,0
0,0,0,0,0,0,0,0,0
673514,556,0,4,4,0,2,1,1
0,0,0,0,0,0,0,0,0
0,0,0,0,0,0,0,0,0
0,0,0,0,0,0,0,0,0
0,0,0,0,0,0,0,0,0
0,0,0,0,0,0,0,0,0
0,0,0,0,0,0,0,0,0
0,0,0,0,0,0,0,0,0
36248,170,2,5,4,1,18,0,0
0,0,0,0,0,0,0,0,0
0,0,0,0,0,0,0,0,0
0,0,0,0,0,0,0,0,0
0,0,0,0,0,0,0,0,0
0,0,0,0,0,0,0,0,0
0,0,0,0,0,0,0,0,0
0,0,0,0,0,0,0,0,0
0,0,0,0,0,0,0,0,0
58109,197,2,8,4,4,1,0,0
0,0,0,0,0,0,0,0,0
0,0,0,0,0,0,0,0,0
0,0,0,0,0,0,0,0,0
0,0,0,0,0,0,0,0,0
0,0,0,0,0,0,0,0,0
59293,391,5,22,19,3,3,1,0
0,0,0,0,0,0,0,0,0
0,0,0,0,0,0,0,0,0
0,0,0,0,0,0,0,0,0
88261,914,1,257,220,37,2,0,0
88743,916,1,257,220,37,3,0,0
0,0,0,0,0,0,0,0,0
0,0,0,0,0,0,0,0,0
0,0,0,0,0,0,0,0,0
0,0,0,0,0,0,0,0,0
0,0,0,0,0,0,0,0,0
0,0,0,0,0,0,0,0,0
22144,147,0,1,0,1,0,1,0
22144,147,0,1,0,1,0,1,0
99236,959,3,149,76,73,2,0,0
0,0,0,0,0,0,0,0,0
0,0,0,0,0,0,0,0,0
0,0,0,0,0,0,0,0,0
0,0,0,0,0,0,0,0,0
0,0,0,0,0,0,0,0,0
0,0,0,0,0,0,0,0,0
0,0,0,0,0,0,0,0,0
0,0,0,0,0,0,0,0,0
0,0,0,0,0,0,0,0,0
0,0,0,0,0,0,0,0,0
0,0,0,0,0,0,0,0,0
0,0,0,0,0,0,0,0,0
0,0,0,0,0,0,0,0,0
0,0,0,0,0,0,0,0,0
0,0,0,0,0,0,0,0,0
0,0,0,0,0,0,0,0,0
13647,99,0,1,0,1,0,0,0
0,0,0,0,0,0,0,0,0
0,0,0,0,0,0,0,0,0
0,0,0,0,0,0,0,0,0
0,0,0,0,0,0,0,0,0
0,0,0,0,0,0,0,0,0
0,0,0,0,0,0,0,0,0
0,0,0,0,0,0,0,0,0
0,0,0,0,0,0,0,0,0
91464,211,4,0,0,0,1,0,0
0,0,0,0,0,0,0,0,0
0,0,0,0,0,0,0,0,0
0,0,0,0,0,0,0,0,0
0,0,0,0,0,0,0,0,0
0,0,0,0,0,0,0,0,0
0,0,0,0,0,0,0,0,0
0,0,0,0,0,0,0,0,0
0,0,0,0,0,0,0,0,0
0,0,0,0,0,0,0,0,0
0,0,0,0,0,0,0,0,0
0,0,0,0,0,0,0,0,0
0,0,0,0,0,0,0,0,0
0,0,0,0,0,0,0,0,0
0,0,0,0,0,0,0,0,0
0,0,0,0,0,0,0,0,0
0,0,0,0,0,0,0,0,0
0,0,0,0,0,0,0,0,0
3572,91,2,0,0,0,1,0,0
0,0,0,0,0,0,0,0,0
675456,557,0,4,4,0,2,1,1
0,0,0,0,0,0,0,0,0
0,0,0,0,0,0,0,0,0
36248,170,2,5,4,1,18,0,0
0,0,0,0,0,0,0,0,0
36248,170,2,5,4,1,18,0,0
0,0,0,0,0,0,0,0,0
0,0,0,0,0,0,0,0,0
91822,212,4,0,0,0,1,0,0
91184,211,4,0,0,0,1,0,0
92053,209,4,0,0,0,1,0,0
91505,211,4,0,0,0,1,0,0
90911,209,4,0,0,0,1,0,0
91262,211,4,0,0,0,1,0,0
91632,214,4,0,0,0,1,0,0
91072,211,4,0,0,0,1,0,0
91581,214,4,0,0,0,1,0,0
92101,211,4,0,0,0,1,0,0
92049,214,4,0,0,0,1,0,0
90882,211,4,0,0,0,1,0,0
91179,211,4,0,0,0,1,0,0
91186,211,4,0,0,0,1,0,0
0,0,0,0,0,0,0,0,0
91318,211,4,0,0,0,1,0,0
91165,211,4,0,0,0,1,0,0
90873,211,4,0,0,0,1,0,0
90961,209,4,0,0,0,1,0,0
91775,212,4,0,0,0,1,0,0
90894,211,4,0,0,0,1,0,0
90883,211,4,0,0,0,1,0,0
0,0,0,0,0,0,0,0,0
92281,214,4,0,0,0,1,0,0
91421,211,4,0,0,0,1,0,0
90831,211,4,0,0,0,1,0,0
92049,211,5,0,0,0,1,0,0
92184,214,4,0,0,0,1,0,0
91113,209,4,0,0,0,1,0,0
91251,211,4,0,0,0,1,0,0
91538,211,4,0,0,0,1,0,0
91298,211,4,0,0,0,1,0,0
91351,211,4,0,0,0,1,0,0
91289,211,4,0,0,0,1,0,0
91668,212,4,0,0,0,1,0,0
91515,211,4,0,0,0,1,0,0
91069,212,4,0,0,0,1,0,0
0,0,0,0,0,0,0,0,0
0,0,0,0,0,0,0,0,0
91683,211,4,0,0,0,1,0,0
0,0,0,0,0,0,0,0,0
0,0,0,0,0,0,0,0,0
0,0,0,0,0,0,0,0,0
0,0,0,0,0,0,0,0,0
0,0,0,0,0,0,0,0,0
204910,155,3,2,1,1,18,0,0
204922,155,3,2,1,1,18,0,0
0,0,0,0,0,0,0,0,0
0,0,0,0,0,0,0,0,0
17694,210,1,51,50,1,0,1,0
17694,210,1,51,50,1,0,1,0
0,0,0,0,0,0,0,0,0
0,0,0,0,0,0,0,0,0
0,0,0,0,0,0,0,0,0
0,0,0,0,0,0,0,0,0
0,0,0,0,0,0,0,0,0
27107,102,1,7,7,0,2,0,0
0,0,0,0,0,0,0,0,0
0,0,0,0,0,0,0,0,0
0,0,0,0,0,0,0,0,0
375801,181,4,1,1,0,0,1,0
0,0,0,0,0,0,0,0,0
0,0,0,0,0,0,0,0,0
277983,171,4,1,1,0,0,1,0
0,0,0,0,0,0,0,0,0
0,0,0,0,0,0,0,0,0
0,0,0,0,0,0,0,0,0
0,0,0,0,0,0,0,0,0
0,0,0,0,0,0,0,0,0
0,0,0,0,0,0,0,0,0
0,0,0,0,0,0,0,0,0
0,0,0,0,0,0,0,0,0
0,0,0,0,0,0,0,0,0
64861,50,3,0,0,0,0,0,0
672021,556,0,4,4,0,2,1,1
0,0,0,0,0,0,0,0,0
0,0,0,0,0,0,0,0,0
0,0,0,0,0,0,0,0,0
36248,170,2,5,4,1,18,0,0
0,0,0,0,0,0,0,0,0
0,0,0,0,0,0,0,0,0
0,0,0,0,0,0,0,0,0
91566,211,4,0,0,0,1,0,0
0,0,0,0,0,0,0,0,0
0,0,0,0,0,0,0,0,0
0,0,0,0,0,0,0,0,0
0,0,0,0,0,0,0,0,0
0,0,0,0,0,0,0,0,0
385,23,0,4,4,0,0,0,0
0,0,0,0,0,0,0,0,0
0,0,0,0,0,0,0,0,0
0,0,0,0,0,0,0,0,0
0,0,0,0,0,0,0,0,0
0,0,0,0,0,0,0,0,0
0,0,0,0,0,0,0,0,0
0,0,0,0,0,0,0,0,0
0,0,0,0,0,0,0,0,0
0,0,0,0,0,0,0,0,0
0,0,0,0,0,0,0,0,0
0,0,0,0,0,0,0,0,0
0,0,0,0,0,0,0,0,0
0,0,0,0,0,0,0,0,0
0,0,0,0,0,0,0,0,0
0,0,0,0,0,0,0,0,0
0,0,0,0,0,0,0,0,0
0,0,0,0,0,0,0,0,0
0,0,0,0,0,0,0,0,0
0,0,0,0,0,0,0,0,0
0,0,0,0,0,0,0,0,0
0,0,0,0,0,0,0,0,0
0,0,0,0,0,0,0,0,0
0,0,0,0,0,0,0,0,0
0,0,0,0,0,0,0,0,0
0,0,0,0,0,0,0,0,0
0,0,0,0,0,0,0,0,0
0,0,0,0,0,0,0,0,0
0,0,0,0,0,0,0,0,0
0,0,0,0,0,0,0,0,0
0,0,0,0,0,0,0,0,0
0,0,0,0,0,0,0,0,0
138286,393,8,26,24,2,32,1,0
2673,21,2,1,0,1,0,0,0
0,0,0,0,0,0,0,0,0
0,0,0,0,0,0,0,0,0
39945,127,2,5,2,3,1,1,0
0,0,0,0,0,0,0,0,0
0,0,0,0,0,0,0,0,0
0,0,0,0,0,0,0,0,0
0,0,0,0,0,0,0,0,0
0,0,0,0,0,0,0,0,0
26510,141,2,16,4,12,0,1,1
26510,141,2,16,4,12,0,1,1
1059955,101,4,5,5,0,3,1,0
0,0,0,0,0,0,0,0,0
327113,60,4,3,3,0,2,1,0
327113,60,4,3,3,0,2,1,0
327113,60,4,3,3,0,2,1,0
415481,62,4,3,3,0,2,1,0
231255,136,3,21,1,20,3,0,0
231255,136,3,21,1,20,3,0,0
327113,60,4,3,3,0,2,1,0
327113,60,4,3,3,0,2,1,0
0,0,0,0,0,0,0,0,0
5663583,213,0,52,51,1,0,1,0
5663583,213,0,52,51,1,0,1,0
327113,60,4,3,3,0,2,1,0
231255,136,3,21,1,20,3,0,0
0,0,0,0,0,0,0,0,0
231255,136,3,21,1,20,3,0,0
5663583,213,0,52,51,1,0,1,0
5663583,213,0,52,51,1,0,1,0
5663583,213,0,52,51,1,0,1,0
0,0,0,0,0,0,0,0,0
0,0,0,0,0,0,0,0,0
0,0,0,0,0,0,0,0,0
0,0,0,0,0,0,0,0,0
0,0,0,0,0,0,0,0,0
0,0,0,0,0,0,0,0,0
0,0,0,0,0,0,0,0,0
0,0,0,0,0,0,0,0,0
0,0,0,0,0,0,0,0,0
0,0,0,0,0,0,0,0,0
0,0,0,0,0,0,0,0,0
0,0,0,0,0,0,0,0,0
0,0,0,0,0,0,0,0,0
20144,53,3,0,0,0,0,0,0
0,0,0,0,0,0,0,0,0
0,0,0,0,0,0,0,0,0
0,0,0,0,0,0,0,0,0
20144,53,3,0,0,0,0,0,0
0,0,0,0,0,0,0,0,0
3766,44,0,2,0,2,1,0,0
144511,62,4,3,3,0,2,1,0
0,0,0,0,0,0,0,0,0
0,0,0,0,0,0,0,0,0
0,0,0,0,0,0,0,0,0
0,0,0,0,0,0,0,0,0
0,0,0,0,0,0,0,0,0
0,0,0,0,0,0,0,0,0
0,0,0,0,0,0,0,0,0
0,0,0,0,0,0,0,0,0
0,0,0,0,0,0,0,0,0
0,0,0,0,0,0,0,0,0
0,0,0,0,0,0,0,0,0
1060484,101,4,5,5,0,3,1,0
0,0,0,0,0,0,0,0,0
0,0,0,0,0,0,0,0,0
0,0,0,0,0,0,0,0,0
0,0,0,0,0,0,0,0,0
0,0,0,0,0,0,0,0,0
0,0,0,0,0,0,0,0,0
0,0,0,0,0,0,0,0,0
0,0,0,0,0,0,0,0,0
0,0,0,0,0,0,0,0,0
0,0,0,0,0,0,0,0,0
0,0,0,0,0,0,0,0,0
673110,542,0,4,4,0,2,1,1
0,0,0,0,0,0,0,0,0
0,0,0,0,0,0,0,0,0
0,0,0,0,0,0,0,0,0
2673,21,2,1,0,1,0,0,0
0,0,0,0,0,0,0,0,0
2673,21,2,1,0,1,0,0,0
0,0,0,0,0,0,0,0,0
0,0,0,0,0,0,0,0,0
0,0,0,0,0,0,0,0,0
0,0,0,0,0,0,0,0,0
2673,21,2,1,0,1,0,0,0
0,0,0,0,0,0,0,0,0
64849,50,3,0,0,0,0,0,0
2673,21,2,1,0,1,0,0,0
0,0,0,0,0,0,0,0,0
0,0,0,0,0,0,0,0,0
0,0,0,0,0,0,0,0,0
0,0,0,0,0,0,0,0,0
0,0,0,0,0,0,0,0,0
0,0,0,0,0,0,0,0,0
0,0,0,0,0,0,0,0,0
64849,50,3,0,0,0,0,0,0
674017,556,0,4,4,0,2,1,1
0,0,0,0,0,0,0,0,0
0,0,0,0,0,0,0,0,0
0,0,0,0,0,0,0,0,0
259630,1332,4,26,1,25,0,1,0
110373,1036,4,161,161,0,2,0,0
91017,211,4,0,0,0,1,0,0
15325,51,2,0,0,0,2,0,0
0,0,0,0,0,0,0,0,0
64860,50,3,0,0,0,0,0,0
0,0,0,0,0,0,0,0,0
677399,556,0,4,2,2,2,1,1
0,0,0,0,0,0,0,0,0
0,0,0,0,0,0,0,0,0
0,0,0,0,0,0,0,0,0
12985,96,0,3,3,0,0,0,0
0,0,0,0,0,0,0,0,0
0,0,0,0,0,0,0,0,0
64849,50,3,0,0,0,0,0,0
0,0,0,0,0,0,0,0,0
0,0,0,0,0,0,0,0,0
0,0,0,0,0,0,0,0,0
0,0,0,0,0,0,0,0,0
671825,556,0,4,4,0,2,1,1
13008,98,0,3,3,0,0,0,0
0,0,0,0,0,0,0,0,0
0,0,0,0,0,0,0,0,0
0,0,0,0,0,0,0,0,0
0,0,0,0,0,0,0,0,0
0,0,0,0,0,0,0,0,0
0,0,0,0,0,0,0,0,0
0,0,0,0,0,0,0,0,0
0,0,0,0,0,0,0,0,0
0,0,0,0,0,0,0,0,0
0,0,0,0,0,0,0,0,0
3501,23,1,1,1,0,0,0,0
0,0,0,0,0,0,0,0,0
0,0,0,0,0,0,0,0,0
0,0,0,0,0,0,0,0,0
0,0,0,0,0,0,0,0,0
0,0,0,0,0,0,0,0,0
0,0,0,0,0,0,0,0,0
0,0,0,0,0,0,0,0,0
0,0,0,0,0,0,0,0,0
0,0,0,0,0,0,0,0,0
0,0,0,0,0,0,0,0,0
0,0,0,0,0,0,0,0,0
0,0,0,0,0,0,0,0,0
0,0,0,0,0,0,0,0,0
0,0,0,0,0,0,0,0,0
0,0,0,0,0,0,0,0,0
0,0,0,0,0,0,0,0,0
0,0,0,0,0,0,0,0,0
0,0,0,0,0,0,0,0,0
0,0,0,0,0,0,0,0,0
0,0,0,0,0,0,0,0,0
0,0,0,0,0,0,0,0,0
23492,59,4,3,3,0,2,1,0
23492,59,4,3,3,0,2,1,0
0,0,0,0,0,0,0,0,0
23492,59,4,3,3,0,2,1,0
0,0,0,0,0,0,0,0,0
0,0,0,0,0,0,0,0,0
0,0,0,0,0,0,0,0,0
0,0,0,0,0,0,0,0,0
23492,59,4,3,3,0,2,1,0
0,0,0,0,0,0,0,0,0
0,0,0,0,0,0,0,0,0
0,0,0,0,0,0,0,0,0
0,0,0,0,0,0,0,0,0
0,0,0,0,0,0,0,0,0
0,0,0,0,0,0,0,0,0
0,0,0,0,0,0,0,0,0
0,0,0,0,0,0,0,0,0
0,0,0,0,0,0,0,0,0
0,0,0,0,0,0,0,0,0
0,0,0,0,0,0,0,0,0
0,0,0,0,0,0,0,0,0
0,0,0,0,0,0,0,0,0
292738,187,4,1,1,0,0,1,0
23291,225,3,24,24,0,0,1,0
0,0,0,0,0,0,0,0,0
23677,228,4,24,24,0,0,1,0
135674,377,6,26,24,2,20,1,0
0,0,0,0,0,0,0,0,0
0,0,0,0,0,0,0,0,0
0,0,0,0,0,0,0,0,0
318842,244,4,7,7,0,0,1,0
0,0,0,0,0,0,0,0,0
0,0,0,0,0,0,0,0,0
0,0,0,0,0,0,0,0,0
0,0,0,0,0,0,0,0,0
397247,4037,8,1052,1052,0,3,0,0
0,0,0,0,0,0,0,0,0
685689,4,0,0,0,0,0,0,0
685689,4,0,0,0,0,0,0,0
685689,4,0,0,0,0,0,0,0
441096,98,3,2,2,0,0,0,0
0,0,0,0,0,0,0,0,0
0,0,0,0,0,0,0,0,0
0,0,0,0,0,0,0,0,0
0,0,0,0,0,0,0,0,0
0,0,0,0,0,0,0,0,0
0,0,0,0,0,0,0,0,0
0,0,0,0,0,0,0,0,0
673451,542,0,4,4,0,2,1,1
0,0,0,0,0,0,0,0,0
0,0,0,0,0,0,0,0,0
0,0,0,0,0,0,0,0,0
0,0,0,0,0,0,0,0,0
0,0,0,0,0,0,0,0,0
0,0,0,0,0,0,0,0,0
0,0,0,0,0,0,0,0,0
0,0,0,0,0,0,0,0,0
0,0,0,0,0,0,0,0,0
0,0,0,0,0,0,0,0,0
0,0,0,0,0,0,0,0,0
34478,50,2,0,0,0,2,0,0
34474,50,2,0,0,0,2,0,0
0,0,0,0,0,0,0,0,0
0,0,0,0,0,0,0,0,0
0,0,0,0,0,0,0,0,0
0,0,0,0,0,0,0,0,0
0,0,0,0,0,0,0,0,0
0,0,0,0,0,0,0,0,0
0,0,0,0,0,0,0,0,0
0,0,0,0,0,0,0,0,0
0,0,0,0,0,0,0,0,0
0,0,0,0,0,0,0,0,0
0,0,0,0,0,0,0,0,0
0,0,0,0,0,0,0,0,0
0,0,0,0,0,0,0,0,0
64849,50,3,0,0,0,0,0,0
0,0,0,0,0,0,0,0,0
0,0,0,0,0,0,0,0,0
0,0,0,0,0,0,0,0,0
0,0,0,0,0,0,0,0,0
0,0,0,0,0,0,0,0,0
0,0,0,0,0,0,0,0,0
0,0,0,0,0,0,0,0,0
0,0,0,0,0,0,0,0,0
0,0,0,0,0,0,0,0,0
64849,50,3,0,0,0,0,0,0
0,0,0,0,0,0,0,0,0
0,0,0,0,0,0,0,0,0
0,0,0,0,0,0,0,0,0
0,0,0,0,0,0,0,0,0
0,0,0,0,0,0,0,0,0
91189,212,4,0,0,0,1,0,0
0,0,0,0,0,0,0,0,0
0,0,0,0,0,0,0,0,0
91320,212,4,0,0,0,1,0,0
91188,209,4,0,0,0,1,0,0
0,0,0,0,0,0,0,0,0
91302,211,4,0,0,0,1,0,0
0,0,0,0,0,0,0,0,0
91493,209,4,0,0,0,1,0,0
90990,211,4,0,0,0,1,0,0
91058,212,4,0,0,0,1,0,0
91847,211,4,0,0,0,1,0,0
91061,212,4,0,0,0,1,0,0
0,0,0,0,0,0,0,0,0
91667,211,4,0,0,0,1,0,0
91720,211,4,0,0,0,1,0,0
0,0,0,0,0,0,0,0,0
0,0,0,0,0,0,0,0,0
91193,211,4,0,0,0,1,0,0
0,0,0,0,0,0,0,0,0
0,0,0,0,0,0,0,0,0
91571,211,4,0,0,0,1,0,0
0,0,0,0,0,0,0,0,0
0,0,0,0,0,0,0,0,0
91847,211,4,0,0,0,1,0,0
0,0,0,0,0,0,0,0,0
93145,209,4,0,0,0,1,0,0
0,0,0,0,0,0,0,0,0
0,0,0,0,0,0,0,0,0
91201,212,4,0,0,0,1,0,0
90858,212,4,0,0,0,1,0,0
0,0,0,0,0,0,0,0,0
91674,211,4,0,0,0,1,0,0
0,0,0,0,0,0,0,0,0
91528,211,4,0,0,0,1,0,0
0,0,0,0,0,0,0,0,0
91579,211,4,0,0,0,1,0,0
0,0,0,0,0,0,0,0,0
91595,212,4,0,0,0,1,0,0
90950,212,4,0,0,0,1,0,0
91205,212,4,0,0,0,1,0,0
0,0,0,0,0,0,0,0,0
91552,212,4,0,0,0,1,0,0
91437,212,4,0,0,0,1,0,0
0,0,0,0,0,0,0,0,0
0,0,0,0,0,0,0,0,0
0,0,0,0,0,0,0,0,0
92394,211,4,0,0,0,1,0,0
0,0,0,0,0,0,0,0,0
0,0,0,0,0,0,0,0,0
0,0,0,0,0,0,0,0,0
0,0,0,0,0,0,0,0,0
0,0,0,0,0,0,0,0,0
0,0,0,0,0,0,0,0,0
91134,211,4,0,0,0,1,0,0
91019,212,4,0,0,0,1,0,0
92328,211,4,0,0,0,1,0,0
0,0,0,0,0,0,0,0,0
91149,209,4,0,0,0,1,0,0
0,0,0,0,0,0,0,0,0
0,0,0,0,0,0,0,0,0
92342,211,4,0,0,0,1,0,0
92506,211,4,0,0,0,1,0,0
91601,211,4,0,0,0,1,0,0
0,0,0,0,0,0,0,0,0
0,0,0,0,0,0,0,0,0
0,0,0,0,0,0,0,0,0
93558,214,4,0,0,0,1,0,0
0,0,0,0,0,0,0,0,0
93644,214,4,0,0,0,1,0,0
93604,214,4,0,0,0,1,0,0
92970,214,4,0,0,0,1,0,0
93314,214,4,0,0,0,1,0,0
93236,214,4,0,0,0,1,0,0
93557,214,4,0,0,0,1,0,0
0,0,0,0,0,0,0,0,0
0,0,0,0,0,0,0,0,0
93555,214,4,0,0,0,1,0,0
0,0,0,0,0,0,0,0,0
0,0,0,0,0,0,0,0,0
0,0,0,0,0,0,0,0,0
0,0,0,0,0,0,0,0,0
93558,214,4,0,0,0,1,0,0
94150,211,4,0,0,0,1,0,0
0,0,0,0,0,0,0,0,0
92973,214,4,0,0,0,1,0,0
0,0,0,0,0,0,0,0,0
93704,214,4,0,0,0,1,0,0
0,0,0,0,0,0,0,0,0
90962,212,4,0,0,0,1,0,0
0,0,0,0,0,0,0,0,0
0,0,0,0,0,0,0,0,0
0,0,0,0,0,0,0,0,0
0,0,0,0,0,0,0,0,0
0,0,0,0,0,0,0,0,0
0,0,0,0,0,0,0,0,0
0,0,0,0,0,0,0,0,0
0,0,0,0,0,0,0,0,0
0,0,0,0,0,0,0,0,0
0,0,0,0,0,0,0,0,0
0,0,0,0,0,0,0,0,0
0,0,0,0,0,0,0,0,0
0,0,0,0,0,0,0,0,0
0,0,0,0,0,0,0,0,0
0,0,0,0,0,0,0,0,0
0,0,0,0,0,0,0,0,0
0,0,0,0,0,0,0,0,0
0,0,0,0,0,0,0,0,0
0,0,0,0,0,0,0,0,0
0,0,0,0,0,0,0,0,0
0,0,0,0,0,0,0,0,0
0,0,0,0,0,0,0,0,0
0,0,0,0,0,0,0,0,0
0,0,0,0,0,0,0,0,0
0,0,0,0,0,0,0,0,0
0,0,0,0,0,0,0,0,0
0,0,0,0,0,0,0,0,0
0,0,0,0,0,0,0,0,0
0,0,0,0,0,0,0,0,0
0,0,0,0,0,0,0,0,0
0,0,0,0,0,0,0,0,0
0,0,0,0,0,0,0,0,0
0,0,0,0,0,0,0,0,0
0,0,0,0,0,0,0,0,0
0,0,0,0,0,0,0,0,0
0,0,0,0,0,0,0,0,0
0,0,0,0,0,0,0,0,0
0,0,0,0,0,0,0,0,0
0,0,0,0,0,0,0,0,0
0,0,0,0,0,0,0,0,0
0,0,0,0,0,0,0,0,0
0,0,0,0,0,0,0,0,0
0,0,0,0,0,0,0,0,0
0,0,0,0,0,0,0,0,0
0,0,0,0,0,0,0,0,0
0,0,0,0,0,0,0,0,0
0,0,0,0,0,0,0,0,0
0,0,0,0,0,0,0,0,0
0,0,0,0,0,0,0,0,0
0,0,0,0,0,0,0,0,0
0,0,0,0,0,0,0,0,0
0,0,0,0,0,0,0,0,0
0,0,0,0,0,0,0,0,0
0,0,0,0,0,0,0,0,0
0,0,0,0,0,0,0,0,0
0,0,0,0,0,0,0,0,0
0,0,0,0,0,0,0,0,0
0,0,0,0,0,0,0,0,0
0,0,0,0,0,0,0,0,0
0,0,0,0,0,0,0,0,0
0,0,0,0,0,0,0,0,0
0,0,0,0,0,0,0,0,0
0,0,0,0,0,0,0,0,0
0,0,0,0,0,0,0,0,0
0,0,0,0,0,0,0,0,0
0,0,0,0,0,0,0,0,0
0,0,0,0,0,0,0,0,0
0,0,0,0,0,0,0,0,0
0,0,0,0,0,0,0,0,0
0,0,0,0,0,0,0,0,0
0,0,0,0,0,0,0,0,0
0,0,0,0,0,0,0,0,0
0,0,0,0,0,0,0,0,0
0,0,0,0,0,0,0,0,0
0,0,0,0,0,0,0,0,0
0,0,0,0,0,0,0,0,0
0,0,0,0,0,0,0,0,0
92374,211,4,0,0,0,1,0,0
0,0,0,0,0,0,0,0,0
92153,211,4,0,0,0,1,0,0
92079,209,4,0,0,0,1,0,0
0,0,0,0,0,0,0,0,0
0,0,0,0,0,0,0,0,0
93188,211,4,0,0,0,1,0,0
0,0,0,0,0,0,0,0,0
0,0,0,0,0,0,0,0,0
0,0,0,0,0,0,0,0,0
0,0,0,0,0,0,0,0,0
0,0,0,0,0,0,0,0,0
0,0,0,0,0,0,0,0,0
0,0,0,0,0,0,0,0,0
0,0,0,0,0,0,0,0,0
0,0,0,0,0,0,0,0,0
0,0,0,0,0,0,0,0,0
0,0,0,0,0,0,0,0,0
0,0,0,0,0,0,0,0,0
0,0,0,0,0,0,0,0,0
0,0,0,0,0,0,0,0,0
0,0,0,0,0,0,0,0,0
0,0,0,0,0,0,0,0,0
0,0,0,0,0,0,0,0,0
0,0,0,0,0,0,0,0,0
0,0,0,0,0,0,0,0,0
0,0,0,0,0,0,0,0,0
92084,212,4,0,0,0,1,0,0
0,0,0,0,0,0,0,0,0
0,0,0,0,0,0,0,0,0
0,0,0,0,0,0,0,0,0
0,0,0,0,0,0,0,0,0
0,0,0,0,0,0,0,0,0
0,0,0,0,0,0,0,0,0
0,0,0,0,0,0,0,0,0
0,0,0,0,0,0,0,0,0
0,0,0,0,0,0,0,0,0
0,0,0,0,0,0,0,0,0
0,0,0,0,0,0,0,0,0
0,0,0,0,0,0,0,0,0
0,0,0,0,0,0,0,0,0
0,0,0,0,0,0,0,0,0
0,0,0,0,0,0,0,0,0
0,0,0,0,0,0,0,0,0
0,0,0,0,0,0,0,0,0
0,0,0,0,0,0,0,0,0
0,0,0,0,0,0,0,0,0
0,0,0,0,0,0,0,0,0
0,0,0,0,0,0,0,0,0
0,0,0,0,0,0,0,0,0
0,0,0,0,0,0,0,0,0
0,0,0,0,0,0,0,0,0
0,0,0,0,0,0,0,0,0
0,0,0,0,0,0,0,0,0
0,0,0,0,0,0,0,0,0
0,0,0,0,0,0,0,0,0
0,0,0,0,0,0,0,0,0
0,0,0,0,0,0,0,0,0
0,0,0,0,0,0,0,0,0
0,0,0,0,0,0,0,0,0
0,0,0,0,0,0,0,0,0
0,0,0,0,0,0,0,0,0
0,0,0,0,0,0,0,0,0
0,0,0,0,0,0,0,0,0
0,0,0,0,0,0,0,0,0
0,0,0,0,0,0,0,0,0
0,0,0,0,0,0,0,0,0
0,0,0,0,0,0,0,0,0
0,0,0,0,0,0,0,0,0
0,0,0,0,0,0,0,0,0
0,0,0,0,0,0,0,0,0
0,0,0,0,0,0,0,0,0
0,0,0,0,0,0,0,0,0
0,0,0,0,0,0,0,0,0
0,0,0,0,0,0,0,0,0
0,0,0,0,0,0,0,0,0
0,0,0,0,0,0,0,0,0
0,0,0,0,0,0,0,0,0
0,0,0,0,0,0,0,0,0
0,0,0,0,0,0,0,0,0
0,0,0,0,0,0,0,0,0
0,0,0,0,0,0,0,0,0
0,0,0,0,0,0,0,0,0
0,0,0,0,0,0,0,0,0
0,0,0,0,0,0,0,0,0
0,0,0,0,0,0,0,0,0
0,0,0,0,0,0,0,0,0
0,0,0,0,0,0,0,0,0
0,0,0,0,0,0,0,0,0
0,0,0,0,0,0,0,0,0
0,0,0,0,0,0,0,0,0
0,0,0,0,0,0,0,0,0
0,0,0,0,0,0,0,0,0
0,0,0,0,0,0,0,0,0
0,0,0,0,0,0,0,0,0
0,0,0,0,0,0,0,0,0
0,0,0,0,0,0,0,0,0
0,0,0,0,0,0,0,0,0
0,0,0,0,0,0,0,0,0
0,0,0,0,0,0,0,0,0
0,0,0,0,0,0,0,0,0
0,0,0,0,0,0,0,0,0
0,0,0,0,0,0,0,0,0
0,0,0,0,0,0,0,0,0
0,0,0,0,0,0,0,0,0
0,0,0,0,0,0,0,0,0
0,0,0,0,0,0,0,0,0
92137,212,4,0,0,0,1,0,0
0,0,0,0,0,0,0,0,0
0,0,0,0,0,0,0,0,0
0,0,0,0,0,0,0,0,0
0,0,0,0,0,0,0,0,0
92069,212,4,0,0,0,1,0,0
92014,210,4,0,0,0,1,0,0
0,0,0,0,0,0,0,0,0
92198,212,4,0,0,0,1,0,0
92383,212,4,0,0,0,1,0,0
92121,210,4,0,0,0,1,0,0
92284,212,4,0,0,0,1,0,0
0,0,0,0,0,0,0,0,0
91949,212,4,0,0,0,1,0,0
91927,212,4,0,0,0,1,0,0
0,0,0,0,0,0,0,0,0
0,0,0,0,0,0,0,0,0
92097,212,4,0,0,0,1,0,0
92172,212,4,0,0,0,1,0,0
0,0,0,0,0,0,0,0,0
0,0,0,0,0,0,0,0,0
92275,212,4,0,0,0,1,0,0
92409,212,4,0,0,0,1,0,0
92154,212,4,0,0,0,1,0,0
92432,212,4,0,0,0,1,0,0
92380,212,4,0,0,0,1,0,0
92481,212,4,0,0,0,1,0,0
92282,212,4,0,0,0,1,0,0
92471,212,4,0,0,0,1,0,0
90908,211,4,0,0,0,1,0,0
92405,212,4,0,0,0,1,0,0
0,0,0,0,0,0,0,0,0
91605,211,4,0,0,0,1,0,0
0,0,0,0,0,0,0,0,0
92799,212,4,0,0,0,1,0,0
92742,212,4,0,0,0,1,0,0
92824,212,4,0,0,0,1,0,0
91589,211,4,0,0,0,1,0,0
0,0,0,0,0,0,0,0,0
92237,212,4,0,0,0,1,0,0
0,0,0,0,0,0,0,0,0
92223,212,4,0,0,0,1,0,0
92692,212,5,0,0,0,1,0,0
91272,211,4,0,0,0,1,0,0
91809,210,4,0,0,0,1,0,0
93542,211,4,0,0,0,1,0,0
0,0,0,0,0,0,0,0,0
0,0,0,0,0,0,0,0,0
92343,212,4,0,0,0,1,0,0
92380,212,4,0,0,0,1,0,0
0,0,0,0,0,0,0,0,0
0,0,0,0,0,0,0,0,0
0,0,0,0,0,0,0,0,0
0,0,0,0,0,0,0,0,0
0,0,0,0,0,0,0,0,0
0,0,0,0,0,0,0,0,0
0,0,0,0,0,0,0,0,0
0,0,0,0,0,0,0,0,0
0,0,0,0,0,0,0,0,0
0,0,0,0,0,0,0,0,0
0,0,0,0,0,0,0,0,0
91828,211,4,0,0,0,1,0,0
0,0,0,0,0,0,0,0,0
0,0,0,0,0,0,0,0,0
0,0,0,0,0,0,0,0,0
0,0,0,0,0,0,0,0,0
0,0,0,0,0,0,0,0,0
0,0,0,0,0,0,0,0,0
0,0,0,0,0,0,0,0,0
0,0,0,0,0,0,0,0,0
0,0,0,0,0,0,0,0,0
0,0,0,0,0,0,0,0,0
0,0,0,0,0,0,0,0,0
0,0,0,0,0,0,0,0,0
0,0,0,0,0,0,0,0,0
0,0,0,0,0,0,0,0,0
0,0,0,0,0,0,0,0,0
0,0,0,0,0,0,0,0,0
0,0,0,0,0,0,0,0,0
0,0,0,0,0,0,0,0,0
0,0,0,0,0,0,0,0,0
0,0,0,0,0,0,0,0,0
0,0,0,0,0,0,0,0,0
0,0,0,0,0,0,0,0,0
0,0,0,0,0,0,0,0,0
0,0,0,0,0,0,0,0,0
0,0,0,0,0,0,0,0,0
88688,209,4,0,0,0,1,0,0
0,0,0,0,0,0,0,0,0
0,0,0,0,0,0,0,0,0
0,0,0,0,0,0,0,0,0
0,0,0,0,0,0,0,0,0
0,0,0,0,0,0,0,0,0
0,0,0,0,0,0,0,0,0
0,0,0,0,0,0,0,0,0
0,0,0,0,0,0,0,0,0
0,0,0,0,0,0,0,0,0
0,0,0,0,0,0,0,0,0
91761,211,4,0,0,0,1,0,0
0,0,0,0,0,0,0,0,0
0,0,0,0,0,0,0,0,0
0,0,0,0,0,0,0,0,0
0,0,0,0,0,0,0,0,0
0,0,0,0,0,0,0,0,0
0,0,0,0,0,0,0,0,0
0,0,0,0,0,0,0,0,0
0,0,0,0,0,0,0,0,0
0,0,0,0,0,0,0,0,0
0,0,0,0,0,0,0,0,0
0,0,0,0,0,0,0,0,0
0,0,0,0,0,0,0,0,0
0,0,0,0,0,0,0,0,0
0,0,0,0,0,0,0,0,0
0,0,0,0,0,0,0,0,0
91376,211,4,0,0,0,1,0,0
0,0,0,0,0,0,0,0,0
0,0,0,0,0,0,0,0,0
0,0,0,0,0,0,0,0,0
0,0,0,0,0,0,0,0,0
0,0,0,0,0,0,0,0,0
0,0,0,0,0,0,0,0,0
0,0,0,0,0,0,0,0,0
0,0,0,0,0,0,0,0,0
0,0,0,0,0,0,0,0,0
91576,211,4,0,0,0,1,0,0
0,0,0,0,0,0,0,0,0
0,0,0,0,0,0,0,0,0
0,0,0,0,0,0,0,0,0
0,0,0,0,0,0,0,0,0
0,0,0,0,0,0,0,0,0
0,0,0,0,0,0,0,0,0
0,0,0,0,0,0,0,0,0
0,0,0,0,0,0,0,0,0
0,0,0,0,0,0,0,0,0
0,0,0,0,0,0,0,0,0
0,0,0,0,0,0,0,0,0
0,0,0,0,0,0,0,0,0
0,0,0,0,0,0,0,0,0
91531,211,4,0,0,0,1,0,0
0,0,0,0,0,0,0,0,0
0,0,0,0,0,0,0,0,0
91532,211,4,0,0,0,1,0,0
0,0,0,0,0,0,0,0,0
91226,211,4,0,0,0,1,0,0
91559,211,4,0,0,0,1,0,0
91141,211,4,0,0,0,1,0,0
0,0,0,0,0,0,0,0,0
0,0,0,0,0,0,0,0,0
0,0,0,0,0,0,0,0,0
91402,209,4,0,0,0,1,0,0
0,0,0,0,0,0,0,0,0
91146,211,4,0,0,0,1,0,0
91244,211,4,0,0,0,1,0,0
0,0,0,0,0,0,0,0,0
91494,211,4,0,0,0,1,0,0
91254,211,4,0,0,0,1,0,0
0,0,0,0,0,0,0,0,0
91113,211,4,0,0,0,1,0,0
91566,211,4,0,0,0,1,0,0
91356,211,4,0,0,0,1,0,0
91055,211,4,0,0,0,1,0,0
0,0,0,0,0,0,0,0,0
91682,209,4,0,0,0,1,0,0
0,0,0,0,0,0,0,0,0
91048,211,4,0,0,0,1,0,0
0,0,0,0,0,0,0,0,0
91335,211,4,0,0,0,1,0,0
91194,211,4,0,0,0,1,0,0
0,0,0,0,0,0,0,0,0
0,0,0,0,0,0,0,0,0
91154,211,4,0,0,0,1,0,0
91669,214,4,0,0,0,1,0,0
0,0,0,0,0,0,0,0,0
93104,211,4,0,0,0,1,0,0
91383,211,4,0,0,0,1,0,0
0,0,0,0,0,0,0,0,0
91222,211,4,0,0,0,1,0,0
91491,211,4,0,0,0,1,0,0
91103,211,4,0,0,0,1,0,0
91015,211,4,0,0,0,1,0,0
0,0,0,0,0,0,0,0,0
91590,211,4,0,0,0,1,0,0
91336,211,4,0,0,0,1,0,0
0,0,0,0,0,0,0,0,0
0,0,0,0,0,0,0,0,0
91618,211,4,0,0,0,1,0,0
0,0,0,0,0,0,0,0,0
91472,211,4,0,0,0,1,0,0
91641,211,4,0,0,0,1,0,0
0,0,0,0,0,0,0,0,0
91428,211,4,0,0,0,1,0,0
0,0,0,0,0,0,0,0,0
91159,211,4,0,0,0,1,0,0
92515,214,4,0,0,0,1,0,0
90880,209,4,0,0,0,1,0,0
90908,211,4,0,0,0,1,0,0
92263,214,4,0,0,0,1,0,0
91281,211,4,0,0,0,1,0,0
64849,50,3,0,0,0,0,0,0
0,0,0,0,0,0,0,0,0
0,0,0,0,0,0,0,0,0
91235,211,4,0,0,0,1,0,0
90932,209,4,0,0,0,1,0,0
0,0,0,0,0,0,0,0,0
94032,211,4,0,0,0,1,0,0
0,0,0,0,0,0,0,0,0
90776,211,4,0,0,0,1,0,0
0,0,0,0,0,0,0,0,0
90766,211,4,0,0,0,1,0,0
91141,211,4,0,0,0,1,0,0
0,0,0,0,0,0,0,0,0
0,0,0,0,0,0,0,0,0
93847,211,4,0,0,0,1,0,0
91500,211,4,0,0,0,1,0,0
0,0,0,0,0,0,0,0,0
0,0,0,0,0,0,0,0,0
0,0,0,0,0,0,0,0,0
0,0,0,0,0,0,0,0,0
0,0,0,0,0,0,0,0,0
0,0,0,0,0,0,0,0,0
0,0,0,0,0,0,0,0,0
0,0,0,0,0,0,0,0,0
0,0,0,0,0,0,0,0,0
0,0,0,0,0,0,0,0,0
0,0,0,0,0,0,0,0,0
0,0,0,0,0,0,0,0,0
0,0,0,0,0,0,0,0,0
0,0,0,0,0,0,0,0,0
0,0,0,0,0,0,0,0,0
91647,211,4,0,0,0,1,0,0
91302,211,4,0,0,0,1,0,0
91889,212,4,0,0,0,1,0,0
91465,211,4,0,0,0,1,0,0
91159,211,4,0,0,0,1,0,0
91533,209,4,0,0,0,1,0,0
93003,211,4,0,0,0,1,0,0
91280,211,4,0,0,0,1,0,0
90801,209,4,0,0,0,1,0,0
91642,211,4,0,0,0,1,0,0
91028,209,4,0,0,0,1,0,0
91440,211,4,0,0,0,1,0,0
92093,209,4,0,0,0,1,0,0
91749,211,4,0,0,0,1,0,0
90968,212,4,0,0,0,1,0,0
91979,211,4,0,0,0,1,0,0
91014,211,4,0,0,0,1,0,0
92781,211,4,0,0,0,1,0,0
0,0,0,0,0,0,0,0,0
91216,211,4,0,0,0,1,0,0
0,0,0,0,0,0,0,0,0
90985,212,4,0,0,0,1,0,0
0,0,0,0,0,0,0,0,0
0,0,0,0,0,0,0,0,0
0,0,0,0,0,0,0,0,0
91262,212,4,0,0,0,1,0,0
91755,211,4,0,0,0,1,0,0
0,0,0,0,0,0,0,0,0
91080,211,4,0,0,0,1,0,0
91096,211,4,0,0,0,1,0,0
0,0,0,0,0,0,0,0,0
91772,211,4,0,0,0,1,0,0
92382,211,4,0,0,0,1,0,0
91003,212,4,0,0,0,1,0,0
91223,211,4,0,0,0,1,0,0
0,0,0,0,0,0,0,0,0
91785,211,4,0,0,0,1,0,0
0,0,0,0,0,0,0,0,0
0,0,0,0,0,0,0,0,0
91520,212,4,0,0,0,1,0,0
91574,211,4,0,0,0,1,0,0
91413,211,4,0,0,0,1,0,0
91200,212,4,0,0,0,1,0,0
0,0,0,0,0,0,0,0,0
91641,211,4,0,0,0,1,0,0
90899,212,4,0,0,0,1,0,0
93295,211,4,0,0,0,1,0,0
91136,211,4,0,0,0,1,0,0
0,0,0,0,0,0,0,0,0
91660,214,4,0,0,0,1,0,0
0,0,0,0,0,0,0,0,0
91254,211,4,0,0,0,1,0,0
0,0,0,0,0,0,0,0,0
0,0,0,0,0,0,0,0,0
91015,212,4,0,0,0,1,0,0
91764,211,4,0,0,0,1,0,0
91566,211,4,0,0,0,1,0,0
91564,209,4,0,0,0,1,0,0
91524,211,4,0,0,0,1,0,0
91152,211,4,0,0,0,1,0,0
91672,211,4,0,0,0,1,0,0
91674,211,4,0,0,0,1,0,0
91708,211,4,0,0,0,1,0,0
91268,211,4,0,0,0,1,0,0
91067,211,4,0,0,0,1,0,0
0,0,0,0,0,0,0,0,0
0,0,0,0,0,0,0,0,0
0,0,0,0,0,0,0,0,0
0,0,0,0,0,0,0,0,0
0,0,0,0,0,0,0,0,0
91327,209,4,0,0,0,1,0,0
90879,212,4,0,0,0,1,0,0
0,0,0,0,0,0,0,0,0
90889,209,4,0,0,0,1,0,0
92460,211,4,0,0,0,1,0,0
0,0,0,0,0,0,0,0,0
91206,211,4,0,0,0,1,0,0
0,0,0,0,0,0,0,0,0
0,0,0,0,0,0,0,0,0
0,0,0,0,0,0,0,0,0
0,0,0,0,0,0,0,0,0
93298,214,4,0,0,0,1,0,0
0,0,0,0,0,0,0,0,0
0,0,0,0,0,0,0,0,0
0,0,0,0,0,0,0,0,0
0,0,0,0,0,0,0,0,0
91056,212,4,0,0,0,1,0,0
0,0,0,0,0,0,0,0,0
0,0,0,0,0,0,0,0,0
0,0,0,0,0,0,0,0,0
0,0,0,0,0,0,0,0,0
0,0,0,0,0,0,0,0,0
91640,211,4,0,0,0,1,0,0
0,0,0,0,0,0,0,0,0
0,0,0,0,0,0,0,0,0
0,0,0,0,0,0,0,0,0
0,0,0,0,0,0,0,0,0
0,0,0,0,0,0,0,0,0
0,0,0,0,0,0,0,0,0
0,0,0,0,0,0,0,0,0
0,0,0,0,0,0,0,0,0
0,0,0,0,0,0,0,0,0
0,0,0,0,0,0,0,0,0
0,0,0,0,0,0,0,0,0
0,0,0,0,0,0,0,0,0
0,0,0,0,0,0,0,0,0
0,0,0,0,0,0,0,0,0
0,0,0,0,0,0,0,0,0
0,0,0,0,0,0,0,0,0
0,0,0,0,0,0,0,0,0
0,0,0,0,0,0,0,0,0
0,0,0,0,0,0,0,0,0
0,0,0,0,0,0,0,0,0
0,0,0,0,0,0,0,0,0
0,0,0,0,0,0,0,0,0
0,0,0,0,0,0,0,0,0
0,0,0,0,0,0,0,0,0
0,0,0,0,0,0,0,0,0
0,0,0,0,0,0,0,0,0
0,0,0,0,0,0,0,0,0
0,0,0,0,0,0,0,0,0
0,0,0,0,0,0,0,0,0
0,0,0,0,0,0,0,0,0
0,0,0,0,0,0,0,0,0
0,0,0,0,0,0,0,0,0
0,0,0,0,0,0,0,0,0
0,0,0,0,0,0,0,0,0
0,0,0,0,0,0,0,0,0
0,0,0,0,0,0,0,0,0
0,0,0,0,0,0,0,0,0
3459,33,2,2,0,2,0,0,0
0,0,0,0,0,0,0,0,0
0,0,0,0,0,0,0,0,0
0,0,0,0,0,0,0,0,0
0,0,0,0,0,0,0,0,0
0,0,0,0,0,0,0,0,0
0,0,0,0,0,0,0,0,0
0,0,0,0,0,0,0,0,0
92229,212,4,0,0,0,1,0,0
0,0,0,0,0,0,0,0,0
0,0,0,0,0,0,0,0,0
0,0,0,0,0,0,0,0,0
0,0,0,0,0,0,0,0,0
0,0,0,0,0,0,0,0,0
0,0,0,0,0,0,0,0,0
0,0,0,0,0,0,0,0,0
0,0,0,0,0,0,0,0,0
0,0,0,0,0,0,0,0,0
0,0,0,0,0,0,0,0,0
0,0,0,0,0,0,0,0,0
0,0,0,0,0,0,0,0,0
0,0,0,0,0,0,0,0,0
0,0,0,0,0,0,0,0,0
0,0,0,0,0,0,0,0,0
0,0,0,0,0,0,0,0,0
0,0,0,0,0,0,0,0,0
0,0,0,0,0,0,0,0,0
0,0,0,0,0,0,0,0,0
0,0,0,0,0,0,0,0,0
0,0,0,0,0,0,0,0,0
0,0,0,0,0,0,0,0,0
0,0,0,0,0,0,0,0,0
0,0,0,0,0,0,0,0,0
0,0,0,0,0,0,0,0,0
0,0,0,0,0,0,0,0,0
0,0,0,0,0,0,0,0,0
0,0,0,0,0,0,0,0,0
0,0,0,0,0,0,0,0,0
0,0,0,0,0,0,0,0,0
0,0,0,0,0,0,0,0,0
0,0,0,0,0,0,0,0,0
0,0,0,0,0,0,0,0,0
0,0,0,0,0,0,0,0,0
64738,49,3,0,0,0,0,0,0
0,0,0,0,0,0,0,0,0
0,0,0,0,0,0,0,0,0
0,0,0,0,0,0,0,0,0
0,0,0,0,0,0,0,0,0
0,0,0,0,0,0,0,0,0
0,0,0,0,0,0,0,0,0
0,0,0,0,0,0,0,0,0
0,0,0,0,0,0,0,0,0
0,0,0,0,0,0,0,0,0
0,0,0,0,0,0,0,0,0
0,0,0,0,0,0,0,0,0
0,0,0,0,0,0,0,0,0
0,0,0,0,0,0,0,0,0
0,0,0,0,0,0,0,0,0
0,0,0,0,0,0,0,0,0
0,0,0,0,0,0,0,0,0
0,0,0,0,0,0,0,0,0
0,0,0,0,0,0,0,0,0
0,0,0,0,0,0,0,0,0
0,0,0,0,0,0,0,0,0
0,0,0,0,0,0,0,0,0
0,0,0,0,0,0,0,0,0
0,0,0,0,0,0,0,0,0
0,0,0,0,0,0,0,0,0
0,0,0,0,0,0,0,0,0
0,0,0,0,0,0,0,0,0
91274,211,4,0,0,0,1,0,0
0,0,0,0,0,0,0,0,0
0,0,0,0,0,0,0,0,0
0,0,0,0,0,0,0,0,0
0,0,0,0,0,0,0,0,0
0,0,0,0,0,0,0,0,0
0,0,0,0,0,0,0,0,0
91063,209,4,0,0,0,1,0,0
0,0,0,0,0,0,0,0,0
92974,214,4,0,0,0,1,0,0
0,0,0,0,0,0,0,0,0
91281,211,4,0,0,0,1,0,0
0,0,0,0,0,0,0,0,0
0,0,0,0,0,0,0,0,0
0,0,0,0,0,0,0,0,0
0,0,0,0,0,0,0,0,0
91586,215,4,0,0,0,1,0,0
0,0,0,0,0,0,0,0,0
0,0,0,0,0,0,0,0,0
0,0,0,0,0,0,0,0,0
91518,211,4,0,0,0,1,0,0
0,0,0,0,0,0,0,0,0
0,0,0,0,0,0,0,0,0
0,0,0,0,0,0,0,0,0
0,0,0,0,0,0,0,0,0
0,0,0,0,0,0,0,0,0
91082,212,4,0,0,0,1,0,0
0,0,0,0,0,0,0,0,0
0,0,0,0,0,0,0,0,0
0,0,0,0,0,0,0,0,0
0,0,0,0,0,0,0,0,0
0,0,0,0,0,0,0,0,0
0,0,0,0,0,0,0,0,0
91334,211,4,0,0,0,1,0,0
0,0,0,0,0,0,0,0,0
92315,211,4,0,0,0,1,0,0
92231,214,4,0,0,0,1,0,0
0,0,0,0,0,0,0,0,0
0,0,0,0,0,0,0,0,0
0,0,0,0,0,0,0,0,0
0,0,0,0,0,0,0,0,0
0,0,0,0,0,0,0,0,0
0,0,0,0,0,0,0,0,0
0,0,0,0,0,0,0,0,0
0,0,0,0,0,0,0,0,0
0,0,0,0,0,0,0,0,0
0,0,0,0,0,0,0,0,0
0,0,0,0,0,0,0,0,0
91148,214,4,0,0,0,1,0,0
0,0,0,0,0,0,0,0,0
0,0,0,0,0,0,0,0,0
0,0,0,0,0,0,0,0,0
0,0,0,0,0,0,0,0,0
0,0,0,0,0,0,0,0,0
0,0,0,0,0,0,0,0,0
0,0,0,0,0,0,0,0,0
0,0,0,0,0,0,0,0,0
0,0,0,0,0,0,0,0,0
0,0,0,0,0,0,0,0,0
0,0,0,0,0,0,0,0,0
0,0,0,0,0,0,0,0,0
0,0,0,0,0,0,0,0,0
64849,50,3,0,0,0,0,0,0
0,0,0,0,0,0,0,0,0
0,0,0,0,0,0,0,0,0
91193,212,4,0,0,0,1,0,0
92184,212,4,0,0,0,1,0,0
92955,212,4,0,0,0,1,0,0
90944,211,4,0,0,0,1,0,0
91905,211,4,0,0,0,1,0,0
92222,212,4,0,0,0,1,0,0
0,0,0,0,0,0,0,0,0
0,0,0,0,0,0,0,0,0
92087,212,4,0,0,0,1,0,0
0,0,0,0,0,0,0,0,0
0,0,0,0,0,0,0,0,0
0,0,0,0,0,0,0,0,0
0,0,0,0,0,0,0,0,0
0,0,0,0,0,0,0,0,0
0,0,0,0,0,0,0,0,0
0,0,0,0,0,0,0,0,0
0,0,0,0,0,0,0,0,0
0,0,0,0,0,0,0,0,0
0,0,0,0,0,0,0,0,0
0,0,0,0,0,0,0,0,0
0,0,0,0,0,0,0,0,0
0,0,0,0,0,0,0,0,0
0,0,0,0,0,0,0,0,0
0,0,0,0,0,0,0,0,0
0,0,0,0,0,0,0,0,0
92210,214,4,0,0,0,1,0,0
0,0,0,0,0,0,0,0,0
92146,214,4,0,0,0,1,0,0
91068,211,4,0,0,0,1,0,0
0,0,0,0,0,0,0,0,0
0,0,0,0,0,0,0,0,0
0,0,0,0,0,0,0,0,0
0,0,0,0,0,0,0,0,0
0,0,0,0,0,0,0,0,0
91547,211,4,0,0,0,1,0,0
90627,209,4,0,0,0,1,0,0
91861,211,4,0,0,0,1,0,0
0,0,0,0,0,0,0,0,0
0,0,0,0,0,0,0,0,0
0,0,0,0,0,0,0,0,0
0,0,0,0,0,0,0,0,0
0,0,0,0,0,0,0,0,0
91151,211,4,0,0,0,1,0,0
0,0,0,0,0,0,0,0,0
0,0,0,0,0,0,0,0,0
0,0,0,0,0,0,0,0,0
0,0,0,0,0,0,0,0,0
0,0,0,0,0,0,0,0,0
90938,209,4,0,0,0,1,0,0
0,0,0,0,0,0,0,0,0
91069,209,4,0,0,0,1,0,0
0,0,0,0,0,0,0,0,0
0,0,0,0,0,0,0,0,0
90930,209,4,0,0,0,1,0,0
91224,212,4,0,0,0,1,0,0
91620,211,4,0,0,0,1,0,0
91266,211,4,0,0,0,1,0,0
0,0,0,0,0,0,0,0,0
91793,214,4,0,0,0,1,0,0
91427,211,4,0,0,0,1,0,0
91182,211,4,0,0,0,1,0,0
91333,211,4,0,0,0,1,0,0
0,0,0,0,0,0,0,0,0
0,0,0,0,0,0,0,0,0
91767,211,4,0,0,0,1,0,0
91428,209,4,0,0,0,1,0,0
91085,211,4,0,0,0,1,0,0
91114,212,4,0,0,0,1,0,0
0,0,0,0,0,0,0,0,0
91470,211,4,0,0,0,1,0,0
91532,212,4,0,0,0,1,0,0
92235,214,4,0,0,0,1,0,0
91237,211,4,0,0,0,1,0,0
91147,211,4,0,0,0,1,0,0
674166,556,0,4,4,0,2,1,1
0,0,0,0,0,0,0,0,0
91652,211,4,0,0,0,1,0,0
90807,211,4,0,0,0,1,0,0
91533,214,4,0,0,0,1,0,0
0,0,0,0,0,0,0,0,0
92168,214,4,0,0,0,1,0,0
91035,211,4,0,0,0,1,0,0
0,0,0,0,0,0,0,0,0
0,0,0,0,0,0,0,0,0
91006,211,4,0,0,0,1,0,0
91784,211,4,0,0,0,1,0,0
92420,211,4,0,0,0,1,0,0
0,0,0,0,0,0,0,0,0
0,0,0,0,0,0,0,0,0
0,0,0,0,0,0,0,0,0
0,0,0,0,0,0,0,0,0
0,0,0,0,0,0,0,0,0
0,0,0,0,0,0,0,0,0
0,0,0,0,0,0,0,0,0
0,0,0,0,0,0,0,0,0
0,0,0,0,0,0,0,0,0
0,0,0,0,0,0,0,0,0
0,0,0,0,0,0,0,0,0
0,0,0,0,0,0,0,0,0
0,0,0,0,0,0,0,0,0
0,0,0,0,0,0,0,0,0
0,0,0,0,0,0,0,0,0
0,0,0,0,0,0,0,0,0
0,0,0,0,0,0,0,0,0
0,0,0,0,0,0,0,0,0
0,0,0,0,0,0,0,0,0
0,0,0,0,0,0,0,0,0
0,0,0,0,0,0,0,0,0
0,0,0,0,0,0,0,0,0
0,0,0,0,0,0,0,0,0
0,0,0,0,0,0,0,0,0
0,0,0,0,0,0,0,0,0
0,0,0,0,0,0,0,0,0
0,0,0,0,0,0,0,0,0
0,0,0,0,0,0,0,0,0
0,0,0,0,0,0,0,0,0
0,0,0,0,0,0,0,0,0
0,0,0,0,0,0,0,0,0
0,0,0,0,0,0,0,0,0
0,0,0,0,0,0,0,0,0
0,0,0,0,0,0,0,0,0
0,0,0,0,0,0,0,0,0
0,0,0,0,0,0,0,0,0
0,0,0,0,0,0,0,0,0
0,0,0,0,0,0,0,0,0
0,0,0,0,0,0,0,0,0
0,0,0,0,0,0,0,0,0
0,0,0,0,0,0,0,0,0
0,0,0,0,0,0,0,0,0
91492,211,4,0,0,0,1,0,0
0,0,0,0,0,0,0,0,0
0,0,0,0,0,0,0,0,0
0,0,0,0,0,0,0,0,0
0,0,0,0,0,0,0,0,0
0,0,0,0,0,0,0,0,0
0,0,0,0,0,0,0,0,0
0,0,0,0,0,0,0,0,0
0,0,0,0,0,0,0,0,0
0,0,0,0,0,0,0,0,0
0,0,0,0,0,0,0,0,0
0,0,0,0,0,0,0,0,0
0,0,0,0,0,0,0,0,0
0,0,0,0,0,0,0,0,0
0,0,0,0,0,0,0,0,0
0,0,0,0,0,0,0,0,0
90919,211,4,0,0,0,1,0,0
0,0,0,0,0,0,0,0,0
0,0,0,0,0,0,0,0,0
0,0,0,0,0,0,0,0,0
0,0,0,0,0,0,0,0,0
0,0,0,0,0,0,0,0,0
0,0,0,0,0,0,0,0,0
0,0,0,0,0,0,0,0,0
0,0,0,0,0,0,0,0,0
0,0,0,0,0,0,0,0,0
0,0,0,0,0,0,0,0,0
0,0,0,0,0,0,0,0,0
0,0,0,0,0,0,0,0,0
0,0,0,0,0,0,0,0,0
0,0,0,0,0,0,0,0,0
0,0,0,0,0,0,0,0,0
0,0,0,0,0,0,0,0,0
0,0,0,0,0,0,0,0,0
0,0,0,0,0,0,0,0,0
0,0,0,0,0,0,0,0,0
0,0,0,0,0,0,0,0,0
0,0,0,0,0,0,0,0,0
0,0,0,0,0,0,0,0,0
0,0,0,0,0,0,0,0,0
0,0,0,0,0,0,0,0,0
90882,211,4,0,0,0,1,0,0
90961,211,4,0,0,0,1,0,0
0,0,0,0,0,0,0,0,0
0,0,0,0,0,0,0,0,0
0,0,0,0,0,0,0,0,0
0,0,0,0,0,0,0,0,0
0,0,0,0,0,0,0,0,0
0,0,0,0,0,0,0,0,0
0,0,0,0,0,0,0,0,0
0,0,0,0,0,0,0,0,0
0,0,0,0,0,0,0,0,0
0,0,0,0,0,0,0,0,0
0,0,0,0,0,0,0,0,0
0,0,0,0,0,0,0,0,0
0,0,0,0,0,0,0,0,0
91627,214,4,0,0,0,1,0,0
0,0,0,0,0,0,0,0,0
0,0,0,0,0,0,0,0,0
0,0,0,0,0,0,0,0,0
0,0,0,0,0,0,0,0,0
0,0,0,0,0,0,0,0,0
0,0,0,0,0,0,0,0,0
0,0,0,0,0,0,0,0,0
0,0,0,0,0,0,0,0,0
0,0,0,0,0,0,0,0,0
0,0,0,0,0,0,0,0,0
0,0,0,0,0,0,0,0,0
0,0,0,0,0,0,0,0,0
0,0,0,0,0,0,0,0,0
0,0,0,0,0,0,0,0,0
0,0,0,0,0,0,0,0,0
0,0,0,0,0,0,0,0,0
0,0,0,0,0,0,0,0,0
0,0,0,0,0,0,0,0,0
0,0,0,0,0,0,0,0,0
0,0,0,0,0,0,0,0,0
0,0,0,0,0,0,0,0,0
93337,214,4,0,0,0,1,0,0
0,0,0,0,0,0,0,0,0
91737,212,4,0,0,0,1,0,0
0,0,0,0,0,0,0,0,0
0,0,0,0,0,0,0,0,0
0,0,0,0,0,0,0,0,0
0,0,0,0,0,0,0,0,0
0,0,0,0,0,0,0,0,0
0,0,0,0,0,0,0,0,0
0,0,0,0,0,0,0,0,0
91377,212,4,0,0,0,1,0,0
0,0,0,0,0,0,0,0,0
0,0,0,0,0,0,0,0,0
0,0,0,0,0,0,0,0,0
91482,209,4,0,0,0,1,0,0
0,0,0,0,0,0,0,0,0
0,0,0,0,0,0,0,0,0
92300,211,4,0,0,0,1,0,0
0,0,0,0,0,0,0,0,0
0,0,0,0,0,0,0,0,0
0,0,0,0,0,0,0,0,0
91838,214,4,0,0,0,1,0,0
0,0,0,0,0,0,0,0,0
91065,212,4,0,0,0,1,0,0
0,0,0,0,0,0,0,0,0
91862,214,4,0,0,0,1,0,0
0,0,0,0,0,0,0,0,0
0,0,0,0,0,0,0,0,0
0,0,0,0,0,0,0,0,0
0,0,0,0,0,0,0,0,0
91689,214,4,0,0,0,1,0,0
91039,209,4,0,0,0,1,0,0
91763,214,4,0,0,0,1,0,0
0,0,0,0,0,0,0,0,0
0,0,0,0,0,0,0,0,0
91739,214,4,0,0,0,1,0,0
91884,214,4,0,0,0,1,0,0
91634,214,4,0,0,0,1,0,0
91737,214,4,0,0,0,1,0,0
93790,223,5,0,0,0,4,0,0
91857,214,4,0,0,0,1,0,0
91738,214,4,0,0,0,1,0,0
0,0,0,0,0,0,0,0,0
91817,214,4,0,0,0,1,0,0
0,0,0,0,0,0,0,0,0
92123,214,4,0,0,0,1,0,0
91595,214,4,0,0,0,1,0,0
90961,211,4,0,0,0,1,0,0
91998,212,4,0,0,0,1,0,0
92272,214,4,0,0,0,1,0,0
91634,214,4,0,0,0,1,0,0
91123,209,4,0,0,0,1,0,0
90919,211,4,0,0,0,1,0,0
91117,209,4,0,0,0,1,0,0
91807,212,4,0,0,0,1,0,0
90924,211,4,0,0,0,1,0,0
90961,211,4,0,0,0,1,0,0
90739,209,4,0,0,0,1,0,0
0,0,0,0,0,0,0,0,0
0,0,0,0,0,0,0,0,0
0,0,0,0,0,0,0,0,0
0,0,0,0,0,0,0,0,0
191978,963,8,80,72,8,3,1,0
0,0,0,0,0,0,0,0,0
0,0,0,0,0,0,0,0,0
0,0,0,0,0,0,0,0,0
0,0,0,0,0,0,0,0,0
0,0,0,0,0,0,0,0,0
0,0,0,0,0,0,0,0,0
0,0,0,0,0,0,0,0,0
0,0,0,0,0,0,0,0,0
0,0,0,0,0,0,0,0,0
0,0,0,0,0,0,0,0,0
0,0,0,0,0,0,0,0,0
0,0,0,0,0,0,0,0,0
0,0,0,0,0,0,0,0,0
0,0,0,0,0,0,0,0,0
0,0,0,0,0,0,0,0,0
0,0,0,0,0,0,0,0,0
40662,59,4,0,0,0,0,0,0
0,0,0,0,0,0,0,0,0
0,0,0,0,0,0,0,0,0
0,0,0,0,0,0,0,0,0
0,0,0,0,0,0,0,0,0
0,0,0,0,0,0,0,0,0
0,0,0,0,0,0,0,0,0
0,0,0,0,0,0,0,0,0
0,0,0,0,0,0,0,0,0
0,0,0,0,0,0,0,0,0
0,0,0,0,0,0,0,0,0
0,0,0,0,0,0,0,0,0
0,0,0,0,0,0,0,0,0
0,0,0,0,0,0,0,0,0
148166,541,9,45,35,10,1,1,0
385369,2014,7,125,124,1,93,1,0
0,0,0,0,0,0,0,0,0
0,0,0,0,0,0,0,0,0
0,0,0,0,0,0,0,0,0
0,0,0,0,0,0,0,0,0
0,0,0,0,0,0,0,0,0
102262,152,4,4,4,0,2,1,0
0,0,0,0,0,0,0,0,0
0,0,0,0,0,0,0,0,0
0,0,0,0,0,0,0,0,0
35061,123,3,15,0,15,0,0,0
23134,194,4,15,9,6,0,1,0
0,0,0,0,0,0,0,0,0
0,0,0,0,0,0,0,0,0
64831,50,3,0,0,0,0,0,0
0,0,0,0,0,0,0,0,0
0,0,0,0,0,0,0,0,0
0,0,0,0,0,0,0,0,0
0,0,0,0,0,0,0,0,0
0,0,0,0,0,0,0,0,0
0,0,0,0,0,0,0,0,0
0,0,0,0,0,0,0,0,0
0,0,0,0,0,0,0,0,0
0,0,0,0,0,0,0,0,0
0,0,0,0,0,0,0,0,0
0,0,0,0,0,0,0,0,0
0,0,0,0,0,0,0,0,0
0,0,0,0,0,0,0,0,0
0,0,0,0,0,0,0,0,0
0,0,0,0,0,0,0,0,0
16126,89,3,7,3,4,0,1,0
0,0,0,0,0,0,0,0,0
0,0,0,0,0,0,0,0,0
0,0,0,0,0,0,0,0,0
0,0,0,0,0,0,0,0,0
20771,158,0,1,0,1,0,1,0
20771,158,0,1,0,1,0,1,0
22376,147,1,1,0,1,0,1,0
22376,147,1,1,0,1,0,1,0
0,0,0,0,0,0,0,0,0
0,0,0,0,0,0,0,0,0
409472,525,6,14,14,0,0,1,0
409731,524,6,14,14,0,0,1,0
0,0,0,0,0,0,0,0,0
0,0,0,0,0,0,0,0,0
0,0,0,0,0,0,0,0,0
0,0,0,0,0,0,0,0,0
0,0,0,0,0,0,0,0,0
0,0,0,0,0,0,0,0,0
0,0,0,0,0,0,0,0,0
0,0,0,0,0,0,0,0,0
0,0,0,0,0,0,0,0,0
0,0,0,0,0,0,0,0,0
0,0,0,0,0,0,0,0,0
0,0,0,0,0,0,0,0,0
12334,84,2,7,6,1,2,1,0
12334,84,2,7,6,1,2,1,0
12334,84,2,7,6,1,2,1,0
12334,84,2,7,6,1,2,1,0
12334,84,2,7,6,1,2,1,0
12334,84,2,7,6,1,2,1,0
12334,84,2,7,6,1,2,1,0
12981,84,1,3,3,0,0,0,0
12981,84,1,3,3,0,0,0,0
12981,84,1,3,3,0,0,0,0
12981,84,1,3,3,0,0,0,0
0,0,0,0,0,0,0,0,0
0,0,0,0,0,0,0,0,0
0,0,0,0,0,0,0,0,0
1028661,1073,2,55,17,38,23,1,0
0,0,0,0,0,0,0,0,0
144444,59,4,3,3,0,2,1,0
0,0,0,0,0,0,0,0,0
0,0,0,0,0,0,0,0,0
0,0,0,0,0,0,0,0,0
144444,59,4,3,3,0,2,1,0
0,0,0,0,0,0,0,0,0
0,0,0,0,0,0,0,0,0
0,0,0,0,0,0,0,0,0
144444,59,4,3,3,0,2,1,0
0,0,0,0,0,0,0,0,0
0,0,0,0,0,0,0,0,0
0,0,0,0,0,0,0,0,0
139333,68,2,1,0,1,0,1,0
139333,68,2,1,0,1,0,1,0
139333,68,2,1,0,1,0,1,0
139333,68,2,1,0,1,0,1,0
139333,68,2,1,0,1,0,1,0
136546,42,4,1,1,0,2,0,0
136546,42,4,1,1,0,2,0,0
136546,42,4,1,1,0,2,0,0
136546,42,4,1,1,0,2,0,0
0,0,0,0,0,0,0,0,0
0,0,0,0,0,0,0,0,0
0,0,0,0,0,0,0,0,0
0,0,0,0,0,0,0,0,0
0,0,0,0,0,0,0,0,0
0,0,0,0,0,0,0,0,0
0,0,0,0,0,0,0,0,0
0,0,0,0,0,0,0,0,0
0,0,0,0,0,0,0,0,0
0,0,0,0,0,0,0,0,0
4000,25,1,0,0,0,2,0,0
0,0,0,0,0,0,0,0,0
0,0,0,0,0,0,0,0,0
0,0,0,0,0,0,0,0,0
0,0,0,0,0,0,0,0,0
26690,36,2,0,0,0,0,0,0
0,0,0,0,0,0,0,0,0
64843,50,3,0,0,0,0,0,0
0,0,0,0,0,0,0,0,0
0,0,0,0,0,0,0,0,0
0,0,0,0,0,0,0,0,0
0,0,0,0,0,0,0,0,0
0,0,0,0,0,0,0,0,0
0,0,0,0,0,0,0,0,0
0,0,0,0,0,0,0,0,0
0,0,0,0,0,0,0,0,0
0,0,0,0,0,0,0,0,0
819536,2031,4,126,113,13,49,1,0
0,0,0,0,0,0,0,0,0
0,0,0,0,0,0,0,0,0
0,0,0,0,0,0,0,0,0
0,0,0,0,0,0,0,0,0
0,0,0,0,0,0,0,0,0
0,0,0,0,0,0,0,0,0
0,0,0,0,0,0,0,0,0
0,0,0,0,0,0,0,0,0
0,0,0,0,0,0,0,0,0
2673,21,2,1,0,1,0,0,0
2673,21,2,1,0,1,0,0,0
2673,21,2,1,0,1,0,0,0
0,0,0,0,0,0,0,0,0
0,0,0,0,0,0,0,0,0
0,0,0,0,0,0,0,0,0
0,0,0,0,0,0,0,0,0
0,0,0,0,0,0,0,0,0
0,0,0,0,0,0,0,0,0
674238,556,0,4,4,0,2,1,1
0,0,0,0,0,0,0,0,0
0,0,0,0,0,0,0,0,0
0,0,0,0,0,0,0,0,0
28081,151,5,5,1,4,1,0,0
162249,218,4,26,18,8,2,1,0
0,0,0,0,0,0,0,0,0
0,0,0,0,0,0,0,0,0
0,0,0,0,0,0,0,0,0
0,0,0,0,0,0,0,0,0
64843,50,3,0,0,0,0,0,0
0,0,0,0,0,0,0,0,0
0,0,0,0,0,0,0,0,0
51238,198,2,8,5,3,2,1,0
0,0,0,0,0,0,0,0,0
0,0,0,0,0,0,0,0,0
0,0,0,0,0,0,0,0,0
0,0,0,0,0,0,0,0,0
0,0,0,0,0,0,0,0,0
0,0,0,0,0,0,0,0,0
12964,98,0,3,3,0,0,0,0
55005,237,4,24,24,0,0,1,0
140236,401,8,27,24,3,34,1,0
2673,21,2,1,0,1,0,0,0
0,0,0,0,0,0,0,0,0
0,0,0,0,0,0,0,0,0
0,0,0,0,0,0,0,0,0
9918,28,1,2,1,1,0,0,0
680434,556,0,4,0,4,2,1,1
197236,121,1,4,1,3,0,1,0
0,0,0,0,0,0,0,0,0
64843,50,3,0,0,0,0,0,0
0,0,0,0,0,0,0,0,0
0,0,0,0,0,0,0,0,0
0,0,0,0,0,0,0,0,0
0,0,0,0,0,0,0,0,0
64831,50,3,0,0,0,0,0,0
0,0,0,0,0,0,0,0,0
0,0,0,0,0,0,0,0,0
0,0,0,0,0,0,0,0,0
0,0,0,0,0,0,0,0,0
0,0,0,0,0,0,0,0,0
0,0,0,0,0,0,0,0,0
9926,28,1,2,2,0,0,0,0
0,0,0,0,0,0,0,0,0
0,0,0,0,0,0,0,0,0
0,0,0,0,0,0,0,0,0
0,0,0,0,0,0,0,0,0
3105,23,2,1,0,1,0,0,0
12942,96,0,3,3,0,0,0,0
181237,1131,2,312,300,12,1,0,0
79872,1099,1,156,156,0,11,1,0
0,0,0,0,0,0,0,0,0
0,0,0,0,0,0,0,0,0
47269,203,2,1,1,0,1,0,0
0,0,0,0,0,0,0,0,0
0,0,0,0,0,0,0,0,0
0,0,0,0,0,0,0,0,0
0,0,0,0,0,0,0,0,0
0,0,0,0,0,0,0,0,0
0,0,0,0,0,0,0,0,0
0,0,0,0,0,0,0,0,0
0,0,0,0,0,0,0,0,0
0,0,0,0,0,0,0,0,0
0,0,0,0,0,0,0,0,0
41850,107,5,0,0,0,3,1,0
0,0,0,0,0,0,0,0,0
0,0,0,0,0,0,0,0,0
0,0,0,0,0,0,0,0,0
0,0,0,0,0,0,0,0,0
0,0,0,0,0,0,0,0,0
0,0,0,0,0,0,0,0,0
64831,50,3,0,0,0,0,0,0
0,0,0,0,0,0,0,0,0
0,0,0,0,0,0,0,0,0
0,0,0,0,0,0,0,0,0
34015,148,5,19,12,7,1,0,0
0,0,0,0,0,0,0,0,0
0,0,0,0,0,0,0,0,0
8602,71,1,0,0,0,0,0,0
0,0,0,0,0,0,0,0,0
673888,556,0,4,4,0,2,1,1
0,0,0,0,0,0,0,0,0
0,0,0,0,0,0,0,0,0
27660,182,0,1,0,1,0,0,0
27660,182,0,1,0,1,0,0,0
0,0,0,0,0,0,0,0,0
0,0,0,0,0,0,0,0,0
0,0,0,0,0,0,0,0,0
0,0,0,0,0,0,0,0,0
0,0,0,0,0,0,0,0,0
64831,50,3,0,0,0,0,0,0
23291,225,3,24,24,0,0,1,0
17702,210,1,51,50,1,0,1,0
17702,210,1,51,50,1,0,1,0
17702,210,1,51,50,1,0,1,0
0,0,0,0,0,0,0,0,0
0,0,0,0,0,0,0,0,0
0,0,0,0,0,0,0,0,0
0,0,0,0,0,0,0,0,0
0,0,0,0,0,0,0,0,0
0,0,0,0,0,0,0,0,0
0,0,0,0,0,0,0,0,0
12392,72,4,0,0,0,0,1,0
0,0,0,0,0,0,0,0,0
0,0,0,0,0,0,0,0,0
27842,38,0,1,0,1,0,0,0
77754,101,1,4,2,2,0,0,0
297072,30,0,3,0,3,0,1,0
26690,36,2,0,0,0,0,0,0
0,0,0,0,0,0,0,0,0
0,0,0,0,0,0,0,0,0
0,0,0,0,0,0,0,0,0
0,0,0,0,0,0,0,0,0
0,0,0,0,0,0,0,0,0
0,0,0,0,0,0,0,0,0
0,0,0,0,0,0,0,0,0
0,0,0,0,0,0,0,0,0
15186,108,0,3,3,0,0,0,0
0,0,0,0,0,0,0,0,0
0,0,0,0,0,0,0,0,0
0,0,0,0,0,0,0,0,0
12960,96,0,3,3,0,0,0,0
0,0,0,0,0,0,0,0,0
131605,1031,5,149,149,0,2,0,0
91590,211,4,0,0,0,1,0,0
0,0,0,0,0,0,0,0,0
0,0,0,0,0,0,0,0,0
0,0,0,0,0,0,0,0,0
35068,409,6,37,7,30,3,1,0
0,0,0,0,0,0,0,0,0
7719,58,4,7,1,6,0,0,0
15595,113,0,1,0,1,0,0,0
0,0,0,0,0,0,0,0,0
64843,50,3,0,0,0,0,0,0
42402,82,5,0,0,0,0,0,0
9118,62,0,1,0,1,0,0,0
0,0,0,0,0,0,0,0,0
0,0,0,0,0,0,0,0,0
0,0,0,0,0,0,0,0,0
3105,23,2,1,0,1,0,0,0
2673,21,2,1,0,1,0,0,0
0,0,0,0,0,0,0,0,0
0,0,0,0,0,0,0,0,0
0,0,0,0,0,0,0,0,0
0,0,0,0,0,0,0,0,0
0,0,0,0,0,0,0,0,0
0,0,0,0,0,0,0,0,0
0,0,0,0,0,0,0,0,0
676604,556,0,4,0,4,2,1,1
0,0,0,0,0,0,0,0,0
0,0,0,0,0,0,0,0,0
2673,21,2,1,0,1,0,0,0
34075,415,5,26,26,0,2,1,0
12971,98,0,3,3,0,0,0,0
125995,1964,2,637,536,101,6,1,0
0,0,0,0,0,0,0,0,0
0,0,0,0,0,0,0,0,0
0,0,0,0,0,0,0,0,0
12665,86,0,1,1,0,0,0,0
14551,104,0,1,1,0,0,0,0
12665,86,0,1,1,0,0,0,0
0,0,0,0,0,0,0,0,0
0,0,0,0,0,0,0,0,0
0,0,0,0,0,0,0,0,0
0,0,0,0,0,0,0,0,0
284163,261,4,1,1,0,0,1,0
323295,276,4,2,1,1,0,1,0
0,0,0,0,0,0,0,0,0
0,0,0,0,0,0,0,0,0
0,0,0,0,0,0,0,0,0
0,0,0,0,0,0,0,0,0
502291,191,4,3,1,2,0,1,0
502291,191,4,3,1,2,0,1,0
0,0,0,0,0,0,0,0,0
0,0,0,0,0,0,0,0,0
0,0,0,0,0,0,0,0,0
0,0,0,0,0,0,0,0,0
0,0,0,0,0,0,0,0,0
0,0,0,0,0,0,0,0,0
36248,170,2,5,4,1,18,0,0
0,0,0,0,0,0,0,0,0
0,0,0,0,0,0,0,0,0
36248,170,2,5,4,1,18,0,0
0,0,0,0,0,0,0,0,0
0,0,0,0,0,0,0,0,0
135787,319,8,27,24,3,19,1,0
36248,170,2,5,4,1,18,0,0
36248,170,2,5,4,1,18,0,0
36248,170,2,5,4,1,18,0,0
36248,170,2,5,4,1,18,0,0
0,0,0,0,0,0,0,0,0
64927,50,3,0,0,0,0,0,0
0,0,0,0,0,0,0,0,0
64916,50,3,0,0,0,0,0,0
0,0,0,0,0,0,0,0,0
2673,21,2,1,0,1,0,0,0
2673,21,2,1,0,1,0,0,0
0,0,0,0,0,0,0,0,0
673671,556,0,4,4,0,2,1,1
0,0,0,0,0,0,0,0,0
65562,300,8,26,24,2,18,1,0
85738,465,1,36,17,19,0,1,0
0,0,0,0,0,0,0,0,0
12525,86,0,1,1,0,0,0,0
0,0,0,0,0,0,0,0,0
12929,97,0,3,3,0,0,0,0
2673,21,2,1,0,1,0,0,0
0,0,0,0,0,0,0,0,0
0,0,0,0,0,0,0,0,0
0,0,0,0,0,0,0,0,0
671144,542,0,4,4,0,2,1,1
25107,67,2,1,1,0,2,0,0
25107,67,2,1,1,0,2,0,0
25107,67,2,1,1,0,2,0,0
25107,67,2,1,1,0,2,0,0
0,0,0,0,0,0,0,0,0
25107,67,2,1,1,0,2,0,0
0,0,0,0,0,0,0,0,0
0,0,0,0,0,0,0,0,0
0,0,0,0,0,0,0,0,0
81527,1057,1,76,20,56,2,1,0
0,0,0,0,0,0,0,0,0
0,0,0,0,0,0,0,0,0
0,0,0,0,0,0,0,0,0
10268,83,1,0,0,0,0,0,0
0,0,0,0,0,0,0,0,0
0,0,0,0,0,0,0,0,0
0,0,0,0,0,0,0,0,0
0,0,0,0,0,0,0,0,0
0,0,0,0,0,0,0,0,0
0,0,0,0,0,0,0,0,0
0,0,0,0,0,0,0,0,0
303890,62,4,0,0,0,3,1,0
303886,62,4,0,0,0,3,1,0
34482,50,2,0,0,0,2,0,0
303879,62,4,0,0,0,3,1,0
303879,62,4,0,0,0,3,1,0
0,0,0,0,0,0,0,0,0
303879,62,4,0,0,0,3,1,0
0,0,0,0,0,0,0,0,0
0,0,0,0,0,0,0,0,0
0,0,0,0,0,0,0,0,0
81082,45,1,0,0,0,0,0,0
81082,45,1,0,0,0,0,0,0
0,0,0,0,0,0,0,0,0
0,0,0,0,0,0,0,0,0
0,0,0,0,0,0,0,0,0
0,0,0,0,0,0,0,0,0
0,0,0,0,0,0,0,0,0
5162,36,1,0,0,0,0,0,0
0,0,0,0,0,0,0,0,0
5162,36,1,0,0,0,0,0,0
0,0,0,0,0,0,0,0,0
0,0,0,0,0,0,0,0,0
0,0,0,0,0,0,0,0,0
182091,59,4,2,2,0,2,1,0
0,0,0,0,0,0,0,0,0
75125,200,3,22,4,18,0,0,0
0,0,0,0,0,0,0,0,0
36426,48,1,0,0,0,0,0,0
0,0,0,0,0,0,0,0,0
0,0,0,0,0,0,0,0,0
0,0,0,0,0,0,0,0,0
716908,599,1,29,0,29,3,1,0
0,0,0,0,0,0,0,0,0
5243,47,4,0,0,0,2,1,0
0,0,0,0,0,0,0,0,0
0,0,0,0,0,0,0,0,0
0,0,0,0,0,0,0,0,0
190713,73,4,2,1,1,2,1,0
0,0,0,0,0,0,0,0,0
15035,112,0,1,0,1,0,0,0
0,0,0,0,0,0,0,0,0
0,0,0,0,0,0,0,0,0
295982,187,4,1,1,0,0,1,0
0,0,0,0,0,0,0,0,0
0,0,0,0,0,0,0,0,0
0,0,0,0,0,0,0,0,0
0,0,0,0,0,0,0,0,0
0,0,0,0,0,0,0,0,0
0,0,0,0,0,0,0,0,0
13672,103,0,3,3,0,0,0,0
0,0,0,0,0,0,0,0,0
0,0,0,0,0,0,0,0,0
2673,21,2,1,0,1,0,0,0
0,0,0,0,0,0,0,0,0
9464,148,1,21,2,19,0,1,0
9464,148,1,21,2,19,0,1,0
0,0,0,0,0,0,0,0,0
0,0,0,0,0,0,0,0,0
0,0,0,0,0,0,0,0,0
0,0,0,0,0,0,0,0,0
0,0,0,0,0,0,0,0,0
0,0,0,0,0,0,0,0,0
0,0,0,0,0,0,0,0,0
0,0,0,0,0,0,0,0,0
2673,21,2,1,0,1,0,0,0
2673,21,2,1,0,1,0,0,0
2673,21,2,1,0,1,0,0,0
0,0,0,0,0,0,0,0,0
0,0,0,0,0,0,0,0,0
0,0,0,0,0,0,0,0,0
0,0,0,0,0,0,0,0,0
0,0,0,0,0,0,0,0,0
9189,75,1,0,0,0,0,0,0
90927,212,4,0,0,0,1,0,0
0,0,0,0,0,0,0,0,0
232,6,0,0,0,0,0,0,0
232,6,0,0,0,0,0,0,0
0,0,0,0,0,0,0,0,0
0,0,0,0,0,0,0,0,0
65689,50,3,0,0,0,0,0,0
0,0,0,0,0,0,0,0,0
0,0,0,0,0,0,0,0,0
1834,40,1,0,0,0,0,0,0
0,0,0,0,0,0,0,0,0
0,0,0,0,0,0,0,0,0
0,0,0,0,0,0,0,0,0
118591,900,6,223,29,194,7,1,0
0,0,0,0,0,0,0,0,0
9065,79,1,0,0,0,0,0,0
0,0,0,0,0,0,0,0,0
12575,86,0,1,1,0,0,0,0
0,0,0,0,0,0,0,0,0
0,0,0,0,0,0,0,0,0
0,0,0,0,0,0,0,0,0
0,0,0,0,0,0,0,0,0
0,0,0,0,0,0,0,0,0
0,0,0,0,0,0,0,0,0
37490,135,1,6,4,2,0,0,0
0,0,0,0,0,0,0,0,0
0,0,0,0,0,0,0,0,0
0,0,0,0,0,0,0,0,0
0,0,0,0,0,0,0,0,0
0,0,0,0,0,0,0,0,0
0,0,0,0,0,0,0,0,0
12535,86,0,1,1,0,0,0,0
9069,79,1,0,0,0,0,0,0
9069,79,1,0,0,0,0,0,0
0,0,0,0,0,0,0,0,0
0,0,0,0,0,0,0,0,0
0,0,0,0,0,0,0,0,0
0,0,0,0,0,0,0,0,0
0,0,0,0,0,0,0,0,0
0,0,0,0,0,0,0,0,0
0,0,0,0,0,0,0,0,0
0,0,0,0,0,0,0,0,0
0,0,0,0,0,0,0,0,0
0,0,0,0,0,0,0,0,0
0,0,0,0,0,0,0,0,0
0,0,0,0,0,0,0,0,0
0,0,0,0,0,0,0,0,0
0,0,0,0,0,0,0,0,0
0,0,0,0,0,0,0,0,0
0,0,0,0,0,0,0,0,0
0,0,0,0,0,0,0,0,0
0,0,0,0,0,0,0,0,0
286810,189,4,1,1,0,0,1,0
0,0,0,0,0,0,0,0,0
0,0,0,0,0,0,0,0,0
0,0,0,0,0,0,0,0,0
0,0,0,0,0,0,0,0,0
0,0,0,0,0,0,0,0,0
0,0,0,0,0,0,0,0,0
0,0,0,0,0,0,0,0,0
0,0,0,0,0,0,0,0,0
0,0,0,0,0,0,0,0,0
0,0,0,0,0,0,0,0,0
0,0,0,0,0,0,0,0,0
0,0,0,0,0,0,0,0,0
14751,106,0,1,0,1,0,0,0
10270,83,1,0,0,0,0,0,0
0,0,0,0,0,0,0,0,0
0,0,0,0,0,0,0,0,0
0,0,0,0,0,0,0,0,0
36248,170,2,5,4,1,18,0,0
0,0,0,0,0,0,0,0,0
0,0,0,0,0,0,0,0,0
350612,380,4,44,3,41,13,1,0
0,0,0,0,0,0,0,0,0
0,0,0,0,0,0,0,0,0
0,0,0,0,0,0,0,0,0
0,0,0,0,0,0,0,0,0
0,0,0,0,0,0,0,0,0
13701,104,0,3,3,0,0,0,0
0,0,0,0,0,0,0,0,0
0,0,0,0,0,0,0,0,0
0,0,0,0,0,0,0,0,0
0,0,0,0,0,0,0,0,0
0,0,0,0,0,0,0,0,0
0,0,0,0,0,0,0,0,0
0,0,0,0,0,0,0,0,0
0,0,0,0,0,0,0,0,0
0,0,0,0,0,0,0,0,0
0,0,0,0,0,0,0,0,0
0,0,0,0,0,0,0,0,0
0,0,0,0,0,0,0,0,0
0,0,0,0,0,0,0,0,0
0,0,0,0,0,0,0,0,0
0,0,0,0,0,0,0,0,0
0,0,0,0,0,0,0,0,0
0,0,0,0,0,0,0,0,0
31683,69,6,1,0,1,0,1,0
31683,69,6,1,0,1,0,1,0
31683,69,6,1,0,1,0,1,0
31683,69,6,1,0,1,0,1,0
0,0,0,0,0,0,0,0,0
0,0,0,0,0,0,0,0,0
0,0,0,0,0,0,0,0,0
0,0,0,0,0,0,0,0,0
0,0,0,0,0,0,0,0,0
0,0,0,0,0,0,0,0,0
0,0,0,0,0,0,0,0,0
0,0,0,0,0,0,0,0,0
0,0,0,0,0,0,0,0,0
9019,47,3,1,1,0,2,0,0
0,0,0,0,0,0,0,0,0
0,0,0,0,0,0,0,0,0
0,0,0,0,0,0,0,0,0
0,0,0,0,0,0,0,0,0
0,0,0,0,0,0,0,0,0
33842,196,5,16,13,3,1,0,0
9062,79,1,0,0,0,0,0,0
0,0,0,0,0,0,0,0,0
0,0,0,0,0,0,0,0,0
27645,155,5,5,2,3,1,0,0
0,0,0,0,0,0,0,0,0
0,0,0,0,0,0,0,0,0
0,0,0,0,0,0,0,0,0
0,0,0,0,0,0,0,0,0
0,0,0,0,0,0,0,0,0
0,0,0,0,0,0,0,0,0
0,0,0,0,0,0,0,0,0
0,0,0,0,0,0,0,0,0
0,0,0,0,0,0,0,0,0
0,0,0,0,0,0,0,0,0
0,0,0,0,0,0,0,0,0
0,0,0,0,0,0,0,0,0
0,0,0,0,0,0,0,0,0
36248,170,2,5,4,1,18,0,0
36248,170,2,5,4,1,18,0,0
36248,170,2,5,4,1,18,0,0
36248,170,2,5,4,1,18,0,0
0,0,0,0,0,0,0,0,0
0,0,0,0,0,0,0,0,0
0,0,0,0,0,0,0,0,0
0,0,0,0,0,0,0,0,0
0,0,0,0,0,0,0,0,0
0,0,0,0,0,0,0,0,0
0,0,0,0,0,0,0,0,0
65687,50,3,0,0,0,0,0,0
65689,50,3,0,0,0,0,0,0
0,0,0,0,0,0,0,0,0
5177,48,3,0,0,0,0,0,0
215021,58,4,2,2,0,2,1,0
127659,125,3,0,0,0,3,0,0
9019,47,3,1,1,0,2,0,0
9019,47,3,1,1,0,2,0,0
9019,47,3,1,1,0,2,0,0
51099,223,2,4,0,4,1,1,0
0,0,0,0,0,0,0,0,0
0,0,0,0,0,0,0,0,0
0,0,0,0,0,0,0,0,0
5573,49,0,0,0,0,0,0,0
0,0,0,0,0,0,0,0,0
0,0,0,0,0,0,0,0,0
91643,211,4,0,0,0,1,0,0
0,0,0,0,0,0,0,0,0
0,0,0,0,0,0,0,0,0
0,0,0,0,0,0,0,0,0
0,0,0,0,0,0,0,0,0
0,0,0,0,0,0,0,0,0
36248,170,2,5,4,1,18,0,0
0,0,0,0,0,0,0,0,0
0,0,0,0,0,0,0,0,0
0,0,0,0,0,0,0,0,0
0,0,0,0,0,0,0,0,0
36248,170,2,5,4,1,18,0,0
42553,348,10,45,45,0,0,1,0
41850,107,5,0,0,0,3,1,0
43498,181,4,1,1,0,4,1,0
0,0,0,0,0,0,0,0,0
2673,21,2,1,0,1,0,0,0
42402,82,5,0,0,0,0,0,0
16244,57,0,2,2,0,0,1,0
0,0,0,0,0,0,0,0,0
0,0,0,0,0,0,0,0,0
0,0,0,0,0,0,0,0,0
0,0,0,0,0,0,0,0,0
0,0,0,0,0,0,0,0,0
0,0,0,0,0,0,0,0,0
0,0,0,0,0,0,0,0,0
0,0,0,0,0,0,0,0,0
22402,147,1,1,0,1,0,1,0
22402,147,1,1,0,1,0,1,0
0,0,0,0,0,0,0,0,0
0,0,0,0,0,0,0,0,0
0,0,0,0,0,0,0,0,0
0,0,0,0,0,0,0,0,0
0,0,0,0,0,0,0,0,0
0,0,0,0,0,0,0,0,0
0,0,0,0,0,0,0,0,0
0,0,0,0,0,0,0,0,0
0,0,0,0,0,0,0,0,0
0,0,0,0,0,0,0,0,0
0,0,0,0,0,0,0,0,0
0,0,0,0,0,0,0,0,0
0,0,0,0,0,0,0,0,0
0,0,0,0,0,0,0,0,0
0,0,0,0,0,0,0,0,0
0,0,0,0,0,0,0,0,0
0,0,0,0,0,0,0,0,0
0,0,0,0,0,0,0,0,0
0,0,0,0,0,0,0,0,0
0,0,0,0,0,0,0,0,0
0,0,0,0,0,0,0,0,0
0,0,0,0,0,0,0,0,0
0,0,0,0,0,0,0,0,0
0,0,0,0,0,0,0,0,0
0,0,0,0,0,0,0,0,0
0,0,0,0,0,0,0,0,0
0,0,0,0,0,0,0,0,0
0,0,0,0,0,0,0,0,0
0,0,0,0,0,0,0,0,0
0,0,0,0,0,0,0,0,0
48748,706,4,163,30,133,3,1,0
0,0,0,0,0,0,0,0,0
0,0,0,0,0,0,0,0,0
0,0,0,0,0,0,0,0,0
0,0,0,0,0,0,0,0,0
16317,124,4,3,3,0,5,1,0
0,0,0,0,0,0,0,0,0
47618,75,2,1,1,0,3,1,0
1059955,101,4,5,5,0,3,1,0
0,0,0,0,0,0,0,0,0
0,0,0,0,0,0,0,0,0
0,0,0,0,0,0,0,0,0
0,0,0,0,0,0,0,0,0
0,0,0,0,0,0,0,0,0
0,0,0,0,0,0,0,0,0
0,0,0,0,0,0,0,0,0
0,0,0,0,0,0,0,0,0
65701,50,3,0,0,0,0,0,0
0,0,0,0,0,0,0,0,0
0,0,0,0,0,0,0,0,0
23291,225,3,24,24,0,0,1,0
151834,106,3,3,3,0,2,1,0
13063,97,0,3,3,0,0,0,0
15263,109,0,3,3,0,0,0,0
0,0,0,0,0,0,0,0,0
0,0,0,0,0,0,0,0,0
0,0,0,0,0,0,0,0,0
0,0,0,0,0,0,0,0,0
0,0,0,0,0,0,0,0,0
16780,126,0,1,0,1,0,0,0
0,0,0,0,0,0,0,0,0
0,0,0,0,0,0,0,0,0
0,0,0,0,0,0,0,0,0
0,0,0,0,0,0,0,0,0
0,0,0,0,0,0,0,0,0
0,0,0,0,0,0,0,0,0
12973,98,0,3,3,0,0,0,0
0,0,0,0,0,0,0,0,0
2673,21,2,1,0,1,0,0,0
0,0,0,0,0,0,0,0,0
0,0,0,0,0,0,0,0,0
16570,124,0,3,3,0,0,0,0
0,0,0,0,0,0,0,0,0
36248,170,2,5,4,1,18,0,0
0,0,0,0,0,0,0,0,0
0,0,0,0,0,0,0,0,0
0,0,0,0,0,0,0,0,0
0,0,0,0,0,0,0,0,0
0,0,0,0,0,0,0,0,0
9160,94,1,12,12,0,1,0,0
0,0,0,0,0,0,0,0,0
66534,306,8,27,24,3,18,1,0
0,0,0,0,0,0,0,0,0
12988,98,0,3,3,0,0,0,0
0,0,0,0,0,0,0,0,0
0,0,0,0,0,0,0,0,0
0,0,0,0,0,0,0,0,0
65689,50,3,0,0,0,0,0,0
2673,21,2,1,0,1,0,0,0
0,0,0,0,0,0,0,0,0
10272,83,1,0,0,0,0,0,0
10272,83,1,0,0,0,0,0,0
0,0,0,0,0,0,0,0,0
0,0,0,0,0,0,0,0,0
0,0,0,0,0,0,0,0,0
671693,556,0,4,4,0,2,1,1
65689,50,3,0,0,0,0,0,0
72705,46,4,0,0,0,1,0,0
0,0,0,0,0,0,0,0,0
0,0,0,0,0,0,0,0,0
22400,147,1,1,0,1,0,1,0
22400,147,1,1,0,1,0,1,0
0,0,0,0,0,0,0,0,0
0,0,0,0,0,0,0,0,0
0,0,0,0,0,0,0,0,0
0,0,0,0,0,0,0,0,0
0,0,0,0,0,0,0,0,0
65689,50,3,0,0,0,0,0,0
0,0,0,0,0,0,0,0,0
0,0,0,0,0,0,0,0,0
0,0,0,0,0,0,0,0,0
0,0,0,0,0,0,0,0,0
20771,158,0,1,0,1,0,1,0
20771,158,0,1,0,1,0,1,0
0,0,0,0,0,0,0,0,0
22400,147,1,1,0,1,0,1,0
22400,147,1,1,0,1,0,1,0
0,0,0,0,0,0,0,0,0
0,0,0,0,0,0,0,0,0
0,0,0,0,0,0,0,0,0
264996,509,4,49,35,14,7,1,0
0,0,0,0,0,0,0,0,0
0,0,0,0,0,0,0,0,0
0,0,0,0,0,0,0,0,0
0,0,0,0,0,0,0,0,0
0,0,0,0,0,0,0,0,0
0,0,0,0,0,0,0,0,0
0,0,0,0,0,0,0,0,0
0,0,0,0,0,0,0,0,0
0,0,0,0,0,0,0,0,0
0,0,0,0,0,0,0,0,0
12216,51,3,0,0,0,2,0,0
12216,51,3,0,0,0,2,0,0
12216,51,3,0,0,0,2,0,0
0,0,0,0,0,0,0,0,0
0,0,0,0,0,0,0,0,0
0,0,0,0,0,0,0,0,0
12216,51,3,0,0,0,2,0,0
12216,51,3,0,0,0,2,0,0
233342,64,4,3,3,0,2,1,0
233342,64,4,3,3,0,2,1,0
0,0,0,0,0,0,0,0,0
233342,64,4,3,3,0,2,1,0
327178,77,4,3,3,0,2,1,0
327178,77,4,3,3,0,2,1,0
0,0,0,0,0,0,0,0,0
5046,24,3,0,0,0,0,0,0
5046,24,3,0,0,0,0,0,0
5046,24,3,0,0,0,0,0,0
0,0,0,0,0,0,0,0,0
0,0,0,0,0,0,0,0,0
0,0,0,0,0,0,0,0,0
0,0,0,0,0,0,0,0,0
0,0,0,0,0,0,0,0,0
0,0,0,0,0,0,0,0,0
0,0,0,0,0,0,0,0,0
0,0,0,0,0,0,0,0,0
0,0,0,0,0,0,0,0,0
0,0,0,0,0,0,0,0,0
5967018,68,5,1,1,0,2,1,0
5967018,68,5,1,1,0,2,1,0
0,0,0,0,0,0,0,0,0
38146,50,1,0,0,0,2,1,0
38146,50,1,0,0,0,2,1,0
0,0,0,0,0,0,0,0,0
0,0,0,0,0,0,0,0,0
0,0,0,0,0,0,0,0,0
0,0,0,0,0,0,0,0,0
0,0,0,0,0,0,0,0,0
0,0,0,0,0,0,0,0,0
0,0,0,0,0,0,0,0,0
5967018,68,5,1,1,0,2,1,0
0,0,0,0,0,0,0,0,0
5967018,68,5,1,1,0,2,1,0
0,0,0,0,0,0,0,0,0
0,0,0,0,0,0,0,0,0
145874,58,5,3,3,0,2,1,0
0,0,0,0,0,0,0,0,0
0,0,0,0,0,0,0,0,0
0,0,0,0,0,0,0,0,0
0,0,0,0,0,0,0,0,0
0,0,0,0,0,0,0,0,0
0,0,0,0,0,0,0,0,0
0,0,0,0,0,0,0,0,0
0,0,0,0,0,0,0,0,0
0,0,0,0,0,0,0,0,0
0,0,0,0,0,0,0,0,0
0,0,0,0,0,0,0,0,0
0,0,0,0,0,0,0,0,0
0,0,0,0,0,0,0,0,0
0,0,0,0,0,0,0,0,0
10398,73,0,0,0,0,0,0,0
92090,211,4,0,0,0,1,0,0
31452,36,1,0,0,0,1,0,0
34627,51,2,0,0,0,2,0,0
34627,51,2,0,0,0,2,0,0
125859,33,2,0,0,0,1,0,0
65688,50,3,0,0,0,0,0,0
122967,91,5,0,0,0,0,0,0
0,0,0,0,0,0,0,0,0
0,0,0,0,0,0,0,0,0
0,0,0,0,0,0,0,0,0
0,0,0,0,0,0,0,0,0
0,0,0,0,0,0,0,0,0
0,0,0,0,0,0,0,0,0
0,0,0,0,0,0,0,0,0
47933,76,2,1,1,0,3,1,0
135900,218,4,26,18,8,2,1,0
0,0,0,0,0,0,0,0,0
28744,168,5,3,1,2,1,0,0
0,0,0,0,0,0,0,0,0
127821,47,2,1,0,1,0,0,0
0,0,0,0,0,0,0,0,0
0,0,0,0,0,0,0,0,0
0,0,0,0,0,0,0,0,0
0,0,0,0,0,0,0,0,0
0,0,0,0,0,0,0,0,0
0,0,0,0,0,0,0,0,0
0,0,0,0,0,0,0,0,0
0,0,0,0,0,0,0,0,0
138768,259,1,20,7,13,7,1,0
123,4,0,0,0,0,0,0,1
0,0,0,0,0,0,0,0,0
0,0,0,0,0,0,0,0,0
0,0,0,0,0,0,0,0,0
0,0,0,0,0,0,0,0,0
0,0,0,0,0,0,0,0,0
0,0,0,0,0,0,0,0,0
0,0,0,0,0,0,0,0,0
0,0,0,0,0,0,0,0,0
0,0,0,0,0,0,0,0,0
33513,277,1,15,11,4,13,0,0
91212,211,4,0,0,0,1,0,0
0,0,0,0,0,0,0,0,0
3854,36,2,2,1,1,0,0,0
0,0,0,0,0,0,0,0,0
0,0,0,0,0,0,0,0,0
0,0,0,0,0,0,0,0,0
0,0,0,0,0,0,0,0,0
0,0,0,0,0,0,0,0,0
127923,141,4,13,13,0,0,0,0
91349,211,4,0,0,0,1,0,0
350724,380,4,44,3,41,13,1,0
350712,380,4,44,3,41,13,1,0
23291,225,3,24,24,0,0,1,0
675734,557,0,4,4,0,2,1,1
0,0,0,0,0,0,0,0,0
0,0,0,0,0,0,0,0,0
0,0,0,0,0,0,0,0,0
148292,74,4,2,0,2,0,1,0
281483,77,4,2,0,2,0,1,0
594,13,0,2,2,0,0,0,0
594,13,0,2,2,0,0,0,0
1639,14,1,0,0,0,0,0,0
0,0,0,0,0,0,0,0,0
2673,21,2,1,0,1,0,0,0
10513,85,1,0,0,0,0,0,0
675485,557,0,4,4,0,2,1,1
65689,50,3,0,0,0,0,0,0
13263,103,0,3,2,1,0,0,0
0,0,0,0,0,0,0,0,0
0,0,0,0,0,0,0,0,0
0,0,0,0,0,0,0,0,0
8929,78,1,0,0,0,0,0,0
65689,50,3,0,0,0,0,0,0
0,0,0,0,0,0,0,0,0
0,0,0,0,0,0,0,0,0
0,0,0,0,0,0,0,0,0
0,0,0,0,0,0,0,0,0
0,0,0,0,0,0,0,0,0
13199,94,0,1,1,0,0,0,0
677023,542,0,4,0,4,2,1,1
65689,50,3,0,0,0,0,0,0
0,0,0,0,0,0,0,0,0
0,0,0,0,0,0,0,0,0
65689,50,3,0,0,0,0,0,0
0,0,0,0,0,0,0,0,0
0,0,0,0,0,0,0,0,0
0,0,0,0,0,0,0,0,0
681921,556,0,4,0,4,2,1,1
0,0,0,0,0,0,0,0,0
0,0,0,0,0,0,0,0,0
0,0,0,0,0,0,0,0,0
0,0,0,0,0,0,0,0,0
0,0,0,0,0,0,0,0,0
0,0,0,0,0,0,0,0,0
0,0,0,0,0,0,0,0,0
0,0,0,0,0,0,0,0,0
0,0,0,0,0,0,0,0,0
134621,314,8,26,24,2,19,1,0
36248,170,2,5,4,1,18,0,0
36248,170,2,5,4,1,18,0,0
0,0,0,0,0,0,0,0,0
0,0,0,0,0,0,0,0,0
0,0,0,0,0,0,0,0,0
0,0,0,0,0,0,0,0,0
0,0,0,0,0,0,0,0,0
0,0,0,0,0,0,0,0,0
0,0,0,0,0,0,0,0,0
0,0,0,0,0,0,0,0,0
0,0,0,0,0,0,0,0,0
34015,148,5,19,12,7,1,0,0
0,0,0,0,0,0,0,0,0
11846,52,3,0,0,0,2,0,0
0,0,0,0,0,0,0,0,0
0,0,0,0,0,0,0,0,0
0,0,0,0,0,0,0,0,0
0,0,0,0,0,0,0,0,0
2673,21,2,1,0,1,0,0,0
0,0,0,0,0,0,0,0,0
0,0,0,0,0,0,0,0,0
0,0,0,0,0,0,0,0,0
0,0,0,0,0,0,0,0,0
0,0,0,0,0,0,0,0,0
0,0,0,0,0,0,0,0,0
0,0,0,0,0,0,0,0,0
0,0,0,0,0,0,0,0,0
0,0,0,0,0,0,0,0,0
0,0,0,0,0,0,0,0,0
0,0,0,0,0,0,0,0,0
0,0,0,0,0,0,0,0,0
0,0,0,0,0,0,0,0,0
42402,82,5,0,0,0,0,0,0
0,0,0,0,0,0,0,0,0
292897,187,4,1,1,0,0,1,0
284016,181,4,1,1,0,0,1,0
0,0,0,0,0,0,0,0,0
0,0,0,0,0,0,0,0,0
0,0,0,0,0,0,0,0,0
279946,176,4,1,1,0,0,1,0
0,0,0,0,0,0,0,0,0
0,0,0,0,0,0,0,0,0
0,0,0,0,0,0,0,0,0
13016,97,0,3,3,0,0,0,0
0,0,0,0,0,0,0,0,0
0,0,0,0,0,0,0,0,0
0,0,0,0,0,0,0,0,0
0,0,0,0,0,0,0,0,0
12970,98,0,3,3,0,0,0,0
0,0,0,0,0,0,0,0,0
0,0,0,0,0,0,0,0,0
0,0,0,0,0,0,0,0,0
0,0,0,0,0,0,0,0,0
0,0,0,0,0,0,0,0,0
285152,47,0,4,4,0,0,0,0
0,0,0,0,0,0,0,0,0
0,0,0,0,0,0,0,0,0
285152,47,0,4,4,0,0,0,0
0,0,0,0,0,0,0,0,0
0,0,0,0,0,0,0,0,0
285152,47,0,4,4,0,0,0,0
285152,47,0,4,4,0,0,0,0
5054,24,3,0,0,0,0,0,0
0,0,0,0,0,0,0,0,0
5054,24,3,0,0,0,0,0,0
5054,24,3,0,0,0,0,0,0
5054,24,3,0,0,0,0,0,0
0,0,0,0,0,0,0,0,0
5054,24,3,0,0,0,0,0,0
0,0,0,0,0,0,0,0,0
0,0,0,0,0,0,0,0,0
0,0,0,0,0,0,0,0,0
0,0,0,0,0,0,0,0,0
0,0,0,0,0,0,0,0,0
0,0,0,0,0,0,0,0,0
58911,900,4,163,2,161,3,1,0
0,0,0,0,0,0,0,0,0
36412,50,2,0,0,0,2,0,0
0,0,0,0,0,0,0,0,0
0,0,0,0,0,0,0,0,0
0,0,0,0,0,0,0,0,0
0,0,0,0,0,0,0,0,0
0,0,0,0,0,0,0,0,0
0,0,0,0,0,0,0,0,0
0,0,0,0,0,0,0,0,0
0,0,0,0,0,0,0,0,0
0,0,0,0,0,0,0,0,0
0,0,0,0,0,0,0,0,0
0,0,0,0,0,0,0,0,0
0,0,0,0,0,0,0,0,0
0,0,0,0,0,0,0,0,0
0,0,0,0,0,0,0,0,0
0,0,0,0,0,0,0,0,0
0,0,0,0,0,0,0,0,0
0,0,0,0,0,0,0,0,0
0,0,0,0,0,0,0,0,0
0,0,0,0,0,0,0,0,0
0,0,0,0,0,0,0,0,0
0,0,0,0,0,0,0,0,0
0,0,0,0,0,0,0,0,0
0,0,0,0,0,0,0,0,0
0,0,0,0,0,0,0,0,0
204914,155,3,2,1,1,18,0,0
203991,145,3,2,1,1,18,0,0
0,0,0,0,0,0,0,0,0
2843865,60,3,1,1,0,4,1,0
0,0,0,0,0,0,0,0,0
0,0,0,0,0,0,0,0,0
0,0,0,0,0,0,0,0,0
0,0,0,0,0,0,0,0,0
0,0,0,0,0,0,0,0,0
0,0,0,0,0,0,0,0,0
9602,83,1,0,0,0,0,0,0
0,0,0,0,0,0,0,0,0
13011,95,0,3,3,0,0,0,0
0,0,0,0,0,0,0,0,0
12948,97,0,3,3,0,0,0,0
10517,85,1,0,0,0,0,0,0
10517,85,1,0,0,0,0,0,0
65689,50,3,0,0,0,0,0,0
12969,97,0,3,3,0,0,0,0
9552,28,1,2,2,0,0,0,0
0,0,0,0,0,0,0,0,0
0,0,0,0,0,0,0,0,0
9547,28,1,2,2,0,0,0,0
0,0,0,0,0,0,0,0,0
0,0,0,0,0,0,0,0,0
0,0,0,0,0,0,0,0,0
2673,21,2,1,0,1,0,0,0
2673,21,2,1,0,1,0,0,0
2673,21,2,1,0,1,0,0,0
2673,21,2,1,0,1,0,0,0
0,0,0,0,0,0,0,0,0
0,0,0,0,0,0,0,0,0
0,0,0,0,0,0,0,0,0
0,0,0,0,0,0,0,0,0
73476,412,7,8,8,0,0,1,0
0,0,0,0,0,0,0,0,0
675461,556,0,4,4,0,2,1,1
2673,21,2,1,0,1,0,0,0
0,0,0,0,0,0,0,0,0
65701,50,3,0,0,0,0,0,0
13402,159,5,1,0,1,0,1,0
13402,159,5,1,0,1,0,1,0
9553,28,1,2,1,1,0,0,0
0,0,0,0,0,0,0,0,0
0,0,0,0,0,0,0,0,0
673068,556,0,4,4,0,2,1,1
675426,556,0,4,4,0,2,1,1
0,0,0,0,0,0,0,0,0
0,0,0,0,0,0,0,0,0
0,0,0,0,0,0,0,0,0
673059,556,0,4,4,0,2,1,1
673851,556,0,4,4,0,2,1,1
2673,21,2,1,0,1,0,0,0
12889,96,0,3,3,0,0,0,0
0,0,0,0,0,0,0,0,0
0,0,0,0,0,0,0,0,0
27495,103,3,3,2,1,1,0,0
0,0,0,0,0,0,0,0,0
0,0,0,0,0,0,0,0,0
0,0,0,0,0,0,0,0,0
0,0,0,0,0,0,0,0,0
0,0,0,0,0,0,0,0,0
0,0,0,0,0,0,0,0,0
0,0,0,0,0,0,0,0,0
0,0,0,0,0,0,0,0,0
0,0,0,0,0,0,0,0,0
0,0,0,0,0,0,0,0,0
0,0,0,0,0,0,0,0,0
0,0,0,0,0,0,0,0,0
0,0,0,0,0,0,0,0,0
0,0,0,0,0,0,0,0,0
0,0,0,0,0,0,0,0,0
299963,237,4,1,1,0,0,1,0
299963,237,4,1,1,0,0,1,0
299963,237,4,1,1,0,0,1,0
0,0,0,0,0,0,0,0,0
0,0,0,0,0,0,0,0,0
0,0,0,0,0,0,0,0,0
0,0,0,0,0,0,0,0,0
0,0,0,0,0,0,0,0,0
0,0,0,0,0,0,0,0,0
0,0,0,0,0,0,0,0,0
0,0,0,0,0,0,0,0,0
0,0,0,0,0,0,0,0,0
0,0,0,0,0,0,0,0,0
0,0,0,0,0,0,0,0,0
39203,167,3,8,4,4,10,1,0
40328,171,3,8,4,4,10,1,0
56320,325,13,23,23,0,0,0,0
0,0,0,0,0,0,0,0,0
0,0,0,0,0,0,0,0,0
0,0,0,0,0,0,0,0,0
2673,21,2,1,0,1,0,0,0
0,0,0,0,0,0,0,0,0
13048,97,0,3,3,0,0,0,0
0,0,0,0,0,0,0,0,0
70273,62,3,0,0,0,3,0,0
0,0,0,0,0,0,0,0,0
0,0,0,0,0,0,0,0,0
0,0,0,0,0,0,0,0,0
0,0,0,0,0,0,0,0,0
0,0,0,0,0,0,0,0,0
0,0,0,0,0,0,0,0,0
0,0,0,0,0,0,0,0,0
0,0,0,0,0,0,0,0,0
0,0,0,0,0,0,0,0,0
0,0,0,0,0,0,0,0,0
0,0,0,0,0,0,0,0,0
0,0,0,0,0,0,0,0,0
31683,69,6,1,0,1,0,1,0
0,0,0,0,0,0,0,0,0
31683,69,6,1,0,1,0,1,0
0,0,0,0,0,0,0,0,0
0,0,0,0,0,0,0,0,0
31683,69,6,1,0,1,0,1,0
0,0,0,0,0,0,0,0,0
0,0,0,0,0,0,0,0,0
0,0,0,0,0,0,0,0,0
0,0,0,0,0,0,0,0,0
0,0,0,0,0,0,0,0,0
0,0,0,0,0,0,0,0,0
0,0,0,0,0,0,0,0,0
0,0,0,0,0,0,0,0,0
31683,69,6,1,0,1,0,1,0
13137,29,1,0,0,0,3,0,0
0,0,0,0,0,0,0,0,0
31683,69,6,1,0,1,0,1,0
0,0,0,0,0,0,0,0,0
0,0,0,0,0,0,0,0,0
0,0,0,0,0,0,0,0,0
0,0,0,0,0,0,0,0,0
0,0,0,0,0,0,0,0,0
0,0,0,0,0,0,0,0,0
13137,29,1,0,0,0,3,0,0
327194,70,4,3,3,0,2,1,0
0,0,0,0,0,0,0,0,0
0,0,0,0,0,0,0,0,0
0,0,0,0,0,0,0,0,0
0,0,0,0,0,0,0,0,0
0,0,0,0,0,0,0,0,0
0,0,0,0,0,0,0,0,0
327194,70,4,3,3,0,2,1,0
327194,70,4,3,3,0,2,1,0
327194,70,4,3,3,0,2,1,0
0,0,0,0,0,0,0,0,0
0,0,0,0,0,0,0,0,0
0,0,0,0,0,0,0,0,0
0,0,0,0,0,0,0,0,0
0,0,0,0,0,0,0,0,0
0,0,0,0,0,0,0,0,0
0,0,0,0,0,0,0,0,0
0,0,0,0,0,0,0,0,0
0,0,0,0,0,0,0,0,0
0,0,0,0,0,0,0,0,0
93780,211,4,0,0,0,1,0,0
0,0,0,0,0,0,0,0,0
26686,36,2,0,0,0,0,0,0
0,0,0,0,0,0,0,0,0
0,0,0,0,0,0,0,0,0
0,0,0,0,0,0,0,0,0
257361,177,4,1,1,0,0,1,0
0,0,0,0,0,0,0,0,0
3385,41,0,6,0,6,0,0,0
6256,82,0,0,0,0,3,1,0
0,0,0,0,0,0,0,0,0
0,0,0,0,0,0,0,0,0
0,0,0,0,0,0,0,0,0
59106,901,4,163,2,161,3,1,0
0,0,0,0,0,0,0,0,0
0,0,0,0,0,0,0,0,0
23291,225,3,24,24,0,0,1,0
0,0,0,0,0,0,0,0,0
0,0,0,0,0,0,0,0,0
16412,115,0,1,1,0,0,0,0
0,0,0,0,0,0,0,0,0
0,0,0,0,0,0,0,0,0
12719,86,0,1,1,0,0,0,0
0,0,0,0,0,0,0,0,0
65724,50,3,0,0,0,1,0,0
673361,542,0,4,4,0,2,1,1
675964,556,0,4,4,0,2,1,1
0,0,0,0,0,0,0,0,0
91975,214,4,0,0,0,1,0,0
0,0,0,0,0,0,0,0,0
0,0,0,0,0,0,0,0,0
12920,96,0,3,3,0,0,0,0
675737,556,0,4,4,0,2,1,1
677436,556,0,4,2,2,2,1,1
676263,556,0,4,4,0,2,1,1
0,0,0,0,0,0,0,0,0
12882,97,0,3,3,0,0,0,0
0,0,0,0,0,0,0,0,0
0,0,0,0,0,0,0,0,0
0,0,0,0,0,0,0,0,0
0,0,0,0,0,0,0,0,0
0,0,0,0,0,0,0,0,0
0,0,0,0,0,0,0,0,0
0,0,0,0,0,0,0,0,0
675626,556,0,4,4,0,2,1,1
0,0,0,0,0,0,0,0,0
0,0,0,0,0,0,0,0,0
2673,21,2,1,0,1,0,0,0
0,0,0,0,0,0,0,0,0
0,0,0,0,0,0,0,0,0
0,0,0,0,0,0,0,0,0
125,4,0,0,0,0,0,0,0
65688,50,3,0,0,0,0,0,0
676977,556,0,4,4,0,2,1,1
65689,50,3,0,0,0,0,0,0
0,0,0,0,0,0,0,0,0
0,0,0,0,0,0,0,0,0
673117,556,0,4,4,0,2,1,1
0,0,0,0,0,0,0,0,0
0,0,0,0,0,0,0,0,0
0,0,0,0,0,0,0,0,0
0,0,0,0,0,0,0,0,0
9551,28,1,2,2,0,0,0,0
261587,174,4,1,1,0,0,1,0
349795,183,6,3,1,2,0,1,0
307913,199,4,1,1,0,0,1,0
65689,50,3,0,0,0,0,0,0
88021,860,3,69,13,56,2,0,0
0,0,0,0,0,0,0,0,0
0,0,0,0,0,0,0,0,0
0,0,0,0,0,0,0,0,0
0,0,0,0,0,0,0,0,0
0,0,0,0,0,0,0,0,0
0,0,0,0,0,0,0,0,0
0,0,0,0,0,0,0,0,0
142834,581,11,51,48,3,0,1,0
0,0,0,0,0,0,0,0,0
0,0,0,0,0,0,0,0,0
0,0,0,0,0,0,0,0,0
0,0,0,0,0,0,0,0,0
0,0,0,0,0,0,0,0,0
33849,46,2,0,0,0,2,0,0
0,0,0,0,0,0,0,0,0
0,0,0,0,0,0,0,0,0
0,0,0,0,0,0,0,0,0
673723,556,0,4,4,0,2,1,1
0,0,0,0,0,0,0,0,0
0,0,0,0,0,0,0,0,0
0,0,0,0,0,0,0,0,0
0,0,0,0,0,0,0,0,0
0,0,0,0,0,0,0,0,0
0,0,0,0,0,0,0,0,0
0,0,0,0,0,0,0,0,0
0,0,0,0,0,0,0,0,0
0,0,0,0,0,0,0,0,0
0,0,0,0,0,0,0,0,0
0,0,0,0,0,0,0,0,0
0,0,0,0,0,0,0,0,0
1547202,213,0,52,51,1,0,1,0
1547202,213,0,52,51,1,0,1,0
0,0,0,0,0,0,0,0,0
1547202,213,0,52,51,1,0,1,0
1547202,213,0,52,51,1,0,1,0
0,0,0,0,0,0,0,0,0
0,0,0,0,0,0,0,0,0
0,0,0,0,0,0,0,0,0
1546986,208,0,52,51,1,0,1,0
0,0,0,0,0,0,0,0,0
0,0,0,0,0,0,0,0,0
0,0,0,0,0,0,0,0,0
0,0,0,0,0,0,0,0,0
0,0,0,0,0,0,0,0,0
0,0,0,0,0,0,0,0,0
0,0,0,0,0,0,0,0,0
0,0,0,0,0,0,0,0,0
332518,60,4,3,3,0,2,1,0
0,0,0,0,0,0,0,0,0
0,0,0,0,0,0,0,0,0
0,0,0,0,0,0,0,0,0
0,0,0,0,0,0,0,0,0
154384,43,2,3,2,1,0,0,0
0,0,0,0,0,0,0,0,0
0,0,0,0,0,0,0,0,0
0,0,0,0,0,0,0,0,0
0,0,0,0,0,0,0,0,0
0,0,0,0,0,0,0,0,0
0,0,0,0,0,0,0,0,0
332518,60,4,3,3,0,2,1,0
332518,60,4,3,3,0,2,1,0
23489,59,4,3,3,0,2,1,0
23489,59,4,3,3,0,2,1,0
23489,59,4,3,3,0,2,1,0
154384,43,2,3,2,1,0,0,0
154384,43,2,3,2,1,0,0,0
23489,59,4,3,3,0,2,1,0
154384,43,2,3,2,1,0,0,0
0,0,0,0,0,0,0,0,0
6978,50,2,1,1,0,0,1,0
6978,50,2,1,1,0,0,1,0
154384,43,2,3,2,1,0,0,0
6978,50,2,1,1,0,0,1,0
6978,50,2,1,1,0,0,1,0
0,0,0,0,0,0,0,0,0
6978,50,2,1,1,0,0,1,0
0,0,0,0,0,0,0,0,0
13499,75,1,2,2,0,2,0,0
13499,75,1,2,2,0,2,0,0
32599,67,3,5,4,1,2,0,0
13499,75,1,2,2,0,2,0,0
0,0,0,0,0,0,0,0,0
13499,75,1,2,2,0,2,0,0
0,0,0,0,0,0,0,0,0
32599,67,3,5,4,1,2,0,0
0,0,0,0,0,0,0,0,0
81082,45,1,0,0,0,0,0,0
81082,45,1,0,0,0,0,0,0
23492,59,4,3,3,0,2,1,0
23492,59,4,3,3,0,2,1,0
81082,45,1,0,0,0,0,0,0
81082,45,1,0,0,0,0,0,0
23492,59,4,3,3,0,2,1,0
23492,59,4,3,3,0,2,1,0
0,0,0,0,0,0,0,0,0
81082,45,1,0,0,0,0,0,0
0,0,0,0,0,0,0,0,0
0,0,0,0,0,0,0,0,0
0,0,0,0,0,0,0,0,0
0,0,0,0,0,0,0,0,0
0,0,0,0,0,0,0,0,0
0,0,0,0,0,0,0,0,0
0,0,0,0,0,0,0,0,0
0,0,0,0,0,0,0,0,0
0,0,0,0,0,0,0,0,0
0,0,0,0,0,0,0,0,0
0,0,0,0,0,0,0,0,0
99612,211,4,0,0,0,1,0,0
0,0,0,0,0,0,0,0,0
0,0,0,0,0,0,0,0,0
0,0,0,0,0,0,0,0,0
0,0,0,0,0,0,0,0,0
0,0,0,0,0,0,0,0,0
0,0,0,0,0,0,0,0,0
0,0,0,0,0,0,0,0,0
90859,209,4,0,0,0,1,0,0
90786,211,4,0,0,0,1,0,0
91373,211,4,0,0,0,1,0,0
91075,211,4,0,0,0,1,0,0
91252,211,4,0,0,0,1,0,0
13668,78,0,7,7,0,0,1,0
0,0,0,0,0,0,0,0,0
0,0,0,0,0,0,0,0,0
0,0,0,0,0,0,0,0,0
0,0,0,0,0,0,0,0,0
0,0,0,0,0,0,0,0,0
267529,512,4,49,36,13,7,1,0
22434,147,1,1,0,1,0,1,0
22434,147,1,1,0,1,0,1,0
3639,46,0,0,0,0,0,0,0
3639,46,0,0,0,0,0,0,0
0,0,0,0,0,0,0,0,0
20771,158,0,1,0,1,0,1,0
20771,158,0,1,0,1,0,1,0
0,0,0,0,0,0,0,0,0
0,0,0,0,0,0,0,0,0
0,0,0,0,0,0,0,0,0
0,0,0,0,0,0,0,0,0
677311,556,0,4,4,0,2,1,1
2673,21,2,1,0,1,0,0,0
2673,21,2,1,0,1,0,0,0
2673,21,2,1,0,1,0,0,0
0,0,0,0,0,0,0,0,0
0,0,0,0,0,0,0,0,0
0,0,0,0,0,0,0,0,0
0,0,0,0,0,0,0,0,0
0,0,0,0,0,0,0,0,0
674859,556,0,4,4,0,2,1,1
65689,50,3,0,0,0,0,0,0
0,0,0,0,0,0,0,0,0
65689,50,3,0,0,0,0,0,0
65689,50,3,0,0,0,0,0,0
0,0,0,0,0,0,0,0,0
29086,169,6,5,1,4,1,0,0
0,0,0,0,0,0,0,0,0
2673,21,2,1,0,1,0,0,0
2673,21,2,1,0,1,0,0,0
2673,21,2,1,0,1,0,0,0
0,0,0,0,0,0,0,0,0
0,0,0,0,0,0,0,0,0
10123,80,1,0,0,0,0,0,0
0,0,0,0,0,0,0,0,0
0,0,0,0,0,0,0,0,0
0,0,0,0,0,0,0,0,0
0,0,0,0,0,0,0,0,0
0,0,0,0,0,0,0,0,0
0,0,0,0,0,0,0,0,0
76157,208,1,9,3,6,7,1,0
2673,21,2,1,0,1,0,0,0
0,0,0,0,0,0,0,0,0
65689,50,3,0,0,0,0,0,0
0,0,0,0,0,0,0,0,0
0,0,0,0,0,0,0,0,0
0,0,0,0,0,0,0,0,0
673855,556,0,4,4,0,2,1,1
0,0,0,0,0,0,0,0,0
0,0,0,0,0,0,0,0,0
0,0,0,0,0,0,0,0,0
0,0,0,0,0,0,0,0,0
0,0,0,0,0,0,0,0,0
12740,86,0,1,1,0,0,0,0
9285,83,1,0,0,0,0,0,0
0,0,0,0,0,0,0,0,0
0,0,0,0,0,0,0,0,0
0,0,0,0,0,0,0,0,0
9574,84,1,0,0,0,0,0,0
307878,198,4,1,1,0,0,1,0
0,0,0,0,0,0,0,0,0
0,0,0,0,0,0,0,0,0
12901,97,0,3,3,0,0,0,0
0,0,0,0,0,0,0,0,0
0,0,0,0,0,0,0,0,0
0,0,0,0,0,0,0,0,0
0,0,0,0,0,0,0,0,0
0,0,0,0,0,0,0,0,0
0,0,0,0,0,0,0,0,0
0,0,0,0,0,0,0,0,0
10267,83,1,0,0,0,0,0,0
0,0,0,0,0,0,0,0,0
0,0,0,0,0,0,0,0,0
0,0,0,0,0,0,0,0,0
0,0,0,0,0,0,0,0,0
13846,67,4,6,5,1,4,1,0
0,0,0,0,0,0,0,0,0
0,0,0,0,0,0,0,0,0
55516,246,4,24,24,0,0,1,0
138564,394,8,26,24,2,34,1,0
673690,542,0,4,4,0,2,1,1
675135,557,0,4,4,0,2,1,1
47230,202,2,2,1,1,1,0,0
9082,77,1,0,0,0,0,0,0
8968,77,1,0,0,0,0,0,0
0,0,0,0,0,0,0,0,0
0,0,0,0,0,0,0,0,0
0,0,0,0,0,0,0,0,0
0,0,0,0,0,0,0,0,0
0,0,0,0,0,0,0,0,0
0,0,0,0,0,0,0,0,0
0,0,0,0,0,0,0,0,0
0,0,0,0,0,0,0,0,0
0,0,0,0,0,0,0,0,0
0,0,0,0,0,0,0,0,0
0,0,0,0,0,0,0,0,0
0,0,0,0,0,0,0,0,0
0,0,0,0,0,0,0,0,0
0,0,0,0,0,0,0,0,0
0,0,0,0,0,0,0,0,0
0,0,0,0,0,0,0,0,0
0,0,0,0,0,0,0,0,0
0,0,0,0,0,0,0,0,0
0,0,0,0,0,0,0,0,0
0,0,0,0,0,0,0,0,0
0,0,0,0,0,0,0,0,0
0,0,0,0,0,0,0,0,0
0,0,0,0,0,0,0,0,0
0,0,0,0,0,0,0,0,0
0,0,0,0,0,0,0,0,0
0,0,0,0,0,0,0,0,0
11000,82,0,7,6,1,0,1,0
0,0,0,0,0,0,0,0,0
0,0,0,0,0,0,0,0,0
0,0,0,0,0,0,0,0,0
0,0,0,0,0,0,0,0,0
28297,160,6,4,2,2,1,0,0
65689,50,3,0,0,0,0,0,0
0,0,0,0,0,0,0,0,0
0,0,0,0,0,0,0,0,0
0,0,0,0,0,0,0,0,0
0,0,0,0,0,0,0,0,0
0,0,0,0,0,0,0,0,0
0,0,0,0,0,0,0,0,0
0,0,0,0,0,0,0,0,0
0,0,0,0,0,0,0,0,0
0,0,0,0,0,0,0,0,0
332514,60,4,3,3,0,2,1,0
332514,60,4,3,3,0,2,1,0
332514,60,4,3,3,0,2,1,0
0,0,0,0,0,0,0,0,0
0,0,0,0,0,0,0,0,0
58911,900,4,163,2,161,3,1,0
0,0,0,0,0,0,0,0,0
0,0,0,0,0,0,0,0,0
36426,48,1,0,0,0,0,0,0
92306,211,4,0,0,0,1,0,0
1060484,101,4,5,5,0,3,1,0
0,0,0,0,0,0,0,0,0
0,0,0,0,0,0,0,0,0
0,0,0,0,0,0,0,0,0
0,0,0,0,0,0,0,0,0
0,0,0,0,0,0,0,0,0
0,0,0,0,0,0,0,0,0
0,0,0,0,0,0,0,0,0
0,0,0,0,0,0,0,0,0
0,0,0,0,0,0,0,0,0
0,0,0,0,0,0,0,0,0
0,0,0,0,0,0,0,0,0
0,0,0,0,0,0,0,0,0
0,0,0,0,0,0,0,0,0
0,0,0,0,0,0,0,0,0
0,0,0,0,0,0,0,0,0
0,0,0,0,0,0,0,0,0
0,0,0,0,0,0,0,0,0
0,0,0,0,0,0,0,0,0
0,0,0,0,0,0,0,0,0
0,0,0,0,0,0,0,0,0
0,0,0,0,0,0,0,0,0
0,0,0,0,0,0,0,0,0
0,0,0,0,0,0,0,0,0
0,0,0,0,0,0,0,0,0
0,0,0,0,0,0,0,0,0
0,0,0,0,0,0,0,0,0
218788,1788,1,201,4,197,3,1,0
57259,229,7,14,12,2,3,0,0
0,0,0,0,0,0,0,0,0
42347,182,2,7,5,2,2,1,0
0,0,0,0,0,0,0,0,0
0,0,0,0,0,0,0,0,0
0,0,0,0,0,0,0,0,0
0,0,0,0,0,0,0,0,0
577371,60,4,3,3,0,2,1,0
577371,60,4,3,3,0,2,1,0
577371,60,4,3,3,0,2,1,0
577371,60,4,3,3,0,2,1,0
0,0,0,0,0,0,0,0,0
0,0,0,0,0,0,0,0,0
23466,59,4,3,3,0,2,1,0
0,0,0,0,0,0,0,0,0
577371,60,4,3,3,0,2,1,0
23466,59,4,3,3,0,2,1,0
23466,59,4,3,3,0,2,1,0
0,0,0,0,0,0,0,0,0
0,0,0,0,0,0,0,0,0
0,0,0,0,0,0,0,0,0
0,0,0,0,0,0,0,0,0
0,0,0,0,0,0,0,0,0
0,0,0,0,0,0,0,0,0
0,0,0,0,0,0,0,0,0
0,0,0,0,0,0,0,0,0
0,0,0,0,0,0,0,0,0
0,0,0,0,0,0,0,0,0
0,0,0,0,0,0,0,0,0
0,0,0,0,0,0,0,0,0
0,0,0,0,0,0,0,0,0
0,0,0,0,0,0,0,0,0
0,0,0,0,0,0,0,0,0
58904,900,4,163,2,161,3,1,0
58904,900,4,163,2,161,3,1,0
0,0,0,0,0,0,0,0,0
27970,139,6,5,3,2,1,0,0
0,0,0,0,0,0,0,0,0
0,0,0,0,0,0,0,0,0
0,0,0,0,0,0,0,0,0
0,0,0,0,0,0,0,0,0
0,0,0,0,0,0,0,0,0
0,0,0,0,0,0,0,0,0
0,0,0,0,0,0,0,0,0
0,0,0,0,0,0,0,0,0
9435,43,3,0,0,0,2,0,0
0,0,0,0,0,0,0,0,0
91927,214,4,0,0,0,1,0,0
0,0,0,0,0,0,0,0,0
0,0,0,0,0,0,0,0,0
278223,174,4,1,1,0,0,1,0
35283,179,6,14,12,2,1,0,0
0,0,0,0,0,0,0,0,0
677651,557,0,4,4,0,2,1,1
0,0,0,0,0,0,0,0,0
0,0,0,0,0,0,0,0,0
90957,211,4,0,0,0,1,0,0
91880,211,4,0,0,0,1,0,0
0,0,0,0,0,0,0,0,0
0,0,0,0,0,0,0,0,0
0,0,0,0,0,0,0,0,0
674173,556,0,4,4,0,2,1,1
0,0,0,0,0,0,0,0,0
0,0,0,0,0,0,0,0,0
10361,83,1,0,0,0,0,0,0
0,0,0,0,0,0,0,0,0
65578,49,3,0,0,0,0,0,0
10361,83,1,0,0,0,0,0,0
0,0,0,0,0,0,0,0,0
65578,49,3,0,0,0,0,0,0
0,0,0,0,0,0,0,0,0
0,0,0,0,0,0,0,0,0
0,0,0,0,0,0,0,0,0
0,0,0,0,0,0,0,0,0
0,0,0,0,0,0,0,0,0
0,0,0,0,0,0,0,0,0
0,0,0,0,0,0,0,0,0
0,0,0,0,0,0,0,0,0
0,0,0,0,0,0,0,0,0
0,0,0,0,0,0,0,0,0
0,0,0,0,0,0,0,0,0
139620,399,8,26,24,2,34,1,0
0,0,0,0,0,0,0,0,0
0,0,0,0,0,0,0,0,0
0,0,0,0,0,0,0,0,0
0,0,0,0,0,0,0,0,0
0,0,0,0,0,0,0,0,0
0,0,0,0,0,0,0,0,0
0,0,0,0,0,0,0,0,0
0,0,0,0,0,0,0,0,0
0,0,0,0,0,0,0,0,0
0,0,0,0,0,0,0,0,0
674722,556,0,4,4,0,2,1,1
0,0,0,0,0,0,0,0,0
0,0,0,0,0,0,0,0,0
0,0,0,0,0,0,0,0,0
0,0,0,0,0,0,0,0,0
0,0,0,0,0,0,0,0,0
0,0,0,0,0,0,0,0,0
0,0,0,0,0,0,0,0,0
0,0,0,0,0,0,0,0,0
0,0,0,0,0,0,0,0,0
0,0,0,0,0,0,0,0,0
0,0,0,0,0,0,0,0,0
0,0,0,0,0,0,0,0,0
0,0,0,0,0,0,0,0,0
0,0,0,0,0,0,0,0,0
0,0,0,0,0,0,0,0,0
0,0,0,0,0,0,0,0,0
0,0,0,0,0,0,0,0,0
0,0,0,0,0,0,0,0,0
0,0,0,0,0,0,0,0,0
0,0,0,0,0,0,0,0,0
167975,52,3,0,0,0,2,0,0
0,0,0,0,0,0,0,0,0
167975,52,3,0,0,0,2,0,0
167975,52,3,0,0,0,2,0,0
0,0,0,0,0,0,0,0,0
0,0,0,0,0,0,0,0,0
59106,901,4,163,2,161,3,1,0
59106,901,4,163,2,161,3,1,0
0,0,0,0,0,0,0,0,0
0,0,0,0,0,0,0,0,0
0,0,0,0,0,0,0,0,0
193754,92,1,3,1,2,5,0,0
6710,59,3,2,2,0,2,1,0
8512,71,1,0,0,0,0,0,0
108195,981,5,26,25,1,1,1,0
0,0,0,0,0,0,0,0,0
0,0,0,0,0,0,0,0,0
0,0,0,0,0,0,0,0,0
0,0,0,0,0,0,0,0,0
0,0,0,0,0,0,0,0,0
0,0,0,0,0,0,0,0,0
0,0,0,0,0,0,0,0,0
0,0,0,0,0,0,0,0,0
0,0,0,0,0,0,0,0,0
0,0,0,0,0,0,0,0,0
0,0,0,0,0,0,0,0,0
0,0,0,0,0,0,0,0,0
65618,49,3,0,0,0,0,0,0
104594,28,2,0,0,0,0,0,0
0,0,0,0,0,0,0,0,0
65618,49,3,0,0,0,0,0,0
17608,124,0,1,0,1,0,0,0
0,0,0,0,0,0,0,0,0
0,0,0,0,0,0,0,0,0
65729,50,3,0,0,0,0,0,0
0,0,0,0,0,0,0,0,0
0,0,0,0,0,0,0,0,0
0,0,0,0,0,0,0,0,0
12914,97,0,3,3,0,0,0,0
674531,556,0,4,4,0,2,1,1
0,0,0,0,0,0,0,0,0
49643,117,2,1,1,0,0,1,0
53086,183,2,8,5,3,2,1,0
0,0,0,0,0,0,0,0,0
65729,50,3,0,0,0,0,0,0
138721,259,1,20,7,13,7,1,0
0,0,0,0,0,0,0,0,0
0,0,0,0,0,0,0,0,0
0,0,0,0,0,0,0,0,0
0,0,0,0,0,0,0,0,0
65741,50,3,0,0,0,0,0,0
0,0,0,0,0,0,0,0,0
0,0,0,0,0,0,0,0,0
50452,231,2,2,2,0,1,0,0
130935,294,6,26,24,2,8,1,0
0,0,0,0,0,0,0,0,0
2673,21,2,1,0,1,0,0,0
2673,21,2,1,0,1,0,0,0
2673,21,2,1,0,1,0,0,0
0,0,0,0,0,0,0,0,0
0,0,0,0,0,0,0,0,0
0,0,0,0,0,0,0,0,0
0,0,0,0,0,0,0,0,0
0,0,0,0,0,0,0,0,0
0,0,0,0,0,0,0,0,0
0,0,0,0,0,0,0,0,0
65741,50,3,0,0,0,0,0,0
0,0,0,0,0,0,0,0,0
0,0,0,0,0,0,0,0,0
0,0,0,0,0,0,0,0,0
0,0,0,0,0,0,0,0,0
0,0,0,0,0,0,0,0,0
671557,556,0,4,4,0,2,1,1
2673,21,2,1,0,1,0,0,0
0,0,0,0,0,0,0,0,0
0,0,0,0,0,0,0,0,0
0,0,0,0,0,0,0,0,0
0,0,0,0,0,0,0,0,0
0,0,0,0,0,0,0,0,0
2673,21,2,1,0,1,0,0,0
65741,50,3,0,0,0,0,0,0
0,0,0,0,0,0,0,0,0
25122,67,2,1,1,0,2,0,0
25122,67,2,1,1,0,2,0,0
0,0,0,0,0,0,0,0,0
25122,67,2,1,1,0,2,0,0
25122,67,2,1,1,0,2,0,0
25122,67,2,1,1,0,2,0,0
25122,67,2,1,1,0,2,0,0
25122,67,2,1,1,0,2,0,0
0,0,0,0,0,0,0,0,0
0,0,0,0,0,0,0,0,0
0,0,0,0,0,0,0,0,0
0,0,0,0,0,0,0,0,0
5881700,59,3,1,1,0,2,1,0
0,0,0,0,0,0,0,0,0
12229,51,3,0,0,0,2,0,0
198123,81,4,4,4,0,2,1,0
0,0,0,0,0,0,0,0,0
0,0,0,0,0,0,0,0,0
5881700,59,3,1,1,0,2,1,0
0,0,0,0,0,0,0,0,0
0,0,0,0,0,0,0,0,0
5881700,59,3,1,1,0,2,1,0
5881700,59,3,1,1,0,2,1,0
0,0,0,0,0,0,0,0,0
12229,51,3,0,0,0,2,0,0
198123,81,4,4,4,0,2,1,0
12229,51,3,0,0,0,2,0,0
198123,81,4,4,4,0,2,1,0
0,0,0,0,0,0,0,0,0
5881700,59,3,1,1,0,2,1,0
0,0,0,0,0,0,0,0,0
0,0,0,0,0,0,0,0,0
0,0,0,0,0,0,0,0,0
0,0,0,0,0,0,0,0,0
0,0,0,0,0,0,0,0,0
4165785,208,0,52,51,1,0,1,0
4166001,213,0,52,51,1,0,1,0
50721,48,4,0,0,0,0,0,0
125172,204,2,50,49,1,0,1,0
0,0,0,0,0,0,0,0,0
0,0,0,0,0,0,0,0,0
0,0,0,0,0,0,0,0,0
4166001,213,0,52,51,1,0,1,0
4166001,213,0,52,51,1,0,1,0
327161,70,4,3,3,0,2,1,0
327161,70,4,3,3,0,2,1,0
125172,204,2,50,49,1,0,1,0
4166001,213,0,52,51,1,0,1,0
4166001,213,0,52,51,1,0,1,0
0,0,0,0,0,0,0,0,0
327161,70,4,3,3,0,2,1,0
327161,70,4,3,3,0,2,1,0
0,0,0,0,0,0,0,0,0
0,0,0,0,0,0,0,0,0
0,0,0,0,0,0,0,0,0
0,0,0,0,0,0,0,0,0
0,0,0,0,0,0,0,0,0
327161,70,4,3,3,0,2,1,0
0,0,0,0,0,0,0,0,0
125172,204,2,50,49,1,0,1,0
0,0,0,0,0,0,0,0,0
0,0,0,0,0,0,0,0,0
0,0,0,0,0,0,0,0,0
0,0,0,0,0,0,0,0,0
0,0,0,0,0,0,0,0,0
0,0,0,0,0,0,0,0,0
0,0,0,0,0,0,0,0,0
0,0,0,0,0,0,0,0,0
0,0,0,0,0,0,0,0,0
0,0,0,0,0,0,0,0,0
0,0,0,0,0,0,0,0,0
0,0,0,0,0,0,0,0,0
0,0,0,0,0,0,0,0,0
0,0,0,0,0,0,0,0,0
0,0,0,0,0,0,0,0,0
0,0,0,0,0,0,0,0,0
51876,175,2,5,1,4,1,1,0
0,0,0,0,0,0,0,0,0
0,0,0,0,0,0,0,0,0
0,0,0,0,0,0,0,0,0
0,0,0,0,0,0,0,0,0
0,0,0,0,0,0,0,0,0
0,0,0,0,0,0,0,0,0
0,0,0,0,0,0,0,0,0
0,0,0,0,0,0,0,0,0
37835,96,7,0,0,0,1,0,0
0,0,0,0,0,0,0,0,0
0,0,0,0,0,0,0,0,0
0,0,0,0,0,0,0,0,0
0,0,0,0,0,0,0,0,0
0,0,0,0,0,0,0,0,0
673906,556,0,4,4,0,2,1,1
675544,556,0,4,4,0,2,1,1
5513,50,1,1,0,1,0,0,0
5513,50,1,1,0,1,0,0,0
0,0,0,0,0,0,0,0,0
0,0,0,0,0,0,0,0,0
0,0,0,0,0,0,0,0,0
0,0,0,0,0,0,0,0,0
0,0,0,0,0,0,0,0,0
0,0,0,0,0,0,0,0,0
12361,28,4,0,0,0,0,0,0
12360,28,4,0,0,0,0,0,0
0,0,0,0,0,0,0,0,0
0,0,0,0,0,0,0,0,0
0,0,0,0,0,0,0,0,0
204918,155,3,2,1,1,18,0,0
204931,155,3,2,1,1,18,0,0
0,0,0,0,0,0,0,0,0
0,0,0,0,0,0,0,0,0
0,0,0,0,0,0,0,0,0
0,0,0,0,0,0,0,0,0
0,0,0,0,0,0,0,0,0
0,0,0,0,0,0,0,0,0
0,0,0,0,0,0,0,0,0
2673,21,2,1,0,1,0,0,0
0,0,0,0,0,0,0,0,0
0,0,0,0,0,0,0,0,0
0,0,0,0,0,0,0,0,0
0,0,0,0,0,0,0,0,0
0,0,0,0,0,0,0,0,0
0,0,0,0,0,0,0,0,0
91577,211,4,0,0,0,1,0,0
0,0,0,0,0,0,0,0,0
672343,542,0,4,4,0,2,1,1
0,0,0,0,0,0,0,0,0
0,0,0,0,0,0,0,0,0
0,0,0,0,0,0,0,0,0
672128,556,0,4,4,0,2,1,1
674311,556,0,4,4,0,2,1,1
0,0,0,0,0,0,0,0,0
2673,21,2,1,0,1,0,0,0
0,0,0,0,0,0,0,0,0
0,0,0,0,0,0,0,0,0
65741,50,3,0,0,0,0,0,0
72147,685,1,126,122,4,12,1,0
0,0,0,0,0,0,0,0,0
0,0,0,0,0,0,0,0,0
0,0,0,0,0,0,0,0,0
243620,535,11,50,41,9,5,0,0
0,0,0,0,0,0,0,0,0
0,0,0,0,0,0,0,0,0
7021,30,0,3,0,3,0,1,0
0,0,0,0,0,0,0,0,0
0,0,0,0,0,0,0,0,0
2673,21,2,1,0,1,0,0,0
673783,556,0,4,4,0,2,1,1
65729,50,3,0,0,0,0,0,0
0,0,0,0,0,0,0,0,0
0,0,0,0,0,0,0,0,0
0,0,0,0,0,0,0,0,0
270870,1110,5,187,185,2,10,1,0
0,0,0,0,0,0,0,0,0
65729,50,3,0,0,0,0,0,0
0,0,0,0,0,0,0,0,0
0,0,0,0,0,0,0,0,0
0,0,0,0,0,0,0,0,0
85243,23,4,1,1,0,0,0,0
85243,23,4,1,1,0,0,0,0
0,0,0,0,0,0,0,0,0
0,0,0,0,0,0,0,0,0
0,0,0,0,0,0,0,0,0
36886,163,3,8,4,4,10,1,0
672955,2996,19,192,50,142,18,1,0
0,0,0,0,0,0,0,0,0
0,0,0,0,0,0,0,0,0
0,0,0,0,0,0,0,0,0
0,0,0,0,0,0,0,0,0
0,0,0,0,0,0,0,0,0
23534,39,2,0,0,0,0,1,0
1998630,67,5,1,1,0,2,1,0
0,0,0,0,0,0,0,0,0
0,0,0,0,0,0,0,0,0
0,0,0,0,0,0,0,0,0
0,0,0,0,0,0,0,0,0
0,0,0,0,0,0,0,0,0
0,0,0,0,0,0,0,0,0
0,0,0,0,0,0,0,0,0
0,0,0,0,0,0,0,0,0
0,0,0,0,0,0,0,0,0
0,0,0,0,0,0,0,0,0
0,0,0,0,0,0,0,0,0
1998630,67,5,1,1,0,2,1,0
0,0,0,0,0,0,0,0,0
1910262,65,5,1,1,0,2,1,0
0,0,0,0,0,0,0,0,0
0,0,0,0,0,0,0,0,0
0,0,0,0,0,0,0,0,0
195025,1116,1,205,43,162,1,1,0
195049,1116,1,205,43,162,1,1,0
195029,1116,1,205,43,162,1,1,0
0,0,0,0,0,0,0,0,0
0,0,0,0,0,0,0,0,0
0,0,0,0,0,0,0,0,0
0,0,0,0,0,0,0,0,0
0,0,0,0,0,0,0,0,0
0,0,0,0,0,0,0,0,0
0,0,0,0,0,0,0,0,0
0,0,0,0,0,0,0,0,0
0,0,0,0,0,0,0,0,0
0,0,0,0,0,0,0,0,0
0,0,0,0,0,0,0,0,0
0,0,0,0,0,0,0,0,0
0,0,0,0,0,0,0,0,0
0,0,0,0,0,0,0,0,0
0,0,0,0,0,0,0,0,0
0,0,0,0,0,0,0,0,0
0,0,0,0,0,0,0,0,0
0,0,0,0,0,0,0,0,0
0,0,0,0,0,0,0,0,0
0,0,0,0,0,0,0,0,0
0,0,0,0,0,0,0,0,0
0,0,0,0,0,0,0,0,0
0,0,0,0,0,0,0,0,0
0,0,0,0,0,0,0,0,0
0,0,0,0,0,0,0,0,0
0,0,0,0,0,0,0,0,0
0,0,0,0,0,0,0,0,0
0,0,0,0,0,0,0,0,0
0,0,0,0,0,0,0,0,0
0,0,0,0,0,0,0,0,0
0,0,0,0,0,0,0,0,0
0,0,0,0,0,0,0,0,0
0,0,0,0,0,0,0,0,0
0,0,0,0,0,0,0,0,0
0,0,0,0,0,0,0,0,0
0,0,0,0,0,0,0,0,0
0,0,0,0,0,0,0,0,0
0,0,0,0,0,0,0,0,0
12645,85,1,5,0,5,0,0,0
9086,79,1,0,0,0,0,0,0
108193,981,5,26,25,1,1,1,0
0,0,0,0,0,0,0,0,0
0,0,0,0,0,0,0,0,0
0,0,0,0,0,0,0,0,0
0,0,0,0,0,0,0,0,0
0,0,0,0,0,0,0,0,0
0,0,0,0,0,0,0,0,0
10327,81,1,0,0,0,0,0,0
0,0,0,0,0,0,0,0,0
0,0,0,0,0,0,0,0,0
0,0,0,0,0,0,0,0,0
0,0,0,0,0,0,0,0,0
65741,50,3,0,0,0,0,0,0
0,0,0,0,0,0,0,0,0
676165,557,0,4,4,0,2,1,1
65729,50,3,0,0,0,0,0,0
2673,21,2,1,0,1,0,0,0
0,0,0,0,0,0,0,0,0
673993,556,0,4,4,0,2,1,1
676332,557,0,4,4,0,2,1,1
0,0,0,0,0,0,0,0,0
0,0,0,0,0,0,0,0,0
2673,21,2,1,0,1,0,0,0
0,0,0,0,0,0,0,0,0
2673,21,2,1,0,1,0,0,0
0,0,0,0,0,0,0,0,0
65729,50,3,0,0,0,0,0,0
0,0,0,0,0,0,0,0,0
0,0,0,0,0,0,0,0,0
65729,50,3,0,0,0,0,0,0
0,0,0,0,0,0,0,0,0
672047,556,0,4,4,0,2,1,1
0,0,0,0,0,0,0,0,0
0,0,0,0,0,0,0,0,0
65729,50,3,0,0,0,0,0,0
0,0,0,0,0,0,0,0,0
2673,21,2,1,0,1,0,0,0
0,0,0,0,0,0,0,0,0
2673,21,2,1,0,1,0,0,0
0,0,0,0,0,0,0,0,0
0,0,0,0,0,0,0,0,0
0,0,0,0,0,0,0,0,0
0,0,0,0,0,0,0,0,0
0,0,0,0,0,0,0,0,0
0,0,0,0,0,0,0,0,0
65729,50,3,0,0,0,0,0,0
0,0,0,0,0,0,0,0,0
0,0,0,0,0,0,0,0,0
65729,50,3,0,0,0,0,0,0
12515,86,0,1,1,0,0,0,0
0,0,0,0,0,0,0,0,0
0,0,0,0,0,0,0,0,0
0,0,0,0,0,0,0,0,0
0,0,0,0,0,0,0,0,0
65741,50,3,0,0,0,0,0,0
0,0,0,0,0,0,0,0,0
0,0,0,0,0,0,0,0,0
7003,31,2,0,0,0,1,0,0
0,0,0,0,0,0,0,0,0
0,0,0,0,0,0,0,0,0
0,0,0,0,0,0,0,0,0
0,0,0,0,0,0,0,0,0
0,0,0,0,0,0,0,0,0
218568,1778,1,201,4,197,3,1,0
0,0,0,0,0,0,0,0,0
0,0,0,0,0,0,0,0,0
0,0,0,0,0,0,0,0,0
90930,1141,4,87,84,3,0,1,0
0,0,0,0,0,0,0,0,0
91778,211,4,0,0,0,1,0,0
0,0,0,0,0,0,0,0,0
0,0,0,0,0,0,0,0,0
91074,209,4,0,0,0,1,0,0
90902,211,4,0,0,0,1,0,0
90902,211,4,0,0,0,1,0,0
0,0,0,0,0,0,0,0,0
36356,50,2,0,0,0,2,0,0
36356,50,2,0,0,0,2,0,0
235936,208,0,52,51,1,0,1,0
236152,213,0,52,51,1,0,1,0
14441,41,2,0,0,0,2,0,0
14441,41,2,0,0,0,2,0,0
236152,213,0,52,51,1,0,1,0
236152,213,0,52,51,1,0,1,0
36356,50,2,0,0,0,2,0,0
236152,213,0,52,51,1,0,1,0
236152,213,0,52,51,1,0,1,0
36356,50,2,0,0,0,2,0,0
0,0,0,0,0,0,0,0,0
236152,213,0,52,51,1,0,1,0
0,0,0,0,0,0,0,0,0
0,0,0,0,0,0,0,0,0
0,0,0,0,0,0,0,0,0
0,0,0,0,0,0,0,0,0
144744,62,4,3,3,0,2,1,0
0,0,0,0,0,0,0,0,0
0,0,0,0,0,0,0,0,0
2026604,61,4,1,1,0,2,1,0
144744,62,4,3,3,0,2,1,0
0,0,0,0,0,0,0,0,0
2026604,61,4,1,1,0,2,1,0
144744,62,4,3,3,0,2,1,0
0,0,0,0,0,0,0,0,0
0,0,0,0,0,0,0,0,0
2026604,61,4,1,1,0,2,1,0
0,0,0,0,0,0,0,0,0
0,0,0,0,0,0,0,0,0
0,0,0,0,0,0,0,0,0
0,0,0,0,0,0,0,0,0
0,0,0,0,0,0,0,0,0
0,0,0,0,0,0,0,0,0
0,0,0,0,0,0,0,0,0
5047,24,3,0,0,0,0,0,0
0,0,0,0,0,0,0,0,0
0,0,0,0,0,0,0,0,0
0,0,0,0,0,0,0,0,0
0,0,0,0,0,0,0,0,0
5880466,59,3,1,1,0,2,1,0
0,0,0,0,0,0,0,0,0
5880466,59,3,1,1,0,2,1,0
5880466,59,3,1,1,0,2,1,0
5880466,59,3,1,1,0,2,1,0
5880466,59,3,1,1,0,2,1,0
0,0,0,0,0,0,0,0,0
5047,24,3,0,0,0,0,0,0
5047,24,3,0,0,0,0,0,0
5047,24,3,0,0,0,0,0,0
5047,24,3,0,0,0,0,0,0
0,0,0,0,0,0,0,0,0
0,0,0,0,0,0,0,0,0
0,0,0,0,0,0,0,0,0
0,0,0,0,0,0,0,0,0
0,0,0,0,0,0,0,0,0
0,0,0,0,0,0,0,0,0
0,0,0,0,0,0,0,0,0
0,0,0,0,0,0,0,0,0
0,0,0,0,0,0,0,0,0
0,0,0,0,0,0,0,0,0
4103,55,0,5,3,2,0,0,0
0,0,0,0,0,0,0,0,0
0,0,0,0,0,0,0,0,0
0,0,0,0,0,0,0,0,0
0,0,0,0,0,0,0,0,0
0,0,0,0,0,0,0,0,0
0,0,0,0,0,0,0,0,0
0,0,0,0,0,0,0,0,0
0,0,0,0,0,0,0,0,0
0,0,0,0,0,0,0,0,0
0,0,0,0,0,0,0,0,0
2478,39,1,7,7,0,0,0,0
0,0,0,0,0,0,0,0,0
0,0,0,0,0,0,0,0,0
0,0,0,0,0,0,0,0,0
0,0,0,0,0,0,0,0,0
0,0,0,0,0,0,0,0,0
0,0,0,0,0,0,0,0,0
0,0,0,0,0,0,0,0,0
0,0,0,0,0,0,0,0,0
2478,39,1,7,7,0,0,0,0
2478,39,1,7,7,0,0,0,0
2478,39,1,7,7,0,0,0,0
0,0,0,0,0,0,0,0,0
0,0,0,0,0,0,0,0,0
0,0,0,0,0,0,0,0,0
0,0,0,0,0,0,0,0,0
0,0,0,0,0,0,0,0,0
0,0,0,0,0,0,0,0,0
0,0,0,0,0,0,0,0,0
0,0,0,0,0,0,0,0,0
2673,21,2,1,0,1,0,0,0
2673,21,2,1,0,1,0,0,0
0,0,0,0,0,0,0,0,0
64984,50,3,0,0,0,0,0,0
2673,21,2,1,0,1,0,0,0
220913,1445,10,152,144,8,11,1,0
674298,556,0,4,4,0,2,1,1
64996,50,3,0,0,0,0,0,0
0,0,0,0,0,0,0,0,0
0,0,0,0,0,0,0,0,0
64996,50,3,0,0,0,0,0,0
64984,50,3,0,0,0,0,0,0
2673,21,2,1,0,1,0,0,0
157,4,0,0,0,0,0,0,0
0,0,0,0,0,0,0,0,0
0,0,0,0,0,0,0,0,0
0,0,0,0,0,0,0,0,0
436751,52,2,1,1,0,0,1,0
385384,271,5,5,5,0,0,1,0
301072,242,4,7,7,0,0,1,0
287052,189,4,1,1,0,0,1,0
0,0,0,0,0,0,0,0,0
0,0,0,0,0,0,0,0,0
0,0,0,0,0,0,0,0,0
0,0,0,0,0,0,0,0,0
0,0,0,0,0,0,0,0,0
0,0,0,0,0,0,0,0,0
0,0,0,0,0,0,0,0,0
0,0,0,0,0,0,0,0,0
0,0,0,0,0,0,0,0,0
0,0,0,0,0,0,0,0,0
2673,21,2,1,0,1,0,0,0
187311,879,0,80,55,25,11,1,0
0,0,0,0,0,0,0,0,0
0,0,0,0,0,0,0,0,0
0,0,0,0,0,0,0,0,0
0,0,0,0,0,0,0,0,0
0,0,0,0,0,0,0,0,0
0,0,0,0,0,0,0,0,0
0,0,0,0,0,0,0,0,0
0,0,0,0,0,0,0,0,0
0,0,0,0,0,0,0,0,0
0,0,0,0,0,0,0,0,0
0,0,0,0,0,0,0,0,0
0,0,0,0,0,0,0,0,0
0,0,0,0,0,0,0,0,0
0,0,0,0,0,0,0,0,0
30885,58,3,0,0,0,3,1,0
102262,152,4,4,4,0,2,1,0
0,0,0,0,0,0,0,0,0
0,0,0,0,0,0,0,0,0
29248,77,3,0,0,0,3,0,0
0,0,0,0,0,0,0,0,0
0,0,0,0,0,0,0,0,0
0,0,0,0,0,0,0,0,0
225811,119,0,15,6,9,0,1,0
225811,119,0,15,6,9,0,1,0
225811,119,0,15,6,9,0,1,0
225811,119,0,15,6,9,0,1,0
225811,119,0,15,6,9,0,1,0
225811,119,0,15,6,9,0,1,0
225811,119,0,15,6,9,0,1,0
8248,146,0,15,15,0,5,1,0
8315,146,0,15,15,0,5,1,0
0,0,0,0,0,0,0,0,0
8248,146,0,15,15,0,5,1,0
8315,146,0,15,15,0,5,1,0
8248,146,0,15,15,0,5,1,0
8315,146,0,15,15,0,5,1,0
0,0,0,0,0,0,0,0,0
0,0,0,0,0,0,0,0,0
0,0,0,0,0,0,0,0,0
0,0,0,0,0,0,0,0,0
0,0,0,0,0,0,0,0,0
14457,41,2,0,0,0,2,0,0
14457,41,2,0,0,0,2,0,0
14457,41,2,0,0,0,2,0,0
0,0,0,0,0,0,0,0,0
0,0,0,0,0,0,0,0,0
0,0,0,0,0,0,0,0,0
0,0,0,0,0,0,0,0,0
0,0,0,0,0,0,0,0,0
36360,50,2,0,0,0,2,0,0
36364,50,2,0,0,0,2,0,0
36356,50,2,0,0,0,2,0,0
33839,46,2,0,0,0,2,0,0
36364,50,2,0,0,0,2,0,0
36352,50,2,0,0,0,2,0,0
36364,50,2,0,0,0,2,0,0
34407,50,2,0,0,0,2,0,0
0,0,0,0,0,0,0,0,0
0,0,0,0,0,0,0,0,0
246828,59,3,1,1,0,2,1,0
36360,50,2,0,0,0,2,0,0
36364,50,2,0,0,0,2,0,0
36356,50,2,0,0,0,2,0,0
33610,46,2,0,0,0,2,0,0
36364,50,2,0,0,0,2,0,0
36364,50,2,0,0,0,2,0,0
36408,50,2,0,0,0,2,0,0
36352,50,2,0,0,0,2,0,0
36376,50,2,0,0,0,2,0,0
0,0,0,0,0,0,0,0,0
36352,50,2,0,0,0,2,0,0
34407,50,2,0,0,0,2,0,0
34415,50,2,0,0,0,2,0,0
36356,50,2,0,0,0,2,0,0
36356,50,2,0,0,0,2,0,0
33610,46,2,0,0,0,2,0,0
0,0,0,0,0,0,0,0,0
36364,50,2,0,0,0,2,0,0
36352,50,2,0,0,0,2,0,0
36364,50,2,0,0,0,2,0,0
36352,50,2,0,0,0,2,0,0
36376,50,2,0,0,0,2,0,0
36376,50,2,0,0,0,2,0,0
0,0,0,0,0,0,0,0,0
34415,50,2,0,0,0,2,0,0
36352,50,2,0,0,0,2,0,0
36352,50,2,0,0,0,2,0,0
34407,50,2,0,0,0,2,0,0
34407,50,2,0,0,0,2,0,0
246828,59,3,1,1,0,2,1,0
246828,59,3,1,1,0,2,1,0
36364,50,2,0,0,0,2,0,0
36364,50,2,0,0,0,2,0,0
36364,50,2,0,0,0,2,0,0
36364,50,2,0,0,0,2,0,0
246828,59,3,1,1,0,2,1,0
36360,50,2,0,0,0,2,0,0
36364,50,2,0,0,0,2,0,0
36356,50,2,0,0,0,2,0,0
33610,46,2,0,0,0,2,0,0
36364,50,2,0,0,0,2,0,0
36364,50,2,0,0,0,2,0,0
36408,50,2,0,0,0,2,0,0
36352,50,2,0,0,0,2,0,0
0,0,0,0,0,0,0,0,0
36376,50,2,0,0,0,2,0,0
0,0,0,0,0,0,0,0,0
36364,50,2,0,0,0,2,0,0
36352,50,2,0,0,0,2,0,0
0,0,0,0,0,0,0,0,0
34407,50,2,0,0,0,2,0,0
34415,50,2,0,0,0,2,0,0
16600,63,4,9,9,0,2,0,0
16602,63,4,9,9,0,2,0,0
16611,63,4,9,9,0,2,0,0
16600,63,4,9,9,0,2,0,0
16602,63,4,9,9,0,2,0,0
0,0,0,0,0,0,0,0,0
0,0,0,0,0,0,0,0,0
16611,63,4,9,9,0,2,0,0
16600,63,4,9,9,0,2,0,0
0,0,0,0,0,0,0,0,0
0,0,0,0,0,0,0,0,0
0,0,0,0,0,0,0,0,0
0,0,0,0,0,0,0,0,0
0,0,0,0,0,0,0,0,0
0,0,0,0,0,0,0,0,0
20158,53,3,0,0,0,0,0,0
20158,53,3,0,0,0,0,0,0
0,0,0,0,0,0,0,0,0
0,0,0,0,0,0,0,0,0
0,0,0,0,0,0,0,0,0
0,0,0,0,0,0,0,0,0
0,0,0,0,0,0,0,0,0
20144,53,3,0,0,0,0,0,0
0,0,0,0,0,0,0,0,0
0,0,0,0,0,0,0,0,0
0,0,0,0,0,0,0,0,0
0,0,0,0,0,0,0,0,0
0,0,0,0,0,0,0,0,0
0,0,0,0,0,0,0,0,0
0,0,0,0,0,0,0,0,0
20158,53,3,0,0,0,0,0,0
20158,53,3,0,0,0,0,0,0
20140,53,3,0,0,0,0,0,0
0,0,0,0,0,0,0,0,0
0,0,0,0,0,0,0,0,0
0,0,0,0,0,0,0,0,0
0,0,0,0,0,0,0,0,0
20144,53,3,0,0,0,0,0,0
0,0,0,0,0,0,0,0,0
0,0,0,0,0,0,0,0,0
0,0,0,0,0,0,0,0,0
0,0,0,0,0,0,0,0,0
0,0,0,0,0,0,0,0,0
0,0,0,0,0,0,0,0,0
0,0,0,0,0,0,0,0,0
0,0,0,0,0,0,0,0,0
0,0,0,0,0,0,0,0,0
20158,53,3,0,0,0,0,0,0
20158,53,3,0,0,0,0,0,0
0,0,0,0,0,0,0,0,0
0,0,0,0,0,0,0,0,0
20140,53,3,0,0,0,0,0,0
20140,53,3,0,0,0,0,0,0
0,0,0,0,0,0,0,0,0
0,0,0,0,0,0,0,0,0
0,0,0,0,0,0,0,0,0
20158,53,3,0,0,0,0,0,0
20140,53,3,0,0,0,0,0,0
0,0,0,0,0,0,0,0,0
0,0,0,0,0,0,0,0,0
0,0,0,0,0,0,0,0,0
20144,53,3,0,0,0,0,0,0
0,0,0,0,0,0,0,0,0
198873,70,4,4,4,0,4,0,0
198873,70,4,4,4,0,4,0,0
198873,70,4,4,4,0,4,0,0
198873,70,4,4,4,0,4,0,0
10395,54,6,0,0,0,2,1,0
10395,54,6,0,0,0,2,1,0
10395,54,6,0,0,0,2,1,0
10395,54,6,0,0,0,2,1,0
10395,54,6,0,0,0,2,1,0
13024,84,1,3,3,0,0,0,0
13024,84,1,3,3,0,0,0,0
13024,84,1,3,3,0,0,0,0
13024,84,1,3,3,0,0,0,0
13024,84,1,3,3,0,0,0,0
0,0,0,0,0,0,0,0,0
144695,60,4,3,3,0,2,1,0
145747,57,4,3,3,0,2,1,0
23474,59,4,3,3,0,2,1,0
23474,59,4,3,3,0,2,1,0
23490,59,4,3,3,0,2,1,0
0,0,0,0,0,0,0,0,0
0,0,0,0,0,0,0,0,0
144458,59,4,3,3,0,2,1,0
233305,64,4,3,3,0,2,1,0
233324,64,4,3,3,0,2,1,0
0,0,0,0,0,0,0,0,0
234115,59,4,3,3,0,2,1,0
111858,61,4,3,3,0,2,1,0
144761,62,4,3,3,0,2,1,0
233305,64,4,3,3,0,2,1,0
0,0,0,0,0,0,0,0,0
233324,64,4,3,3,0,2,1,0
233324,64,4,3,3,0,2,1,0
0,0,0,0,0,0,0,0,0
0,0,0,0,0,0,0,0,0
145747,57,4,3,3,0,2,1,0
145747,57,4,3,3,0,2,1,0
144761,62,4,3,3,0,2,1,0
0,0,0,0,0,0,0,0,0
23490,59,4,3,3,0,2,1,0
23490,59,4,3,3,0,2,1,0
144458,59,4,3,3,0,2,1,0
144458,59,4,3,3,0,2,1,0
144458,59,4,3,3,0,2,1,0
233305,64,4,3,3,0,2,1,0
233324,64,4,3,3,0,2,1,0
0,0,0,0,0,0,0,0,0
145747,57,4,3,3,0,2,1,0
0,0,0,0,0,0,0,0,0
23490,59,4,3,3,0,2,1,0
144761,62,4,3,3,0,2,1,0
139186,51,2,0,0,0,2,0,0
0,0,0,0,0,0,0,0,0
144518,62,4,3,3,0,2,1,0
33839,46,2,0,0,0,2,0,0
0,0,0,0,0,0,0,0,0
0,0,0,0,0,0,0,0,0
0,0,0,0,0,0,0,0,0
33839,46,2,0,0,0,2,0,0
33839,46,2,0,0,0,2,0,0
1358248,68,4,9,9,0,2,0,0
1358248,68,4,9,9,0,2,0,0
36408,50,2,0,0,0,2,0,0
36408,50,2,0,0,0,2,0,0
3717,22,0,2,2,0,1,0,0
3717,22,0,2,2,0,1,0,0
36364,50,2,0,0,0,2,0,0
36364,50,2,0,0,0,2,0,0
0,0,0,0,0,0,0,0,0
0,0,0,0,0,0,0,0,0
10486,39,1,0,0,0,1,0,0
10486,39,1,0,0,0,1,0,0
0,0,0,0,0,0,0,0,0
0,0,0,0,0,0,0,0,0
36360,50,2,0,0,0,2,0,0
36360,50,2,0,0,0,2,0,0
139186,51,2,0,0,0,2,0,0
139186,51,2,0,0,0,2,0,0
0,0,0,0,0,0,0,0,0
0,0,0,0,0,0,0,0,0
0,0,0,0,0,0,0,0,0
0,0,0,0,0,0,0,0,0
0,0,0,0,0,0,0,0,0
0,0,0,0,0,0,0,0,0
0,0,0,0,0,0,0,0,0
0,0,0,0,0,0,0,0,0
1315864,66,5,0,0,0,4,1,0
1315864,66,5,0,0,0,4,1,0
0,0,0,0,0,0,0,0,0
0,0,0,0,0,0,0,0,0
139186,51,2,0,0,0,2,0,0
144518,62,4,3,3,0,2,1,0
33839,46,2,0,0,0,2,0,0
0,0,0,0,0,0,0,0,0
0,0,0,0,0,0,0,0,0
0,0,0,0,0,0,0,0,0
0,0,0,0,0,0,0,0,0
0,0,0,0,0,0,0,0,0
0,0,0,0,0,0,0,0,0
0,0,0,0,0,0,0,0,0
160196,43,3,0,0,0,0,0,0
0,0,0,0,0,0,0,0,0
1315864,66,5,0,0,0,4,1,0
0,0,0,0,0,0,0,0,0
1358248,68,4,9,9,0,2,0,0
241310,54,3,0,0,0,0,1,0
0,0,0,0,0,0,0,0,0
144761,62,4,3,3,0,2,1,0
20158,53,3,0,0,0,0,0,0
20154,53,3,0,0,0,0,0,0
0,0,0,0,0,0,0,0,0
135934,41,4,1,1,0,2,0,0
0,0,0,0,0,0,0,0,0
1315864,66,5,0,0,0,4,1,0
7985,50,4,0,0,0,0,0,0
144744,62,4,3,3,0,2,1,0
55707,73,4,0,0,0,0,1,0
9293,37,4,0,0,0,2,0,0
0,0,0,0,0,0,0,0,0
144747,62,4,3,3,0,2,1,0
1358248,68,4,9,9,0,2,0,0
7530,52,4,1,1,0,2,1,0
144741,62,4,3,3,0,2,1,0
241310,54,3,0,0,0,0,1,0
0,0,0,0,0,0,0,0,0
0,0,0,0,0,0,0,0,0
0,0,0,0,0,0,0,0,0
0,0,0,0,0,0,0,0,0
144761,62,4,3,3,0,2,1,0
0,0,0,0,0,0,0,0,0
20154,53,3,0,0,0,0,0,0
7985,50,4,0,0,0,0,0,0
144744,62,4,3,3,0,2,1,0
144761,62,4,3,3,0,2,1,0
20158,53,3,0,0,0,0,0,0
20154,53,3,0,0,0,0,0,0
0,0,0,0,0,0,0,0,0
1315864,66,5,0,0,0,4,1,0
7985,50,4,0,0,0,0,0,0
144744,62,4,3,3,0,2,1,0
55707,73,4,0,0,0,0,1,0
9293,37,4,0,0,0,2,0,0
0,0,0,0,0,0,0,0,0
1358248,68,4,9,9,0,2,0,0
0,0,0,0,0,0,0,0,0
144741,62,4,3,3,0,2,1,0
241310,54,3,0,0,0,0,1,0
0,0,0,0,0,0,0,0,0
10486,39,1,0,0,0,1,0,0
10486,39,1,0,0,0,1,0,0
0,0,0,0,0,0,0,0,0
10486,39,1,0,0,0,1,0,0
144518,62,4,3,3,0,2,1,0
144518,62,4,3,3,0,2,1,0
144518,62,4,3,3,0,2,1,0
0,0,0,0,0,0,0,0,0
0,0,0,0,0,0,0,0,0
0,0,0,0,0,0,0,0,0
0,0,0,0,0,0,0,0,0
0,0,0,0,0,0,0,0,0
0,0,0,0,0,0,0,0,0
0,0,0,0,0,0,0,0,0
3717,22,0,2,2,0,1,0,0
3717,22,0,2,2,0,1,0,0
0,0,0,0,0,0,0,0,0
0,0,0,0,0,0,0,0,0
327041,60,4,3,3,0,2,1,0
327041,60,4,3,3,0,2,1,0
94057,58,4,2,0,2,2,1,0
94057,58,4,2,0,2,2,1,0
327174,71,4,3,3,0,2,1,0
327174,71,4,3,3,0,2,1,0
139186,51,2,0,0,0,2,0,0
94041,58,4,2,0,2,2,1,0
94041,58,4,2,0,2,2,1,0
327149,60,4,3,3,0,2,1,0
327149,60,4,3,3,0,2,1,0
0,0,0,0,0,0,0,0,0
0,0,0,0,0,0,0,0,0
327164,68,4,3,3,0,2,1,0
327164,68,4,3,3,0,2,1,0
0,0,0,0,0,0,0,0,0
327041,60,4,3,3,0,2,1,0
327041,60,4,3,3,0,2,1,0
94057,58,4,2,0,2,2,1,0
94057,58,4,2,0,2,2,1,0
327174,71,4,3,3,0,2,1,0
327174,71,4,3,3,0,2,1,0
327095,60,4,3,3,0,2,1,0
327095,60,4,3,3,0,2,1,0
94041,58,4,2,0,2,2,1,0
94041,58,4,2,0,2,2,1,0
327115,60,4,3,3,0,2,1,0
327115,60,4,3,3,0,2,1,0
577363,60,4,3,3,0,2,1,0
577363,60,4,3,3,0,2,1,0
327095,60,4,3,3,0,2,1,0
327095,60,4,3,3,0,2,1,0
327149,60,4,3,3,0,2,1,0
327149,60,4,3,3,0,2,1,0
327175,72,4,3,3,0,2,1,0
327175,72,4,3,3,0,2,1,0
94205,79,3,0,0,0,3,0,0
327164,68,4,3,3,0,2,1,0
327164,68,4,3,3,0,2,1,0
327089,60,4,3,3,0,2,1,0
327089,60,4,3,3,0,2,1,0
3262982,210,0,52,51,1,0,1,0
3262982,210,0,52,51,1,0,1,0
420881,62,4,3,3,0,2,1,0
332525,60,4,3,3,0,2,1,0
0,0,0,0,0,0,0,0,0
0,0,0,0,0,0,0,0,0
327115,60,4,3,3,0,2,1,0
327115,60,4,3,3,0,2,1,0
94041,58,4,2,0,2,2,1,0
0,0,0,0,0,0,0,0,0
415463,62,4,3,3,0,2,1,0
327095,60,4,3,3,0,2,1,0
327175,72,4,3,3,0,2,1,0
327164,68,4,3,3,0,2,1,0
327175,72,4,3,3,0,2,1,0
327164,68,4,3,3,0,2,1,0
327149,60,4,3,3,0,2,1,0
327089,60,4,3,3,0,2,1,0
327149,60,4,3,3,0,2,1,0
327089,60,4,3,3,0,2,1,0
0,0,0,0,0,0,0,0,0
0,0,0,0,0,0,0,0,0
0,0,0,0,0,0,0,0,0
0,0,0,0,0,0,0,0,0
0,0,0,0,0,0,0,0,0
0,0,0,0,0,0,0,0,0
63280,55,3,0,0,0,0,0,0
63280,55,3,0,0,0,0,0,0
94057,58,4,2,0,2,2,1,0
0,0,0,0,0,0,0,0,0
327041,60,4,3,3,0,2,1,0
327041,60,4,3,3,0,2,1,0
327174,71,4,3,3,0,2,1,0
327174,71,4,3,3,0,2,1,0
327095,60,4,3,3,0,2,1,0
327095,60,4,3,3,0,2,1,0
0,0,0,0,0,0,0,0,0
0,0,0,0,0,0,0,0,0
577363,60,4,3,3,0,2,1,0
577363,60,4,3,3,0,2,1,0
327041,60,4,3,3,0,2,1,0
94057,58,4,2,0,2,2,1,0
327174,71,4,3,3,0,2,1,0
327095,60,4,3,3,0,2,1,0
94041,58,4,2,0,2,2,1,0
327115,60,4,3,3,0,2,1,0
577363,60,4,3,3,0,2,1,0
327095,60,4,3,3,0,2,1,0
327149,60,4,3,3,0,2,1,0
327175,72,4,3,3,0,2,1,0
0,0,0,0,0,0,0,0,0
0,0,0,0,0,0,0,0,0
0,0,0,0,0,0,0,0,0
327164,68,4,3,3,0,2,1,0
327089,60,4,3,3,0,2,1,0
3262982,210,0,52,51,1,0,1,0
63280,55,3,0,0,0,0,0,0
332513,60,4,3,3,0,2,1,0
332525,60,4,3,3,0,2,1,0
0,0,0,0,0,0,0,0,0
0,0,0,0,0,0,0,0,0
6592,120,0,1,1,0,0,1,0
0,0,0,0,0,0,0,0,0
0,0,0,0,0,0,0,0,0
0,0,0,0,0,0,0,0,0
0,0,0,0,0,0,0,0,0
0,0,0,0,0,0,0,0,0
9704,33,4,0,0,0,2,0,0
0,0,0,0,0,0,0,0,0
0,0,0,0,0,0,0,0,0
0,0,0,0,0,0,0,0,0
0,0,0,0,0,0,0,0,0
484162,103,0,7,0,7,1,0,0
0,0,0,0,0,0,0,0,0
244327,81,4,4,4,0,2,1,0
41857,51,3,0,0,0,2,0,0
0,0,0,0,0,0,0,0,0
0,0,0,0,0,0,0,0,0
22416,50,0,0,0,0,0,0,0
2706,27,1,2,2,0,0,0,0
0,0,0,0,0,0,0,0,0
0,0,0,0,0,0,0,0,0
0,0,0,0,0,0,0,0,0
77754,101,1,4,2,2,0,0,0
0,0,0,0,0,0,0,0,0
278420,38,2,0,0,0,0,1,0
91676,211,4,0,0,0,1,0,0
0,0,0,0,0,0,0,0,0
12699,82,0,3,3,0,0,0,0
13471,85,0,3,3,0,0,0,0
11506,57,0,7,5,2,0,0,0
0,0,0,0,0,0,0,0,0
0,0,0,0,0,0,0,0,0
0,0,0,0,0,0,0,0,0
14141,117,0,11,6,5,5,1,0
0,0,0,0,0,0,0,0,0
0,0,0,0,0,0,0,0,0
0,0,0,0,0,0,0,0,0
144473,59,4,3,3,0,2,1,0
0,0,0,0,0,0,0,0,0
675949,557,0,4,4,0,2,1,1
43892,64,4,9,9,0,2,0,0
91756,211,4,0,0,0,1,0,0
0,0,0,0,0,0,0,0,0
0,0,0,0,0,0,0,0,0
0,0,0,0,0,0,0,0,0
0,0,0,0,0,0,0,0,0
0,0,0,0,0,0,0,0,0
0,0,0,0,0,0,0,0,0
0,0,0,0,0,0,0,0,0
0,0,0,0,0,0,0,0,0
0,0,0,0,0,0,0,0,0
0,0,0,0,0,0,0,0,0
0,0,0,0,0,0,0,0,0
0,0,0,0,0,0,0,0,0
0,0,0,0,0,0,0,0,0
0,0,0,0,0,0,0,0,0
0,0,0,0,0,0,0,0,0
0,0,0,0,0,0,0,0,0
204915,155,3,2,1,1,18,0,0
204928,155,3,2,1,1,18,0,0
0,0,0,0,0,0,0,0,0
2673,21,2,1,0,1,0,0,0
0,0,0,0,0,0,0,0,0
64984,50,3,0,0,0,0,0,0
0,0,0,0,0,0,0,0,0
91680,211,4,0,0,0,1,0,0
0,0,0,0,0,0,0,0,0
0,0,0,0,0,0,0,0,0
0,0,0,0,0,0,0,0,0
0,0,0,0,0,0,0,0,0
0,0,0,0,0,0,0,0,0
0,0,0,0,0,0,0,0,0
0,0,0,0,0,0,0,0,0
0,0,0,0,0,0,0,0,0
0,0,0,0,0,0,0,0,0
0,0,0,0,0,0,0,0,0
64984,50,3,0,0,0,0,0,0
64984,50,3,0,0,0,0,0,0
0,0,0,0,0,0,0,0,0
0,0,0,0,0,0,0,0,0
0,0,0,0,0,0,0,0,0
0,0,0,0,0,0,0,0,0
0,0,0,0,0,0,0,0,0
13540,142,0,56,51,5,0,0,0
7934,55,6,1,1,0,0,0,0
0,0,0,0,0,0,0,0,0
4131,13,1,0,0,0,0,0,0
0,0,0,0,0,0,0,0,0
0,0,0,0,0,0,0,0,0
0,0,0,0,0,0,0,0,0
0,0,0,0,0,0,0,0,0
28244,134,9,1,1,0,0,0,0
382842,258,5,5,5,0,0,1,0
0,0,0,0,0,0,0,0,0
0,0,0,0,0,0,0,0,0
0,0,0,0,0,0,0,0,0
0,0,0,0,0,0,0,0,0
0,0,0,0,0,0,0,0,0
50581,231,2,2,2,0,1,0,0
50616,231,2,2,2,0,1,0,0
0,0,0,0,0,0,0,0,0
0,0,0,0,0,0,0,0,0
0,0,0,0,0,0,0,0,0
0,0,0,0,0,0,0,0,0
580339,420,4,0,0,0,0,1,0
64996,50,3,0,0,0,0,0,0
0,0,0,0,0,0,0,0,0
2673,21,2,1,0,1,0,0,0
0,0,0,0,0,0,0,0,0
138253,313,3,11,11,0,2,0,0
0,0,0,0,0,0,0,0,0
0,0,0,0,0,0,0,0,0
0,0,0,0,0,0,0,0,0
0,0,0,0,0,0,0,0,0
0,0,0,0,0,0,0,0,0
0,0,0,0,0,0,0,0,0
0,0,0,0,0,0,0,0,0
0,0,0,0,0,0,0,0,0
0,0,0,0,0,0,0,0,0
23291,225,3,24,24,0,0,1,0
0,0,0,0,0,0,0,0,0
0,0,0,0,0,0,0,0,0
0,0,0,0,0,0,0,0,0
672257,542,0,4,4,0,2,1,1
676105,557,0,4,4,0,2,1,1
671831,556,0,4,4,0,2,1,1
674285,556,0,4,4,0,2,1,1
0,0,0,0,0,0,0,0,0
0,0,0,0,0,0,0,0,0
0,0,0,0,0,0,0,0,0
0,0,0,0,0,0,0,0,0
0,0,0,0,0,0,0,0,0
0,0,0,0,0,0,0,0,0
0,0,0,0,0,0,0,0,0
0,0,0,0,0,0,0,0,0
0,0,0,0,0,0,0,0,0
0,0,0,0,0,0,0,0,0
0,0,0,0,0,0,0,0,0
64996,50,3,0,0,0,0,0,0
2673,21,2,1,0,1,0,0,0
0,0,0,0,0,0,0,0,0
0,0,0,0,0,0,0,0,0
20048,52,5,11,10,1,0,0,0
28358,152,6,4,2,2,1,0,0
0,0,0,0,0,0,0,0,0
16966,31,0,1,1,0,0,1,0
0,0,0,0,0,0,0,0,0
0,0,0,0,0,0,0,0,0
0,0,0,0,0,0,0,0,0
0,0,0,0,0,0,0,0,0
675244,557,0,4,4,0,2,1,1
4552,25,0,4,0,4,0,0,0
0,0,0,0,0,0,0,0,0
0,0,0,0,0,0,0,0,0
0,0,0,0,0,0,0,0,0
0,0,0,0,0,0,0,0,0
235226,60,4,1,1,0,2,1,0
0,0,0,0,0,0,0,0,0
0,0,0,0,0,0,0,0,0
235226,60,4,1,1,0,2,1,0
0,0,0,0,0,0,0,0,0
0,0,0,0,0,0,0,0,0
235226,60,4,1,1,0,2,1,0
23492,59,4,3,3,0,2,1,0
337630,58,1,6,3,3,0,0,0
0,0,0,0,0,0,0,0,0
0,0,0,0,0,0,0,0,0
0,0,0,0,0,0,0,0,0
0,0,0,0,0,0,0,0,0
0,0,0,0,0,0,0,0,0
5326,44,4,0,0,0,3,0,0
5326,44,4,0,0,0,3,0,0
5326,44,4,0,0,0,3,0,0
5326,44,4,0,0,0,3,0,0
5326,44,4,0,0,0,3,0,0
2026704,61,4,1,1,0,2,1,0
2026704,61,4,1,1,0,2,1,0
2026704,61,4,1,1,0,2,1,0
0,0,0,0,0,0,0,0,0
35563,172,6,3,1,2,1,0,0
64984,50,3,0,0,0,0,0,0
64984,50,3,0,0,0,0,0,0
0,0,0,0,0,0,0,0,0
77758,101,1,4,2,2,0,0,0
60535,95,0,11,10,1,0,1,0
87905,347,9,24,5,19,4,0,0
0,0,0,0,0,0,0,0,0
0,0,0,0,0,0,0,0,0
0,0,0,0,0,0,0,0,0
0,0,0,0,0,0,0,0,0
0,0,0,0,0,0,0,0,0
0,0,0,0,0,0,0,0,0
0,0,0,0,0,0,0,0,0
0,0,0,0,0,0,0,0,0
7021,30,0,3,0,3,0,1,0
0,0,0,0,0,0,0,0,0
0,0,0,0,0,0,0,0,0
0,0,0,0,0,0,0,0,0
0,0,0,0,0,0,0,0,0
0,0,0,0,0,0,0,0,0
0,0,0,0,0,0,0,0,0
0,0,0,0,0,0,0,0,0
0,0,0,0,0,0,0,0,0
0,0,0,0,0,0,0,0,0
0,0,0,0,0,0,0,0,0
0,0,0,0,0,0,0,0,0
64984,50,3,0,0,0,0,0,0
64984,50,3,0,0,0,0,0,0
0,0,0,0,0,0,0,0,0
0,0,0,0,0,0,0,0,0
0,0,0,0,0,0,0,0,0
0,0,0,0,0,0,0,0,0
0,0,0,0,0,0,0,0,0
0,0,0,0,0,0,0,0,0
181701,82,2,9,3,6,0,1,0
2673,21,2,1,0,1,0,0,0
2673,21,2,1,0,1,0,0,0
2673,21,2,1,0,1,0,0,0
2673,21,2,1,0,1,0,0,0
7314773,213,0,52,51,1,0,1,0
7314773,213,0,52,51,1,0,1,0
10871,33,1,0,0,0,1,0,0
10871,33,1,0,0,0,1,0,0
7314773,213,0,52,51,1,0,1,0
7314773,213,0,52,51,1,0,1,0
7314773,213,0,52,51,1,0,1,0
7314773,213,0,52,51,1,0,1,0
7314773,213,0,52,51,1,0,1,0
0,0,0,0,0,0,0,0,0
645692,99,4,4,4,0,4,1,0
645692,99,4,4,4,0,4,1,0
0,0,0,0,0,0,0,0,0
0,0,0,0,0,0,0,0,0
0,0,0,0,0,0,0,0,0
0,0,0,0,0,0,0,0,0
0,0,0,0,0,0,0,0,0
0,0,0,0,0,0,0,0,0
16116,72,4,0,0,0,0,1,0
16116,72,4,0,0,0,0,1,0
16098,72,4,0,0,0,0,1,0
16098,72,4,0,0,0,0,1,0
16040,72,4,0,0,0,0,1,0
0,0,0,0,0,0,0,0,0
16040,72,4,0,0,0,0,1,0
16040,72,4,0,0,0,0,1,0
0,0,0,0,0,0,0,0,0
0,0,0,0,0,0,0,0,0
0,0,0,0,0,0,0,0,0
0,0,0,0,0,0,0,0,0
0,0,0,0,0,0,0,0,0
0,0,0,0,0,0,0,0,0
0,0,0,0,0,0,0,0,0
0,0,0,0,0,0,0,0,0
0,0,0,0,0,0,0,0,0
4404,25,0,1,0,1,0,0,0
4404,25,0,1,0,1,0,0,0
18718,177,1,24,24,0,2,1,0
18419,174,1,24,24,0,2,1,0
5299,87,0,7,3,4,1,1,0
96324,212,4,0,0,0,1,0,0
0,0,0,0,0,0,0,0,0
0,0,0,0,0,0,0,0,0
0,0,0,0,0,0,0,0,0
0,0,0,0,0,0,0,0,0
0,0,0,0,0,0,0,0,0
0,0,0,0,0,0,0,0,0
0,0,0,0,0,0,0,0,0
64984,50,3,0,0,0,0,0,0
44811,175,2,5,2,3,1,1,0
65042,50,3,0,0,0,0,0,0
91439,211,4,0,0,0,1,0,0
65042,50,3,0,0,0,0,0,0
0,0,0,0,0,0,0,0,0
65042,50,3,0,0,0,0,0,0
0,0,0,0,0,0,0,0,0
0,0,0,0,0,0,0,0,0
11768,60,5,0,0,0,4,1,0
1059553,101,4,5,5,0,3,1,0
0,0,0,0,0,0,0,0,0
65042,50,3,0,0,0,0,0,0
0,0,0,0,0,0,0,0,0
0,0,0,0,0,0,0,0,0
92356,214,4,0,0,0,1,0,0
90924,211,4,0,0,0,1,0,0
0,0,0,0,0,0,0,0,0
0,0,0,0,0,0,0,0,0
0,0,0,0,0,0,0,0,0
0,0,0,0,0,0,0,0,0
0,0,0,0,0,0,0,0,0
1420530,35,4,0,0,0,0,1,0
0,0,0,0,0,0,0,0,0
0,0,0,0,0,0,0,0,0
0,0,0,0,0,0,0,0,0
0,0,0,0,0,0,0,0,0
0,0,0,0,0,0,0,0,0
0,0,0,0,0,0,0,0,0
148190,104,5,3,3,0,3,0,0
0,0,0,0,0,0,0,0,0
0,0,0,0,0,0,0,0,0
0,0,0,0,0,0,0,0,0
0,0,0,0,0,0,0,0,0
0,0,0,0,0,0,0,0,0
0,0,0,0,0,0,0,0,0
65042,50,3,0,0,0,0,0,0
9255,81,1,0,0,0,0,0,0
0,0,0,0,0,0,0,0,0
0,0,0,0,0,0,0,0,0
2673,21,2,1,0,1,0,0,0
4458,25,0,3,2,1,0,0,0
4552,25,0,4,0,4,0,0,0
11267,120,4,12,12,0,0,0,0
0,0,0,0,0,0,0,0,0
11268,120,4,12,12,0,0,0,0
0,0,0,0,0,0,0,0,0
65042,50,3,0,0,0,0,0,0
0,0,0,0,0,0,0,0,0
91445,211,4,0,0,0,1,0,0
0,0,0,0,0,0,0,0,0
0,0,0,0,0,0,0,0,0
0,0,0,0,0,0,0,0,0
0,0,0,0,0,0,0,0,0
671464,556,0,4,4,0,2,1,1
674885,557,0,4,4,0,2,1,1
0,0,0,0,0,0,0,0,0
65042,50,3,0,0,0,0,0,0
134709,314,8,26,24,2,19,1,0
0,0,0,0,0,0,0,0,0
139825,402,8,27,24,3,34,1,0
0,0,0,0,0,0,0,0,0
0,0,0,0,0,0,0,0,0
0,0,0,0,0,0,0,0,0
0,0,0,0,0,0,0,0,0
0,0,0,0,0,0,0,0,0
0,0,0,0,0,0,0,0,0
0,0,0,0,0,0,0,0,0
0,0,0,0,0,0,0,0,0
0,0,0,0,0,0,0,0,0
139776,399,8,26,24,2,34,1,0
0,0,0,0,0,0,0,0,0
0,0,0,0,0,0,0,0,0
253040,29,0,1,1,0,0,0,0
0,0,0,0,0,0,0,0,0
0,0,0,0,0,0,0,0,0
0,0,0,0,0,0,0,0,0
0,0,0,0,0,0,0,0,0
0,0,0,0,0,0,0,0,0
0,0,0,0,0,0,0,0,0
19844,53,3,0,0,0,0,0,0
19844,53,3,0,0,0,0,0,0
19844,53,3,0,0,0,0,0,0
19844,53,3,0,0,0,0,0,0
19844,53,3,0,0,0,0,0,0
19844,53,3,0,0,0,0,0,0
19844,53,3,0,0,0,0,0,0
327105,60,4,3,3,0,2,1,0
327105,60,4,3,3,0,2,1,0
327105,60,4,3,3,0,2,1,0
327105,60,4,3,3,0,2,1,0
327105,60,4,3,3,0,2,1,0
327105,60,4,3,3,0,2,1,0
327105,60,4,3,3,0,2,1,0
6002699,71,5,1,1,0,2,1,0
0,0,0,0,0,0,0,0,0
0,0,0,0,0,0,0,0,0
0,0,0,0,0,0,0,0,0
0,0,0,0,0,0,0,0,0
0,0,0,0,0,0,0,0,0
0,0,0,0,0,0,0,0,0
0,0,0,0,0,0,0,0,0
0,0,0,0,0,0,0,0,0
0,0,0,0,0,0,0,0,0
0,0,0,0,0,0,0,0,0
0,0,0,0,0,0,0,0,0
0,0,0,0,0,0,0,0,0
0,0,0,0,0,0,0,0,0
0,0,0,0,0,0,0,0,0
0,0,0,0,0,0,0,0,0
332514,60,4,3,3,0,2,1,0
135979,42,4,1,1,0,2,0,0
135979,42,4,1,1,0,2,0,0
135979,42,4,1,1,0,2,0,0
135979,42,4,1,1,0,2,0,0
135979,42,4,1,1,0,2,0,0
0,0,0,0,0,0,0,0,0
0,0,0,0,0,0,0,0,0
51270,140,4,1,0,1,4,0,0
51277,140,4,1,0,1,4,0,0
44003,95,4,0,0,0,2,0,0
51284,140,4,1,0,1,4,0,0
48365,142,4,1,0,1,3,0,0
11368,33,1,0,0,0,1,0,0
0,0,0,0,0,0,0,0,0
0,0,0,0,0,0,0,0,0
0,0,0,0,0,0,0,0,0
0,0,0,0,0,0,0,0,0
0,0,0,0,0,0,0,0,0
225815,119,0,15,6,9,0,1,0
225815,119,0,15,6,9,0,1,0
225815,119,0,15,6,9,0,1,0
225815,119,0,15,6,9,0,1,0
225815,119,0,15,6,9,0,1,0
225815,119,0,15,6,9,0,1,0
0,0,0,0,0,0,0,0,0
0,0,0,0,0,0,0,0,0
0,0,0,0,0,0,0,0,0
0,0,0,0,0,0,0,0,0
0,0,0,0,0,0,0,0,0
0,0,0,0,0,0,0,0,0
25114,67,2,1,1,0,2,0,0
0,0,0,0,0,0,0,0,0
0,0,0,0,0,0,0,0,0
0,0,0,0,0,0,0,0,0
0,0,0,0,0,0,0,0,0
0,0,0,0,0,0,0,0,0
0,0,0,0,0,0,0,0,0
0,0,0,0,0,0,0,0,0
0,0,0,0,0,0,0,0,0
0,0,0,0,0,0,0,0,0
0,0,0,0,0,0,0,0,0
0,0,0,0,0,0,0,0,0
0,0,0,0,0,0,0,0,0
36190,50,2,0,0,0,2,0,0
19790,66,0,1,0,1,2,1,0
0,0,0,0,0,0,0,0,0
5031,53,2,0,0,0,0,0,0
28292,160,6,4,2,2,1,0,0
40227,299,5,1,0,1,1,0,0
102665,76,4,6,6,0,5,1,0
0,0,0,0,0,0,0,0,0
0,0,0,0,0,0,0,0,0
9255,81,1,0,0,0,0,0,0
0,0,0,0,0,0,0,0,0
0,0,0,0,0,0,0,0,0
0,0,0,0,0,0,0,0,0
94025,295,1,0,0,0,1,0,0
0,0,0,0,0,0,0,0,0
95111,895,3,142,76,66,2,0,0
0,0,0,0,0,0,0,0,0
0,0,0,0,0,0,0,0,0
0,0,0,0,0,0,0,0,0
0,0,0,0,0,0,0,0,0
0,0,0,0,0,0,0,0,0
328,6,4,0,0,0,0,0,0
65042,50,3,0,0,0,0,0,0
0,0,0,0,0,0,0,0,0
0,0,0,0,0,0,0,0,0
0,0,0,0,0,0,0,0,0
0,0,0,0,0,0,0,0,0
0,0,0,0,0,0,0,0,0
0,0,0,0,0,0,0,0,0
0,0,0,0,0,0,0,0,0
0,0,0,0,0,0,0,0,0
0,0,0,0,0,0,0,0,0
139205,400,8,26,24,2,34,1,0
0,0,0,0,0,0,0,0,0
0,0,0,0,0,0,0,0,0
0,0,0,0,0,0,0,0,0
0,0,0,0,0,0,0,0,0
0,0,0,0,0,0,0,0,0
0,0,0,0,0,0,0,0,0
0,0,0,0,0,0,0,0,0
0,0,0,0,0,0,0,0,0
0,0,0,0,0,0,0,0,0
2673,21,2,1,0,1,0,0,0
0,0,0,0,0,0,0,0,0
2673,21,2,1,0,1,0,0,0
0,0,0,0,0,0,0,0,0
0,0,0,0,0,0,0,0,0
134669,312,8,26,24,2,19,1,0
65042,50,3,0,0,0,0,0,0
47607,209,2,3,1,2,1,0,0
40405,75,1,0,0,0,0,1,0
0,0,0,0,0,0,0,0,0
0,0,0,0,0,0,0,0,0
0,0,0,0,0,0,0,0,0
0,0,0,0,0,0,0,0,0
0,0,0,0,0,0,0,0,0
679889,556,0,4,2,2,2,1,1
0,0,0,0,0,0,0,0,0
0,0,0,0,0,0,0,0,0
0,0,0,0,0,0,0,0,0
0,0,0,0,0,0,0,0,0
2673,21,2,1,0,1,0,0,0
2673,21,2,1,0,1,0,0,0
0,0,0,0,0,0,0,0,0
0,0,0,0,0,0,0,0,0
0,0,0,0,0,0,0,0,0
2673,21,2,1,0,1,0,0,0
0,0,0,0,0,0,0,0,0
0,0,0,0,0,0,0,0,0
0,0,0,0,0,0,0,0,0
0,0,0,0,0,0,0,0,0
15909,339,4,31,28,3,0,1,0
0,0,0,0,0,0,0,0,0
9187,28,1,2,2,0,0,0,0
0,0,0,0,0,0,0,0,0
9183,28,1,2,2,0,0,0,0
23291,225,3,24,24,0,0,1,0
0,0,0,0,0,0,0,0,0
0,0,0,0,0,0,0,0,0
673432,556,0,4,4,0,2,1,1
9183,28,1,2,2,0,0,0,0
0,0,0,0,0,0,0,0,0
674667,557,0,4,4,0,2,1,1
673991,556,0,4,4,0,2,1,1
306572,189,4,1,1,0,0,1,0
0,0,0,0,0,0,0,0,0
307506,196,6,1,1,0,0,1,0
0,0,0,0,0,0,0,0,0
0,0,0,0,0,0,0,0,0
0,0,0,0,0,0,0,0,0
0,0,0,0,0,0,0,0,0
0,0,0,0,0,0,0,0,0
314623,276,4,1,1,0,0,1,0
306503,189,4,1,1,0,0,1,0
0,0,0,0,0,0,0,0,0
0,0,0,0,0,0,0,0,0
0,0,0,0,0,0,0,0,0
0,0,0,0,0,0,0,0,0
0,0,0,0,0,0,0,0,0
0,0,0,0,0,0,0,0,0
0,0,0,0,0,0,0,0,0
280583,233,6,1,1,0,0,1,0
0,0,0,0,0,0,0,0,0
356491,177,4,1,1,0,0,1,0
23291,225,3,24,24,0,0,1,0
23291,225,3,24,24,0,0,1,0
0,0,0,0,0,0,0,0,0
0,0,0,0,0,0,0,0,0
0,0,0,0,0,0,0,0,0
0,0,0,0,0,0,0,0,0
0,0,0,0,0,0,0,0,0
0,0,0,0,0,0,0,0,0
0,0,0,0,0,0,0,0,0
0,0,0,0,0,0,0,0,0
0,0,0,0,0,0,0,0,0
0,0,0,0,0,0,0,0,0
672760,553,0,4,0,4,2,1,1
0,0,0,0,0,0,0,0,0
0,0,0,0,0,0,0,0,0
0,0,0,0,0,0,0,0,0
0,0,0,0,0,0,0,0,0
31754,52,2,0,0,0,0,0,0
31754,52,2,0,0,0,0,0,0
0,0,0,0,0,0,0,0,0
0,0,0,0,0,0,0,0,0
42836,48,2,0,0,0,2,0,0
42836,48,2,0,0,0,2,0,0
31754,52,2,0,0,0,0,0,0
42836,48,2,0,0,0,2,0,0
25121,67,2,1,1,0,2,0,0
16632,63,4,9,9,0,2,0,0
16632,63,4,9,9,0,2,0,0
0,0,0,0,0,0,0,0,0
16632,63,4,9,9,0,2,0,0
0,0,0,0,0,0,0,0,0
25121,67,2,1,1,0,2,0,0
198495,49,3,0,0,0,0,0,0
0,0,0,0,0,0,0,0,0
0,0,0,0,0,0,0,0,0
0,0,0,0,0,0,0,0,0
0,0,0,0,0,0,0,0,0
0,0,0,0,0,0,0,0,0
0,0,0,0,0,0,0,0,0
0,0,0,0,0,0,0,0,0
0,0,0,0,0,0,0,0,0
0,0,0,0,0,0,0,0,0
0,0,0,0,0,0,0,0,0
0,0,0,0,0,0,0,0,0
0,0,0,0,0,0,0,0,0
0,0,0,0,0,0,0,0,0
0,0,0,0,0,0,0,0,0
0,0,0,0,0,0,0,0,0
0,0,0,0,0,0,0,0,0
0,0,0,0,0,0,0,0,0
0,0,0,0,0,0,0,0,0
0,0,0,0,0,0,0,0,0
0,0,0,0,0,0,0,0,0
0,0,0,0,0,0,0,0,0
0,0,0,0,0,0,0,0,0
0,0,0,0,0,0,0,0,0
0,0,0,0,0,0,0,0,0
0,0,0,0,0,0,0,0,0
0,0,0,0,0,0,0,0,0
0,0,0,0,0,0,0,0,0
0,0,0,0,0,0,0,0,0
0,0,0,0,0,0,0,0,0
0,0,0,0,0,0,0,0,0
0,0,0,0,0,0,0,0,0
0,0,0,0,0,0,0,0,0
0,0,0,0,0,0,0,0,0
0,0,0,0,0,0,0,0,0
0,0,0,0,0,0,0,0,0
0,0,0,0,0,0,0,0,0
0,0,0,0,0,0,0,0,0
0,0,0,0,0,0,0,0,0
0,0,0,0,0,0,0,0,0
0,0,0,0,0,0,0,0,0
0,0,0,0,0,0,0,0,0
0,0,0,0,0,0,0,0,0
0,0,0,0,0,0,0,0,0
0,0,0,0,0,0,0,0,0
0,0,0,0,0,0,0,0,0
332514,60,4,3,3,0,2,1,0
332514,60,4,3,3,0,2,1,0
12383,72,4,0,0,0,0,1,0
12383,72,4,0,0,0,0,1,0
420882,62,4,3,3,0,2,1,0
0,0,0,0,0,0,0,0,0
0,0,0,0,0,0,0,0,0
12383,72,4,0,0,0,0,1,0
12383,72,4,0,0,0,0,1,0
12383,72,4,0,0,0,0,1,0
12383,72,4,0,0,0,0,1,0
12383,72,4,0,0,0,0,1,0
0,0,0,0,0,0,0,0,0
0,0,0,0,0,0,0,0,0
0,0,0,0,0,0,0,0,0
0,0,0,0,0,0,0,0,0
0,0,0,0,0,0,0,0,0
0,0,0,0,0,0,0,0,0
0,0,0,0,0,0,0,0,0
0,0,0,0,0,0,0,0,0
0,0,0,0,0,0,0,0,0
0,0,0,0,0,0,0,0,0
0,0,0,0,0,0,0,0,0
991073,60,3,0,0,0,2,1,0
95142,220,5,0,0,0,4,0,0
0,0,0,0,0,0,0,0,0
0,0,0,0,0,0,0,0,0
34963,193,5,13,9,4,1,0,0
0,0,0,0,0,0,0,0,0
0,0,0,0,0,0,0,0,0
0,0,0,0,0,0,0,0,0
508521,48,2,2,2,0,2,0,0
0,0,0,0,0,0,0,0,0
0,0,0,0,0,0,0,0,0
291400,173,4,1,1,0,0,1,0
383600,187,4,1,1,0,0,1,0
0,0,0,0,0,0,0,0,0
0,0,0,0,0,0,0,0,0
0,0,0,0,0,0,0,0,0
118278,195,1,4,1,3,0,0,0
0,0,0,0,0,0,0,0,0
0,0,0,0,0,0,0,0,0
0,0,0,0,0,0,0,0,0
0,0,0,0,0,0,0,0,0
0,0,0,0,0,0,0,0,0
0,0,0,0,0,0,0,0,0
0,0,0,0,0,0,0,0,0
0,0,0,0,0,0,0,0,0
0,0,0,0,0,0,0,0,0
0,0,0,0,0,0,0,0,0
0,0,0,0,0,0,0,0,0
0,0,0,0,0,0,0,0,0
0,0,0,0,0,0,0,0,0
0,0,0,0,0,0,0,0,0
0,0,0,0,0,0,0,0,0
0,0,0,0,0,0,0,0,0
48822,319,6,1,1,0,1,0,0
48822,319,6,1,1,0,1,0,0
0,0,0,0,0,0,0,0,0
0,0,0,0,0,0,0,0,0
0,0,0,0,0,0,0,0,0
0,0,0,0,0,0,0,0,0
0,0,0,0,0,0,0,0,0
0,0,0,0,0,0,0,0,0
0,0,0,0,0,0,0,0,0
0,0,0,0,0,0,0,0,0
0,0,0,0,0,0,0,0,0
0,0,0,0,0,0,0,0,0
0,0,0,0,0,0,0,0,0
0,0,0,0,0,0,0,0,0
0,0,0,0,0,0,0,0,0
0,0,0,0,0,0,0,0,0
0,0,0,0,0,0,0,0,0
0,0,0,0,0,0,0,0,0
0,0,0,0,0,0,0,0,0
0,0,0,0,0,0,0,0,0
0,0,0,0,0,0,0,0,0
0,0,0,0,0,0,0,0,0
0,0,0,0,0,0,0,0,0
0,0,0,0,0,0,0,0,0
0,0,0,0,0,0,0,0,0
0,0,0,0,0,0,0,0,0
0,0,0,0,0,0,0,0,0
0,0,0,0,0,0,0,0,0
0,0,0,0,0,0,0,0,0
0,0,0,0,0,0,0,0,0
65042,50,3,0,0,0,0,0,0
0,0,0,0,0,0,0,0,0
0,0,0,0,0,0,0,0,0
65042,50,3,0,0,0,0,0,0
65042,50,3,0,0,0,0,0,0
0,0,0,0,0,0,0,0,0
65042,50,3,0,0,0,0,0,0
65042,50,3,0,0,0,0,0,0
65042,50,3,0,0,0,0,0,0
0,0,0,0,0,0,0,0,0
9196,28,1,2,2,0,0,0,0
0,0,0,0,0,0,0,0,0
0,0,0,0,0,0,0,0,0
0,0,0,0,0,0,0,0,0
0,0,0,0,0,0,0,0,0
35800,61,3,3,3,0,2,0,0
0,0,0,0,0,0,0,0,0
65042,50,3,0,0,0,0,0,0
133298,369,5,26,24,2,22,1,0
0,0,0,0,0,0,0,0,0
76385,161,2,18,16,2,1,1,0
0,0,0,0,0,0,0,0,0
0,0,0,0,0,0,0,0,0
2673,21,2,1,0,1,0,0,0
65042,50,3,0,0,0,0,0,0
672369,556,0,4,4,0,2,1,1
0,0,0,0,0,0,0,0,0
65042,50,3,0,0,0,0,0,0
0,0,0,0,0,0,0,0,0
0,0,0,0,0,0,0,0,0
23291,225,3,24,24,0,0,1,0
46497,185,2,5,1,4,1,1,0
0,0,0,0,0,0,0,0,0
9186,28,1,2,2,0,0,0,0
0,0,0,0,0,0,0,0,0
0,0,0,0,0,0,0,0,0
0,0,0,0,0,0,0,0,0
0,0,0,0,0,0,0,0,0
0,0,0,0,0,0,0,0,0
0,0,0,0,0,0,0,0,0
23291,225,3,24,24,0,0,1,0
10686,162,7,26,17,9,0,1,0
9180,28,1,2,2,0,0,0,0
2673,21,2,1,0,1,0,0,0
0,0,0,0,0,0,0,0,0
0,0,0,0,0,0,0,0,0
65042,50,3,0,0,0,0,0,0
0,0,0,0,0,0,0,0,0
0,0,0,0,0,0,0,0,0
67445,312,11,27,21,6,2,1,0
0,0,0,0,0,0,0,0,0
0,0,0,0,0,0,0,0,0
25758,379,2,48,45,3,0,1,0
0,0,0,0,0,0,0,0,0
0,0,0,0,0,0,0,0,0
0,0,0,0,0,0,0,0,0
247263,170,6,1,1,0,0,1,0
44375,405,9,24,23,1,1,1,0
0,0,0,0,0,0,0,0,0
0,0,0,0,0,0,0,0,0
0,0,0,0,0,0,0,0,0
0,0,0,0,0,0,0,0,0
0,0,0,0,0,0,0,0,0
0,0,0,0,0,0,0,0,0
0,0,0,0,0,0,0,0,0
0,0,0,0,0,0,0,0,0
0,0,0,0,0,0,0,0,0
0,0,0,0,0,0,0,0,0
0,0,0,0,0,0,0,0,0
0,0,0,0,0,0,0,0,0
0,0,0,0,0,0,0,0,0
0,0,0,0,0,0,0,0,0
0,0,0,0,0,0,0,0,0
160090,43,2,3,2,1,0,0,0
0,0,0,0,0,0,0,0,0
5993591,71,5,1,1,0,2,1,0
145844,58,5,3,3,0,2,1,0
145844,58,5,3,3,0,2,1,0
145844,58,5,3,3,0,2,1,0
0,0,0,0,0,0,0,0,0
0,0,0,0,0,0,0,0,0
0,0,0,0,0,0,0,0,0
0,0,0,0,0,0,0,0,0
0,0,0,0,0,0,0,0,0
0,0,0,0,0,0,0,0,0
0,0,0,0,0,0,0,0,0
0,0,0,0,0,0,0,0,0
0,0,0,0,0,0,0,0,0
0,0,0,0,0,0,0,0,0
0,0,0,0,0,0,0,0,0
0,0,0,0,0,0,0,0,0
0,0,0,0,0,0,0,0,0
6760,30,2,0,0,0,1,0,0
0,0,0,0,0,0,0,0,0
0,0,0,0,0,0,0,0,0
6760,30,2,0,0,0,1,0,0
0,0,0,0,0,0,0,0,0
0,0,0,0,0,0,0,0,0
0,0,0,0,0,0,0,0,0
0,0,0,0,0,0,0,0,0
0,0,0,0,0,0,0,0,0
0,0,0,0,0,0,0,0,0
0,0,0,0,0,0,0,0,0
0,0,0,0,0,0,0,0,0
0,0,0,0,0,0,0,0,0
0,0,0,0,0,0,0,0,0
0,0,0,0,0,0,0,0,0
0,0,0,0,0,0,0,0,0
0,0,0,0,0,0,0,0,0
0,0,0,0,0,0,0,0,0
0,0,0,0,0,0,0,0,0
0,0,0,0,0,0,0,0,0
0,0,0,0,0,0,0,0,0
0,0,0,0,0,0,0,0,0
0,0,0,0,0,0,0,0,0
0,0,0,0,0,0,0,0,0
0,0,0,0,0,0,0,0,0
1110415,60,4,3,3,0,2,1,0
105115,739,2,180,15,165,1,0,0
104603,735,2,179,14,165,1,0,0
0,0,0,0,0,0,0,0,0
104583,735,2,179,14,165,1,0,0
104027,731,2,179,14,165,1,0,0
104215,732,2,179,14,165,1,0,0
104524,734,2,179,14,165,1,0,0
0,0,0,0,0,0,0,0,0
0,0,0,0,0,0,0,0,0
104603,735,2,179,14,165,1,0,0
0,0,0,0,0,0,0,0,0
0,0,0,0,0,0,0,0,0
0,0,0,0,0,0,0,0,0
0,0,0,0,0,0,0,0,0
0,0,0,0,0,0,0,0,0
1166255,13514,3,2355,2351,4,9,1,0
2897,38,2,0,0,0,0,0,0
94459,220,5,0,0,0,4,0,0
91484,211,4,0,0,0,1,0,0
65042,50,3,0,0,0,0,0,0
0,0,0,0,0,0,0,0,0
0,0,0,0,0,0,0,0,0
0,0,0,0,0,0,0,0,0
47889,76,2,1,1,0,3,1,0
263092,100,4,5,5,0,3,1,0
20286,251,3,65,63,2,1,1,0
508524,48,2,2,2,0,2,0,0
0,0,0,0,0,0,0,0,0
9045,78,1,0,0,0,0,0,0
0,0,0,0,0,0,0,0,0
0,0,0,0,0,0,0,0,0
0,0,0,0,0,0,0,0,0
0,0,0,0,0,0,0,0,0
0,0,0,0,0,0,0,0,0
0,0,0,0,0,0,0,0,0
65042,50,3,0,0,0,0,0,0
0,0,0,0,0,0,0,0,0
0,0,0,0,0,0,0,0,0
0,0,0,0,0,0,0,0,0
0,0,0,0,0,0,0,0,0
0,0,0,0,0,0,0,0,0
0,0,0,0,0,0,0,0,0
10353,83,1,0,0,0,0,0,0
65042,50,3,0,0,0,0,0,0
65042,50,3,0,0,0,0,0,0
65042,50,3,0,0,0,0,0,0
0,0,0,0,0,0,0,0,0
0,0,0,0,0,0,0,0,0
0,0,0,0,0,0,0,0,0
0,0,0,0,0,0,0,0,0
0,0,0,0,0,0,0,0,0
2146,33,0,4,4,0,0,1,0
668750,542,0,4,4,0,2,1,1
65042,50,3,0,0,0,0,0,0
65030,50,3,0,0,0,0,0,0
0,0,0,0,0,0,0,0,0
2673,21,2,1,0,1,0,0,0
2673,21,2,1,0,1,0,0,0
10465,83,1,0,0,0,0,0,0
0,0,0,0,0,0,0,0,0
0,0,0,0,0,0,0,0,0
0,0,0,0,0,0,0,0,0
0,0,0,0,0,0,0,0,0
65042,50,3,0,0,0,0,0,0
16105,205,3,17,14,3,0,0,0
0,0,0,0,0,0,0,0,0
0,0,0,0,0,0,0,0,0
292174,186,4,1,1,0,0,1,0
294914,193,4,3,1,2,0,1,0
23291,225,3,24,24,0,0,1,0
0,0,0,0,0,0,0,0,0
0,0,0,0,0,0,0,0,0
140054,400,8,26,24,2,35,1,0
9255,116,4,23,19,4,2,0,0
0,0,0,0,0,0,0,0,0
0,0,0,0,0,0,0,0,0
0,0,0,0,0,0,0,0,0
39338,254,9,41,39,2,8,1,0
0,0,0,0,0,0,0,0,0
0,0,0,0,0,0,0,0,0
0,0,0,0,0,0,0,0,0
416253,450,2,35,1,34,1,1,0
0,0,0,0,0,0,0,0,0
12985,97,0,3,3,0,0,0,0
8106,46,1,1,0,1,0,1,0
0,0,0,0,0,0,0,0,0
64931,49,3,0,0,0,0,0,0
0,0,0,0,0,0,0,0,0
0,0,0,0,0,0,0,0,0
0,0,0,0,0,0,0,0,0
0,0,0,0,0,0,0,0,0
0,0,0,0,0,0,0,0,0
0,0,0,0,0,0,0,0,0
0,0,0,0,0,0,0,0,0
0,0,0,0,0,0,0,0,0
0,0,0,0,0,0,0,0,0
17548,142,0,56,51,5,0,0,0
0,0,0,0,0,0,0,0,0
669744,553,0,4,0,4,2,1,1
170159,172,0,6,2,4,1,1,1
671392,553,0,4,0,4,2,1,1
0,0,0,0,0,0,0,0,0
169391,172,0,6,2,4,1,1,1
670992,553,0,4,0,4,2,1,1
0,0,0,0,0,0,0,0,0
673083,553,0,4,0,4,2,1,1
0,0,0,0,0,0,0,0,0
0,0,0,0,0,0,0,0,0
0,0,0,0,0,0,0,0,0
0,0,0,0,0,0,0,0,0
0,0,0,0,0,0,0,0,0
0,0,0,0,0,0,0,0,0
673165,553,0,4,0,4,2,1,1
135020,717,17,86,71,15,2,0,0
10908,77,2,6,5,1,0,0,0
2781,24,1,3,0,3,0,0,0
65042,50,3,0,0,0,0,0,0
0,0,0,0,0,0,0,0,0
0,0,0,0,0,0,0,0,0
0,0,0,0,0,0,0,0,0
0,0,0,0,0,0,0,0,0
0,0,0,0,0,0,0,0,0
0,0,0,0,0,0,0,0,0
0,0,0,0,0,0,0,0,0
0,0,0,0,0,0,0,0,0
36126,257,10,10,10,0,0,1,0
0,0,0,0,0,0,0,0,0
0,0,0,0,0,0,0,0,0
0,0,0,0,0,0,0,0,0
0,0,0,0,0,0,0,0,0
0,0,0,0,0,0,0,0,0
0,0,0,0,0,0,0,0,0
0,0,0,0,0,0,0,0,0
0,0,0,0,0,0,0,0,0
0,0,0,0,0,0,0,0,0
0,0,0,0,0,0,0,0,0
0,0,0,0,0,0,0,0,0
0,0,0,0,0,0,0,0,0
0,0,0,0,0,0,0,0,0
0,0,0,0,0,0,0,0,0
0,0,0,0,0,0,0,0,0
0,0,0,0,0,0,0,0,0
675993,557,0,4,4,0,2,1,1
0,0,0,0,0,0,0,0,0
0,0,0,0,0,0,0,0,0
0,0,0,0,0,0,0,0,0
0,0,0,0,0,0,0,0,0
0,0,0,0,0,0,0,0,0
0,0,0,0,0,0,0,0,0
0,0,0,0,0,0,0,0,0
0,0,0,0,0,0,0,0,0
0,0,0,0,0,0,0,0,0
0,0,0,0,0,0,0,0,0
0,0,0,0,0,0,0,0,0
0,0,0,0,0,0,0,0,0
0,0,0,0,0,0,0,0,0
0,0,0,0,0,0,0,0,0
437455,53,2,1,1,0,0,1,0
36606,56,2,0,0,0,2,0,0
36606,56,2,0,0,0,2,0,0
0,0,0,0,0,0,0,0,0
685701,4,0,0,0,0,0,0,0
0,0,0,0,0,0,0,0,0
56035,62,5,1,1,0,0,0,0
0,0,0,0,0,0,0,0,0
0,0,0,0,0,0,0,0,0
0,0,0,0,0,0,0,0,0
0,0,0,0,0,0,0,0,0
0,0,0,0,0,0,0,0,0
0,0,0,0,0,0,0,0,0
0,0,0,0,0,0,0,0,0
0,0,0,0,0,0,0,0,0
56035,62,5,1,1,0,0,0,0
36606,56,2,0,0,0,2,0,0
0,0,0,0,0,0,0,0,0
0,0,0,0,0,0,0,0,0
0,0,0,0,0,0,0,0,0
11784,99,2,0,0,0,2,0,0
11784,99,2,0,0,0,2,0,0
685701,4,0,0,0,0,0,0,0
685701,4,0,0,0,0,0,0,0
0,0,0,0,0,0,0,0,0
0,0,0,0,0,0,0,0,0
0,0,0,0,0,0,0,0,0
0,0,0,0,0,0,0,0,0
0,0,0,0,0,0,0,0,0
0,0,0,0,0,0,0,0,0
0,0,0,0,0,0,0,0,0
0,0,0,0,0,0,0,0,0
36606,56,2,0,0,0,2,0,0
0,0,0,0,0,0,0,0,0
685701,4,0,0,0,0,0,0,0
0,0,0,0,0,0,0,0,0
0,0,0,0,0,0,0,0,0
0,0,0,0,0,0,0,0,0
0,0,0,0,0,0,0,0,0
0,0,0,0,0,0,0,0,0
0,0,0,0,0,0,0,0,0
0,0,0,0,0,0,0,0,0
0,0,0,0,0,0,0,0,0
0,0,0,0,0,0,0,0,0
36606,56,2,0,0,0,2,0,0
36606,56,2,0,0,0,2,0,0
0,0,0,0,0,0,0,0,0
0,0,0,0,0,0,0,0,0
0,0,0,0,0,0,0,0,0
0,0,0,0,0,0,0,0,0
56035,62,5,1,1,0,0,0,0
56035,62,5,1,1,0,0,0,0
0,0,0,0,0,0,0,0,0
0,0,0,0,0,0,0,0,0
36606,56,2,0,0,0,2,0,0
0,0,0,0,0,0,0,0,0
0,0,0,0,0,0,0,0,0
0,0,0,0,0,0,0,0,0
0,0,0,0,0,0,0,0,0
0,0,0,0,0,0,0,0,0
0,0,0,0,0,0,0,0,0
0,0,0,0,0,0,0,0,0
0,0,0,0,0,0,0,0,0
0,0,0,0,0,0,0,0,0
65042,50,3,0,0,0,0,0,0
0,0,0,0,0,0,0,0,0
0,0,0,0,0,0,0,0,0
0,0,0,0,0,0,0,0,0
436891,52,2,1,1,0,0,1,0
436891,52,2,1,1,0,0,1,0
11784,99,2,0,0,0,2,0,0
11784,99,2,0,0,0,2,0,0
11784,99,2,0,0,0,2,0,0
0,0,0,0,0,0,0,0,0
0,0,0,0,0,0,0,0,0
0,0,0,0,0,0,0,0,0
95566,220,5,0,0,0,4,0,0
0,0,0,0,0,0,0,0,0
0,0,0,0,0,0,0,0,0
0,0,0,0,0,0,0,0,0
460223,76,2,1,1,0,3,1,0
0,0,0,0,0,0,0,0,0
0,0,0,0,0,0,0,0,0
280221,187,4,1,1,0,0,1,0
65042,50,3,0,0,0,0,0,0
0,0,0,0,0,0,0,0,0
65042,50,3,0,0,0,0,0,0
0,0,0,0,0,0,0,0,0
0,0,0,0,0,0,0,0,0
3385,41,0,6,0,6,0,0,0
0,0,0,0,0,0,0,0,0
0,0,0,0,0,0,0,0,0
0,0,0,0,0,0,0,0,0
0,0,0,0,0,0,0,0,0
2781,24,1,3,0,3,0,0,0
65042,50,3,0,0,0,0,0,0
65042,50,3,0,0,0,0,0,0
65042,50,3,0,0,0,0,0,0
73353,367,14,55,44,11,6,1,0
0,0,0,0,0,0,0,0,0
0,0,0,0,0,0,0,0,0
0,0,0,0,0,0,0,0,0
0,0,0,0,0,0,0,0,0
0,0,0,0,0,0,0,0,0
0,0,0,0,0,0,0,0,0
0,0,0,0,0,0,0,0,0
0,0,0,0,0,0,0,0,0
0,0,0,0,0,0,0,0,0
0,0,0,0,0,0,0,0,0
0,0,0,0,0,0,0,0,0
0,0,0,0,0,0,0,0,0
0,0,0,0,0,0,0,0,0
0,0,0,0,0,0,0,0,0
0,0,0,0,0,0,0,0,0
23291,225,3,24,24,0,0,1,0
0,0,0,0,0,0,0,0,0
0,0,0,0,0,0,0,0,0
0,0,0,0,0,0,0,0,0
0,0,0,0,0,0,0,0,0
0,0,0,0,0,0,0,0,0
0,0,0,0,0,0,0,0,0
0,0,0,0,0,0,0,0,0
379058,236,5,2,0,2,2,0,0
283208,197,4,1,1,0,0,1,0
0,0,0,0,0,0,0,0,0
0,0,0,0,0,0,0,0,0
0,0,0,0,0,0,0,0,0
0,0,0,0,0,0,0,0,0
671395,542,0,4,4,0,2,1,1
0,0,0,0,0,0,0,0,0
0,0,0,0,0,0,0,0,0
0,0,0,0,0,0,0,0,0
0,0,0,0,0,0,0,0,0
0,0,0,0,0,0,0,0,0
0,0,0,0,0,0,0,0,0
0,0,0,0,0,0,0,0,0
55972,282,2,3,2,1,1,1,0
674373,556,0,4,4,0,2,1,1
6295,40,4,0,0,0,2,1,0
0,0,0,0,0,0,0,0,0
0,0,0,0,0,0,0,0,0
0,0,0,0,0,0,0,0,0
0,0,0,0,0,0,0,0,0
0,0,0,0,0,0,0,0,0
0,0,0,0,0,0,0,0,0
0,0,0,0,0,0,0,0,0
0,0,0,0,0,0,0,0,0
0,0,0,0,0,0,0,0,0
0,0,0,0,0,0,0,0,0
0,0,0,0,0,0,0,0,0
0,0,0,0,0,0,0,0,0
0,0,0,0,0,0,0,0,0
137342,386,6,27,24,3,23,1,0
0,0,0,0,0,0,0,0,0
0,0,0,0,0,0,0,0,0
0,0,0,0,0,0,0,0,0
0,0,0,0,0,0,0,0,0
0,0,0,0,0,0,0,0,0
0,0,0,0,0,0,0,0,0
6330,64,2,6,4,2,0,1,0
23291,225,3,24,24,0,0,1,0
0,0,0,0,0,0,0,0,0
8412,53,3,1,1,0,4,0,0
8412,53,3,1,1,0,4,0,0
8412,53,3,1,1,0,4,0,0
8412,53,3,1,1,0,4,0,0
8412,53,3,1,1,0,4,0,0
0,0,0,0,0,0,0,0,0
73547,371,8,22,1,21,1,1,0
0,0,0,0,0,0,0,0,0
0,0,0,0,0,0,0,0,0
0,0,0,0,0,0,0,0,0
46971,139,2,1,0,1,0,1,0
0,0,0,0,0,0,0,0,0
87359,66,0,9,4,5,5,0,0
87673,66,0,9,4,5,5,0,0
0,0,0,0,0,0,0,0,0
0,0,0,0,0,0,0,0,0
0,0,0,0,0,0,0,0,0
0,0,0,0,0,0,0,0,0
0,0,0,0,0,0,0,0,0
0,0,0,0,0,0,0,0,0
0,0,0,0,0,0,0,0,0
3105,23,2,1,0,1,0,0,0
0,0,0,0,0,0,0,0,0
2443,18,1,0,0,0,0,0,0
0,0,0,0,0,0,0,0,0
0,0,0,0,0,0,0,0,0
0,0,0,0,0,0,0,0,0
671814,556,0,4,4,0,2,1,1
52710,200,1,6,4,2,0,0,0
0,0,0,0,0,0,0,0,0
0,0,0,0,0,0,0,0,0
0,0,0,0,0,0,0,0,0
65041,50,3,0,0,0,0,0,0
0,0,0,0,0,0,0,0,0
65042,50,3,0,0,0,0,0,0
2673,21,2,1,0,1,0,0,0
65042,50,3,0,0,0,0,0,0
65042,50,3,0,0,0,0,0,0
2146,33,0,4,4,0,0,1,0
65042,50,3,0,0,0,0,0,0
0,0,0,0,0,0,0,0,0
674126,556,0,4,4,0,2,1,1
65042,50,3,0,0,0,0,0,0
65042,50,3,0,0,0,0,0,0
65042,50,3,0,0,0,0,0,0
65042,50,3,0,0,0,0,0,0
34055,52,3,0,0,0,2,0,0
34055,52,3,0,0,0,2,0,0
34055,52,3,0,0,0,2,0,0
0,0,0,0,0,0,0,0,0
0,0,0,0,0,0,0,0,0
0,0,0,0,0,0,0,0,0
0,0,0,0,0,0,0,0,0
0,0,0,0,0,0,0,0,0
0,0,0,0,0,0,0,0,0
0,0,0,0,0,0,0,0,0
0,0,0,0,0,0,0,0,0
0,0,0,0,0,0,0,0,0
0,0,0,0,0,0,0,0,0
2673,21,2,1,0,1,0,0,0
0,0,0,0,0,0,0,0,0
0,0,0,0,0,0,0,0,0
30463,99,2,1,1,0,0,0,0
20275,49,2,1,1,0,0,0,0
0,0,0,0,0,0,0,0,0
110186,55,1,0,0,0,0,0,0
8969,105,2,13,8,5,0,1,0
8993,105,2,13,8,5,0,1,0
2673,21,2,1,0,1,0,0,0
0,0,0,0,0,0,0,0,0
0,0,0,0,0,0,0,0,0
0,0,0,0,0,0,0,0,0
46057,190,2,7,4,3,1,1,0
65042,50,3,0,0,0,0,0,0
0,0,0,0,0,0,0,0,0
0,0,0,0,0,0,0,0,0
0,0,0,0,0,0,0,0,0
0,0,0,0,0,0,0,0,0
0,0,0,0,0,0,0,0,0
65041,50,3,0,0,0,0,0,0
0,0,0,0,0,0,0,0,0
18862,200,0,73,31,42,6,1,0
0,0,0,0,0,0,0,0,0
0,0,0,0,0,0,0,0,0
65042,50,3,0,0,0,0,0,0
0,0,0,0,0,0,0,0,0
65042,50,3,0,0,0,0,0,0
0,0,0,0,0,0,0,0,0
695,13,0,1,1,0,0,0,1
65042,50,3,0,0,0,0,0,0
65042,50,3,0,0,0,0,0,0
65042,50,3,0,0,0,0,0,0
0,0,0,0,0,0,0,0,0
65042,50,3,0,0,0,0,0,0
65030,50,3,0,0,0,0,0,0
65042,50,3,0,0,0,0,0,0
675488,556,0,4,4,0,2,1,1
65041,50,3,0,0,0,0,0,0
671741,542,0,4,4,0,2,1,1
65042,50,3,0,0,0,0,0,0
0,0,0,0,0,0,0,0,0
16663,31,0,1,1,0,0,1,0
6330,64,2,6,4,2,0,1,0
6330,64,2,6,4,2,0,1,0
16659,31,0,1,1,0,0,1,0
0,0,0,0,0,0,0,0,0
2673,21,2,1,0,1,0,0,0
65042,50,3,0,0,0,0,0,0
65041,50,3,0,0,0,0,0,0
0,0,0,0,0,0,0,0,0
46,3,0,0,0,0,0,0,0
0,0,0,0,0,0,0,0,0
144450,59,4,3,3,0,2,1,0
25114,67,2,1,1,0,2,0,0
0,0,0,0,0,0,0,0,0
0,0,0,0,0,0,0,0,0
0,0,0,0,0,0,0,0,0
0,0,0,0,0,0,0,0,0
144450,59,4,3,3,0,2,1,0
144450,59,4,3,3,0,2,1,0
144450,59,4,3,3,0,2,1,0
144450,59,4,3,3,0,2,1,0
0,0,0,0,0,0,0,0,0
0,0,0,0,0,0,0,0,0
0,0,0,0,0,0,0,0,0
0,0,0,0,0,0,0,0,0
0,0,0,0,0,0,0,0,0
0,0,0,0,0,0,0,0,0
20904,234,2,48,47,1,2,1,0
20904,234,2,48,47,1,2,1,0
20904,234,2,48,47,1,2,1,0
20904,234,2,48,47,1,2,1,0
0,0,0,0,0,0,0,0,0
20904,234,2,48,47,1,2,1,0
0,0,0,0,0,0,0,0,0
0,0,0,0,0,0,0,0,0
0,0,0,0,0,0,0,0,0
232818,61,4,3,3,0,2,1,0
0,0,0,0,0,0,0,0,0
0,0,0,0,0,0,0,0,0
0,0,0,0,0,0,0,0,0
0,0,0,0,0,0,0,0,0
0,0,0,0,0,0,0,0,0
0,0,0,0,0,0,0,0,0
36427,48,1,0,0,0,0,0,0
91507,211,4,0,0,0,1,0,0
65042,50,3,0,0,0,0,0,0
70243,349,1,4,2,2,0,0,0
0,0,0,0,0,0,0,0,0
0,0,0,0,0,0,0,0,0
102681,76,4,6,6,0,5,1,0
350070,181,4,1,1,0,0,1,0
82623,238,3,20,17,3,0,0,0
0,0,0,0,0,0,0,0,0
24091,148,7,5,3,2,1,1,0
7021,30,0,3,0,3,0,1,0
0,0,0,0,0,0,0,0,0
0,0,0,0,0,0,0,0,0
0,0,0,0,0,0,0,0,0
0,0,0,0,0,0,0,0,0
0,0,0,0,0,0,0,0,0
0,0,0,0,0,0,0,0,0
0,0,0,0,0,0,0,0,0
0,0,0,0,0,0,0,0,0
0,0,0,0,0,0,0,0,0
0,0,0,0,0,0,0,0,0
0,0,0,0,0,0,0,0,0
0,0,0,0,0,0,0,0,0
0,0,0,0,0,0,0,0,0
65042,50,3,0,0,0,0,0,0
18259,267,3,26,22,4,0,0,0
13540,142,0,56,51,5,0,0,0
95128,783,1,52,15,37,4,1,0
12639,142,0,56,51,5,0,0,0
0,0,0,0,0,0,0,0,0
672840,556,0,4,4,0,2,1,1
0,0,0,0,0,0,0,0,0
0,0,0,0,0,0,0,0,0
296095,181,4,1,1,0,0,1,0
0,0,0,0,0,0,0,0,0
0,0,0,0,0,0,0,0,0
2673,21,2,1,0,1,0,0,0
0,0,0,0,0,0,0,0,0
0,0,0,0,0,0,0,0,0
9403,31,1,0,0,0,1,0,0
0,0,0,0,0,0,0,0,0
0,0,0,0,0,0,0,0,0
0,0,0,0,0,0,0,0,0
0,0,0,0,0,0,0,0,0
0,0,0,0,0,0,0,0,0
0,0,0,0,0,0,0,0,0
0,0,0,0,0,0,0,0,0
0,0,0,0,0,0,0,0,0
279567,232,4,1,1,0,0,1,0
0,0,0,0,0,0,0,0,0
0,0,0,0,0,0,0,0,0
0,0,0,0,0,0,0,0,0
4138922,63,2,2,0,2,0,1,0
34286,59,2,0,0,0,0,0,0
65042,50,3,0,0,0,0,0,0
82512,1347,2,7,7,0,1,1,0
82504,1347,2,7,7,0,1,1,0
140259,965,14,96,93,3,5,1,0
137633,1053,18,121,96,25,6,1,0
82728,238,3,20,10,10,0,0,0
82728,238,3,20,10,10,0,0,0
82728,238,3,20,17,3,0,0,0
0,0,0,0,0,0,0,0,0
0,0,0,0,0,0,0,0,0
0,0,0,0,0,0,0,0,0
0,0,0,0,0,0,0,0,0
0,0,0,0,0,0,0,0,0
0,0,0,0,0,0,0,0,0
65042,50,3,0,0,0,0,0,0
65041,50,3,0,0,0,0,0,0
0,0,0,0,0,0,0,0,0
0,0,0,0,0,0,0,0,0
33365,155,3,8,4,4,9,1,0
331104,127,4,27,18,9,1,1,0
28322,403,1,96,96,0,1,0,0
0,0,0,0,0,0,0,0,0
0,0,0,0,0,0,0,0,0
0,0,0,0,0,0,0,0,0
0,0,0,0,0,0,0,0,0
48828,319,6,1,1,0,1,0,0
48828,319,6,1,1,0,1,0,0
0,0,0,0,0,0,0,0,0
0,0,0,0,0,0,0,0,0
0,0,0,0,0,0,0,0,0
33841,46,2,0,0,0,2,0,0
0,0,0,0,0,0,0,0,0
33841,46,2,0,0,0,2,0,0
33841,46,2,0,0,0,2,0,0
0,0,0,0,0,0,0,0,0
0,0,0,0,0,0,0,0,0
0,0,0,0,0,0,0,0,0
0,0,0,0,0,0,0,0,0
0,0,0,0,0,0,0,0,0
10585,64,4,0,0,0,2,0,0
98953,66,4,0,0,0,2,1,0
0,0,0,0,0,0,0,0,0
98953,66,4,0,0,0,2,1,0
98953,66,4,0,0,0,2,1,0
0,0,0,0,0,0,0,0,0
98953,66,4,0,0,0,2,1,0
0,0,0,0,0,0,0,0,0
0,0,0,0,0,0,0,0,0
0,0,0,0,0,0,0,0,0
0,0,0,0,0,0,0,0,0
0,0,0,0,0,0,0,0,0
0,0,0,0,0,0,0,0,0
61300,5,0,0,0,0,0,0,0
0,0,0,0,0,0,0,0,0
0,0,0,0,0,0,0,0,0
0,0,0,0,0,0,0,0,0
8432,53,3,1,1,0,4,0,0
8432,53,3,1,1,0,4,0,0
8432,53,3,1,1,0,4,0,0
8432,53,3,1,1,0,4,0,0
0,0,0,0,0,0,0,0,0
8432,53,3,1,1,0,4,0,0
144428,59,4,3,3,0,2,1,0
0,0,0,0,0,0,0,0,0
200615,1709,2,298,32,266,2,1,0
104524,734,2,179,14,165,1,0,0
104583,735,2,179,14,165,1,0,0
104524,734,2,179,14,165,1,0,0
200694,1710,2,298,32,266,2,1,0
104524,734,2,179,14,165,1,0,0
685701,4,0,0,0,0,0,0,0
104027,731,2,179,14,165,1,0,0
685701,4,0,0,0,0,0,0,0
685701,4,0,0,0,0,0,0,0
685701,4,0,0,0,0,0,0,0
0,0,0,0,0,0,0,0,0
26672,36,0,3,1,2,0,0,0
65042,50,3,0,0,0,0,0,0
0,0,0,0,0,0,0,0,0
18262,255,3,33,32,1,0,0,0
91420,214,4,0,0,0,1,0,0
91405,211,4,0,0,0,1,0,0
0,0,0,0,0,0,0,0,0
0,0,0,0,0,0,0,0,0
0,0,0,0,0,0,0,0,0
669639,542,0,4,4,0,2,1,1
294912,197,4,1,1,0,0,1,0
0,0,0,0,0,0,0,0,0
0,0,0,0,0,0,0,0,0
0,0,0,0,0,0,0,0,0
0,0,0,0,0,0,0,0,0
14855,172,1,30,6,24,0,1,0
0,0,0,0,0,0,0,0,0
0,0,0,0,0,0,0,0,0
0,0,0,0,0,0,0,0,0
165998,363,3,7,4,3,1,0,0
672745,556,0,4,4,0,2,1,1
0,0,0,0,0,0,0,0,0
2673,21,2,1,0,1,0,0,0
0,0,0,0,0,0,0,0,0
65042,50,3,0,0,0,0,0,0
65042,50,3,0,0,0,0,0,0
25659,352,6,45,43,2,0,1,0
65042,50,3,0,0,0,0,0,0
65030,50,3,0,0,0,0,0,0
0,0,0,0,0,0,0,0,0
0,0,0,0,0,0,0,0,0
673168,557,0,4,4,0,2,1,1
0,0,0,0,0,0,0,0,0
13677,66,3,3,2,1,6,1,0
65042,50,3,0,0,0,0,0,0
65042,50,3,0,0,0,0,0,0
0,0,0,0,0,0,0,0,0
674414,556,0,4,4,0,2,1,1
9706,78,1,0,0,0,0,0,0
65042,50,3,0,0,0,0,0,0
65042,50,3,0,0,0,0,0,0
65042,50,3,0,0,0,0,0,0
65042,50,3,0,0,0,0,0,0
0,0,0,0,0,0,0,0,0
0,0,0,0,0,0,0,0,0
264202,504,4,49,33,16,7,1,0
28302,160,6,4,2,2,1,0,0
4337,36,2,0,0,0,0,0,0
76619,356,8,29,3,26,1,0,0
0,0,0,0,0,0,0,0,0
22408,50,0,0,0,0,0,0,0
0,0,0,0,0,0,0,0,0
0,0,0,0,0,0,0,0,0
0,0,0,0,0,0,0,0,0
0,0,0,0,0,0,0,0,0
0,0,0,0,0,0,0,0,0
0,0,0,0,0,0,0,0,0
65042,50,3,0,0,0,0,0,0
65042,50,3,0,0,0,0,0,0
0,0,0,0,0,0,0,0,0
676771,556,0,4,0,4,2,1,1
16244,57,0,2,2,0,0,1,0
14822,104,0,4,3,1,0,1,0
276943,1179,18,90,85,5,1,1,0
0,0,0,0,0,0,0,0,0
65042,50,3,0,0,0,0,0,0
65042,50,3,0,0,0,0,0,0
65042,50,3,0,0,0,0,0,0
0,0,0,0,0,0,0,0,0
16244,57,0,2,2,0,0,1,0
16244,57,0,2,2,0,0,1,0
0,0,0,0,0,0,0,0,0
471075,496,8,34,23,11,1,1,0
65042,50,3,0,0,0,0,0,0
23779,122,5,21,17,4,9,0,0
65041,50,3,0,0,0,0,0,0
0,0,0,0,0,0,0,0,0
0,0,0,0,0,0,0,0,0
0,0,0,0,0,0,0,0,0
0,0,0,0,0,0,0,0,0
15891,259,3,53,52,1,1,1,0
15900,259,3,53,52,1,1,1,0
104294,733,2,179,14,165,1,0,0
104027,731,2,179,14,165,1,0,0
104524,734,2,179,14,165,1,0,0
104524,734,2,179,14,165,1,0,0
0,0,0,0,0,0,0,0,0
32695,67,3,5,4,1,2,0,0
0,0,0,0,0,0,0,0,0
32695,67,3,5,4,1,2,0,0
32695,67,3,5,4,1,2,0,0
104027,731,2,179,14,165,1,0,0
104524,734,2,179,14,165,1,0,0
0,0,0,0,0,0,0,0,0
0,0,0,0,0,0,0,0,0
104027,731,2,179,14,165,1,0,0
13149,29,1,0,0,0,3,0,0
436907,52,2,1,1,0,0,1,0
13149,29,1,0,0,0,3,0,0
13149,29,1,0,0,0,3,0,0
25114,67,2,1,1,0,2,0,0
0,0,0,0,0,0,0,0,0
0,0,0,0,0,0,0,0,0
0,0,0,0,0,0,0,0,0
0,0,0,0,0,0,0,0,0
0,0,0,0,0,0,0,0,0
0,0,0,0,0,0,0,0,0
436907,52,2,1,1,0,0,1,0
0,0,0,0,0,0,0,0,0
144755,62,4,3,3,0,2,1,0
144755,62,4,3,3,0,2,1,0
58533,87,2,8,8,0,2,1,0
58533,87,2,8,8,0,2,1,0
0,0,0,0,0,0,0,0,0
0,0,0,0,0,0,0,0,0
65042,50,3,0,0,0,0,0,0
0,0,0,0,0,0,0,0,0
0,0,0,0,0,0,0,0,0
58533,87,2,8,8,0,2,1,0
58533,87,2,8,8,0,2,1,0
0,0,0,0,0,0,0,0,0
58533,87,2,8,8,0,2,1,0
0,0,0,0,0,0,0,0,0
58533,87,2,8,8,0,2,1,0
58533,87,2,8,8,0,2,1,0
0,0,0,0,0,0,0,0,0
0,0,0,0,0,0,0,0,0
0,0,0,0,0,0,0,0,0
0,0,0,0,0,0,0,0,0
0,0,0,0,0,0,0,0,0
0,0,0,0,0,0,0,0,0
0,0,0,0,0,0,0,0,0
0,0,0,0,0,0,0,0,0
0,0,0,0,0,0,0,0,0
0,0,0,0,0,0,0,0,0
0,0,0,0,0,0,0,0,0
0,0,0,0,0,0,0,0,0
0,0,0,0,0,0,0,0,0
0,0,0,0,0,0,0,0,0
0,0,0,0,0,0,0,0,0
0,0,0,0,0,0,0,0,0
0,0,0,0,0,0,0,0,0
0,0,0,0,0,0,0,0,0
0,0,0,0,0,0,0,0,0
0,0,0,0,0,0,0,0,0
144450,59,4,3,3,0,2,1,0
796695,93,3,6,6,0,2,1,0
0,0,0,0,0,0,0,0,0
0,0,0,0,0,0,0,0,0
144450,59,4,3,3,0,2,1,0
0,0,0,0,0,0,0,0,0
0,0,0,0,0,0,0,0,0
0,0,0,0,0,0,0,0,0
0,0,0,0,0,0,0,0,0
0,0,0,0,0,0,0,0,0
144450,59,4,3,3,0,2,1,0
796695,93,3,6,6,0,2,1,0
0,0,0,0,0,0,0,0,0
0,0,0,0,0,0,0,0,0
0,0,0,0,0,0,0,0,0
0,0,0,0,0,0,0,0,0
0,0,0,0,0,0,0,0,0
0,0,0,0,0,0,0,0,0
0,0,0,0,0,0,0,0,0
25101,67,2,1,1,0,2,0,0
0,0,0,0,0,0,0,0,0
0,0,0,0,0,0,0,0,0
0,0,0,0,0,0,0,0,0
65042,50,3,0,0,0,0,0,0
65030,50,3,0,0,0,0,0,0
65042,50,3,0,0,0,0,0,0
65042,50,3,0,0,0,0,0,0
0,0,0,0,0,0,0,0,0
0,0,0,0,0,0,0,0,0
0,0,0,0,0,0,0,0,0
0,0,0,0,0,0,0,0,0
0,0,0,0,0,0,0,0,0
0,0,0,0,0,0,0,0,0
0,0,0,0,0,0,0,0,0
0,0,0,0,0,0,0,0,0
0,0,0,0,0,0,0,0,0
45162,43,3,0,0,0,0,0,0
74700,323,9,20,15,5,1,0,0
0,0,0,0,0,0,0,0,0
0,0,0,0,0,0,0,0,0
0,0,0,0,0,0,0,0,0
2673,21,2,1,0,1,0,0,0
0,0,0,0,0,0,0,0,0
0,0,0,0,0,0,0,0,0
0,0,0,0,0,0,0,0,0
65042,50,3,0,0,0,0,0,0
0,0,0,0,0,0,0,0,0
9200,28,1,2,2,0,0,0,0
2673,21,2,1,0,1,0,0,0
65042,50,3,0,0,0,0,0,0
65042,50,3,0,0,0,0,0,0
65042,50,3,0,0,0,0,0,0
0,0,0,0,0,0,0,0,0
0,0,0,0,0,0,0,0,0
0,0,0,0,0,0,0,0,0
65042,50,3,0,0,0,0,0,0
65042,50,3,0,0,0,0,0,0
65042,50,3,0,0,0,0,0,0
0,0,0,0,0,0,0,0,0
0,0,0,0,0,0,0,0,0
0,0,0,0,0,0,0,0,0
0,0,0,0,0,0,0,0,0
133487,312,8,26,24,2,19,1,0
13116,142,0,56,51,5,0,0,0
2673,21,2,1,0,1,0,0,0
65042,50,3,0,0,0,0,0,0
0,0,0,0,0,0,0,0,0
0,0,0,0,0,0,0,0,0
0,0,0,0,0,0,0,0,0
0,0,0,0,0,0,0,0,0
0,0,0,0,0,0,0,0,0
65042,50,3,0,0,0,0,0,0
0,0,0,0,0,0,0,0,0
0,0,0,0,0,0,0,0,0
673018,557,0,4,4,0,2,1,1
673031,542,0,4,4,0,2,1,1
65042,50,3,0,0,0,0,0,0
65042,50,3,0,0,0,0,0,0
2673,21,2,1,0,1,0,0,0
0,0,0,0,0,0,0,0,0
128671,512,10,50,42,8,4,0,0
65042,50,3,0,0,0,0,0,0
2673,21,2,1,0,1,0,0,0
65041,50,3,0,0,0,0,0,0
0,0,0,0,0,0,0,0,0
0,0,0,0,0,0,0,0,0
0,0,0,0,0,0,0,0,0
0,0,0,0,0,0,0,0,0
0,0,0,0,0,0,0,0,0
0,0,0,0,0,0,0,0,0
0,0,0,0,0,0,0,0,0
0,0,0,0,0,0,0,0,0
0,0,0,0,0,0,0,0,0
0,0,0,0,0,0,0,0,0
0,0,0,0,0,0,0,0,0
0,0,0,0,0,0,0,0,0
0,0,0,0,0,0,0,0,0
0,0,0,0,0,0,0,0,0
0,0,0,0,0,0,0,0,0
0,0,0,0,0,0,0,0,0
0,0,0,0,0,0,0,0,0
0,0,0,0,0,0,0,0,0
0,0,0,0,0,0,0,0,0
0,0,0,0,0,0,0,0,0
0,0,0,0,0,0,0,0,0
0,0,0,0,0,0,0,0,0
0,0,0,0,0,0,0,0,0
23461,59,4,3,3,0,2,1,0
0,0,0,0,0,0,0,0,0
0,0,0,0,0,0,0,0,0
0,0,0,0,0,0,0,0,0
0,0,0,0,0,0,0,0,0
0,0,0,0,0,0,0,0,0
144444,59,4,3,3,0,2,1,0
144444,59,4,3,3,0,2,1,0
23461,59,4,3,3,0,2,1,0
23461,59,4,3,3,0,2,1,0
144444,59,4,3,3,0,2,1,0
23461,59,4,3,3,0,2,1,0
23461,59,4,3,3,0,2,1,0
25283,91,3,7,7,0,2,1,0
0,0,0,0,0,0,0,0,0
0,0,0,0,0,0,0,0,0
0,0,0,0,0,0,0,0,0
0,0,0,0,0,0,0,0,0
0,0,0,0,0,0,0,0,0
0,0,0,0,0,0,0,0,0
65042,50,3,0,0,0,0,0,0
65030,50,3,0,0,0,0,0,0
0,0,0,0,0,0,0,0,0
0,0,0,0,0,0,0,0,0
93109,453,5,58,52,6,14,1,0
8382,32,2,0,0,0,0,0,0
0,0,0,0,0,0,0,0,0
0,0,0,0,0,0,0,0,0
0,0,0,0,0,0,0,0,0
279104,186,4,1,1,0,0,1,0
0,0,0,0,0,0,0,0,0
0,0,0,0,0,0,0,0,0
22529,38,0,2,2,0,0,1,0
90945,211,4,0,0,0,1,0,0
11695,145,4,10,8,2,2,1,0
0,0,0,0,0,0,0,0,0
0,0,0,0,0,0,0,0,0
0,0,0,0,0,0,0,0,0
0,0,0,0,0,0,0,0,0
0,0,0,0,0,0,0,0,0
0,0,0,0,0,0,0,0,0
0,0,0,0,0,0,0,0,0
0,0,0,0,0,0,0,0,0
0,0,0,0,0,0,0,0,0
0,0,0,0,0,0,0,0,0
0,0,0,0,0,0,0,0,0
116826,57,3,0,0,0,0,0,0
116826,57,3,0,0,0,0,0,0
0,0,0,0,0,0,0,0,0
0,0,0,0,0,0,0,0,0
0,0,0,0,0,0,0,0,0
2673,21,2,1,0,1,0,0,0
0,0,0,0,0,0,0,0,0
0,0,0,0,0,0,0,0,0
2673,21,2,1,0,1,0,0,0
65042,50,3,0,0,0,0,0,0
0,0,0,0,0,0,0,0,0
65042,50,3,0,0,0,0,0,0
6330,64,2,6,4,2,0,1,0
0,0,0,0,0,0,0,0,0
0,0,0,0,0,0,0,0,0
65042,50,3,0,0,0,0,0,0
0,0,0,0,0,0,0,0,0
65042,50,3,0,0,0,0,0,0
0,0,0,0,0,0,0,0,0
65042,50,3,0,0,0,0,0,0
0,0,0,0,0,0,0,0,0
138506,258,1,20,7,13,7,1,0
671304,542,0,4,4,0,2,1,1
0,0,0,0,0,0,0,0,0
0,0,0,0,0,0,0,0,0
0,0,0,0,0,0,0,0,0
0,0,0,0,0,0,0,0,0
0,0,0,0,0,0,0,0,0
671997,556,0,4,4,0,2,1,1
41776,181,1,4,2,2,0,0,0
0,0,0,0,0,0,0,0,0
0,0,0,0,0,0,0,0,0
0,0,0,0,0,0,0,0,0
30341,74,0,7,1,6,0,0,0
0,0,0,0,0,0,0,0,0
65042,50,3,0,0,0,0,0,0
0,0,0,0,0,0,0,0,0
0,0,0,0,0,0,0,0,0
135793,320,8,27,24,3,19,1,0
2673,21,2,1,0,1,0,0,0
0,0,0,0,0,0,0,0,0
0,0,0,0,0,0,0,0,0
65042,50,3,0,0,0,0,0,0
0,0,0,0,0,0,0,0,0
65030,50,3,0,0,0,0,0,0
65042,50,3,0,0,0,0,0,0
0,0,0,0,0,0,0,0,0
0,0,0,0,0,0,0,0,0
0,0,0,0,0,0,0,0,0
0,0,0,0,0,0,0,0,0
0,0,0,0,0,0,0,0,0
0,0,0,0,0,0,0,0,0
0,0,0,0,0,0,0,0,0
0,0,0,0,0,0,0,0,0
0,0,0,0,0,0,0,0,0
0,0,0,0,0,0,0,0,0
0,0,0,0,0,0,0,0,0
0,0,0,0,0,0,0,0,0
0,0,0,0,0,0,0,0,0
0,0,0,0,0,0,0,0,0
0,0,0,0,0,0,0,0,0
677921,542,0,4,0,4,2,1,1
0,0,0,0,0,0,0,0,0
0,0,0,0,0,0,0,0,0
0,0,0,0,0,0,0,0,0
0,0,0,0,0,0,0,0,0
0,0,0,0,0,0,0,0,0
6762,28,1,2,2,0,0,0,0
669680,542,0,4,4,0,2,1,1
0,0,0,0,0,0,0,0,0
66267,49,3,0,0,0,0,0,0
66267,49,3,0,0,0,0,0,0
0,0,0,0,0,0,0,0,0
0,0,0,0,0,0,0,0,0
0,0,0,0,0,0,0,0,0
0,0,0,0,0,0,0,0,0
0,0,0,0,0,0,0,0,0
0,0,0,0,0,0,0,0,0
286882,184,4,1,1,0,0,1,0
0,0,0,0,0,0,0,0,0
0,0,0,0,0,0,0,0,0
0,0,0,0,0,0,0,0,0
173379,51,3,3,3,0,0,1,0
0,0,0,0,0,0,0,0,0
0,0,0,0,0,0,0,0,0
0,0,0,0,0,0,0,0,0
0,0,0,0,0,0,0,0,0
0,0,0,0,0,0,0,0,0
0,0,0,0,0,0,0,0,0
0,0,0,0,0,0,0,0,0
0,0,0,0,0,0,0,0,0
0,0,0,0,0,0,0,0,0
0,0,0,0,0,0,0,0,0
0,0,0,0,0,0,0,0,0
675141,556,0,4,4,0,2,1,1
6330,64,2,6,4,2,0,1,0
28931,286,5,28,25,3,0,1,0
0,0,0,0,0,0,0,0,0
221127,1797,1,203,4,199,3,1,0
0,0,0,0,0,0,0,0,0
30341,74,0,7,1,6,0,0,0
0,0,0,0,0,0,0,0,0
0,0,0,0,0,0,0,0,0
0,0,0,0,0,0,0,0,0
0,0,0,0,0,0,0,0,0
0,0,0,0,0,0,0,0,0
2673,21,2,1,0,1,0,0,0
0,0,0,0,0,0,0,0,0
0,0,0,0,0,0,0,0,0
0,0,0,0,0,0,0,0,0
0,0,0,0,0,0,0,0,0
132876,58,4,5,5,0,2,1,0
52494,111,2,11,8,3,5,0,0
52494,111,2,11,8,3,5,0,0
52494,111,2,11,8,3,5,0,0
132876,58,4,5,5,0,2,1,0
25114,67,2,1,1,0,2,0,0
44508,56,4,5,5,0,2,0,0
25114,67,2,1,1,0,2,0,0
25114,67,2,1,1,0,2,0,0
135981,42,4,1,1,0,2,0,0
25114,67,2,1,1,0,2,0,0
6006867,71,5,1,1,0,2,1,0
6006867,71,5,1,1,0,2,1,0
6006867,71,5,1,1,0,2,1,0
135981,42,4,1,1,0,2,0,0
135981,42,4,1,1,0,2,0,0
0,0,0,0,0,0,0,0,0
6006867,71,5,1,1,0,2,1,0
0,0,0,0,0,0,0,0,0
0,0,0,0,0,0,0,0,0
0,0,0,0,0,0,0,0,0
0,0,0,0,0,0,0,0,0
0,0,0,0,0,0,0,0,0
0,0,0,0,0,0,0,0,0
0,0,0,0,0,0,0,0,0
0,0,0,0,0,0,0,0,0
0,0,0,0,0,0,0,0,0
655881,28,1,0,0,0,0,0,0
655881,28,1,0,0,0,0,0,0
655881,28,1,0,0,0,0,0,0
655881,28,1,0,0,0,0,0,0
0,0,0,0,0,0,0,0,0
655881,28,1,0,0,0,0,0,0
0,0,0,0,0,0,0,0,0
0,0,0,0,0,0,0,0,0
36426,48,1,0,0,0,0,0,0
2673,21,2,1,0,1,0,0,0
0,0,0,0,0,0,0,0,0
0,0,0,0,0,0,0,0,0
0,0,0,0,0,0,0,0,0
0,0,0,0,0,0,0,0,0
0,0,0,0,0,0,0,0,0
0,0,0,0,0,0,0,0,0
0,0,0,0,0,0,0,0,0
0,0,0,0,0,0,0,0,0
0,0,0,0,0,0,0,0,0
0,0,0,0,0,0,0,0,0
1059963,101,4,5,5,0,3,1,0
0,0,0,0,0,0,0,0,0
263753,175,4,1,1,0,0,1,0
269106,217,4,1,1,0,0,1,0
270364,220,4,1,1,0,0,1,0
0,0,0,0,0,0,0,0,0
0,0,0,0,0,0,0,0,0
0,0,0,0,0,0,0,0,0
0,0,0,0,0,0,0,0,0
0,0,0,0,0,0,0,0,0
0,0,0,0,0,0,0,0,0
0,0,0,0,0,0,0,0,0
0,0,0,0,0,0,0,0,0
0,0,0,0,0,0,0,0,0
0,0,0,0,0,0,0,0,0
0,0,0,0,0,0,0,0,0
0,0,0,0,0,0,0,0,0
0,0,0,0,0,0,0,0,0
0,0,0,0,0,0,0,0,0
204926,155,3,2,1,1,18,0,0
204938,155,3,2,1,1,18,0,0
0,0,0,0,0,0,0,0,0
0,0,0,0,0,0,0,0,0
66267,49,3,0,0,0,0,0,0
672468,556,0,4,4,0,2,1,1
66267,49,3,0,0,0,0,0,0
2673,21,2,1,0,1,0,0,0
0,0,0,0,0,0,0,0,0
0,0,0,0,0,0,0,0,0
0,0,0,0,0,0,0,0,0
0,0,0,0,0,0,0,0,0
66267,49,3,0,0,0,0,0,0
0,0,0,0,0,0,0,0,0
66254,49,3,0,0,0,0,0,0
48886,855,6,72,35,37,0,0,0
28504,663,7,136,134,2,6,1,0
2673,21,2,1,0,1,0,0,0
66267,49,3,0,0,0,0,0,0
66267,49,3,0,0,0,0,0,0
676190,557,0,4,4,0,2,1,1
0,0,0,0,0,0,0,0,0
0,0,0,0,0,0,0,0,0
0,0,0,0,0,0,0,0,0
0,0,0,0,0,0,0,0,0
2673,21,2,1,0,1,0,0,0
672740,542,0,4,4,0,2,1,1
66267,49,3,0,0,0,0,0,0
0,0,0,0,0,0,0,0,0
672318,556,0,4,4,0,2,1,1
2673,21,2,1,0,1,0,0,0
66255,49,3,0,0,0,0,0,0
23291,225,3,24,24,0,0,1,0
61260,381,5,29,8,21,3,0,0
47330,204,2,1,1,0,1,0,0
0,0,0,0,0,0,0,0,0
188322,860,9,80,79,1,3,1,0
64136,56,0,2,2,0,0,1,0
64197,56,0,2,2,0,0,1,0
64197,56,0,2,2,0,0,1,0
64197,56,0,2,2,0,0,1,0
64197,56,0,2,2,0,0,1,0
0,0,0,0,0,0,0,0,0
4547,35,0,2,0,2,0,0,0
45140,122,4,6,3,3,0,1,0
0,0,0,0,0,0,0,0,0
0,0,0,0,0,0,0,0,0
0,0,0,0,0,0,0,0,0
484968,193,4,3,1,2,0,1,0
0,0,0,0,0,0,0,0,0
0,0,0,0,0,0,0,0,0
169270,2241,8,106,78,28,25,1,0
0,0,0,0,0,0,0,0,0
0,0,0,0,0,0,0,0,0
0,0,0,0,0,0,0,0,0
0,0,0,0,0,0,0,0,0
0,0,0,0,0,0,0,0,0
0,0,0,0,0,0,0,0,0
0,0,0,0,0,0,0,0,0
33456,155,3,8,4,4,9,1,0
31754,52,2,0,0,0,0,0,0
31754,52,2,0,0,0,0,0,0
31754,52,2,0,0,0,0,0,0
106487,545,8,19,12,7,1,0,0
860,29,0,0,0,0,0,0,0
0,0,0,0,0,0,0,0,0
0,0,0,0,0,0,0,0,0
0,0,0,0,0,0,0,0,0
0,0,0,0,0,0,0,0,0
0,0,0,0,0,0,0,0,0
0,0,0,0,0,0,0,0,0
0,0,0,0,0,0,0,0,0
0,0,0,0,0,0,0,0,0
0,0,0,0,0,0,0,0,0
0,0,0,0,0,0,0,0,0
0,0,0,0,0,0,0,0,0
840,26,0,0,0,0,0,0,0
66266,49,3,0,0,0,0,0,0
0,0,0,0,0,0,0,0,0
0,0,0,0,0,0,0,0,0
0,0,0,0,0,0,0,0,0
30295,75,0,7,1,6,0,0,0
0,0,0,0,0,0,0,0,0
0,0,0,0,0,0,0,0,0
0,0,0,0,0,0,0,0,0
0,0,0,0,0,0,0,0,0
0,0,0,0,0,0,0,0,0
144748,62,4,3,3,0,2,1,0
144748,62,4,3,3,0,2,1,0
144748,62,4,3,3,0,2,1,0
144748,62,4,3,3,0,2,1,0
144748,62,4,3,3,0,2,1,0
144411,59,4,3,3,0,2,1,0
0,0,0,0,0,0,0,0,0
0,0,0,0,0,0,0,0,0
0,0,0,0,0,0,0,0,0
0,0,0,0,0,0,0,0,0
279407,175,4,1,1,0,0,1,0
0,0,0,0,0,0,0,0,0
0,0,0,0,0,0,0,0,0
0,0,0,0,0,0,0,0,0
0,0,0,0,0,0,0,0,0
7234,44,1,0,0,0,2,0,0
0,0,0,0,0,0,0,0,0
0,0,0,0,0,0,0,0,0
672567,542,0,4,4,0,2,1,1
0,0,0,0,0,0,0,0,0
0,0,0,0,0,0,0,0,0
508528,48,2,2,2,0,2,0,0
171360,172,0,6,6,0,1,1,1
0,0,0,0,0,0,0,0,0
12768,217,0,72,2,70,0,1,0
6330,64,2,6,4,2,0,1,0
114109,775,1,47,45,2,18,1,0
0,0,0,0,0,0,0,0,0
66267,49,3,0,0,0,0,0,0
0,0,0,0,0,0,0,0,0
62077,337,6,41,41,0,2,0,0
0,0,0,0,0,0,0,0,0
0,0,0,0,0,0,0,0,0
66265,49,3,0,0,0,0,0,0
11288,60,5,0,0,0,4,1,0
436892,52,2,1,1,0,0,1,0
436892,52,2,1,1,0,0,1,0
0,0,0,0,0,0,0,0,0
436892,52,2,1,1,0,0,1,0
436892,52,2,1,1,0,0,1,0
436892,52,2,1,1,0,0,1,0
436892,52,2,1,1,0,0,1,0
11288,60,5,0,0,0,4,1,0
11516,131,4,4,1,3,1,1,0
436892,52,2,1,1,0,0,1,0
0,0,0,0,0,0,0,0,0
0,0,0,0,0,0,0,0,0
0,0,0,0,0,0,0,0,0
25114,67,2,1,1,0,2,0,0
0,0,0,0,0,0,0,0,0
0,0,0,0,0,0,0,0,0
0,0,0,0,0,0,0,0,0
25114,67,2,1,1,0,2,0,0
25114,67,2,1,1,0,2,0,0
0,0,0,0,0,0,0,0,0
0,0,0,0,0,0,0,0,0
25114,67,2,1,1,0,2,0,0
0,0,0,0,0,0,0,0,0
33888,67,3,5,4,1,2,0,0
33888,67,3,5,4,1,2,0,0
33888,67,3,5,4,1,2,0,0
33888,67,3,5,4,1,2,0,0
7234,44,1,0,0,0,2,0,0
0,0,0,0,0,0,0,0,0
0,0,0,0,0,0,0,0,0
0,0,0,0,0,0,0,0,0
0,0,0,0,0,0,0,0,0
0,0,0,0,0,0,0,0,0
0,0,0,0,0,0,0,0,0
0,0,0,0,0,0,0,0,0
0,0,0,0,0,0,0,0,0
16038,72,4,0,0,0,0,1,0
0,0,0,0,0,0,0,0,0
0,0,0,0,0,0,0,0,0
0,0,0,0,0,0,0,0,0
0,0,0,0,0,0,0,0,0
0,0,0,0,0,0,0,0,0
0,0,0,0,0,0,0,0,0
0,0,0,0,0,0,0,0,0
0,0,0,0,0,0,0,0,0
66267,49,3,0,0,0,0,0,0
0,0,0,0,0,0,0,0,0
0,0,0,0,0,0,0,0,0
0,0,0,0,0,0,0,0,0
0,0,0,0,0,0,0,0,0
0,0,0,0,0,0,0,0,0
0,0,0,0,0,0,0,0,0
0,0,0,0,0,0,0,0,0
0,0,0,0,0,0,0,0,0
6584,71,3,1,0,1,0,0,0
0,0,0,0,0,0,0,0,0
0,0,0,0,0,0,0,0,0
0,0,0,0,0,0,0,0,0
0,0,0,0,0,0,0,0,0
0,0,0,0,0,0,0,0,0
0,0,0,0,0,0,0,0,0
166179,1544,6,337,299,38,0,1,0
166600,1546,6,337,300,37,0,1,0
0,0,0,0,0,0,0,0,0
0,0,0,0,0,0,0,0,0
0,0,0,0,0,0,0,0,0
0,0,0,0,0,0,0,0,0
0,0,0,0,0,0,0,0,0
0,0,0,0,0,0,0,0,0
9212,28,1,2,2,0,0,0,0
0,0,0,0,0,0,0,0,0
0,0,0,0,0,0,0,0,0
66267,49,3,0,0,0,0,0,0
25289,361,6,11,2,9,0,1,0
0,0,0,0,0,0,0,0,0
13120,142,0,56,51,5,0,0,0
0,0,0,0,0,0,0,0,0
0,0,0,0,0,0,0,0,0
0,0,0,0,0,0,0,0,0
10698,117,0,5,4,1,4,1,0
23291,225,3,24,24,0,0,1,0
0,0,0,0,0,0,0,0,0
140312,403,8,26,24,2,34,1,0
2673,21,2,1,0,1,0,0,0
2673,21,2,1,0,1,0,0,0
137784,392,8,27,24,3,33,1,0
0,0,0,0,0,0,0,0,0
0,0,0,0,0,0,0,0,0
673507,556,0,4,4,0,2,1,1
0,0,0,0,0,0,0,0,0
0,0,0,0,0,0,0,0,0
0,0,0,0,0,0,0,0,0
0,0,0,0,0,0,0,0,0
0,0,0,0,0,0,0,0,0
10686,162,7,26,17,9,0,1,0
12435,142,0,56,52,4,0,0,0
10686,162,7,26,17,9,0,1,0
10686,162,7,26,17,9,0,1,0
6330,64,2,6,4,2,0,1,0
0,0,0,0,0,0,0,0,0
0,0,0,0,0,0,0,0,0
0,0,0,0,0,0,0,0,0
10378,85,1,0,0,0,0,0,0
0,0,0,0,0,0,0,0,0
0,0,0,0,0,0,0,0,0
0,0,0,0,0,0,0,0,0
0,0,0,0,0,0,0,0,0
279239,191,4,1,1,0,0,1,0
505645,266,4,3,1,2,0,1,0
0,0,0,0,0,0,0,0,0
504864,266,4,3,1,2,0,1,0
0,0,0,0,0,0,0,0,0
674479,556,0,4,4,0,2,1,1
672074,556,0,4,4,0,2,1,1
0,0,0,0,0,0,0,0,0
16623,63,4,9,9,0,2,0,0
0,0,0,0,0,0,0,0,0
0,0,0,0,0,0,0,0,0
0,0,0,0,0,0,0,0,0
0,0,0,0,0,0,0,0,0
0,0,0,0,0,0,0,0,0
0,0,0,0,0,0,0,0,0
0,0,0,0,0,0,0,0,0
0,0,0,0,0,0,0,0,0
0,0,0,0,0,0,0,0,0
0,0,0,0,0,0,0,0,0
0,0,0,0,0,0,0,0,0
0,0,0,0,0,0,0,0,0
0,0,0,0,0,0,0,0,0
0,0,0,0,0,0,0,0,0
0,0,0,0,0,0,0,0,0
0,0,0,0,0,0,0,0,0
0,0,0,0,0,0,0,0,0
0,0,0,0,0,0,0,0,0
135970,42,4,1,1,0,2,0,0
233114,64,4,3,3,0,2,1,0
0,0,0,0,0,0,0,0,0
34493,50,2,0,0,0,2,0,0
0,0,0,0,0,0,0,0,0
138296,69,3,2,1,1,2,1,0
0,0,0,0,0,0,0,0,0
0,0,0,0,0,0,0,0,0
0,0,0,0,0,0,0,0,0
0,0,0,0,0,0,0,0,0
0,0,0,0,0,0,0,0,0
135970,42,4,1,1,0,2,0,0
0,0,0,0,0,0,0,0,0
144746,62,4,3,3,0,2,1,0
0,0,0,0,0,0,0,0,0
0,0,0,0,0,0,0,0,0
0,0,0,0,0,0,0,0,0
0,0,0,0,0,0,0,0,0
135970,42,4,1,1,0,2,0,0
144746,62,4,3,3,0,2,1,0
0,0,0,0,0,0,0,0,0
0,0,0,0,0,0,0,0,0
0,0,0,0,0,0,0,0,0
0,0,0,0,0,0,0,0,0
0,0,0,0,0,0,0,0,0
138296,69,3,2,1,1,2,1,0
0,0,0,0,0,0,0,0,0
332533,60,4,3,3,0,2,1,0
0,0,0,0,0,0,0,0,0
0,0,0,0,0,0,0,0,0
332533,60,4,3,3,0,2,1,0
0,0,0,0,0,0,0,0,0
0,0,0,0,0,0,0,0,0
332533,60,4,3,3,0,2,1,0
0,0,0,0,0,0,0,0,0
0,0,0,0,0,0,0,0,0
0,0,0,0,0,0,0,0,0
0,0,0,0,0,0,0,0,0
0,0,0,0,0,0,0,0,0
0,0,0,0,0,0,0,0,0
0,0,0,0,0,0,0,0,0
91509,211,4,0,0,0,1,0,0
0,0,0,0,0,0,0,0,0
0,0,0,0,0,0,0,0,0
0,0,0,0,0,0,0,0,0
0,0,0,0,0,0,0,0,0
0,0,0,0,0,0,0,0,0
0,0,0,0,0,0,0,0,0
0,0,0,0,0,0,0,0,0
0,0,0,0,0,0,0,0,0
387163,209,4,1,1,0,0,1,0
392532,216,4,1,1,0,0,1,0
0,0,0,0,0,0,0,0,0
0,0,0,0,0,0,0,0,0
226726,947,6,104,84,20,13,1,0
0,0,0,0,0,0,0,0,0
0,0,0,0,0,0,0,0,0
20771,158,0,1,0,1,0,1,0
20771,158,0,1,0,1,0,1,0
0,0,0,0,0,0,0,0,0
0,0,0,0,0,0,0,0,0
0,0,0,0,0,0,0,0,0
0,0,0,0,0,0,0,0,0
997022,3935,4,123,2,121,17,1,0
997046,3935,4,123,0,123,17,1,0
64136,56,0,2,2,0,0,1,0
64197,56,0,2,2,0,0,1,0
64197,56,0,2,2,0,0,1,0
64197,56,0,2,2,0,0,1,0
64197,56,0,2,2,0,0,1,0
2673,21,2,1,0,1,0,0,0
0,0,0,0,0,0,0,0,0
677177,556,0,4,0,4,2,1,1
0,0,0,0,0,0,0,0,0
0,0,0,0,0,0,0,0,0
64197,56,0,2,2,0,0,1,0
64136,56,0,2,2,0,0,1,0
64136,56,0,2,2,0,0,1,0
64136,56,0,2,2,0,0,1,0
64197,56,0,2,2,0,0,1,0
65217,49,3,0,0,0,0,0,0
2673,21,2,1,0,1,0,0,0
23291,225,3,24,24,0,0,1,0
0,0,0,0,0,0,0,0,0
0,0,0,0,0,0,0,0,0
0,0,0,0,0,0,0,0,0
2673,21,2,1,0,1,0,0,0
305207,188,4,1,1,0,0,1,0
0,0,0,0,0,0,0,0,0
0,0,0,0,0,0,0,0,0
23291,225,3,24,24,0,0,1,0
2673,21,2,1,0,1,0,0,0
2673,21,2,1,0,1,0,0,0
0,0,0,0,0,0,0,0,0
0,0,0,0,0,0,0,0,0
0,0,0,0,0,0,0,0,0
0,0,0,0,0,0,0,0,0
0,0,0,0,0,0,0,0,0
0,0,0,0,0,0,0,0,0
21798,33,0,1,1,0,0,1,0
23291,225,3,24,24,0,0,1,0
16329,142,0,56,51,5,0,0,0
0,0,0,0,0,0,0,0,0
0,0,0,0,0,0,0,0,0
0,0,0,0,0,0,0,0,0
0,0,0,0,0,0,0,0,0
1537,16,0,0,0,0,0,0,0
0,0,0,0,0,0,0,0,0
0,0,0,0,0,0,0,0,0
292874,188,2,43,9,34,3,1,0
292874,188,2,43,9,34,3,1,0
292874,188,2,43,9,34,3,1,0
13732,40,2,0,0,0,0,0,0
292874,188,2,43,9,34,3,1,0
0,0,0,0,0,0,0,0,0
0,0,0,0,0,0,0,0,0
0,0,0,0,0,0,0,0,0
0,0,0,0,0,0,0,0,0
0,0,0,0,0,0,0,0,0
0,0,0,0,0,0,0,0,0
25094,67,2,1,1,0,2,0,0
25094,67,2,1,1,0,2,0,0
25094,67,2,1,1,0,2,0,0
0,0,0,0,0,0,0,0,0
0,0,0,0,0,0,0,0,0
0,0,0,0,0,0,0,0,0
0,0,0,0,0,0,0,0,0
0,0,0,0,0,0,0,0,0
0,0,0,0,0,0,0,0,0
0,0,0,0,0,0,0,0,0
0,0,0,0,0,0,0,0,0
0,0,0,0,0,0,0,0,0
0,0,0,0,0,0,0,0,0
0,0,0,0,0,0,0,0,0
0,0,0,0,0,0,0,0,0
0,0,0,0,0,0,0,0,0
0,0,0,0,0,0,0,0,0
0,0,0,0,0,0,0,0,0
0,0,0,0,0,0,0,0,0
0,0,0,0,0,0,0,0,0
0,0,0,0,0,0,0,0,0
0,0,0,0,0,0,0,0,0
0,0,0,0,0,0,0,0,0
0,0,0,0,0,0,0,0,0
0,0,0,0,0,0,0,0,0
0,0,0,0,0,0,0,0,0
0,0,0,0,0,0,0,0,0
0,0,0,0,0,0,0,0,0
0,0,0,0,0,0,0,0,0
0,0,0,0,0,0,0,0,0
0,0,0,0,0,0,0,0,0
0,0,0,0,0,0,0,0,0
0,0,0,0,0,0,0,0,0
0,0,0,0,0,0,0,0,0
0,0,0,0,0,0,0,0,0
0,0,0,0,0,0,0,0,0
6328,64,2,6,4,2,0,1,0
0,0,0,0,0,0,0,0,0
0,0,0,0,0,0,0,0,0
0,0,0,0,0,0,0,0,0
0,0,0,0,0,0,0,0,0
0,0,0,0,0,0,0,0,0
0,0,0,0,0,0,0,0,0
0,0,0,0,0,0,0,0,0
0,0,0,0,0,0,0,0,0
0,0,0,0,0,0,0,0,0
0,0,0,0,0,0,0,0,0
0,0,0,0,0,0,0,0,0
0,0,0,0,0,0,0,0,0
0,0,0,0,0,0,0,0,0
243181,132,4,7,7,0,5,1,0
0,0,0,0,0,0,0,0,0
164116,79,1,9,0,9,0,1,0
102673,76,4,6,6,0,5,1,0
0,0,0,0,0,0,0,0,0
0,0,0,0,0,0,0,0,0
0,0,0,0,0,0,0,0,0
0,0,0,0,0,0,0,0,0
0,0,0,0,0,0,0,0,0
0,0,0,0,0,0,0,0,0
0,0,0,0,0,0,0,0,0
0,0,0,0,0,0,0,0,0
0,0,0,0,0,0,0,0,0
0,0,0,0,0,0,0,0,0
0,0,0,0,0,0,0,0,0
0,0,0,0,0,0,0,0,0
0,0,0,0,0,0,0,0,0
0,0,0,0,0,0,0,0,0
0,0,0,0,0,0,0,0,0
0,0,0,0,0,0,0,0,0
0,0,0,0,0,0,0,0,0
0,0,0,0,0,0,0,0,0
0,0,0,0,0,0,0,0,0
0,0,0,0,0,0,0,0,0
0,0,0,0,0,0,0,0,0
0,0,0,0,0,0,0,0,0
0,0,0,0,0,0,0,0,0
0,0,0,0,0,0,0,0,0
0,0,0,0,0,0,0,0,0
0,0,0,0,0,0,0,0,0
0,0,0,0,0,0,0,0,0
0,0,0,0,0,0,0,0,0
0,0,0,0,0,0,0,0,0
19014,179,1,25,25,0,2,1,0
19014,179,1,25,25,0,2,1,0
0,0,0,0,0,0,0,0,0
0,0,0,0,0,0,0,0,0
0,0,0,0,0,0,0,0,0
0,0,0,0,0,0,0,0,0
0,0,0,0,0,0,0,0,0
0,0,0,0,0,0,0,0,0
0,0,0,0,0,0,0,0,0
674939,556,0,4,4,0,2,1,1
40574,42,0,5,5,0,0,0,0
0,0,0,0,0,0,0,0,0
0,0,0,0,0,0,0,0,0
0,0,0,0,0,0,0,0,0
9215,28,1,2,2,0,0,0,0
0,0,0,0,0,0,0,0,0
0,0,0,0,0,0,0,0,0
0,0,0,0,0,0,0,0,0
0,0,0,0,0,0,0,0,0
0,0,0,0,0,0,0,0,0
0,0,0,0,0,0,0,0,0
0,0,0,0,0,0,0,0,0
0,0,0,0,0,0,0,0,0
0,0,0,0,0,0,0,0,0
672003,556,0,4,4,0,2,1,1
0,0,0,0,0,0,0,0,0
0,0,0,0,0,0,0,0,0
0,0,0,0,0,0,0,0,0
0,0,0,0,0,0,0,0,0
15679,114,2,12,11,1,2,1,0
0,0,0,0,0,0,0,0,0
0,0,0,0,0,0,0,0,0
0,0,0,0,0,0,0,0,0
65216,49,3,0,0,0,0,0,0
65217,49,3,0,0,0,0,0,0
65217,49,3,0,0,0,0,0,0
0,0,0,0,0,0,0,0,0
0,0,0,0,0,0,0,0,0
131297,1995,6,75,59,16,37,1,0
0,0,0,0,0,0,0,0,0
0,0,0,0,0,0,0,0,0
0,0,0,0,0,0,0,0,0
0,0,0,0,0,0,0,0,0
0,0,0,0,0,0,0,0,0
0,0,0,0,0,0,0,0,0
0,0,0,0,0,0,0,0,0
0,0,0,0,0,0,0,0,0
9202,28,1,2,2,0,0,0,0
6330,64,2,6,4,2,0,1,0
528037,292,4,11,1,10,0,1,0
7975,81,1,8,6,2,2,0,0
0,0,0,0,0,0,0,0,0
8967,47,3,1,1,0,2,0,0
0,0,0,0,0,0,0,0,0
138321,69,3,2,1,1,2,1,0
138321,69,3,2,1,1,2,1,0
0,0,0,0,0,0,0,0,0
0,0,0,0,0,0,0,0,0
0,0,0,0,0,0,0,0,0
0,0,0,0,0,0,0,0,0
0,0,0,0,0,0,0,0,0
0,0,0,0,0,0,0,0,0
0,0,0,0,0,0,0,0,0
0,0,0,0,0,0,0,0,0
0,0,0,0,0,0,0,0,0
0,0,0,0,0,0,0,0,0
0,0,0,0,0,0,0,0,0
0,0,0,0,0,0,0,0,0
0,0,0,0,0,0,0,0,0
0,0,0,0,0,0,0,0,0
109932,49,3,0,0,0,0,0,0
109932,49,3,0,0,0,0,0,0
109932,49,3,0,0,0,0,0,0
109932,49,3,0,0,0,0,0,0
0,0,0,0,0,0,0,0,0
0,0,0,0,0,0,0,0,0
13732,40,2,0,0,0,0,0,0
13732,40,2,0,0,0,0,0,0
13732,40,2,0,0,0,0,0,0
13732,40,2,0,0,0,0,0,0
0,0,0,0,0,0,0,0,0
0,0,0,0,0,0,0,0,0
0,0,0,0,0,0,0,0,0
0,0,0,0,0,0,0,0,0
22412,50,0,0,0,0,0,0,0
0,0,0,0,0,0,0,0,0
0,0,0,0,0,0,0,0,0
17725,55,6,0,0,0,2,1,0
0,0,0,0,0,0,0,0,0
0,0,0,0,0,0,0,0,0
0,0,0,0,0,0,0,0,0
0,0,0,0,0,0,0,0,0
0,0,0,0,0,0,0,0,0
276990,160,4,0,0,0,0,1,0
188967,64,1,5,5,0,0,1,0
367052,1868,10,423,418,5,1,1,0
0,0,0,0,0,0,0,0,0
0,0,0,0,0,0,0,0,0
0,0,0,0,0,0,0,0,0
0,0,0,0,0,0,0,0,0
0,0,0,0,0,0,0,0,0
0,0,0,0,0,0,0,0,0
0,0,0,0,0,0,0,0,0
0,0,0,0,0,0,0,0,0
0,0,0,0,0,0,0,0,0
0,0,0,0,0,0,0,0,0
0,0,0,0,0,0,0,0,0
0,0,0,0,0,0,0,0,0
0,0,0,0,0,0,0,0,0
0,0,0,0,0,0,0,0,0
0,0,0,0,0,0,0,0,0
65217,49,3,0,0,0,0,0,0
44380,47,3,2,2,0,0,0,0
0,0,0,0,0,0,0,0,0
65217,49,3,0,0,0,0,0,0
0,0,0,0,0,0,0,0,0
0,0,0,0,0,0,0,0,0
0,0,0,0,0,0,0,0,0
0,0,0,0,0,0,0,0,0
0,0,0,0,0,0,0,0,0
0,0,0,0,0,0,0,0,0
61618,420,2,0,0,0,2,0,0
21473,61,0,2,2,0,0,0,0
21473,61,0,2,2,0,0,0,0
0,0,0,0,0,0,0,0,0
15910,339,4,31,28,3,0,1,0
0,0,0,0,0,0,0,0,0
0,0,0,0,0,0,0,0,0
9209,28,1,2,2,0,0,0,0
0,0,0,0,0,0,0,0,0
0,0,0,0,0,0,0,0,0
0,0,0,0,0,0,0,0,0
65217,49,3,0,0,0,0,0,0
0,0,0,0,0,0,0,0,0
54784,114,1,4,4,0,0,0,0
0,0,0,0,0,0,0,0,0
0,0,0,0,0,0,0,0,0
0,0,0,0,0,0,0,0,0
0,0,0,0,0,0,0,0,0
0,0,0,0,0,0,0,0,0
0,0,0,0,0,0,0,0,0
0,0,0,0,0,0,0,0,0
0,0,0,0,0,0,0,0,0
459286,468,4,4,4,0,0,1,0
0,0,0,0,0,0,0,0,0
0,0,0,0,0,0,0,0,0
0,0,0,0,0,0,0,0,0
0,0,0,0,0,0,0,0,0
0,0,0,0,0,0,0,0,0
2673,21,2,1,0,1,0,0,0
0,0,0,0,0,0,0,0,0
0,0,0,0,0,0,0,0,0
0,0,0,0,0,0,0,0,0
286374,188,4,1,1,0,0,1,0
114615,830,3,75,74,1,0,1,0
21692,33,0,1,1,0,0,1,0
0,0,0,0,0,0,0,0,0
0,0,0,0,0,0,0,0,0
29243,77,3,0,0,0,3,0,0
0,0,0,0,0,0,0,0,0
696711,175,4,18,17,1,3,0,0
0,0,0,0,0,0,0,0,0
696711,175,4,18,17,1,3,0,0
696711,175,4,18,17,1,3,0,0
30816,163,4,17,16,1,4,0,0
30816,163,4,17,16,1,4,0,0
0,0,0,0,0,0,0,0,0
0,0,0,0,0,0,0,0,0
0,0,0,0,0,0,0,0,0
13121,29,1,0,0,0,3,0,0
0,0,0,0,0,0,0,0,0
0,0,0,0,0,0,0,0,0
13121,29,1,0,0,0,3,0,0
13121,29,1,0,0,0,3,0,0
0,0,0,0,0,0,0,0,0
0,0,0,0,0,0,0,0,0
0,0,0,0,0,0,0,0,0
0,0,0,0,0,0,0,0,0
135974,42,4,1,1,0,2,0,0
135974,42,4,1,1,0,2,0,0
0,0,0,0,0,0,0,0,0
135974,42,4,1,1,0,2,0,0
0,0,0,0,0,0,0,0,0
135974,42,4,1,1,0,2,0,0
135974,42,4,1,1,0,2,0,0
557257,43,4,1,1,0,2,0,0
557257,43,4,1,1,0,2,0,0
83226,132,2,10,10,0,0,1,0
0,0,0,0,0,0,0,0,0
10971,56,3,0,0,0,2,0,0
0,0,0,0,0,0,0,0,0
0,0,0,0,0,0,0,0,0
0,0,0,0,0,0,0,0,0
0,0,0,0,0,0,0,0,0
0,0,0,0,0,0,0,0,0
0,0,0,0,0,0,0,0,0
0,0,0,0,0,0,0,0,0
0,0,0,0,0,0,0,0,0
0,0,0,0,0,0,0,0,0
0,0,0,0,0,0,0,0,0
0,0,0,0,0,0,0,0,0
5054,24,3,0,0,0,0,0,0
5054,24,3,0,0,0,0,0,0
5054,24,3,0,0,0,0,0,0
5054,24,3,0,0,0,0,0,0
5054,24,3,0,0,0,0,0,0
0,0,0,0,0,0,0,0,0
0,0,0,0,0,0,0,0,0
0,0,0,0,0,0,0,0,0
0,0,0,0,0,0,0,0,0
36591,221,2,49,3,46,0,1,0
672065,26,1,0,0,0,0,0,0
0,0,0,0,0,0,0,0,0
91881,512,3,26,12,14,1,1,0
0,0,0,0,0,0,0,0,0
0,0,0,0,0,0,0,0,0
0,0,0,0,0,0,0,0,0
0,0,0,0,0,0,0,0,0
0,0,0,0,0,0,0,0,0
91558,214,4,0,0,0,1,0,0
0,0,0,0,0,0,0,0,0
270004,178,4,1,1,0,0,1,0
0,0,0,0,0,0,0,0,0
0,0,0,0,0,0,0,0,0
0,0,0,0,0,0,0,0,0
0,0,0,0,0,0,0,0,0
0,0,0,0,0,0,0,0,0
0,0,0,0,0,0,0,0,0
0,0,0,0,0,0,0,0,0
0,0,0,0,0,0,0,0,0
0,0,0,0,0,0,0,0,0
0,0,0,0,0,0,0,0,0
0,0,0,0,0,0,0,0,0
0,0,0,0,0,0,0,0,0
0,0,0,0,0,0,0,0,0
0,0,0,0,0,0,0,0,0
0,0,0,0,0,0,0,0,0
0,0,0,0,0,0,0,0,0
0,0,0,0,0,0,0,0,0
0,0,0,0,0,0,0,0,0
5800,76,1,2,2,0,0,0,0
5800,76,1,2,2,0,0,0,0
0,0,0,0,0,0,0,0,0
0,0,0,0,0,0,0,0,0
0,0,0,0,0,0,0,0,0
0,0,0,0,0,0,0,0,0
0,0,0,0,0,0,0,0,0
0,0,0,0,0,0,0,0,0
0,0,0,0,0,0,0,0,0
203983,145,3,2,1,1,18,0,0
204931,155,3,2,1,1,18,0,0
0,0,0,0,0,0,0,0,0
0,0,0,0,0,0,0,0,0
57146,78,2,4,1,3,0,0,0
0,0,0,0,0,0,0,0,0
0,0,0,0,0,0,0,0,0
0,0,0,0,0,0,0,0,0
0,0,0,0,0,0,0,0,0
0,0,0,0,0,0,0,0,0
0,0,0,0,0,0,0,0,0
0,0,0,0,0,0,0,0,0
0,0,0,0,0,0,0,0,0
4071,60,3,0,0,0,0,0,0
20965,259,7,9,8,1,4,0,0
0,0,0,0,0,0,0,0,0
0,0,0,0,0,0,0,0,0
9684,93,0,12,11,1,0,0,0
47196,549,3,120,117,3,8,0,0
47143,549,3,120,117,3,8,0,0
0,0,0,0,0,0,0,0,0
0,0,0,0,0,0,0,0,0
0,0,0,0,0,0,0,0,0
0,0,0,0,0,0,0,0,0
0,0,0,0,0,0,0,0,0
65217,49,3,0,0,0,0,0,0
0,0,0,0,0,0,0,0,0
203494,1243,4,215,179,36,1,0,0
65203,49,3,0,0,0,0,0,0
0,0,0,0,0,0,0,0,0
0,0,0,0,0,0,0,0,0
0,0,0,0,0,0,0,0,0
65217,49,3,0,0,0,0,0,0
0,0,0,0,0,0,0,0,0
0,0,0,0,0,0,0,0,0
12590,142,0,56,51,5,0,0,0
12908,142,0,56,51,5,0,0,0
0,0,0,0,0,0,0,0,0
0,0,0,0,0,0,0,0,0
651355,187,4,1,1,0,0,1,0
0,0,0,0,0,0,0,0,0
0,0,0,0,0,0,0,0,0
672079,556,0,4,4,0,2,1,1
671782,542,0,4,4,0,2,1,1
673582,557,0,4,4,0,2,1,1
45716,185,2,1,0,1,1,0,0
0,0,0,0,0,0,0,0,0
136246,320,8,27,24,3,19,1,0
0,0,0,0,0,0,0,0,0
0,0,0,0,0,0,0,0,0
0,0,0,0,0,0,0,0,0
0,0,0,0,0,0,0,0,0
0,0,0,0,0,0,0,0,0
0,0,0,0,0,0,0,0,0
0,0,0,0,0,0,0,0,0
0,0,0,0,0,0,0,0,0
0,0,0,0,0,0,0,0,0
0,0,0,0,0,0,0,0,0
0,0,0,0,0,0,0,0,0
0,0,0,0,0,0,0,0,0
0,0,0,0,0,0,0,0,0
0,0,0,0,0,0,0,0,0
0,0,0,0,0,0,0,0,0
0,0,0,0,0,0,0,0,0
0,0,0,0,0,0,0,0,0
0,0,0,0,0,0,0,0,0
0,0,0,0,0,0,0,0,0
33345,102,2,8,1,7,0,1,0
6330,64,2,6,4,2,0,1,0
0,0,0,0,0,0,0,0,0
0,0,0,0,0,0,0,0,0
674144,556,0,4,4,0,2,1,1
135035,318,8,27,24,3,19,1,0
682154,260,4,2,2,0,0,1,0
0,0,0,0,0,0,0,0,0
47573,210,2,2,1,1,1,0,0
0,0,0,0,0,0,0,0,0
0,0,0,0,0,0,0,0,0
438231,1340,0,70,38,32,1,1,1
0,0,0,0,0,0,0,0,0
623907,191,4,1,1,0,0,1,0
671783,556,0,4,4,0,2,1,1
0,0,0,0,0,0,0,0,0
262543,1033,15,64,58,6,8,1,0
0,0,0,0,0,0,0,0,0
139199,400,8,26,24,2,34,1,0
0,0,0,0,0,0,0,0,0
0,0,0,0,0,0,0,0,0
0,0,0,0,0,0,0,0,0
0,0,0,0,0,0,0,0,0
0,0,0,0,0,0,0,0,0
0,0,0,0,0,0,0,0,0
0,0,0,0,0,0,0,0,0
28052,97,0,2,0,2,2,0,0
0,0,0,0,0,0,0,0,0
0,0,0,0,0,0,0,0,0
621528,187,4,1,1,0,0,1,0
0,0,0,0,0,0,0,0,0
0,0,0,0,0,0,0,0,0
0,0,0,0,0,0,0,0,0
4404,25,0,1,0,1,0,0,0
4404,25,0,1,0,1,0,0,0
0,0,0,0,0,0,0,0,0
0,0,0,0,0,0,0,0,0
0,0,0,0,0,0,0,0,0
0,0,0,0,0,0,0,0,0
0,0,0,0,0,0,0,0,0
2673,21,2,1,0,1,0,0,0
2572,20,1,1,0,1,0,0,0
65217,49,3,0,0,0,0,0,0
65217,49,3,0,0,0,0,0,0
0,0,0,0,0,0,0,0,0
12768,217,0,72,2,70,0,1,0
0,0,0,0,0,0,0,0,0
0,0,0,0,0,0,0,0,0
122728,869,8,102,42,60,1,1,0
90892,211,4,0,0,0,1,0,0
93144,211,4,0,0,0,1,0,0
91208,211,4,0,0,0,1,0,0
0,0,0,0,0,0,0,0,0
0,0,0,0,0,0,0,0,0
0,0,0,0,0,0,0,0,0
0,0,0,0,0,0,0,0,0
0,0,0,0,0,0,0,0,0
0,0,0,0,0,0,0,0,0
1059921,101,4,5,5,0,3,1,0
0,0,0,0,0,0,0,0,0
16244,57,0,2,2,0,0,1,0
0,0,0,0,0,0,0,0,0
0,0,0,0,0,0,0,0,0
137051,42,4,1,1,0,2,0,0
137051,42,4,1,1,0,2,0,0
137051,42,4,1,1,0,2,0,0
137051,42,4,1,1,0,2,0,0
0,0,0,0,0,0,0,0,0
127293,579,2,90,5,85,1,0,0
0,0,0,0,0,0,0,0,0
47622,75,2,1,1,0,3,1,0
0,0,0,0,0,0,0,0,0
0,0,0,0,0,0,0,0,0
0,0,0,0,0,0,0,0,0
0,0,0,0,0,0,0,0,0
0,0,0,0,0,0,0,0,0
37743,35,4,0,0,0,0,0,0
0,0,0,0,0,0,0,0,0
37743,35,4,0,0,0,0,0,0
37743,35,4,0,0,0,0,0,0
0,0,0,0,0,0,0,0,0
0,0,0,0,0,0,0,0,0
0,0,0,0,0,0,0,0,0
0,0,0,0,0,0,0,0,0
0,0,0,0,0,0,0,0,0
0,0,0,0,0,0,0,0,0
0,0,0,0,0,0,0,0,0
0,0,0,0,0,0,0,0,0
119623,52,0,0,0,0,0,0,0
0,0,0,0,0,0,0,0,0
0,0,0,0,0,0,0,0,0
0,0,0,0,0,0,0,0,0
0,0,0,0,0,0,0,0,0
0,0,0,0,0,0,0,0,0
0,0,0,0,0,0,0,0,0
5118,28,1,2,2,0,0,0,0
0,0,0,0,0,0,0,0,0
0,0,0,0,0,0,0,0,0
573316,631,4,36,10,26,2,1,0
573316,631,4,36,10,26,2,1,0
0,0,0,0,0,0,0,0,0
0,0,0,0,0,0,0,0,0
0,0,0,0,0,0,0,0,0
46819,204,2,1,1,0,1,0,0
365198,2544,10,215,208,7,10,1,0
365197,2544,10,215,208,7,10,1,0
365197,2544,10,215,208,7,10,1,0
365198,2544,10,215,208,7,10,1,0
0,0,0,0,0,0,0,0,0
365175,2543,10,215,208,7,10,1,0
365175,2543,10,215,208,7,10,1,0
365175,2543,10,215,208,7,10,1,0
365175,2543,10,215,208,7,10,1,0
365256,2545,10,215,208,7,10,1,0
0,0,0,0,0,0,0,0,0
671962,542,0,4,4,0,2,1,1
2673,21,2,1,0,1,0,0,0
0,0,0,0,0,0,0,0,0
0,0,0,0,0,0,0,0,0
0,0,0,0,0,0,0,0,0
0,0,0,0,0,0,0,0,0
0,0,0,0,0,0,0,0,0
0,0,0,0,0,0,0,0,0
0,0,0,0,0,0,0,0,0
0,0,0,0,0,0,0,0,0
0,0,0,0,0,0,0,0,0
0,0,0,0,0,0,0,0,0
0,0,0,0,0,0,0,0,0
0,0,0,0,0,0,0,0,0
0,0,0,0,0,0,0,0,0
0,0,0,0,0,0,0,0,0
0,0,0,0,0,0,0,0,0
0,0,0,0,0,0,0,0,0
0,0,0,0,0,0,0,0,0
20942,234,2,48,47,1,2,1,0
0,0,0,0,0,0,0,0,0
0,0,0,0,0,0,0,0,0
0,0,0,0,0,0,0,0,0
0,0,0,0,0,0,0,0,0
0,0,0,0,0,0,0,0,0
0,0,0,0,0,0,0,0,0
0,0,0,0,0,0,0,0,0
0,0,0,0,0,0,0,0,0
0,0,0,0,0,0,0,0,0
144503,62,4,3,3,0,2,1,0
144503,62,4,3,3,0,2,1,0
144503,62,4,3,3,0,2,1,0
144503,62,4,3,3,0,2,1,0
144503,62,4,3,3,0,2,1,0
0,0,0,0,0,0,0,0,0
0,0,0,0,0,0,0,0,0
436144,35,2,1,1,0,0,1,0
0,0,0,0,0,0,0,0,0
0,0,0,0,0,0,0,0,0
0,0,0,0,0,0,0,0,0
0,0,0,0,0,0,0,0,0
0,0,0,0,0,0,0,0,0
0,0,0,0,0,0,0,0,0
0,0,0,0,0,0,0,0,0
0,0,0,0,0,0,0,0,0
0,0,0,0,0,0,0,0,0
0,0,0,0,0,0,0,0,0
0,0,0,0,0,0,0,0,0
0,0,0,0,0,0,0,0,0
0,0,0,0,0,0,0,0,0
0,0,0,0,0,0,0,0,0
0,0,0,0,0,0,0,0,0
0,0,0,0,0,0,0,0,0
0,0,0,0,0,0,0,0,0
0,0,0,0,0,0,0,0,0
0,0,0,0,0,0,0,0,0
0,0,0,0,0,0,0,0,0
0,0,0,0,0,0,0,0,0
0,0,0,0,0,0,0,0,0
0,0,0,0,0,0,0,0,0
0,0,0,0,0,0,0,0,0
0,0,0,0,0,0,0,0,0
0,0,0,0,0,0,0,0,0
0,0,0,0,0,0,0,0,0
0,0,0,0,0,0,0,0,0
0,0,0,0,0,0,0,0,0
0,0,0,0,0,0,0,0,0
0,0,0,0,0,0,0,0,0
0,0,0,0,0,0,0,0,0
0,0,0,0,0,0,0,0,0
0,0,0,0,0,0,0,0,0
0,0,0,0,0,0,0,0,0
0,0,0,0,0,0,0,0,0
0,0,0,0,0,0,0,0,0
0,0,0,0,0,0,0,0,0
1060484,101,4,5,5,0,3,1,0
1059922,101,4,5,5,0,3,1,0
1060484,101,4,5,5,0,3,1,0
1059955,101,4,5,5,0,3,1,0
0,0,0,0,0,0,0,0,0
0,0,0,0,0,0,0,0,0
0,0,0,0,0,0,0,0,0
0,0,0,0,0,0,0,0,0
0,0,0,0,0,0,0,0,0
0,0,0,0,0,0,0,0,0
0,0,0,0,0,0,0,0,0
0,0,0,0,0,0,0,0,0
0,0,0,0,0,0,0,0,0
0,0,0,0,0,0,0,0,0
0,0,0,0,0,0,0,0,0
0,0,0,0,0,0,0,0,0
0,0,0,0,0,0,0,0,0
0,0,0,0,0,0,0,0,0
0,0,0,0,0,0,0,0,0
0,0,0,0,0,0,0,0,0
0,0,0,0,0,0,0,0,0
0,0,0,0,0,0,0,0,0
0,0,0,0,0,0,0,0,0
0,0,0,0,0,0,0,0,0
0,0,0,0,0,0,0,0,0
0,0,0,0,0,0,0,0,0
0,0,0,0,0,0,0,0,0
0,0,0,0,0,0,0,0,0
0,0,0,0,0,0,0,0,0
0,0,0,0,0,0,0,0,0
0,0,0,0,0,0,0,0,0
0,0,0,0,0,0,0,0,0
0,0,0,0,0,0,0,0,0
1130,19,1,1,0,1,0,0,0
1130,19,1,1,0,1,0,0,0
0,0,0,0,0,0,0,0,0
0,0,0,0,0,0,0,0,0
0,0,0,0,0,0,0,0,0
0,0,0,0,0,0,0,0,0
65217,49,3,0,0,0,0,0,0
0,0,0,0,0,0,0,0,0
0,0,0,0,0,0,0,0,0
0,0,0,0,0,0,0,0,0
0,0,0,0,0,0,0,0,0
0,0,0,0,0,0,0,0,0
0,0,0,0,0,0,0,0,0
64197,56,0,2,2,0,0,1,0
64136,56,0,2,2,0,0,1,0
64197,56,0,2,2,0,0,1,0
3519,60,4,3,3,0,0,0,0
0,0,0,0,0,0,0,0,0
0,0,0,0,0,0,0,0,0
0,0,0,0,0,0,0,0,0
123902,28,1,2,2,0,0,0,0
21875,33,0,1,1,0,0,1,0
0,0,0,0,0,0,0,0,0
65217,49,3,0,0,0,0,0,0
0,0,0,0,0,0,0,0,0
0,0,0,0,0,0,0,0,0
0,0,0,0,0,0,0,0,0
0,0,0,0,0,0,0,0,0
65217,49,3,0,0,0,0,0,0
0,0,0,0,0,0,0,0,0
0,0,0,0,0,0,0,0,0
0,0,0,0,0,0,0,0,0
0,0,0,0,0,0,0,0,0
0,0,0,0,0,0,0,0,0
0,0,0,0,0,0,0,0,0
0,0,0,0,0,0,0,0,0
0,0,0,0,0,0,0,0,0
0,0,0,0,0,0,0,0,0
0,0,0,0,0,0,0,0,0
135624,320,8,27,24,3,19,1,0
107528,280,3,17,2,15,0,0,0
0,0,0,0,0,0,0,0,0
669780,542,0,4,4,0,2,1,1
0,0,0,0,0,0,0,0,0
272753,1052,12,25,22,3,2,1,0
64197,56,0,2,2,0,0,1,0
64136,56,0,2,2,0,0,1,0
64197,56,0,2,2,0,0,1,0
64136,56,0,2,2,0,0,1,0
0,0,0,0,0,0,0,0,0
0,0,0,0,0,0,0,0,0
0,0,0,0,0,0,0,0,0
0,0,0,0,0,0,0,0,0
0,0,0,0,0,0,0,0,0
0,0,0,0,0,0,0,0,0
0,0,0,0,0,0,0,0,0
0,0,0,0,0,0,0,0,0
0,0,0,0,0,0,0,0,0
0,0,0,0,0,0,0,0,0
0,0,0,0,0,0,0,0,0
0,0,0,0,0,0,0,0,0
0,0,0,0,0,0,0,0,0
0,0,0,0,0,0,0,0,0
0,0,0,0,0,0,0,0,0
0,0,0,0,0,0,0,0,0
0,0,0,0,0,0,0,0,0
0,0,0,0,0,0,0,0,0
0,0,0,0,0,0,0,0,0
0,0,0,0,0,0,0,0,0
263184,100,4,5,5,0,3,1,0
139414,401,8,27,24,3,34,1,0
0,0,0,0,0,0,0,0,0
0,0,0,0,0,0,0,0,0
52985,610,2,41,8,33,1,1,0
0,0,0,0,0,0,0,0,0
0,0,0,0,0,0,0,0,0
0,0,0,0,0,0,0,0,0
0,0,0,0,0,0,0,0,0
300651,259,4,4,4,0,0,1,0
454390,177,4,1,1,0,0,1,0
241491,2150,9,266,256,10,4,1,0
48093,196,2,7,4,3,1,1,0
0,0,0,0,0,0,0,0,0
88601,50,2,0,0,0,2,0,0
0,0,0,0,0,0,0,0,0
88601,50,2,0,0,0,2,0,0
0,0,0,0,0,0,0,0,0
0,0,0,0,0,0,0,0,0
0,0,0,0,0,0,0,0,0
88601,50,2,0,0,0,2,0,0
0,0,0,0,0,0,0,0,0
88601,50,2,0,0,0,2,0,0
0,0,0,0,0,0,0,0,0
88601,50,2,0,0,0,2,0,0
88601,50,2,0,0,0,2,0,0
88601,50,2,0,0,0,2,0,0
0,0,0,0,0,0,0,0,0
0,0,0,0,0,0,0,0,0
0,0,0,0,0,0,0,0,0
0,0,0,0,0,0,0,0,0
0,0,0,0,0,0,0,0,0
0,0,0,0,0,0,0,0,0
0,0,0,0,0,0,0,0,0
0,0,0,0,0,0,0,0,0
0,0,0,0,0,0,0,0,0
0,0,0,0,0,0,0,0,0
50303,713,4,163,0,163,3,1,0
0,0,0,0,0,0,0,0,0
0,0,0,0,0,0,0,0,0
0,0,0,0,0,0,0,0,0
0,0,0,0,0,0,0,0,0
0,0,0,0,0,0,0,0,0
0,0,0,0,0,0,0,0,0
9406,31,1,0,0,0,1,0,0
292857,188,2,43,9,34,3,1,0
0,0,0,0,0,0,0,0,0
0,0,0,0,0,0,0,0,0
0,0,0,0,0,0,0,0,0
0,0,0,0,0,0,0,0,0
0,0,0,0,0,0,0,0,0
0,0,0,0,0,0,0,0,0
0,0,0,0,0,0,0,0,0
0,0,0,0,0,0,0,0,0
0,0,0,0,0,0,0,0,0
0,0,0,0,0,0,0,0,0
0,0,0,0,0,0,0,0,0
114023,72,4,2,1,1,2,1,0
0,0,0,0,0,0,0,0,0
135943,42,4,1,1,0,2,0,0
17745,61,3,2,2,0,2,1,0
0,0,0,0,0,0,0,0,0
0,0,0,0,0,0,0,0,0
0,0,0,0,0,0,0,0,0
0,0,0,0,0,0,0,0,0
0,0,0,0,0,0,0,0,0
0,0,0,0,0,0,0,0,0
0,0,0,0,0,0,0,0,0
65217,49,3,0,0,0,0,0,0
0,0,0,0,0,0,0,0,0
0,0,0,0,0,0,0,0,0
0,0,0,0,0,0,0,0,0
0,0,0,0,0,0,0,0,0
0,0,0,0,0,0,0,0,0
0,0,0,0,0,0,0,0,0
0,0,0,0,0,0,0,0,0
0,0,0,0,0,0,0,0,0
0,0,0,0,0,0,0,0,0
0,0,0,0,0,0,0,0,0
0,0,0,0,0,0,0,0,0
0,0,0,0,0,0,0,0,0
0,0,0,0,0,0,0,0,0
0,0,0,0,0,0,0,0,0
0,0,0,0,0,0,0,0,0
0,0,0,0,0,0,0,0,0
0,0,0,0,0,0,0,0,0
0,0,0,0,0,0,0,0,0
0,0,0,0,0,0,0,0,0
0,0,0,0,0,0,0,0,0
0,0,0,0,0,0,0,0,0
0,0,0,0,0,0,0,0,0
0,0,0,0,0,0,0,0,0
674817,556,0,4,4,0,2,1,1
0,0,0,0,0,0,0,0,0
20771,158,0,1,0,1,0,1,0
20771,158,0,1,0,1,0,1,0
0,0,0,0,0,0,0,0,0
0,0,0,0,0,0,0,0,0
0,0,0,0,0,0,0,0,0
0,0,0,0,0,0,0,0,0
0,0,0,0,0,0,0,0,0
0,0,0,0,0,0,0,0,0
0,0,0,0,0,0,0,0,0
0,0,0,0,0,0,0,0,0
0,0,0,0,0,0,0,0,0
0,0,0,0,0,0,0,0,0
0,0,0,0,0,0,0,0,0
0,0,0,0,0,0,0,0,0
0,0,0,0,0,0,0,0,0
64136,56,0,2,2,0,0,1,0
64197,56,0,2,2,0,0,1,0
64197,56,0,2,2,0,0,1,0
64136,56,0,2,2,0,0,1,0
0,0,0,0,0,0,0,0,0
0,0,0,0,0,0,0,0,0
0,0,0,0,0,0,0,0,0
11221,79,0,4,3,1,0,0,0
0,0,0,0,0,0,0,0,0
32165,89,0,3,1,2,0,0,0
0,0,0,0,0,0,0,0,0
0,0,0,0,0,0,0,0,0
0,0,0,0,0,0,0,0,0
0,0,0,0,0,0,0,0,0
0,0,0,0,0,0,0,0,0
2673,21,2,1,0,1,0,0,0
0,0,0,0,0,0,0,0,0
2673,21,2,1,0,1,0,0,0
264536,507,4,48,32,16,7,1,0
0,0,0,0,0,0,0,0,0
0,0,0,0,0,0,0,0,0
0,0,0,0,0,0,0,0,0
14119,142,0,56,52,4,0,0,0
0,0,0,0,0,0,0,0,0
0,0,0,0,0,0,0,0,0
0,0,0,0,0,0,0,0,0
91622,211,4,0,0,0,1,0,0
0,0,0,0,0,0,0,0,0
0,0,0,0,0,0,0,0,0
0,0,0,0,0,0,0,0,0
0,0,0,0,0,0,0,0,0
64197,56,0,2,2,0,0,1,0
64197,56,0,2,2,0,0,1,0
0,0,0,0,0,0,0,0,0
0,0,0,0,0,0,0,0,0
0,0,0,0,0,0,0,0,0
0,0,0,0,0,0,0,0,0
0,0,0,0,0,0,0,0,0
0,0,0,0,0,0,0,0,0
0,0,0,0,0,0,0,0,0
0,0,0,0,0,0,0,0,0
0,0,0,0,0,0,0,0,0
0,0,0,0,0,0,0,0,0
0,0,0,0,0,0,0,0,0
669380,542,0,4,4,0,2,1,1
0,0,0,0,0,0,0,0,0
0,0,0,0,0,0,0,0,0
0,0,0,0,0,0,0,0,0
0,0,0,0,0,0,0,0,0
0,0,0,0,0,0,0,0,0
135458,318,8,27,1,26,19,1,0
0,0,0,0,0,0,0,0,0
674977,556,0,4,4,0,2,1,1
0,0,0,0,0,0,0,0,0
2728,18,1,0,0,0,0,0,0
0,0,0,0,0,0,0,0,0
137632,436,10,127,119,8,9,0,0
65217,49,3,0,0,0,0,0,0
0,0,0,0,0,0,0,0,0
0,0,0,0,0,0,0,0,0
285972,181,4,1,1,0,0,1,0
0,0,0,0,0,0,0,0,0
23291,225,3,24,24,0,0,1,0
0,0,0,0,0,0,0,0,0
0,0,0,0,0,0,0,0,0
0,0,0,0,0,0,0,0,0
120259,244,3,5,5,0,2,1,0
0,0,0,0,0,0,0,0,0
0,0,0,0,0,0,0,0,0
0,0,0,0,0,0,0,0,0
0,0,0,0,0,0,0,0,0
7748,65,2,1,1,0,1,1,0
7748,65,2,1,1,0,1,1,0
7748,65,2,1,1,0,1,1,0
7748,65,2,1,1,0,1,1,0
7748,65,2,1,1,0,1,1,0
77709,47,2,0,0,0,2,0,0
36360,50,2,0,0,0,2,0,0
36360,50,2,0,0,0,2,0,0
36360,50,2,0,0,0,2,0,0
36401,50,2,0,0,0,2,0,0
36401,50,2,0,0,0,2,0,0
36360,50,2,0,0,0,2,0,0
246828,59,3,1,1,0,2,1,0
246828,59,3,1,1,0,2,1,0
36401,50,2,0,0,0,2,0,0
36401,50,2,0,0,0,2,0,0
6010146,71,5,1,1,0,2,1,0
246828,59,3,1,1,0,2,1,0
246828,59,3,1,1,0,2,1,0
246828,59,3,1,1,0,2,1,0
0,0,0,0,0,0,0,0,0
0,0,0,0,0,0,0,0,0
6010146,71,5,1,1,0,2,1,0
0,0,0,0,0,0,0,0,0
0,0,0,0,0,0,0,0,0
0,0,0,0,0,0,0,0,0
0,0,0,0,0,0,0,0,0
0,0,0,0,0,0,0,0,0
0,0,0,0,0,0,0,0,0
0,0,0,0,0,0,0,0,0
0,0,0,0,0,0,0,0,0
0,0,0,0,0,0,0,0,0
0,0,0,0,0,0,0,0,0
0,0,0,0,0,0,0,0,0
6010146,71,5,1,1,0,2,1,0
6010146,71,5,1,1,0,2,1,0
32101,163,4,17,16,1,4,0,0
32101,163,4,17,16,1,4,0,0
0,0,0,0,0,0,0,0,0
32101,163,4,17,16,1,4,0,0
32101,163,4,17,16,1,4,0,0
0,0,0,0,0,0,0,0,0
32101,163,4,17,16,1,4,0,0
32101,163,4,17,16,1,4,0,0
0,0,0,0,0,0,0,0,0
0,0,0,0,0,0,0,0,0
0,0,0,0,0,0,0,0,0
0,0,0,0,0,0,0,0,0
0,0,0,0,0,0,0,0,0
0,0,0,0,0,0,0,0,0
0,0,0,0,0,0,0,0,0
0,0,0,0,0,0,0,0,0
0,0,0,0,0,0,0,0,0
32101,163,4,17,16,1,4,0,0
0,0,0,0,0,0,0,0,0
0,0,0,0,0,0,0,0,0
0,0,0,0,0,0,0,0,0
0,0,0,0,0,0,0,0,0
0,0,0,0,0,0,0,0,0
0,0,0,0,0,0,0,0,0
0,0,0,0,0,0,0,0,0
145886,42,4,1,1,0,2,0,0
145886,42,4,1,1,0,2,0,0
0,0,0,0,0,0,0,0,0
0,0,0,0,0,0,0,0,0
145886,42,4,1,1,0,2,0,0
0,0,0,0,0,0,0,0,0
145886,42,4,1,1,0,2,0,0
0,0,0,0,0,0,0,0,0
15818,140,0,14,14,0,2,0,0
0,0,0,0,0,0,0,0,0
22416,50,0,0,0,0,0,0,0
0,0,0,0,0,0,0,0,0
0,0,0,0,0,0,0,0,0
67976,58,3,1,1,0,4,1,0
0,0,0,0,0,0,0,0,0
0,0,0,0,0,0,0,0,0
0,0,0,0,0,0,0,0,0
0,0,0,0,0,0,0,0,0
0,0,0,0,0,0,0,0,0
0,0,0,0,0,0,0,0,0
246347,122,4,7,7,0,3,1,0
263187,100,4,5,5,0,3,1,0
0,0,0,0,0,0,0,0,0
581132,62,4,3,3,0,2,1,0
6710,59,3,2,2,0,2,1,0
2781,24,1,3,0,3,0,0,0
534846,43,4,1,1,0,2,0,0
0,0,0,0,0,0,0,0,0
0,0,0,0,0,0,0,0,0
124389,353,2,11,1,10,0,1,0
0,0,0,0,0,0,0,0,0
0,0,0,0,0,0,0,0,0
300594,204,4,3,2,1,0,1,0
0,0,0,0,0,0,0,0,0
0,0,0,0,0,0,0,0,0
0,0,0,0,0,0,0,0,0
0,0,0,0,0,0,0,0,0
0,0,0,0,0,0,0,0,0
0,0,0,0,0,0,0,0,0
0,0,0,0,0,0,0,0,0
0,0,0,0,0,0,0,0,0
0,0,0,0,0,0,0,0,0
0,0,0,0,0,0,0,0,0
0,0,0,0,0,0,0,0,0
0,0,0,0,0,0,0,0,0
64136,56,0,2,2,0,0,1,0
64197,56,0,2,2,0,0,1,0
0,0,0,0,0,0,0,0,0
0,0,0,0,0,0,0,0,0
0,0,0,0,0,0,0,0,0
0,0,0,0,0,0,0,0,0
0,0,0,0,0,0,0,0,0
0,0,0,0,0,0,0,0,0
46690,47,2,3,0,3,2,0,0
46690,47,2,3,2,1,2,0,0
22353,147,1,1,0,1,0,1,0
22353,147,1,1,0,1,0,1,0
0,0,0,0,0,0,0,0,0
0,0,0,0,0,0,0,0,0
0,0,0,0,0,0,0,0,0
0,0,0,0,0,0,0,0,0
6330,64,2,6,4,2,0,1,0
9399,31,1,0,0,0,1,0,0
23291,225,3,24,24,0,0,1,0
0,0,0,0,0,0,0,0,0
0,0,0,0,0,0,0,0,0
0,0,0,0,0,0,0,0,0
64136,56,0,2,2,0,0,1,0
64136,56,0,2,2,0,0,1,0
64136,56,0,2,2,0,0,1,0
64136,56,0,2,2,0,0,1,0
65217,49,3,0,0,0,0,0,0
0,0,0,0,0,0,0,0,0
0,0,0,0,0,0,0,0,0
0,0,0,0,0,0,0,0,0
0,0,0,0,0,0,0,0,0
678372,556,0,4,0,4,2,1,1
678379,556,0,4,0,4,2,1,1
677341,556,0,4,0,4,2,1,1
21860,33,0,1,1,0,0,1,0
63105,406,3,52,51,1,3,1,0
2781,24,1,3,0,3,0,0,0
3701,34,1,6,0,6,0,0,0
0,0,0,0,0,0,0,0,0
0,0,0,0,0,0,0,0,0
0,0,0,0,0,0,0,0,0
339052,101,8,0,0,0,0,1,0
0,0,0,0,0,0,0,0,0
13275,142,0,56,51,5,0,0,0
25101,67,2,1,1,0,2,0,0
25101,67,2,1,1,0,2,0,0
33657,46,2,0,0,0,2,0,0
33657,46,2,0,0,0,2,0,0
33657,46,2,0,0,0,2,0,0
25094,67,2,1,1,0,2,0,0
25101,67,2,1,1,0,2,0,0
25101,67,2,1,1,0,2,0,0
25101,67,2,1,1,0,2,0,0
25101,67,2,1,1,0,2,0,0
0,0,0,0,0,0,0,0,0
0,0,0,0,0,0,0,0,0
0,0,0,0,0,0,0,0,0
0,0,0,0,0,0,0,0,0
0,0,0,0,0,0,0,0,0
0,0,0,0,0,0,0,0,0
0,0,0,0,0,0,0,0,0
0,0,0,0,0,0,0,0,0
0,0,0,0,0,0,0,0,0
0,0,0,0,0,0,0,0,0
327181,72,4,3,3,0,2,1,0
327181,72,4,3,3,0,2,1,0
0,0,0,0,0,0,0,0,0
0,0,0,0,0,0,0,0,0
0,0,0,0,0,0,0,0,0
0,0,0,0,0,0,0,0,0
0,0,0,0,0,0,0,0,0
327181,72,4,3,3,0,2,1,0
0,0,0,0,0,0,0,0,0
137433,67,4,0,0,0,2,1,0
327181,72,4,3,3,0,2,1,0
327181,72,4,3,3,0,2,1,0
327181,72,4,3,3,0,2,1,0
5050,24,3,0,0,0,0,0,0
137433,67,4,0,0,0,2,1,0
137433,67,4,0,0,0,2,1,0
137433,67,4,0,0,0,2,1,0
137433,67,4,0,0,0,2,1,0
5050,24,3,0,0,0,0,0,0
5050,24,3,0,0,0,0,0,0
5050,24,3,0,0,0,0,0,0
0,0,0,0,0,0,0,0,0
0,0,0,0,0,0,0,0,0
144414,59,4,3,3,0,2,1,0
144414,59,4,3,3,0,2,1,0
0,0,0,0,0,0,0,0,0
0,0,0,0,0,0,0,0,0
0,0,0,0,0,0,0,0,0
0,0,0,0,0,0,0,0,0
0,0,0,0,0,0,0,0,0
34447,50,2,0,0,0,2,0,0
34447,50,2,0,0,0,2,0,0
34447,50,2,0,0,0,2,0,0
34447,50,2,0,0,0,2,0,0
144414,59,4,3,3,0,2,1,0
144414,59,4,3,3,0,2,1,0
144414,59,4,3,3,0,2,1,0
144414,59,4,3,3,0,2,1,0
0,0,0,0,0,0,0,0,0
144414,59,4,3,3,0,2,1,0
0,0,0,0,0,0,0,0,0
16105,72,4,0,0,0,0,1,0
0,0,0,0,0,0,0,0,0
16105,72,4,0,0,0,0,1,0
16105,72,4,0,0,0,0,1,0
0,0,0,0,0,0,0,0,0
0,0,0,0,0,0,0,0,0
0,0,0,0,0,0,0,0,0
28102,173,0,9,9,0,0,0,0
0,0,0,0,0,0,0,0,0
0,0,0,0,0,0,0,0,0
7159,152,0,24,23,1,2,1,0
0,0,0,0,0,0,0,0,0
0,0,0,0,0,0,0,0,0
15227,35,0,2,2,0,0,0,0
0,0,0,0,0,0,0,0,0
53773,398,0,78,3,75,0,1,0
0,0,0,0,0,0,0,0,0
0,0,0,0,0,0,0,0,0
0,0,0,0,0,0,0,0,0
0,0,0,0,0,0,0,0,0
0,0,0,0,0,0,0,0,0
1072996,438,5,21,20,1,0,1,0
0,0,0,0,0,0,0,0,0
211760,46,5,0,0,0,0,0,0
211760,46,5,0,0,0,0,0,0
0,0,0,0,0,0,0,0,0
0,0,0,0,0,0,0,0,0
280225,188,6,1,1,0,0,1,0
0,0,0,0,0,0,0,0,0
0,0,0,0,0,0,0,0,0
13668,78,0,7,7,0,0,1,0
2752347,34,4,0,0,0,0,1,0
0,0,0,0,0,0,0,0,0
0,0,0,0,0,0,0,0,0
0,0,0,0,0,0,0,0,0
0,0,0,0,0,0,0,0,0
0,0,0,0,0,0,0,0,0
0,0,0,0,0,0,0,0,0
0,0,0,0,0,0,0,0,0
0,0,0,0,0,0,0,0,0
0,0,0,0,0,0,0,0,0
0,0,0,0,0,0,0,0,0
23219,177,0,2,0,2,0,0,0
23219,177,0,2,0,2,0,0,0
0,0,0,0,0,0,0,0,0
0,0,0,0,0,0,0,0,0
0,0,0,0,0,0,0,0,0
0,0,0,0,0,0,0,0,0
116569,719,0,151,149,2,14,1,0
0,0,0,0,0,0,0,0,0
65217,49,3,0,0,0,0,0,0
0,0,0,0,0,0,0,0,0
0,0,0,0,0,0,0,0,0
0,0,0,0,0,0,0,0,0
0,0,0,0,0,0,0,0,0
0,0,0,0,0,0,0,0,0
17962,218,0,23,23,0,0,1,0
0,0,0,0,0,0,0,0,0
131971,301,6,27,24,3,8,1,0
140542,404,8,28,24,4,34,1,0
65647,303,8,26,24,2,18,1,0
135012,314,8,26,24,2,19,1,0
0,0,0,0,0,0,0,0,0
83144,272,4,13,12,1,2,1,0
139830,404,8,27,24,3,34,1,0
0,0,0,0,0,0,0,0,0
0,0,0,0,0,0,0,0,0
139544,401,8,27,24,3,35,1,0
135460,318,8,27,24,3,19,1,0
53371,474,8,84,68,16,0,1,0
0,0,0,0,0,0,0,0,0
0,0,0,0,0,0,0,0,0
35062,432,5,131,8,123,5,0,0
0,0,0,0,0,0,0,0,0
0,0,0,0,0,0,0,0,0
312725,206,4,1,1,0,0,1,0
0,0,0,0,0,0,0,0,0
672093,556,0,4,4,0,2,1,1
0,0,0,0,0,0,0,0,0
0,0,0,0,0,0,0,0,0
64136,56,0,2,2,0,0,1,0
64336,56,0,2,2,0,0,1,0
0,0,0,0,0,0,0,0,0
0,0,0,0,0,0,0,0,0
0,0,0,0,0,0,0,0,0
3304,29,1,1,1,0,0,0,0
3304,29,1,1,1,0,0,0,0
0,0,0,0,0,0,0,0,0
0,0,0,0,0,0,0,0,0
0,0,0,0,0,0,0,0,0
65217,49,3,0,0,0,0,0,0
0,0,0,0,0,0,0,0,0
23291,225,3,24,24,0,0,1,0
0,0,0,0,0,0,0,0,0
33951,175,5,4,1,3,1,0,0
0,0,0,0,0,0,0,0,0
0,0,0,0,0,0,0,0,0
76887,830,7,140,127,13,2,1,0
0,0,0,0,0,0,0,0,0
0,0,0,0,0,0,0,0,0
144394,42,4,1,1,0,2,0,0
0,0,0,0,0,0,0,0,0
0,0,0,0,0,0,0,0,0
0,0,0,0,0,0,0,0,0
0,0,0,0,0,0,0,0,0
0,0,0,0,0,0,0,0,0
144394,42,4,1,1,0,2,0,0
144394,42,4,1,1,0,2,0,0
0,0,0,0,0,0,0,0,0
0,0,0,0,0,0,0,0,0
0,0,0,0,0,0,0,0,0
140685,49,3,5,5,0,0,0,0
140685,49,3,5,5,0,0,0,0
140685,49,3,5,5,0,0,0,0
140685,49,3,5,5,0,0,0,0
140685,49,3,5,5,0,0,0,0
0,0,0,0,0,0,0,0,0
0,0,0,0,0,0,0,0,0
0,0,0,0,0,0,0,0,0
0,0,0,0,0,0,0,0,0
0,0,0,0,0,0,0,0,0
0,0,0,0,0,0,0,0,0
0,0,0,0,0,0,0,0,0
0,0,0,0,0,0,0,0,0
0,0,0,0,0,0,0,0,0
0,0,0,0,0,0,0,0,0
0,0,0,0,0,0,0,0,0
0,0,0,0,0,0,0,0,0
0,0,0,0,0,0,0,0,0
0,0,0,0,0,0,0,0,0
0,0,0,0,0,0,0,0,0
144740,62,4,3,3,0,2,1,0
47194,54,2,0,0,0,1,0,0
47194,54,2,0,0,0,1,0,0
0,0,0,0,0,0,0,0,0
0,0,0,0,0,0,0,0,0
144740,62,4,3,3,0,2,1,0
47194,54,2,0,0,0,1,0,0
47194,54,2,0,0,0,1,0,0
144740,62,4,3,3,0,2,1,0
47194,54,2,0,0,0,1,0,0
47194,54,2,0,0,0,1,0,0
6978,50,2,1,1,0,0,1,0
6978,50,2,1,1,0,0,1,0
47194,54,2,0,0,0,1,0,0
6978,50,2,1,1,0,0,1,0
6978,50,2,1,1,0,0,1,0
1067088,60,4,3,3,0,2,1,0
6978,50,2,1,1,0,0,1,0
0,0,0,0,0,0,0,0,0
137035,42,4,1,1,0,2,0,0
137035,42,4,1,1,0,2,0,0
137035,42,4,1,1,0,2,0,0
137035,42,4,1,1,0,2,0,0
0,0,0,0,0,0,0,0,0
0,0,0,0,0,0,0,0,0
0,0,0,0,0,0,0,0,0
0,0,0,0,0,0,0,0,0
0,0,0,0,0,0,0,0,0
0,0,0,0,0,0,0,0,0
0,0,0,0,0,0,0,0,0
0,0,0,0,0,0,0,0,0
0,0,0,0,0,0,0,0,0
0,0,0,0,0,0,0,0,0
0,0,0,0,0,0,0,0,0
0,0,0,0,0,0,0,0,0
0,0,0,0,0,0,0,0,0
0,0,0,0,0,0,0,0,0
0,0,0,0,0,0,0,0,0
0,0,0,0,0,0,0,0,0
0,0,0,0,0,0,0,0,0
22353,147,1,1,0,1,0,1,0
22353,147,1,1,0,1,0,1,0
0,0,0,0,0,0,0,0,0
0,0,0,0,0,0,0,0,0
0,0,0,0,0,0,0,0,0
22440,50,0,0,0,0,0,0,0
0,0,0,0,0,0,0,0,0
0,0,0,0,0,0,0,0,0
32284,181,5,8,5,3,1,0,0
0,0,0,0,0,0,0,0,0
8389,93,1,4,0,4,2,1,0
28436,42,3,1,1,0,0,0,0
0,0,0,0,0,0,0,0,0
0,0,0,0,0,0,0,0,0
0,0,0,0,0,0,0,0,0
0,0,0,0,0,0,0,0,0
0,0,0,0,0,0,0,0,0
0,0,0,0,0,0,0,0,0
0,0,0,0,0,0,0,0,0
0,0,0,0,0,0,0,0,0
0,0,0,0,0,0,0,0,0
0,0,0,0,0,0,0,0,0
0,0,0,0,0,0,0,0,0
0,0,0,0,0,0,0,0,0
3275,11,0,0,0,0,0,0,0
5028,53,0,9,0,9,0,0,0
0,0,0,0,0,0,0,0,0
387957,1266,12,103,13,90,8,0,0
0,0,0,0,0,0,0,0,0
0,0,0,0,0,0,0,0,0
9212,28,1,2,2,0,0,0,0
232786,611,0,49,44,5,0,1,0
26677,36,0,3,1,2,0,0,0
0,0,0,0,0,0,0,0,0
0,0,0,0,0,0,0,0,0
65106,48,3,0,0,0,0,0,0
0,0,0,0,0,0,0,0,0
0,0,0,0,0,0,0,0,0
0,0,0,0,0,0,0,0,0
280780,189,4,1,1,0,0,1,0
15712,249,1,6,5,1,0,1,0
139378,401,8,27,24,3,34,1,0
0,0,0,0,0,0,0,0,0
0,0,0,0,0,0,0,0,0
0,0,0,0,0,0,0,0,0
0,0,0,0,0,0,0,0,0
0,0,0,0,0,0,0,0,0
0,0,0,0,0,0,0,0,0
0,0,0,0,0,0,0,0,0
0,0,0,0,0,0,0,0,0
0,0,0,0,0,0,0,0,0
0,0,0,0,0,0,0,0,0
0,0,0,0,0,0,0,0,0
0,0,0,0,0,0,0,0,0
0,0,0,0,0,0,0,0,0
0,0,0,0,0,0,0,0,0
0,0,0,0,0,0,0,0,0
0,0,0,0,0,0,0,0,0
0,0,0,0,0,0,0,0,0
0,0,0,0,0,0,0,0,0
0,0,0,0,0,0,0,0,0
0,0,0,0,0,0,0,0,0
673898,542,0,4,0,4,2,1,1
678654,556,0,4,0,4,2,1,1
0,0,0,0,0,0,0,0,0
32882,241,7,2,2,0,9,0,0
0,0,0,0,0,0,0,0,0
0,0,0,0,0,0,0,0,0
0,0,0,0,0,0,0,0,0
543,30,0,5,5,0,0,0,0
0,0,0,0,0,0,0,0,0
0,0,0,0,0,0,0,0,0
35477,167,7,20,17,3,1,1,0
0,0,0,0,0,0,0,0,0
138881,395,8,27,24,3,33,1,0
134969,317,8,27,24,3,19,1,0
0,0,0,0,0,0,0,0,0
0,0,0,0,0,0,0,0,0
0,0,0,0,0,0,0,0,0
0,0,0,0,0,0,0,0,0
0,0,0,0,0,0,0,0,0
0,0,0,0,0,0,0,0,0
0,0,0,0,0,0,0,0,0
0,0,0,0,0,0,0,0,0
855,14,0,1,1,0,0,0,0
0,0,0,0,0,0,0,0,0
0,0,0,0,0,0,0,0,0
0,0,0,0,0,0,0,0,0
0,0,0,0,0,0,0,0,0
0,0,0,0,0,0,0,0,0
0,0,0,0,0,0,0,0,0
10854,80,2,12,11,1,0,1,0
10854,80,2,12,11,1,0,1,0
10854,80,2,12,11,1,0,1,0
0,0,0,0,0,0,0,0,0
0,0,0,0,0,0,0,0,0
0,0,0,0,0,0,0,0,0
0,0,0,0,0,0,0,0,0
0,0,0,0,0,0,0,0,0
0,0,0,0,0,0,0,0,0
0,0,0,0,0,0,0,0,0
0,0,0,0,0,0,0,0,0
0,0,0,0,0,0,0,0,0
0,0,0,0,0,0,0,0,0
0,0,0,0,0,0,0,0,0
0,0,0,0,0,0,0,0,0
2369,33,1,3,0,3,0,0,0
7009,113,1,5,0,5,2,1,0
0,0,0,0,0,0,0,0,0
0,0,0,0,0,0,0,0,0
0,0,0,0,0,0,0,0,0
0,0,0,0,0,0,0,0,0
0,0,0,0,0,0,0,0,0
0,0,0,0,0,0,0,0,0
0,0,0,0,0,0,0,0,0
0,0,0,0,0,0,0,0,0
0,0,0,0,0,0,0,0,0
160573,1505,5,142,89,53,4,1,0
0,0,0,0,0,0,0,0,0
0,0,0,0,0,0,0,0,0
0,0,0,0,0,0,0,0,0
0,0,0,0,0,0,0,0,0
0,0,0,0,0,0,0,0,0
65217,49,3,0,0,0,0,0,0
28479,45,0,4,1,3,0,0,0
0,0,0,0,0,0,0,0,0
0,0,0,0,0,0,0,0,0
0,0,0,0,0,0,0,0,0
99653,68,4,0,0,0,2,1,0
188021,70,4,0,0,0,2,1,0
188021,70,4,0,0,0,2,1,0
0,0,0,0,0,0,0,0,0
0,0,0,0,0,0,0,0,0
0,0,0,0,0,0,0,0,0
0,0,0,0,0,0,0,0,0
0,0,0,0,0,0,0,0,0
0,0,0,0,0,0,0,0,0
0,0,0,0,0,0,0,0,0
0,0,0,0,0,0,0,0,0
0,0,0,0,0,0,0,0,0
0,0,0,0,0,0,0,0,0
12006,47,3,5,5,0,1,0,0
12006,47,3,5,5,0,1,0,0
135974,42,4,1,1,0,2,0,0
135974,42,4,1,1,0,2,0,0
12006,47,3,5,5,0,1,0,0
135974,42,4,1,1,0,2,0,0
135974,42,4,1,1,0,2,0,0
135974,42,4,1,1,0,2,0,0
0,0,0,0,0,0,0,0,0
0,0,0,0,0,0,0,0,0
0,0,0,0,0,0,0,0,0
0,0,0,0,0,0,0,0,0
0,0,0,0,0,0,0,0,0
0,0,0,0,0,0,0,0,0
0,0,0,0,0,0,0,0,0
0,0,0,0,0,0,0,0,0
534846,43,4,1,1,0,2,0,0
0,0,0,0,0,0,0,0,0
0,0,0,0,0,0,0,0,0
16928,69,3,5,5,0,0,0,0
0,0,0,0,0,0,0,0,0
8507,49,2,7,5,2,2,0,0
0,0,0,0,0,0,0,0,0
0,0,0,0,0,0,0,0,0
0,0,0,0,0,0,0,0,0
0,0,0,0,0,0,0,0,0
0,0,0,0,0,0,0,0,0
0,0,0,0,0,0,0,0,0
0,0,0,0,0,0,0,0,0
0,0,0,0,0,0,0,0,0
0,0,0,0,0,0,0,0,0
0,0,0,0,0,0,0,0,0
9734,106,2,6,1,5,5,1,0
1373454,7612,2,339,330,9,1,1,0
15909,339,4,31,28,3,0,1,0
0,0,0,0,0,0,0,0,0
0,0,0,0,0,0,0,0,0
0,0,0,0,0,0,0,0,0
0,0,0,0,0,0,0,0,0
0,0,0,0,0,0,0,0,0
0,0,0,0,0,0,0,0,0
261862,170,4,1,1,0,0,1,0
0,0,0,0,0,0,0,0,0
0,0,0,0,0,0,0,0,0
41167,175,1,4,2,2,0,0,0
0,0,0,0,0,0,0,0,0
0,0,0,0,0,0,0,0,0
0,0,0,0,0,0,0,0,0
0,0,0,0,0,0,0,0,0
0,0,0,0,0,0,0,0,0
25094,67,2,1,1,0,2,0,0
0,0,0,0,0,0,0,0,0
0,0,0,0,0,0,0,0,0
0,0,0,0,0,0,0,0,0
0,0,0,0,0,0,0,0,0
0,0,0,0,0,0,0,0,0
0,0,0,0,0,0,0,0,0
0,0,0,0,0,0,0,0,0
0,0,0,0,0,0,0,0,0
0,0,0,0,0,0,0,0,0
0,0,0,0,0,0,0,0,0
0,0,0,0,0,0,0,0,0
0,0,0,0,0,0,0,0,0
0,0,0,0,0,0,0,0,0
0,0,0,0,0,0,0,0,0
0,0,0,0,0,0,0,0,0
0,0,0,0,0,0,0,0,0
0,0,0,0,0,0,0,0,0
0,0,0,0,0,0,0,0,0
0,0,0,0,0,0,0,0,0
0,0,0,0,0,0,0,0,0
0,0,0,0,0,0,0,0,0
0,0,0,0,0,0,0,0,0
126209,56,4,2,1,1,0,1,0
126209,56,4,2,1,1,0,1,0
126187,56,4,2,1,1,0,1,0
126209,56,4,2,1,1,0,1,0
126187,56,4,2,1,1,0,1,0
126187,56,4,2,1,1,0,1,0
0,0,0,0,0,0,0,0,0
0,0,0,0,0,0,0,0,0
0,0,0,0,0,0,0,0,0
8432,53,3,1,1,0,4,0,0
8432,53,3,1,1,0,4,0,0
8432,53,3,1,1,0,4,0,0
0,0,0,0,0,0,0,0,0
0,0,0,0,0,0,0,0,0
327352,60,4,3,3,0,2,1,0
327352,60,4,3,3,0,2,1,0
8432,53,3,1,1,0,4,0,0
167640,63,4,0,0,0,2,0,0
167640,63,4,0,0,0,2,0,0
0,0,0,0,0,0,0,0,0
254921,159,0,41,39,2,0,0,0
0,0,0,0,0,0,0,0,0
0,0,0,0,0,0,0,0,0
212789,47,4,0,0,0,2,1,0
212789,47,4,0,0,0,2,1,0
327352,60,4,3,3,0,2,1,0
327352,60,4,3,3,0,2,1,0
327352,60,4,3,3,0,2,1,0
327352,60,4,3,3,0,2,1,0
0,0,0,0,0,0,0,0,0
0,0,0,0,0,0,0,0,0
167640,63,4,0,0,0,2,0,0
167640,63,4,0,0,0,2,0,0
98953,66,4,0,0,0,2,1,0
250228,75,0,17,15,2,0,0,0
250228,75,0,17,15,2,0,0,0
255896,159,0,41,39,2,0,0,0
255896,159,0,41,39,2,0,0,0
0,0,0,0,0,0,0,0,0
0,0,0,0,0,0,0,0,0
327352,60,4,3,3,0,2,1,0
98953,66,4,0,0,0,2,1,0
249877,75,0,17,15,2,0,0,0
249877,75,0,17,15,2,0,0,0
254921,159,0,41,39,2,0,0,0
254921,159,0,41,39,2,0,0,0
0,0,0,0,0,0,0,0,0
0,0,0,0,0,0,0,0,0
0,0,0,0,0,0,0,0,0
0,0,0,0,0,0,0,0,0
0,0,0,0,0,0,0,0,0
0,0,0,0,0,0,0,0,0
10181,151,2,28,23,5,0,0,0
10181,151,2,28,23,5,0,0,0
0,0,0,0,0,0,0,0,0
0,0,0,0,0,0,0,0,0
0,0,0,0,0,0,0,0,0
0,0,0,0,0,0,0,0,0
0,0,0,0,0,0,0,0,0
61359,13,0,0,0,0,0,0,0
0,0,0,0,0,0,0,0,0
0,0,0,0,0,0,0,0,0
0,0,0,0,0,0,0,0,0
0,0,0,0,0,0,0,0,0
0,0,0,0,0,0,0,0,0
0,0,0,0,0,0,0,0,0
0,0,0,0,0,0,0,0,0
0,0,0,0,0,0,0,0,0
0,0,0,0,0,0,0,0,0
0,0,0,0,0,0,0,0,0
0,0,0,0,0,0,0,0,0
0,0,0,0,0,0,0,0,0
0,0,0,0,0,0,0,0,0
0,0,0,0,0,0,0,0,0
0,0,0,0,0,0,0,0,0
0,0,0,0,0,0,0,0,0
0,0,0,0,0,0,0,0,0
0,0,0,0,0,0,0,0,0
0,0,0,0,0,0,0,0,0
0,0,0,0,0,0,0,0,0
0,0,0,0,0,0,0,0,0
0,0,0,0,0,0,0,0,0
0,0,0,0,0,0,0,0,0
0,0,0,0,0,0,0,0,0
0,0,0,0,0,0,0,0,0
0,0,0,0,0,0,0,0,0
0,0,0,0,0,0,0,0,0
0,0,0,0,0,0,0,0,0
0,0,0,0,0,0,0,0,0
0,0,0,0,0,0,0,0,0
0,0,0,0,0,0,0,0,0
0,0,0,0,0,0,0,0,0
29168,62,4,2,2,0,2,0,0
29168,62,4,2,2,0,2,0,0
17324,138,0,1,0,1,0,1,0
17324,138,0,1,0,1,0,1,0
0,0,0,0,0,0,0,0,0
2673,21,2,1,0,1,0,0,0
0,0,0,0,0,0,0,0,0
0,0,0,0,0,0,0,0,0
15910,339,4,31,28,3,0,1,0
0,0,0,0,0,0,0,0,0
0,0,0,0,0,0,0,0,0
0,0,0,0,0,0,0,0,0
0,0,0,0,0,0,0,0,0
0,0,0,0,0,0,0,0,0
0,0,0,0,0,0,0,0,0
0,0,0,0,0,0,0,0,0
0,0,0,0,0,0,0,0,0
2673,21,2,1,0,1,0,0,0
0,0,0,0,0,0,0,0,0
670311,542,0,4,4,0,2,1,1
0,0,0,0,0,0,0,0,0
0,0,0,0,0,0,0,0,0
0,0,0,0,0,0,0,0,0
10913,14,0,1,0,1,0,0,0
0,0,0,0,0,0,0,0,0
0,0,0,0,0,0,0,0,0
0,0,0,0,0,0,0,0,0
0,0,0,0,0,0,0,0,0
0,0,0,0,0,0,0,0,0
0,0,0,0,0,0,0,0,0
0,0,0,0,0,0,0,0,0
0,0,0,0,0,0,0,0,0
366773,187,4,1,1,0,0,1,0
7246,52,0,6,6,0,0,1,0
21229,261,7,30,30,0,0,1,0
0,0,0,0,0,0,0,0,0
107181,457,1,13,5,8,7,1,0
21653,303,4,51,50,1,2,1,0
0,0,0,0,0,0,0,0,0
0,0,0,0,0,0,0,0,0
98823,211,4,0,0,0,1,0,0
0,0,0,0,0,0,0,0,0
0,0,0,0,0,0,0,0,0
0,0,0,0,0,0,0,0,0
0,0,0,0,0,0,0,0,0
37351,53,3,0,0,0,2,0,0
0,0,0,0,0,0,0,0,0
0,0,0,0,0,0,0,0,0
14449,41,2,0,0,0,2,0,0
0,0,0,0,0,0,0,0,0
14449,41,2,0,0,0,2,0,0
144391,42,4,1,1,0,2,0,0
14449,41,2,0,0,0,2,0,0
0,0,0,0,0,0,0,0,0
0,0,0,0,0,0,0,0,0
37351,53,3,0,0,0,2,0,0
37351,53,3,0,0,0,2,0,0
37351,53,3,0,0,0,2,0,0
14449,41,2,0,0,0,2,0,0
37351,53,3,0,0,0,2,0,0
0,0,0,0,0,0,0,0,0
0,0,0,0,0,0,0,0,0
0,0,0,0,0,0,0,0,0
0,0,0,0,0,0,0,0,0
16759,33,1,0,0,0,1,0,0
16759,33,1,0,0,0,1,0,0
144391,42,4,1,1,0,2,0,0
144391,42,4,1,1,0,2,0,0
0,0,0,0,0,0,0,0,0
0,0,0,0,0,0,0,0,0
0,0,0,0,0,0,0,0,0
0,0,0,0,0,0,0,0,0
0,0,0,0,0,0,0,0,0
0,0,0,0,0,0,0,0,0
0,0,0,0,0,0,0,0,0
0,0,0,0,0,0,0,0,0
0,0,0,0,0,0,0,0,0
0,0,0,0,0,0,0,0,0
0,0,0,0,0,0,0,0,0
0,0,0,0,0,0,0,0,0
0,0,0,0,0,0,0,0,0
0,0,0,0,0,0,0,0,0
0,0,0,0,0,0,0,0,0
0,0,0,0,0,0,0,0,0
0,0,0,0,0,0,0,0,0
0,0,0,0,0,0,0,0,0
0,0,0,0,0,0,0,0,0
0,0,0,0,0,0,0,0,0
144384,42,4,1,1,0,2,0,0
0,0,0,0,0,0,0,0,0
292570,63,2,0,0,0,2,0,0
292570,63,2,0,0,0,2,0,0
0,0,0,0,0,0,0,0,0
0,0,0,0,0,0,0,0,0
0,0,0,0,0,0,0,0,0
0,0,0,0,0,0,0,0,0
0,0,0,0,0,0,0,0,0
0,0,0,0,0,0,0,0,0
0,0,0,0,0,0,0,0,0
292570,63,2,0,0,0,2,0,0
0,0,0,0,0,0,0,0,0
212789,47,4,0,0,0,2,1,0
212789,47,4,0,0,0,2,1,0
5989111,71,5,1,1,0,2,1,0
5989111,71,5,1,1,0,2,1,0
144384,42,4,1,1,0,2,0,0
144384,42,4,1,1,0,2,0,0
41500,76,3,0,0,0,0,0,0
0,0,0,0,0,0,0,0,0
41500,76,3,0,0,0,0,0,0
41500,76,3,0,0,0,0,0,0
212789,47,4,0,0,0,2,1,0
212789,47,4,0,0,0,2,1,0
0,0,0,0,0,0,0,0,0
5989111,71,5,1,1,0,2,1,0
0,0,0,0,0,0,0,0,0
212789,47,4,0,0,0,2,1,0
41500,76,3,0,0,0,0,0,0
41500,76,3,0,0,0,0,0,0
5989111,71,5,1,1,0,2,1,0
0,0,0,0,0,0,0,0,0
0,0,0,0,0,0,0,0,0
0,0,0,0,0,0,0,0,0
0,0,0,0,0,0,0,0,0
0,0,0,0,0,0,0,0,0
19857,155,2,28,23,5,0,0,0
19857,155,2,28,23,5,0,0,0
19857,155,2,28,23,5,0,0,0
19857,155,2,28,23,5,0,0,0
19857,155,2,28,23,5,0,0,0
0,0,0,0,0,0,0,0,0
0,0,0,0,0,0,0,0,0
0,0,0,0,0,0,0,0,0
0,0,0,0,0,0,0,0,0
0,0,0,0,0,0,0,0,0
343753,76,3,0,0,0,0,1,0
64912,56,0,2,2,0,0,1,0
64912,56,0,2,2,0,0,1,0
77747,101,1,4,2,2,0,0,0
64973,56,0,2,2,0,0,1,0
0,0,0,0,0,0,0,0,0
0,0,0,0,0,0,0,0,0
0,0,0,0,0,0,0,0,0
0,0,0,0,0,0,0,0,0
0,0,0,0,0,0,0,0,0
0,0,0,0,0,0,0,0,0
0,0,0,0,0,0,0,0,0
0,0,0,0,0,0,0,0,0
0,0,0,0,0,0,0,0,0
91160,209,4,0,0,0,1,0,0
36265,182,6,4,1,3,1,0,0
0,0,0,0,0,0,0,0,0
93499,220,5,0,0,0,4,0,0
91559,211,4,0,0,0,1,0,0
0,0,0,0,0,0,0,0,0
0,0,0,0,0,0,0,0,0
0,0,0,0,0,0,0,0,0
0,0,0,0,0,0,0,0,0
0,0,0,0,0,0,0,0,0
0,0,0,0,0,0,0,0,0
0,0,0,0,0,0,0,0,0
0,0,0,0,0,0,0,0,0
0,0,0,0,0,0,0,0,0
0,0,0,0,0,0,0,0,0
6330,64,2,6,4,2,0,1,0
0,0,0,0,0,0,0,0,0
0,0,0,0,0,0,0,0,0
0,0,0,0,0,0,0,0,0
0,0,0,0,0,0,0,0,0
0,0,0,0,0,0,0,0,0
0,0,0,0,0,0,0,0,0
0,0,0,0,0,0,0,0,0
0,0,0,0,0,0,0,0,0
0,0,0,0,0,0,0,0,0
0,0,0,0,0,0,0,0,0
0,0,0,0,0,0,0,0,0
0,0,0,0,0,0,0,0,0
0,0,0,0,0,0,0,0,0
0,0,0,0,0,0,0,0,0
0,0,0,0,0,0,0,0,0
0,0,0,0,0,0,0,0,0
0,0,0,0,0,0,0,0,0
0,0,0,0,0,0,0,0,0
123911,28,1,2,1,1,0,0,0
0,0,0,0,0,0,0,0,0
0,0,0,0,0,0,0,0,0
0,0,0,0,0,0,0,0,0
0,0,0,0,0,0,0,0,0
0,0,0,0,0,0,0,0,0
0,0,0,0,0,0,0,0,0
0,0,0,0,0,0,0,0,0
64973,56,0,2,2,0,0,1,0
64912,56,0,2,2,0,0,1,0
0,0,0,0,0,0,0,0,0
100335,529,8,53,48,5,2,0,0
16793,263,0,6,6,0,1,0,0
0,0,0,0,0,0,0,0,0
2673,21,2,1,0,1,0,0,0
0,0,0,0,0,0,0,0,0
0,0,0,0,0,0,0,0,0
0,0,0,0,0,0,0,0,0
0,0,0,0,0,0,0,0,0
0,0,0,0,0,0,0,0,0
0,0,0,0,0,0,0,0,0
0,0,0,0,0,0,0,0,0
0,0,0,0,0,0,0,0,0
677086,556,0,4,0,4,2,1,1
35845,61,3,3,3,0,0,0,0
64965,49,3,0,0,0,0,0,0
0,0,0,0,0,0,0,0,0
9328,81,1,0,0,0,0,0,0
0,0,0,0,0,0,0,0,0
123911,28,1,2,2,0,0,0,0
0,0,0,0,0,0,0,0,0
0,0,0,0,0,0,0,0,0
675943,556,0,4,0,4,2,1,1
0,0,0,0,0,0,0,0,0
0,0,0,0,0,0,0,0,0
0,0,0,0,0,0,0,0,0
0,0,0,0,0,0,0,0,0
65076,50,3,0,0,0,0,0,0
0,0,0,0,0,0,0,0,0
28642,164,6,4,1,3,1,0,0
28648,164,6,4,1,3,1,0,0
91471,211,4,0,0,0,1,0,0
29010,176,6,4,2,2,1,0,0
91598,211,4,0,0,0,1,0,0
37105,209,6,4,1,3,1,0,0
0,0,0,0,0,0,0,0,0
0,0,0,0,0,0,0,0,0
0,0,0,0,0,0,0,0,0
6760,30,2,0,0,0,1,0,0
6760,30,2,0,0,0,1,0,0
6760,30,2,0,0,0,1,0,0
6760,30,2,0,0,0,1,0,0
0,0,0,0,0,0,0,0,0
293458,42,4,0,0,0,3,0,0
0,0,0,0,0,0,0,0,0
293458,42,4,0,0,0,3,0,0
293458,42,4,0,0,0,3,0,0
0,0,0,0,0,0,0,0,0
293458,42,4,0,0,0,3,0,0
7021,30,0,3,0,3,0,1,0
0,0,0,0,0,0,0,0,0
0,0,0,0,0,0,0,0,0
109932,49,3,0,0,0,0,0,0
0,0,0,0,0,0,0,0,0
0,0,0,0,0,0,0,0,0
109932,49,3,0,0,0,0,0,0
109932,49,3,0,0,0,0,0,0
0,0,0,0,0,0,0,0,0
0,0,0,0,0,0,0,0,0
0,0,0,0,0,0,0,0,0
0,0,0,0,0,0,0,0,0
0,0,0,0,0,0,0,0,0
0,0,0,0,0,0,0,0,0
0,0,0,0,0,0,0,0,0
0,0,0,0,0,0,0,0,0
0,0,0,0,0,0,0,0,0
0,0,0,0,0,0,0,0,0
144740,62,4,3,3,0,2,1,0
17246,21,0,0,0,0,0,0,0
144740,62,4,3,3,0,2,1,0
17246,21,0,0,0,0,0,0,0
0,0,0,0,0,0,0,0,0
0,0,0,0,0,0,0,0,0
0,0,0,0,0,0,0,0,0
0,0,0,0,0,0,0,0,0
0,0,0,0,0,0,0,0,0
0,0,0,0,0,0,0,0,0
0,0,0,0,0,0,0,0,0
0,0,0,0,0,0,0,0,0
0,0,0,0,0,0,0,0,0
0,0,0,0,0,0,0,0,0
0,0,0,0,0,0,0,0,0
0,0,0,0,0,0,0,0,0
0,0,0,0,0,0,0,0,0
0,0,0,0,0,0,0,0,0
0,0,0,0,0,0,0,0,0
0,0,0,0,0,0,0,0,0
0,0,0,0,0,0,0,0,0
0,0,0,0,0,0,0,0,0
0,0,0,0,0,0,0,0,0
0,0,0,0,0,0,0,0,0
0,0,0,0,0,0,0,0,0
0,0,0,0,0,0,0,0,0
0,0,0,0,0,0,0,0,0
0,0,0,0,0,0,0,0,0
0,0,0,0,0,0,0,0,0
0,0,0,0,0,0,0,0,0
144741,62,4,3,3,0,2,1,0
144736,62,4,3,3,0,2,1,0
144741,62,4,3,3,0,2,1,0
0,0,0,0,0,0,0,0,0
0,0,0,0,0,0,0,0,0
0,0,0,0,0,0,0,0,0
0,0,0,0,0,0,0,0,0
0,0,0,0,0,0,0,0,0
0,0,0,0,0,0,0,0,0
0,0,0,0,0,0,0,0,0
0,0,0,0,0,0,0,0,0
0,0,0,0,0,0,0,0,0
0,0,0,0,0,0,0,0,0
655873,28,1,0,0,0,0,0,0
0,0,0,0,0,0,0,0,0
0,0,0,0,0,0,0,0,0
655873,28,1,0,0,0,0,0,0
655873,28,1,0,0,0,0,0,0
0,0,0,0,0,0,0,0,0
0,0,0,0,0,0,0,0,0
144736,62,4,3,3,0,2,1,0
0,0,0,0,0,0,0,0,0
0,0,0,0,0,0,0,0,0
144736,62,4,3,3,0,2,1,0
0,0,0,0,0,0,0,0,0
0,0,0,0,0,0,0,0,0
0,0,0,0,0,0,0,0,0
0,0,0,0,0,0,0,0,0
0,0,0,0,0,0,0,0,0
0,0,0,0,0,0,0,0,0
0,0,0,0,0,0,0,0,0
0,0,0,0,0,0,0,0,0
0,0,0,0,0,0,0,0,0
0,0,0,0,0,0,0,0,0
0,0,0,0,0,0,0,0,0
0,0,0,0,0,0,0,0,0
0,0,0,0,0,0,0,0,0
0,0,0,0,0,0,0,0,0
0,0,0,0,0,0,0,0,0
0,0,0,0,0,0,0,0,0
549738,613,6,21,21,0,0,1,0
0,0,0,0,0,0,0,0,0
0,0,0,0,0,0,0,0,0
0,0,0,0,0,0,0,0,0
0,0,0,0,0,0,0,0,0
0,0,0,0,0,0,0,0,0
0,0,0,0,0,0,0,0,0
0,0,0,0,0,0,0,0,0
0,0,0,0,0,0,0,0,0
0,0,0,0,0,0,0,0,0
0,0,0,0,0,0,0,0,0
0,0,0,0,0,0,0,0,0
0,0,0,0,0,0,0,0,0
0,0,0,0,0,0,0,0,0
0,0,0,0,0,0,0,0,0
192498,48,0,2,1,1,0,1,0
0,0,0,0,0,0,0,0,0
0,0,0,0,0,0,0,0,0
0,0,0,0,0,0,0,0,0
0,0,0,0,0,0,0,0,0
0,0,0,0,0,0,0,0,0
0,0,0,0,0,0,0,0,0
0,0,0,0,0,0,0,0,0
0,0,0,0,0,0,0,0,0
0,0,0,0,0,0,0,0,0
0,0,0,0,0,0,0,0,0
0,0,0,0,0,0,0,0,0
0,0,0,0,0,0,0,0,0
0,0,0,0,0,0,0,0,0
0,0,0,0,0,0,0,0,0
0,0,0,0,0,0,0,0,0
0,0,0,0,0,0,0,0,0
0,0,0,0,0,0,0,0,0
0,0,0,0,0,0,0,0,0
64912,56,0,2,2,0,0,1,0
64912,56,0,2,2,0,0,1,0
16282,89,0,15,1,14,0,1,0
0,0,0,0,0,0,0,0,0
2142,38,4,2,1,1,0,1,0
123917,28,1,2,1,1,0,0,0
123917,28,1,2,2,0,0,0,0
100295,529,8,53,48,5,2,0,0
64973,56,0,2,2,0,0,1,0
64973,56,0,2,2,0,0,1,0
117294,870,8,69,60,9,1,0,0
0,0,0,0,0,0,0,0,0
0,0,0,0,0,0,0,0,0
2673,21,2,1,0,1,0,0,0
2673,21,2,1,0,1,0,0,0
0,0,0,0,0,0,0,0,0
0,0,0,0,0,0,0,0,0
140813,68,1,3,3,0,0,1,0
26797,36,0,3,1,2,0,0,0
0,0,0,0,0,0,0,0,0
0,0,0,0,0,0,0,0,0
0,0,0,0,0,0,0,0,0
0,0,0,0,0,0,0,0,0
6685,70,1,1,1,0,0,0,0
6685,70,1,1,1,0,0,0,0
159163,1167,5,272,190,82,10,1,0
16509,79,3,4,3,1,1,0,0
91685,211,4,0,0,0,1,0,0
47193,549,3,120,117,3,8,0,0
16998,31,0,1,1,0,0,1,0
0,0,0,0,0,0,0,0,0
17014,31,0,1,1,0,0,1,0
0,0,0,0,0,0,0,0,0
0,0,0,0,0,0,0,0,0
0,0,0,0,0,0,0,0,0
0,0,0,0,0,0,0,0,0
0,0,0,0,0,0,0,0,0
23772,37,0,3,1,2,0,0,0
65008,49,3,0,0,0,0,0,0
0,0,0,0,0,0,0,0,0
0,0,0,0,0,0,0,0,0
0,0,0,0,0,0,0,0,0
0,0,0,0,0,0,0,0,0
0,0,0,0,0,0,0,0,0
0,0,0,0,0,0,0,0,0
0,0,0,0,0,0,0,0,0
0,0,0,0,0,0,0,0,0
0,0,0,0,0,0,0,0,0
0,0,0,0,0,0,0,0,0
0,0,0,0,0,0,0,0,0
0,0,0,0,0,0,0,0,0
0,0,0,0,0,0,0,0,0
0,0,0,0,0,0,0,0,0
23291,225,3,24,24,0,0,1,0
220550,1362,14,40,35,5,18,0,0
219144,1361,14,40,35,5,18,0,0
14910,142,0,56,52,4,0,0,0
65118,50,3,0,0,0,0,0,0
0,0,0,0,0,0,0,0,0
0,0,0,0,0,0,0,0,0
65119,50,3,0,0,0,0,0,0
0,0,0,0,0,0,0,0,0
0,0,0,0,0,0,0,0,0
0,0,0,0,0,0,0,0,0
0,0,0,0,0,0,0,0,0
0,0,0,0,0,0,0,0,0
0,0,0,0,0,0,0,0,0
449292,326,4,9,4,5,0,1,0
0,0,0,0,0,0,0,0,0
0,0,0,0,0,0,0,0,0
0,0,0,0,0,0,0,0,0
0,0,0,0,0,0,0,0,0
0,0,0,0,0,0,0,0,0
0,0,0,0,0,0,0,0,0
0,0,0,0,0,0,0,0,0
0,0,0,0,0,0,0,0,0
0,0,0,0,0,0,0,0,0
0,0,0,0,0,0,0,0,0
0,0,0,0,0,0,0,0,0
295982,214,4,1,1,0,0,1,0
0,0,0,0,0,0,0,0,0
0,0,0,0,0,0,0,0,0
107722,475,1,3,3,0,4,0,0
5639,72,5,3,1,2,0,1,0
0,0,0,0,0,0,0,0,0
45268,178,2,1,1,0,1,0,0
3304,29,1,1,1,0,0,0,0
0,0,0,0,0,0,0,0,0
0,0,0,0,0,0,0,0,0
25061,67,2,1,1,0,2,0,0
88784,60,0,5,5,0,0,1,0
37357,53,3,0,0,0,2,0,0
293458,42,4,0,0,0,3,0,0
88784,60,0,5,5,0,0,1,0
37357,53,3,0,0,0,2,0,0
88784,60,0,5,5,0,0,1,0
37357,53,3,0,0,0,2,0,0
37357,53,3,0,0,0,2,0,0
37357,53,3,0,0,0,2,0,0
25061,67,2,1,1,0,2,0,0
0,0,0,0,0,0,0,0,0
0,0,0,0,0,0,0,0,0
23492,59,4,3,3,0,2,1,0
23492,59,4,3,3,0,2,1,0
0,0,0,0,0,0,0,0,0
0,0,0,0,0,0,0,0,0
0,0,0,0,0,0,0,0,0
0,0,0,0,0,0,0,0,0
25061,67,2,1,1,0,2,0,0
0,0,0,0,0,0,0,0,0
0,0,0,0,0,0,0,0,0
0,0,0,0,0,0,0,0,0
0,0,0,0,0,0,0,0,0
0,0,0,0,0,0,0,0,0
0,0,0,0,0,0,0,0,0
0,0,0,0,0,0,0,0,0
0,0,0,0,0,0,0,0,0
0,0,0,0,0,0,0,0,0
0,0,0,0,0,0,0,0,0
0,0,0,0,0,0,0,0,0
0,0,0,0,0,0,0,0,0
0,0,0,0,0,0,0,0,0
0,0,0,0,0,0,0,0,0
23492,59,4,3,3,0,2,1,0
0,0,0,0,0,0,0,0,0
23492,59,4,3,3,0,2,1,0
0,0,0,0,0,0,0,0,0
0,0,0,0,0,0,0,0,0
144738,62,4,3,3,0,2,1,0
144738,62,4,3,3,0,2,1,0
0,0,0,0,0,0,0,0,0
0,0,0,0,0,0,0,0,0
144738,62,4,3,3,0,2,1,0
135965,42,4,1,1,0,2,0,0
135965,42,4,1,1,0,2,0,0
0,0,0,0,0,0,0,0,0
0,0,0,0,0,0,0,0,0
0,0,0,0,0,0,0,0,0
0,0,0,0,0,0,0,0,0
0,0,0,0,0,0,0,0,0
329719,78,4,0,0,0,2,1,0
329719,78,4,0,0,0,2,1,0
0,0,0,0,0,0,0,0,0
0,0,0,0,0,0,0,0,0
0,0,0,0,0,0,0,0,0
0,0,0,0,0,0,0,0,0
0,0,0,0,0,0,0,0,0
0,0,0,0,0,0,0,0,0
0,0,0,0,0,0,0,0,0
0,0,0,0,0,0,0,0,0
0,0,0,0,0,0,0,0,0
34479,50,2,0,0,0,2,0,0
34479,50,2,0,0,0,2,0,0
0,0,0,0,0,0,0,0,0
468176,1047,0,52,6,46,0,0,0
77722,101,1,4,2,2,0,0,0
0,0,0,0,0,0,0,0,0
143046,326,3,6,6,0,0,1,0
0,0,0,0,0,0,0,0,0
0,0,0,0,0,0,0,0,0
0,0,0,0,0,0,0,0,0
164097,79,1,9,0,9,0,1,0
0,0,0,0,0,0,0,0,0
0,0,0,0,0,0,0,0,0
0,0,0,0,0,0,0,0,0
0,0,0,0,0,0,0,0,0
0,0,0,0,0,0,0,0,0
0,0,0,0,0,0,0,0,0
0,0,0,0,0,0,0,0,0
0,0,0,0,0,0,0,0,0
0,0,0,0,0,0,0,0,0
0,0,0,0,0,0,0,0,0
0,0,0,0,0,0,0,0,0
0,0,0,0,0,0,0,0,0
0,0,0,0,0,0,0,0,0
0,0,0,0,0,0,0,0,0
0,0,0,0,0,0,0,0,0
0,0,0,0,0,0,0,0,0
15597,124,2,25,24,1,2,1,0
15595,124,2,25,24,1,2,1,0
0,0,0,0,0,0,0,0,0
0,0,0,0,0,0,0,0,0
0,0,0,0,0,0,0,0,0
0,0,0,0,0,0,0,0,0
0,0,0,0,0,0,0,0,0
11578,85,0,15,14,1,0,1,0
0,0,0,0,0,0,0,0,0
0,0,0,0,0,0,0,0,0
0,0,0,0,0,0,0,0,0
0,0,0,0,0,0,0,0,0
0,0,0,0,0,0,0,0,0
0,0,0,0,0,0,0,0,0
0,0,0,0,0,0,0,0,0
47018,549,3,120,117,3,8,0,0
47102,549,3,120,117,3,8,0,0
0,0,0,0,0,0,0,0,0
47122,549,3,120,117,3,8,0,0
0,0,0,0,0,0,0,0,0
0,0,0,0,0,0,0,0,0
0,0,0,0,0,0,0,0,0
0,0,0,0,0,0,0,0,0
0,0,0,0,0,0,0,0,0
0,0,0,0,0,0,0,0,0
0,0,0,0,0,0,0,0,0
7703,69,2,1,1,0,2,1,0
64973,56,0,2,2,0,0,1,0
2673,21,2,1,0,1,0,0,0
2673,21,2,1,0,1,0,0,0
0,0,0,0,0,0,0,0,0
35689,28,1,2,2,0,0,0,0
0,0,0,0,0,0,0,0,0
0,0,0,0,0,0,0,0,0
0,0,0,0,0,0,0,0,0
0,0,0,0,0,0,0,0,0
0,0,0,0,0,0,0,0,0
0,0,0,0,0,0,0,0,0
0,0,0,0,0,0,0,0,0
65119,50,3,0,0,0,0,0,0
0,0,0,0,0,0,0,0,0
0,0,0,0,0,0,0,0,0
0,0,0,0,0,0,0,0,0
61745,367,1,6,4,2,0,0,0
0,0,0,0,0,0,0,0,0
0,0,0,0,0,0,0,0,0
8669,47,1,3,3,0,0,0,0
0,0,0,0,0,0,0,0,0
12914,113,1,1,1,0,0,0,0
12912,113,1,1,1,0,0,0,0
0,0,0,0,0,0,0,0,0
0,0,0,0,0,0,0,0,0
0,0,0,0,0,0,0,0,0
0,0,0,0,0,0,0,0,0
10855,33,1,0,0,0,1,0,0
10855,33,1,0,0,0,1,0,0
10855,33,1,0,0,0,1,0,0
0,0,0,0,0,0,0,0,0
10855,33,1,0,0,0,1,0,0
0,0,0,0,0,0,0,0,0
0,0,0,0,0,0,0,0,0
0,0,0,0,0,0,0,0,0
0,0,0,0,0,0,0,0,0
0,0,0,0,0,0,0,0,0
0,0,0,0,0,0,0,0,0
0,0,0,0,0,0,0,0,0
327249,60,4,3,3,0,2,1,0
327249,60,4,3,3,0,2,1,0
5067,24,3,0,0,0,0,0,0
0,0,0,0,0,0,0,0,0
21860,33,0,1,1,0,0,1,0
327249,60,4,3,3,0,2,1,0
327249,60,4,3,3,0,2,1,0
327249,60,4,3,3,0,2,1,0
327249,60,4,3,3,0,2,1,0
327249,60,4,3,3,0,2,1,0
5067,24,3,0,0,0,0,0,0
5067,24,3,0,0,0,0,0,0
5067,24,3,0,0,0,0,0,0
5067,24,3,0,0,0,0,0,0
5067,24,3,0,0,0,0,0,0
5067,24,3,0,0,0,0,0,0
5067,24,3,0,0,0,0,0,0
5067,24,3,0,0,0,0,0,0
5067,24,3,0,0,0,0,0,0
5067,24,3,0,0,0,0,0,0
0,0,0,0,0,0,0,0,0
0,0,0,0,0,0,0,0,0
0,0,0,0,0,0,0,0,0
0,0,0,0,0,0,0,0,0
0,0,0,0,0,0,0,0,0
0,0,0,0,0,0,0,0,0
0,0,0,0,0,0,0,0,0
0,0,0,0,0,0,0,0,0
0,0,0,0,0,0,0,0,0
0,0,0,0,0,0,0,0,0
0,0,0,0,0,0,0,0,0
0,0,0,0,0,0,0,0,0
16202,85,3,6,5,1,4,0,0
0,0,0,0,0,0,0,0,0
0,0,0,0,0,0,0,0,0
0,0,0,0,0,0,0,0,0
0,0,0,0,0,0,0,0,0
0,0,0,0,0,0,0,0,0
0,0,0,0,0,0,0,0,0
0,0,0,0,0,0,0,0,0
0,0,0,0,0,0,0,0,0
0,0,0,0,0,0,0,0,0
0,0,0,0,0,0,0,0,0
0,0,0,0,0,0,0,0,0
0,0,0,0,0,0,0,0,0
0,0,0,0,0,0,0,0,0
0,0,0,0,0,0,0,0,0
0,0,0,0,0,0,0,0,0
0,0,0,0,0,0,0,0,0
0,0,0,0,0,0,0,0,0
0,0,0,0,0,0,0,0,0
25225,57,0,9,4,5,0,0,0
138560,259,1,20,7,13,7,1,0
28052,97,0,2,0,2,2,0,0
35674,28,1,2,2,0,0,0,0
35674,28,1,2,1,1,0,0,0
0,0,0,0,0,0,0,0,0
11303,266,3,24,24,0,1,1,0
192635,518,10,63,60,3,3,1,0
3385,41,0,6,0,6,0,0,0
65119,50,3,0,0,0,0,0,0
65117,50,3,0,0,0,0,0,0
1028,28,0,2,2,0,0,0,0
1028,28,0,2,2,0,0,0,0
0,0,0,0,0,0,0,0,0
21751,110,2,11,8,3,5,0,0
27779,153,6,2,1,1,1,0,0
0,0,0,0,0,0,0,0,0
0,0,0,0,0,0,0,0,0
0,0,0,0,0,0,0,0,0
0,0,0,0,0,0,0,0,0
0,0,0,0,0,0,0,0,0
275358,170,4,1,1,0,0,1,0
0,0,0,0,0,0,0,0,0
0,0,0,0,0,0,0,0,0
46787,549,3,120,117,3,8,0,0
0,0,0,0,0,0,0,0,0
0,0,0,0,0,0,0,0,0
0,0,0,0,0,0,0,0,0
0,0,0,0,0,0,0,0,0
7424,164,0,26,26,0,0,0,0
0,0,0,0,0,0,0,0,0
0,0,0,0,0,0,0,0,0
73917,434,10,35,32,3,1,1,0
35674,28,1,2,2,0,0,0,0
35675,28,1,2,1,1,0,0,0
47316,549,3,120,117,3,8,0,0
35675,28,1,2,2,0,0,0,0
35674,28,1,2,1,1,0,0,0
0,0,0,0,0,0,0,0,0
676595,556,0,4,2,2,2,1,1
9197,28,1,2,2,0,0,0,0
0,0,0,0,0,0,0,0,0
0,0,0,0,0,0,0,0,0
0,0,0,0,0,0,0,0,0
0,0,0,0,0,0,0,0,0
0,0,0,0,0,0,0,0,0
0,0,0,0,0,0,0,0,0
0,0,0,0,0,0,0,0,0
0,0,0,0,0,0,0,0,0
0,0,0,0,0,0,0,0,0
0,0,0,0,0,0,0,0,0
0,0,0,0,0,0,0,0,0
65119,50,3,0,0,0,0,0,0
0,0,0,0,0,0,0,0,0
0,0,0,0,0,0,0,0,0
135654,316,8,26,24,2,19,1,0
0,0,0,0,0,0,0,0,0
0,0,0,0,0,0,0,0,0
21703,33,0,1,1,0,0,1,0
0,0,0,0,0,0,0,0,0
0,0,0,0,0,0,0,0,0
0,0,0,0,0,0,0,0,0
23739,37,0,3,1,2,0,0,0
8508,120,4,23,23,0,0,1,0
0,0,0,0,0,0,0,0,0
0,0,0,0,0,0,0,0,0
0,0,0,0,0,0,0,0,0
0,0,0,0,0,0,0,0,0
0,0,0,0,0,0,0,0,0
0,0,0,0,0,0,0,0,0
26057,206,2,50,49,1,0,1,0
26057,206,2,50,49,1,0,1,0
26057,206,2,50,49,1,0,1,0
20893,234,2,48,47,1,2,1,0
20893,234,2,48,47,1,2,1,0
0,0,0,0,0,0,0,0,0
0,0,0,0,0,0,0,0,0
135971,42,4,1,1,0,2,0,0
20893,234,2,48,47,1,2,1,0
20893,234,2,48,47,1,2,1,0
20893,234,2,48,47,1,2,1,0
0,0,0,0,0,0,0,0,0
0,0,0,0,0,0,0,0,0
0,0,0,0,0,0,0,0,0
135971,42,4,1,1,0,2,0,0
135971,42,4,1,1,0,2,0,0
0,0,0,0,0,0,0,0,0
0,0,0,0,0,0,0,0,0
0,0,0,0,0,0,0,0,0
3046,18,1,0,0,0,0,0,0
34591,51,2,0,0,0,2,0,0
23523,39,2,0,0,0,0,1,0
0,0,0,0,0,0,0,0,0
0,0,0,0,0,0,0,0,0
0,0,0,0,0,0,0,0,0
0,0,0,0,0,0,0,0,0
0,0,0,0,0,0,0,0,0
0,0,0,0,0,0,0,0,0
0,0,0,0,0,0,0,0,0
0,0,0,0,0,0,0,0,0
0,0,0,0,0,0,0,0,0
0,0,0,0,0,0,0,0,0
0,0,0,0,0,0,0,0,0
0,0,0,0,0,0,0,0,0
0,0,0,0,0,0,0,0,0
0,0,0,0,0,0,0,0,0
0,0,0,0,0,0,0,0,0
0,0,0,0,0,0,0,0,0
0,0,0,0,0,0,0,0,0
0,0,0,0,0,0,0,0,0
53512,725,7,193,159,34,1,1,0
0,0,0,0,0,0,0,0,0
0,0,0,0,0,0,0,0,0
0,0,0,0,0,0,0,0,0
672519,556,0,4,4,0,2,1,1
0,0,0,0,0,0,0,0,0
0,0,0,0,0,0,0,0,0
0,0,0,0,0,0,0,0,0
0,0,0,0,0,0,0,0,0
0,0,0,0,0,0,0,0,0
0,0,0,0,0,0,0,0,0
0,0,0,0,0,0,0,0,0
0,0,0,0,0,0,0,0,0
0,0,0,0,0,0,0,0,0
0,0,0,0,0,0,0,0,0
0,0,0,0,0,0,0,0,0
0,0,0,0,0,0,0,0,0
0,0,0,0,0,0,0,0,0
0,0,0,0,0,0,0,0,0
0,0,0,0,0,0,0,0,0
0,0,0,0,0,0,0,0,0
0,0,0,0,0,0,0,0,0
0,0,0,0,0,0,0,0,0
0,0,0,0,0,0,0,0,0
0,0,0,0,0,0,0,0,0
144631,57,3,0,0,0,0,1,0
0,0,0,0,0,0,0,0,0
0,0,0,0,0,0,0,0,0
0,0,0,0,0,0,0,0,0
0,0,0,0,0,0,0,0,0
0,0,0,0,0,0,0,0,0
0,0,0,0,0,0,0,0,0
0,0,0,0,0,0,0,0,0
0,0,0,0,0,0,0,0,0
0,0,0,0,0,0,0,0,0
145390,193,6,5,5,0,1,0,0
0,0,0,0,0,0,0,0,0
332015,2519,1,477,411,66,34,0,0
0,0,0,0,0,0,0,0,0
0,0,0,0,0,0,0,0,0
0,0,0,0,0,0,0,0,0
0,0,0,0,0,0,0,0,0
11317,266,3,24,24,0,1,1,0
0,0,0,0,0,0,0,0,0
11323,266,3,24,24,0,1,1,0
0,0,0,0,0,0,0,0,0
23582,116,1,0,0,0,1,0,0
329707,78,4,0,0,0,2,1,0
7466,103,1,0,0,0,0,0,0
7466,103,1,0,0,0,0,0,0
0,0,0,0,0,0,0,0,0
0,0,0,0,0,0,0,0,0
0,0,0,0,0,0,0,0,0
0,0,0,0,0,0,0,0,0
0,0,0,0,0,0,0,0,0
0,0,0,0,0,0,0,0,0
0,0,0,0,0,0,0,0,0
0,0,0,0,0,0,0,0,0
0,0,0,0,0,0,0,0,0
0,0,0,0,0,0,0,0,0
0,0,0,0,0,0,0,0,0
0,0,0,0,0,0,0,0,0
0,0,0,0,0,0,0,0,0
0,0,0,0,0,0,0,0,0
0,0,0,0,0,0,0,0,0
0,0,0,0,0,0,0,0,0
125456,204,2,50,49,1,0,1,0
0,0,0,0,0,0,0,0,0
0,0,0,0,0,0,0,0,0
773,17,0,0,0,0,0,0,0
143053,326,3,6,6,0,0,1,0
180976,1288,12,168,163,5,5,1,0
0,0,0,0,0,0,0,0,0
0,0,0,0,0,0,0,0,0
0,0,0,0,0,0,0,0,0
0,0,0,0,0,0,0,0,0
3202,51,3,1,1,0,0,0,0
0,0,0,0,0,0,0,0,0
0,0,0,0,0,0,0,0,0
0,0,0,0,0,0,0,0,0
0,0,0,0,0,0,0,0,0
0,0,0,0,0,0,0,0,0
0,0,0,0,0,0,0,0,0
0,0,0,0,0,0,0,0,0
0,0,0,0,0,0,0,0,0
0,0,0,0,0,0,0,0,0
0,0,0,0,0,0,0,0,0
0,0,0,0,0,0,0,0,0
13173,142,0,56,51,5,0,0,0
0,0,0,0,0,0,0,0,0
0,0,0,0,0,0,0,0,0
65011,56,0,2,2,0,0,1,0
64950,56,0,2,2,0,0,1,0
65011,56,0,2,2,0,0,1,0
65011,56,0,2,2,0,0,1,0
65011,56,0,2,2,0,0,1,0
65011,56,0,2,2,0,0,1,0
65011,56,0,2,2,0,0,1,0
64950,56,0,2,2,0,0,1,0
65011,56,0,2,2,0,0,1,0
65225,56,0,2,2,0,0,1,0
0,0,0,0,0,0,0,0,0
2673,21,2,1,0,1,0,0,0
0,0,0,0,0,0,0,0,0
0,0,0,0,0,0,0,0,0
0,0,0,0,0,0,0,0,0
0,0,0,0,0,0,0,0,0
29228,42,0,1,1,0,1,0,0
10785,77,5,8,0,8,0,1,0
0,0,0,0,0,0,0,0,0
2673,21,2,1,0,1,0,0,0
0,0,0,0,0,0,0,0,0
0,0,0,0,0,0,0,0,0
0,0,0,0,0,0,0,0,0
673192,542,0,4,4,0,2,1,1
0,0,0,0,0,0,0,0,0
20508,408,7,69,69,0,0,0,0
64340,50,3,0,0,0,0,0,0
64328,50,3,0,0,0,0,0,0
272954,598,4,57,48,9,17,1,0
0,0,0,0,0,0,0,0,0
0,0,0,0,0,0,0,0,0
0,0,0,0,0,0,0,0,0
6224,71,6,4,4,0,0,0,0
0,0,0,0,0,0,0,0,0
17933,198,5,28,28,0,0,1,0
0,0,0,0,0,0,0,0,0
17933,198,5,28,28,0,0,1,0
0,0,0,0,0,0,0,0,0
0,0,0,0,0,0,0,0,0
0,0,0,0,0,0,0,0,0
43526,181,4,1,1,0,4,1,0
0,0,0,0,0,0,0,0,0
0,0,0,0,0,0,0,0,0
0,0,0,0,0,0,0,0,0
0,0,0,0,0,0,0,0,0
0,0,0,0,0,0,0,0,0
0,0,0,0,0,0,0,0,0
0,0,0,0,0,0,0,0,0
186779,1244,1,168,18,150,7,1,0
179465,1243,1,168,18,150,1,1,0
0,0,0,0,0,0,0,0,0
0,0,0,0,0,0,0,0,0
0,0,0,0,0,0,0,0,0
0,0,0,0,0,0,0,0,0
22738,148,1,1,0,1,0,1,0
22738,148,1,1,0,1,0,1,0
0,0,0,0,0,0,0,0,0
0,0,0,0,0,0,0,0,0
0,0,0,0,0,0,0,0,0
0,0,0,0,0,0,0,0,0
0,0,0,0,0,0,0,0,0
0,0,0,0,0,0,0,0,0
0,0,0,0,0,0,0,0,0
0,0,0,0,0,0,0,0,0
4221,31,0,0,0,0,0,0,0
4221,31,0,0,0,0,0,0,0
4404,25,0,1,0,1,0,0,0
4404,25,0,1,0,1,0,0,0
0,0,0,0,0,0,0,0,0
0,0,0,0,0,0,0,0,0
0,0,0,0,0,0,0,0,0
0,0,0,0,0,0,0,0,0
0,0,0,0,0,0,0,0,0
0,0,0,0,0,0,0,0,0
0,0,0,0,0,0,0,0,0
0,0,0,0,0,0,0,0,0
9403,31,1,0,0,0,1,0,0
9403,31,1,0,0,0,1,0,0
9403,31,1,0,0,0,1,0,0
0,0,0,0,0,0,0,0,0
0,0,0,0,0,0,0,0,0
0,0,0,0,0,0,0,0,0
0,0,0,0,0,0,0,0,0
0,0,0,0,0,0,0,0,0
0,0,0,0,0,0,0,0,0
0,0,0,0,0,0,0,0,0
278113,70,2,11,11,0,0,1,0
0,0,0,0,0,0,0,0,0
0,0,0,0,0,0,0,0,0
77738,101,1,4,2,2,0,0,0
2673,21,2,1,0,1,0,0,0
0,0,0,0,0,0,0,0,0
0,0,0,0,0,0,0,0,0
0,0,0,0,0,0,0,0,0
0,0,0,0,0,0,0,0,0
0,0,0,0,0,0,0,0,0
0,0,0,0,0,0,0,0,0
0,0,0,0,0,0,0,0,0
0,0,0,0,0,0,0,0,0
0,0,0,0,0,0,0,0,0
0,0,0,0,0,0,0,0,0
0,0,0,0,0,0,0,0,0
0,0,0,0,0,0,0,0,0
0,0,0,0,0,0,0,0,0
0,0,0,0,0,0,0,0,0
0,0,0,0,0,0,0,0,0
0,0,0,0,0,0,0,0,0
0,0,0,0,0,0,0,0,0
0,0,0,0,0,0,0,0,0
0,0,0,0,0,0,0,0,0
0,0,0,0,0,0,0,0,0
0,0,0,0,0,0,0,0,0
0,0,0,0,0,0,0,0,0
0,0,0,0,0,0,0,0,0
0,0,0,0,0,0,0,0,0
0,0,0,0,0,0,0,0,0
0,0,0,0,0,0,0,0,0
0,0,0,0,0,0,0,0,0
0,0,0,0,0,0,0,0,0
0,0,0,0,0,0,0,0,0
138986,396,8,26,24,2,34,1,0
0,0,0,0,0,0,0,0,0
47135,549,3,120,117,3,8,0,0
10028,57,7,0,0,0,1,0,0
83503,652,6,136,112,24,5,1,0
17985,218,0,23,0,23,0,1,0
17962,218,0,23,23,0,0,1,0
0,0,0,0,0,0,0,0,0
41435,397,4,79,78,1,2,0,0
31473,20,1,0,0,0,0,0,0
0,0,0,0,0,0,0,0,0
0,0,0,0,0,0,0,0,0
0,0,0,0,0,0,0,0,0
0,0,0,0,0,0,0,0,0
0,0,0,0,0,0,0,0,0
0,0,0,0,0,0,0,0,0
676674,556,0,4,0,4,2,1,1
183290,116,2,7,0,7,1,1,0
183290,116,2,7,0,7,1,1,0
0,0,0,0,0,0,0,0,0
11554,251,5,35,35,0,0,1,0
0,0,0,0,0,0,0,0,0
0,0,0,0,0,0,0,0,0
0,0,0,0,0,0,0,0,0
109847,518,11,98,95,3,5,1,0
89060,627,12,65,4,61,4,1,0
0,0,0,0,0,0,0,0,0
13010,142,0,56,51,5,0,0,0
1537,16,0,0,0,0,0,0,0
0,0,0,0,0,0,0,0,0
64340,50,3,0,0,0,0,0,0
7786,145,2,21,21,0,0,0,0
1537,16,0,0,0,0,0,0,0
0,0,0,0,0,0,0,0,0
0,0,0,0,0,0,0,0,0
6330,64,2,6,4,2,0,1,0
0,0,0,0,0,0,0,0,0
0,0,0,0,0,0,0,0,0
0,0,0,0,0,0,0,0,0
0,0,0,0,0,0,0,0,0
329717,78,4,0,0,0,2,1,0
329705,78,4,0,0,0,2,1,0
329719,78,4,0,0,0,2,1,0
245195,2068,2,278,37,241,4,1,0
146562,1056,2,153,21,132,3,0,0
66581,80,3,0,0,0,4,0,0
20048,52,5,11,10,1,0,0,0
20048,52,5,11,10,1,0,0,0
0,0,0,0,0,0,0,0,0
0,0,0,0,0,0,0,0,0
20771,158,0,1,0,1,0,1,0
20771,158,0,1,0,1,0,1,0
0,0,0,0,0,0,0,0,0
0,0,0,0,0,0,0,0,0
15644,259,3,53,52,1,1,1,0
15644,259,3,53,52,1,1,1,0
0,0,0,0,0,0,0,0,0
0,0,0,0,0,0,0,0,0
0,0,0,0,0,0,0,0,0
0,0,0,0,0,0,0,0,0
0,0,0,0,0,0,0,0,0
0,0,0,0,0,0,0,0,0
0,0,0,0,0,0,0,0,0
0,0,0,0,0,0,0,0,0
0,0,0,0,0,0,0,0,0
27265,27,2,0,0,0,0,0,0
27265,27,2,0,0,0,0,0,0
27265,27,2,0,0,0,0,0,0
0,0,0,0,0,0,0,0,0
0,0,0,0,0,0,0,0,0
0,0,0,0,0,0,0,0,0
0,0,0,0,0,0,0,0,0
0,0,0,0,0,0,0,0,0
0,0,0,0,0,0,0,0,0
0,0,0,0,0,0,0,0,0
0,0,0,0,0,0,0,0,0
0,0,0,0,0,0,0,0,0
0,0,0,0,0,0,0,0,0
0,0,0,0,0,0,0,0,0
0,0,0,0,0,0,0,0,0
0,0,0,0,0,0,0,0,0
0,0,0,0,0,0,0,0,0
0,0,0,0,0,0,0,0,0
0,0,0,0,0,0,0,0,0
0,0,0,0,0,0,0,0,0
0,0,0,0,0,0,0,0,0
0,0,0,0,0,0,0,0,0
0,0,0,0,0,0,0,0,0
0,0,0,0,0,0,0,0,0
0,0,0,0,0,0,0,0,0
0,0,0,0,0,0,0,0,0
0,0,0,0,0,0,0,0,0
0,0,0,0,0,0,0,0,0
0,0,0,0,0,0,0,0,0
0,0,0,0,0,0,0,0,0
0,0,0,0,0,0,0,0,0
0,0,0,0,0,0,0,0,0
66581,80,3,0,0,0,4,0,0
23491,59,4,3,3,0,2,1,0
0,0,0,0,0,0,0,0,0
66581,80,3,0,0,0,4,0,0
23491,59,4,3,3,0,2,1,0
66581,80,3,0,0,0,4,0,0
66581,80,3,0,0,0,4,0,0
23491,59,4,3,3,0,2,1,0
23491,59,4,3,3,0,2,1,0
0,0,0,0,0,0,0,0,0
66581,80,3,0,0,0,4,0,0
23491,59,4,3,3,0,2,1,0
0,0,0,0,0,0,0,0,0
0,0,0,0,0,0,0,0,0
0,0,0,0,0,0,0,0,0
0,0,0,0,0,0,0,0,0
0,0,0,0,0,0,0,0,0
0,0,0,0,0,0,0,0,0
0,0,0,0,0,0,0,0,0
0,0,0,0,0,0,0,0,0
0,0,0,0,0,0,0,0,0
0,0,0,0,0,0,0,0,0
21515,171,1,7,6,1,0,0,0
21515,171,1,7,6,1,0,0,0
21515,171,1,7,6,1,0,0,0
21515,171,1,7,6,1,0,0,0
0,0,0,0,0,0,0,0,0
0,0,0,0,0,0,0,0,0
0,0,0,0,0,0,0,0,0
21515,171,1,7,6,1,0,0,0
0,0,0,0,0,0,0,0,0
0,0,0,0,0,0,0,0,0
0,0,0,0,0,0,0,0,0
0,0,0,0,0,0,0,0,0
0,0,0,0,0,0,0,0,0
0,0,0,0,0,0,0,0,0
0,0,0,0,0,0,0,0,0
0,0,0,0,0,0,0,0,0
0,0,0,0,0,0,0,0,0
0,0,0,0,0,0,0,0,0
0,0,0,0,0,0,0,0,0
0,0,0,0,0,0,0,0,0
0,0,0,0,0,0,0,0,0
0,0,0,0,0,0,0,0,0
0,0,0,0,0,0,0,0,0
193290,39,6,1,1,0,0,0,0
46076,66,1,2,0,2,4,0,0
0,0,0,0,0,0,0,0,0
0,0,0,0,0,0,0,0,0
0,0,0,0,0,0,0,0,0
0,0,0,0,0,0,0,0,0
0,0,0,0,0,0,0,0,0
0,0,0,0,0,0,0,0,0
0,0,0,0,0,0,0,0,0
0,0,0,0,0,0,0,0,0
0,0,0,0,0,0,0,0,0
0,0,0,0,0,0,0,0,0
0,0,0,0,0,0,0,0,0
0,0,0,0,0,0,0,0,0
0,0,0,0,0,0,0,0,0
0,0,0,0,0,0,0,0,0
0,0,0,0,0,0,0,0,0
0,0,0,0,0,0,0,0,0
0,0,0,0,0,0,0,0,0
0,0,0,0,0,0,0,0,0
193290,39,6,1,1,0,0,0,0
46076,66,1,2,0,2,4,0,0
0,0,0,0,0,0,0,0,0
56375,52,2,0,0,0,0,0,0
0,0,0,0,0,0,0,0,0
193290,39,6,1,1,0,0,0,0
46076,66,1,2,0,2,4,0,0
0,0,0,0,0,0,0,0,0
0,0,0,0,0,0,0,0,0
56375,52,2,0,0,0,0,0,0
0,0,0,0,0,0,0,0,0
0,0,0,0,0,0,0,0,0
0,0,0,0,0,0,0,0,0
0,0,0,0,0,0,0,0,0
0,0,0,0,0,0,0,0,0
0,0,0,0,0,0,0,0,0
0,0,0,0,0,0,0,0,0
193290,39,6,1,1,0,0,0,0
46076,66,1,2,0,2,4,0,0
0,0,0,0,0,0,0,0,0
0,0,0,0,0,0,0,0,0
0,0,0,0,0,0,0,0,0
2000169,186,1,19,2,17,3,0,0
0,0,0,0,0,0,0,0,0
2000169,186,1,19,2,17,3,0,0
2000169,186,1,19,2,17,3,0,0
2000169,186,1,19,2,17,3,0,0
0,0,0,0,0,0,0,0,0
0,0,0,0,0,0,0,0,0
0,0,0,0,0,0,0,0,0
0,0,0,0,0,0,0,0,0
0,0,0,0,0,0,0,0,0
0,0,0,0,0,0,0,0,0
0,0,0,0,0,0,0,0,0
0,0,0,0,0,0,0,0,0
0,0,0,0,0,0,0,0,0
0,0,0,0,0,0,0,0,0
0,0,0,0,0,0,0,0,0
0,0,0,0,0,0,0,0,0
0,0,0,0,0,0,0,0,0
13010,142,0,56,51,5,0,0,0
0,0,0,0,0,0,0,0,0
0,0,0,0,0,0,0,0,0
0,0,0,0,0,0,0,0,0
0,0,0,0,0,0,0,0,0
0,0,0,0,0,0,0,0,0
0,0,0,0,0,0,0,0,0
0,0,0,0,0,0,0,0,0
0,0,0,0,0,0,0,0,0
1584,36,0,4,3,1,0,0,0
3193,72,2,20,20,0,0,1,0
0,0,0,0,0,0,0,0,0
0,0,0,0,0,0,0,0,0
0,0,0,0,0,0,0,0,0
0,0,0,0,0,0,0,0,0
2939,16,2,1,0,1,0,0,0
53476,59,1,3,3,0,0,1,0
37395,181,6,5,2,3,1,0,0
89603,67,0,9,4,5,5,0,0
676312,557,0,4,4,0,2,1,1
0,0,0,0,0,0,0,0,0
0,0,0,0,0,0,0,0,0
0,0,0,0,0,0,0,0,0
0,0,0,0,0,0,0,0,0
0,0,0,0,0,0,0,0,0
9196,28,1,2,2,0,0,0,0
674347,556,0,4,4,0,2,1,1
9202,28,1,2,2,0,0,0,0
35430,175,6,12,11,1,1,0,0
21487,100,2,0,0,0,0,1,0
0,0,0,0,0,0,0,0,0
0,0,0,0,0,0,0,0,0
0,0,0,0,0,0,0,0,0
0,0,0,0,0,0,0,0,0
0,0,0,0,0,0,0,0,0
0,0,0,0,0,0,0,0,0
0,0,0,0,0,0,0,0,0
0,0,0,0,0,0,0,0,0
3025,18,1,0,0,0,0,0,0
0,0,0,0,0,0,0,0,0
64341,50,3,0,0,0,0,0,0
0,0,0,0,0,0,0,0,0
676084,557,0,4,4,0,2,1,1
13387,61,0,2,1,1,0,0,0
37561,129,2,4,2,2,1,1,0
0,0,0,0,0,0,0,0,0
0,0,0,0,0,0,0,0,0
23291,225,3,24,24,0,0,1,0
135943,320,8,26,24,2,19,1,0
132600,301,6,27,24,3,8,1,0
0,0,0,0,0,0,0,0,0
0,0,0,0,0,0,0,0,0
0,0,0,0,0,0,0,0,0
0,0,0,0,0,0,0,0,0
0,0,0,0,0,0,0,0,0
0,0,0,0,0,0,0,0,0
0,0,0,0,0,0,0,0,0
0,0,0,0,0,0,0,0,0
0,0,0,0,0,0,0,0,0
0,0,0,0,0,0,0,0,0
0,0,0,0,0,0,0,0,0
0,0,0,0,0,0,0,0,0
0,0,0,0,0,0,0,0,0
0,0,0,0,0,0,0,0,0
0,0,0,0,0,0,0,0,0
0,0,0,0,0,0,0,0,0
109934,49,3,0,0,0,0,0,0
144443,59,4,3,3,0,2,1,0
0,0,0,0,0,0,0,0,0
0,0,0,0,0,0,0,0,0
13475208,47,6,0,0,0,3,0,0
0,0,0,0,0,0,0,0,0
0,0,0,0,0,0,0,0,0
0,0,0,0,0,0,0,0,0
0,0,0,0,0,0,0,0,0
0,0,0,0,0,0,0,0,0
0,0,0,0,0,0,0,0,0
109934,49,3,0,0,0,0,0,0
0,0,0,0,0,0,0,0,0
144443,59,4,3,3,0,2,1,0
11203,77,3,2,2,0,4,0,0
0,0,0,0,0,0,0,0,0
0,0,0,0,0,0,0,0,0
13475208,47,6,0,0,0,3,0,0
8320,146,0,15,15,0,5,1,0
135557,42,4,1,1,0,2,0,0
0,0,0,0,0,0,0,0,0
0,0,0,0,0,0,0,0,0
144443,59,4,3,3,0,2,1,0
0,0,0,0,0,0,0,0,0
11203,77,3,2,2,0,4,0,0
0,0,0,0,0,0,0,0,0
0,0,0,0,0,0,0,0,0
109934,49,3,0,0,0,0,0,0
0,0,0,0,0,0,0,0,0
8320,146,0,15,15,0,5,1,0
135557,42,4,1,1,0,2,0,0
0,0,0,0,0,0,0,0,0
0,0,0,0,0,0,0,0,0
0,0,0,0,0,0,0,0,0
0,0,0,0,0,0,0,0,0
0,0,0,0,0,0,0,0,0
0,0,0,0,0,0,0,0,0
0,0,0,0,0,0,0,0,0
0,0,0,0,0,0,0,0,0
0,0,0,0,0,0,0,0,0
0,0,0,0,0,0,0,0,0
0,0,0,0,0,0,0,0,0
0,0,0,0,0,0,0,0,0
0,0,0,0,0,0,0,0,0
0,0,0,0,0,0,0,0,0
0,0,0,0,0,0,0,0,0
0,0,0,0,0,0,0,0,0
0,0,0,0,0,0,0,0,0
0,0,0,0,0,0,0,0,0
0,0,0,0,0,0,0,0,0
0,0,0,0,0,0,0,0,0
0,0,0,0,0,0,0,0,0
0,0,0,0,0,0,0,0,0
0,0,0,0,0,0,0,0,0
0,0,0,0,0,0,0,0,0
0,0,0,0,0,0,0,0,0
0,0,0,0,0,0,0,0,0
0,0,0,0,0,0,0,0,0
0,0,0,0,0,0,0,0,0
144443,59,4,3,3,0,2,1,0
11203,77,3,2,2,0,4,0,0
0,0,0,0,0,0,0,0,0
0,0,0,0,0,0,0,0,0
11335,118,2,0,0,0,0,0,0
0,0,0,0,0,0,0,0,0
13475208,47,6,0,0,0,3,0,0
0,0,0,0,0,0,0,0,0
0,0,0,0,0,0,0,0,0
0,0,0,0,0,0,0,0,0
0,0,0,0,0,0,0,0,0
0,0,0,0,0,0,0,0,0
0,0,0,0,0,0,0,0,0
0,0,0,0,0,0,0,0,0
0,0,0,0,0,0,0,0,0
0,0,0,0,0,0,0,0,0
0,0,0,0,0,0,0,0,0
0,0,0,0,0,0,0,0,0
0,0,0,0,0,0,0,0,0
0,0,0,0,0,0,0,0,0
354995,232,4,5,2,3,0,1,0
0,0,0,0,0,0,0,0,0
0,0,0,0,0,0,0,0,0
0,0,0,0,0,0,0,0,0
0,0,0,0,0,0,0,0,0
0,0,0,0,0,0,0,0,0
0,0,0,0,0,0,0,0,0
0,0,0,0,0,0,0,0,0
0,0,0,0,0,0,0,0,0
0,0,0,0,0,0,0,0,0
0,0,0,0,0,0,0,0,0
0,0,0,0,0,0,0,0,0
0,0,0,0,0,0,0,0,0
0,0,0,0,0,0,0,0,0
0,0,0,0,0,0,0,0,0
0,0,0,0,0,0,0,0,0
0,0,0,0,0,0,0,0,0
0,0,0,0,0,0,0,0,0
0,0,0,0,0,0,0,0,0
0,0,0,0,0,0,0,0,0
0,0,0,0,0,0,0,0,0
0,0,0,0,0,0,0,0,0
0,0,0,0,0,0,0,0,0
0,0,0,0,0,0,0,0,0
0,0,0,0,0,0,0,0,0
0,0,0,0,0,0,0,0,0
0,0,0,0,0,0,0,0,0
0,0,0,0,0,0,0,0,0
0,0,0,0,0,0,0,0,0
0,0,0,0,0,0,0,0,0
0,0,0,0,0,0,0,0,0
0,0,0,0,0,0,0,0,0
0,0,0,0,0,0,0,0,0
0,0,0,0,0,0,0,0,0
0,0,0,0,0,0,0,0,0
0,0,0,0,0,0,0,0,0
0,0,0,0,0,0,0,0,0
0,0,0,0,0,0,0,0,0
0,0,0,0,0,0,0,0,0
2673,21,2,1,0,1,0,0,0
318567,319,4,13,7,6,0,1,0
0,0,0,0,0,0,0,0,0
140587,408,8,27,1,26,34,1,0
0,0,0,0,0,0,0,0,0
9201,28,1,2,2,0,0,0,0
0,0,0,0,0,0,0,0,0
0,0,0,0,0,0,0,0,0
0,0,0,0,0,0,0,0,0
15757,253,1,6,6,0,0,0,0
2673,21,2,1,0,1,0,0,0
6330,64,2,6,4,2,0,1,0
2673,21,2,1,0,1,0,0,0
2673,21,2,1,0,1,0,0,0
0,0,0,0,0,0,0,0,0
28418,44,0,4,3,1,0,0,0
0,0,0,0,0,0,0,0,0
0,0,0,0,0,0,0,0,0
0,0,0,0,0,0,0,0,0
0,0,0,0,0,0,0,0,0
0,0,0,0,0,0,0,0,0
0,0,0,0,0,0,0,0,0
31619,228,11,19,18,1,6,1,0
6590,35,0,7,0,7,0,1,0
0,0,0,0,0,0,0,0,0
0,0,0,0,0,0,0,0,0
0,0,0,0,0,0,0,0,0
0,0,0,0,0,0,0,0,0
0,0,0,0,0,0,0,0,0
0,0,0,0,0,0,0,0,0
0,0,0,0,0,0,0,0,0
0,0,0,0,0,0,0,0,0
0,0,0,0,0,0,0,0,0
0,0,0,0,0,0,0,0,0
0,0,0,0,0,0,0,0,0
0,0,0,0,0,0,0,0,0
0,0,0,0,0,0,0,0,0
0,0,0,0,0,0,0,0,0
0,0,0,0,0,0,0,0,0
0,0,0,0,0,0,0,0,0
0,0,0,0,0,0,0,0,0
0,0,0,0,0,0,0,0,0
0,0,0,0,0,0,0,0,0
0,0,0,0,0,0,0,0,0
0,0,0,0,0,0,0,0,0
0,0,0,0,0,0,0,0,0
0,0,0,0,0,0,0,0,0
0,0,0,0,0,0,0,0,0
0,0,0,0,0,0,0,0,0
0,0,0,0,0,0,0,0,0
0,0,0,0,0,0,0,0,0
0,0,0,0,0,0,0,0,0
0,0,0,0,0,0,0,0,0
0,0,0,0,0,0,0,0,0
0,0,0,0,0,0,0,0,0
81338,45,1,0,0,0,0,0,0
81338,45,1,0,0,0,0,0,0
81338,45,1,0,0,0,0,0,0
81338,45,1,0,0,0,0,0,0
81338,45,1,0,0,0,0,0,0
0,0,0,0,0,0,0,0,0
0,0,0,0,0,0,0,0,0
0,0,0,0,0,0,0,0,0
0,0,0,0,0,0,0,0,0
0,0,0,0,0,0,0,0,0
0,0,0,0,0,0,0,0,0
0,0,0,0,0,0,0,0,0
0,0,0,0,0,0,0,0,0
0,0,0,0,0,0,0,0,0
0,0,0,0,0,0,0,0,0
0,0,0,0,0,0,0,0,0
0,0,0,0,0,0,0,0,0
0,0,0,0,0,0,0,0,0
144436,59,4,3,3,0,2,1,0
144436,59,4,3,3,0,2,1,0
144436,59,4,3,3,0,2,1,0
0,0,0,0,0,0,0,0,0
0,0,0,0,0,0,0,0,0
0,0,0,0,0,0,0,0,0
0,0,0,0,0,0,0,0,0
0,0,0,0,0,0,0,0,0
0,0,0,0,0,0,0,0,0
0,0,0,0,0,0,0,0,0
0,0,0,0,0,0,0,0,0
0,0,0,0,0,0,0,0,0
0,0,0,0,0,0,0,0,0
0,0,0,0,0,0,0,0,0
3040,18,1,0,0,0,0,0,0
12653,44,0,0,0,0,0,0,0
0,0,0,0,0,0,0,0,0
9191,28,1,2,2,0,0,0,0
2673,21,2,1,0,1,0,0,0
0,0,0,0,0,0,0,0,0
193750,92,1,3,1,2,5,0,0
0,0,0,0,0,0,0,0,0
0,0,0,0,0,0,0,0,0
0,0,0,0,0,0,0,0,0
0,0,0,0,0,0,0,0,0
0,0,0,0,0,0,0,0,0
0,0,0,0,0,0,0,0,0
0,0,0,0,0,0,0,0,0
0,0,0,0,0,0,0,0,0
0,0,0,0,0,0,0,0,0
0,0,0,0,0,0,0,0,0
0,0,0,0,0,0,0,0,0
0,0,0,0,0,0,0,0,0
0,0,0,0,0,0,0,0,0
0,0,0,0,0,0,0,0,0
22550,38,0,2,2,0,0,1,0
0,0,0,0,0,0,0,0,0
0,0,0,0,0,0,0,0,0
0,0,0,0,0,0,0,0,0
0,0,0,0,0,0,0,0,0
0,0,0,0,0,0,0,0,0
65940,50,3,0,0,0,0,0,0
80456,134,6,8,7,1,8,1,0
0,0,0,0,0,0,0,0,0
0,0,0,0,0,0,0,0,0
0,0,0,0,0,0,0,0,0
2673,21,2,1,0,1,0,0,0
65215,315,1,4,1,3,0,0,0
64817,306,1,4,2,2,0,0,0
0,0,0,0,0,0,0,0,0
0,0,0,0,0,0,0,0,0
0,0,0,0,0,0,0,0,0
0,0,0,0,0,0,0,0,0
674239,553,0,4,0,4,2,1,1
675849,543,0,4,0,4,2,1,1
0,0,0,0,0,0,0,0,0
0,0,0,0,0,0,0,0,0
0,0,0,0,0,0,0,0,0
0,0,0,0,0,0,0,0,0
0,0,0,0,0,0,0,0,0
144740,62,4,3,3,0,2,1,0
144740,62,4,3,3,0,2,1,0
144740,62,4,3,3,0,2,1,0
0,0,0,0,0,0,0,0,0
0,0,0,0,0,0,0,0,0
0,0,0,0,0,0,0,0,0
0,0,0,0,0,0,0,0,0
0,0,0,0,0,0,0,0,0
0,0,0,0,0,0,0,0,0
0,0,0,0,0,0,0,0,0
77774,101,1,4,2,2,0,0,0
0,0,0,0,0,0,0,0,0
0,0,0,0,0,0,0,0,0
0,0,0,0,0,0,0,0,0
0,0,0,0,0,0,0,0,0
0,0,0,0,0,0,0,0,0
0,0,0,0,0,0,0,0,0
8028,103,3,3,3,0,0,1,0
0,0,0,0,0,0,0,0,0
0,0,0,0,0,0,0,0,0
0,0,0,0,0,0,0,0,0
0,0,0,0,0,0,0,0,0
29270,77,3,0,0,0,3,0,0
29270,77,3,0,0,0,3,0,0
29270,77,3,0,0,0,3,0,0
332514,60,4,3,3,0,2,1,0
332514,60,4,3,3,0,2,1,0
0,0,0,0,0,0,0,0,0
0,0,0,0,0,0,0,0,0
0,0,0,0,0,0,0,0,0
0,0,0,0,0,0,0,0,0
0,0,0,0,0,0,0,0,0
0,0,0,0,0,0,0,0,0
0,0,0,0,0,0,0,0,0
0,0,0,0,0,0,0,0,0
0,0,0,0,0,0,0,0,0
0,0,0,0,0,0,0,0,0
0,0,0,0,0,0,0,0,0
77778,101,1,4,2,2,0,0,0
0,0,0,0,0,0,0,0,0
2673,21,2,1,0,1,0,0,0
0,0,0,0,0,0,0,0,0
0,0,0,0,0,0,0,0,0
9403,31,1,0,0,0,1,0,0
1442,19,4,0,0,0,0,0,0
0,0,0,0,0,0,0,0,0
0,0,0,0,0,0,0,0,0
0,0,0,0,0,0,0,0,0
0,0,0,0,0,0,0,0,0
0,0,0,0,0,0,0,0,0
0,0,0,0,0,0,0,0,0
2673,21,2,1,0,1,0,0,0
0,0,0,0,0,0,0,0,0
0,0,0,0,0,0,0,0,0
135119,218,4,26,18,8,2,1,0
0,0,0,0,0,0,0,0,0
2663983,32,4,0,0,0,0,1,0
0,0,0,0,0,0,0,0,0
0,0,0,0,0,0,0,0,0
0,0,0,0,0,0,0,0,0
0,0,0,0,0,0,0,0,0
0,0,0,0,0,0,0,0,0
0,0,0,0,0,0,0,0,0
0,0,0,0,0,0,0,0,0
0,0,0,0,0,0,0,0,0
0,0,0,0,0,0,0,0,0
0,0,0,0,0,0,0,0,0
0,0,0,0,0,0,0,0,0
0,0,0,0,0,0,0,0,0
0,0,0,0,0,0,0,0,0
0,0,0,0,0,0,0,0,0
0,0,0,0,0,0,0,0,0
0,0,0,0,0,0,0,0,0
0,0,0,0,0,0,0,0,0
0,0,0,0,0,0,0,0,0
0,0,0,0,0,0,0,0,0
0,0,0,0,0,0,0,0,0
0,0,0,0,0,0,0,0,0
0,0,0,0,0,0,0,0,0
0,0,0,0,0,0,0,0,0
0,0,0,0,0,0,0,0,0
0,0,0,0,0,0,0,0,0
0,0,0,0,0,0,0,0,0
0,0,0,0,0,0,0,0,0
0,0,0,0,0,0,0,0,0
0,0,0,0,0,0,0,0,0
0,0,0,0,0,0,0,0,0
0,0,0,0,0,0,0,0,0
0,0,0,0,0,0,0,0,0
0,0,0,0,0,0,0,0,0
0,0,0,0,0,0,0,0,0
0,0,0,0,0,0,0,0,0
126175,56,4,2,1,1,0,1,0
126175,56,4,2,1,1,0,1,0
0,0,0,0,0,0,0,0,0
0,0,0,0,0,0,0,0,0
126175,56,4,2,1,1,0,1,0
126175,56,4,2,1,1,0,1,0
327095,60,4,3,3,0,2,1,0
327095,60,4,3,3,0,2,1,0
126175,56,4,2,1,1,0,1,0
327095,60,4,3,3,0,2,1,0
327095,60,4,3,3,0,2,1,0
327095,60,4,3,3,0,2,1,0
327095,60,4,3,3,0,2,1,0
0,0,0,0,0,0,0,0,0
327095,60,4,3,3,0,2,1,0
0,0,0,0,0,0,0,0,0
0,0,0,0,0,0,0,0,0
0,0,0,0,0,0,0,0,0
0,0,0,0,0,0,0,0,0
0,0,0,0,0,0,0,0,0
162995,218,4,26,18,8,2,1,0
34302,160,5,23,12,11,1,0,0
9193,28,1,2,2,0,0,0,0
205021,1111,12,52,39,13,2,1,0
144857,818,9,133,126,7,0,1,0
0,0,0,0,0,0,0,0,0
679934,558,0,4,0,4,2,1,1
0,0,0,0,0,0,0,0,0
0,0,0,0,0,0,0,0,0
204891,1110,12,52,39,13,2,1,0
0,0,0,0,0,0,0,0,0
28415,45,0,4,1,3,0,0,0
116983,719,0,151,149,2,14,1,0
407209,659,4,1,1,0,1,0,0
75543,419,1,6,4,2,0,0,0
0,0,0,0,0,0,0,0,0
3736,24,0,1,0,1,0,1,0
3735,24,0,1,0,1,0,1,0
0,0,0,0,0,0,0,0,0
0,0,0,0,0,0,0,0,0
0,0,0,0,0,0,0,0,0
3171,51,0,7,7,0,0,0,0
0,0,0,0,0,0,0,0,0
65952,50,3,0,0,0,0,0,0
0,0,0,0,0,0,0,0,0
0,0,0,0,0,0,0,0,0
0,0,0,0,0,0,0,0,0
145826,440,2,9,6,3,7,1,0
0,0,0,0,0,0,0,0,0
0,0,0,0,0,0,0,0,0
3105,23,2,1,0,1,0,0,0
2673,21,2,1,0,1,0,0,0
0,0,0,0,0,0,0,0,0
0,0,0,0,0,0,0,0,0
0,0,0,0,0,0,0,0,0
6330,64,2,6,4,2,0,1,0
0,0,0,0,0,0,0,0,0
0,0,0,0,0,0,0,0,0
0,0,0,0,0,0,0,0,0
0,0,0,0,0,0,0,0,0
572,14,1,0,0,0,0,0,0
0,0,0,0,0,0,0,0,0
0,0,0,0,0,0,0,0,0
0,0,0,0,0,0,0,0,0
84457,519,4,119,109,10,0,1,0
0,0,0,0,0,0,0,0,0
0,0,0,0,0,0,0,0,0
0,0,0,0,0,0,0,0,0
0,0,0,0,0,0,0,0,0
0,0,0,0,0,0,0,0,0
0,0,0,0,0,0,0,0,0
0,0,0,0,0,0,0,0,0
0,0,0,0,0,0,0,0,0
0,0,0,0,0,0,0,0,0
0,0,0,0,0,0,0,0,0
8248,146,0,15,15,0,5,1,0
8248,146,0,15,15,0,5,1,0
12006,47,3,5,5,0,1,0,0
8248,146,0,15,15,0,5,1,0
33614,46,2,0,0,0,2,0,0
12006,47,3,5,5,0,1,0,0
0,0,0,0,0,0,0,0,0
0,0,0,0,0,0,0,0,0
0,0,0,0,0,0,0,0,0
0,0,0,0,0,0,0,0,0
0,0,0,0,0,0,0,0,0
0,0,0,0,0,0,0,0,0
0,0,0,0,0,0,0,0,0
0,0,0,0,0,0,0,0,0
0,0,0,0,0,0,0,0,0
0,0,0,0,0,0,0,0,0
0,0,0,0,0,0,0,0,0
0,0,0,0,0,0,0,0,0
0,0,0,0,0,0,0,0,0
144419,59,4,3,3,0,2,1,0
144419,59,4,3,3,0,2,1,0
0,0,0,0,0,0,0,0,0
0,0,0,0,0,0,0,0,0
144419,59,4,3,3,0,2,1,0
144419,59,4,3,3,0,2,1,0
144745,62,4,3,3,0,2,1,0
144745,62,4,3,3,0,2,1,0
144419,59,4,3,3,0,2,1,0
144745,62,4,3,3,0,2,1,0
0,0,0,0,0,0,0,0,0
0,0,0,0,0,0,0,0,0
0,0,0,0,0,0,0,0,0
0,0,0,0,0,0,0,0,0
0,0,0,0,0,0,0,0,0
0,0,0,0,0,0,0,0,0
0,0,0,0,0,0,0,0,0
0,0,0,0,0,0,0,0,0
0,0,0,0,0,0,0,0,0
0,0,0,0,0,0,0,0,0
0,0,0,0,0,0,0,0,0
144741,62,4,3,3,0,2,1,0
144741,62,4,3,3,0,2,1,0
0,0,0,0,0,0,0,0,0
0,0,0,0,0,0,0,0,0
136016,42,4,1,1,0,2,0,0
136016,42,4,1,1,0,2,0,0
0,0,0,0,0,0,0,0,0
144741,62,4,3,3,0,2,1,0
136016,42,4,1,1,0,2,0,0
136016,42,4,1,1,0,2,0,0
0,0,0,0,0,0,0,0,0
47610,75,2,1,1,0,3,1,0
10286,184,6,20,19,1,2,1,0
0,0,0,0,0,0,0,0,0
0,0,0,0,0,0,0,0,0
0,0,0,0,0,0,0,0,0
1537,16,0,0,0,0,0,0,0
0,0,0,0,0,0,0,0,0
678655,543,0,4,0,4,2,1,1
0,0,0,0,0,0,0,0,0
0,0,0,0,0,0,0,0,0
0,0,0,0,0,0,0,0,0
0,0,0,0,0,0,0,0,0
0,0,0,0,0,0,0,0,0
3733,24,0,1,0,1,0,1,0
0,0,0,0,0,0,0,0,0
0,0,0,0,0,0,0,0,0
35103,123,3,15,0,15,0,0,0
0,0,0,0,0,0,0,0,0
0,0,0,0,0,0,0,0,0
22427,34,0,1,1,0,0,1,0
0,0,0,0,0,0,0,0,0
0,0,0,0,0,0,0,0,0
0,0,0,0,0,0,0,0,0
0,0,0,0,0,0,0,0,0
2673,21,2,1,0,1,0,0,0
2673,21,2,1,0,1,0,0,0
2673,21,2,1,0,1,0,0,0
0,0,0,0,0,0,0,0,0
4547,35,0,2,0,2,0,0,0
0,0,0,0,0,0,0,0,0
65953,50,3,0,0,0,0,0,0
2830,21,2,0,0,0,0,0,0
0,0,0,0,0,0,0,0,0
28640,45,0,4,1,3,0,0,0
0,0,0,0,0,0,0,0,0
0,0,0,0,0,0,0,0,0
2024862,61,4,1,1,0,2,1,0
0,0,0,0,0,0,0,0,0
0,0,0,0,0,0,0,0,0
0,0,0,0,0,0,0,0,0
0,0,0,0,0,0,0,0,0
0,0,0,0,0,0,0,0,0
0,0,0,0,0,0,0,0,0
0,0,0,0,0,0,0,0,0
0,0,0,0,0,0,0,0,0
0,0,0,0,0,0,0,0,0
0,0,0,0,0,0,0,0,0
0,0,0,0,0,0,0,0,0
0,0,0,0,0,0,0,0,0
33614,46,2,0,0,0,2,0,0
0,0,0,0,0,0,0,0,0
0,0,0,0,0,0,0,0,0
33614,46,2,0,0,0,2,0,0
0,0,0,0,0,0,0,0,0
0,0,0,0,0,0,0,0,0
0,0,0,0,0,0,0,0,0
2024862,61,4,1,1,0,2,1,0
2024862,61,4,1,1,0,2,1,0
0,0,0,0,0,0,0,0,0
0,0,0,0,0,0,0,0,0
144733,62,4,3,3,0,2,1,0
0,0,0,0,0,0,0,0,0
0,0,0,0,0,0,0,0,0
215021,58,4,2,2,0,2,1,0
144733,62,4,3,3,0,2,1,0
0,0,0,0,0,0,0,0,0
0,0,0,0,0,0,0,0,0
0,0,0,0,0,0,0,0,0
144733,62,4,3,3,0,2,1,0
0,0,0,0,0,0,0,0,0
184778,15,0,0,0,0,0,0,0
184778,15,0,0,0,0,0,0,0
184778,15,0,0,0,0,0,0,0
0,0,0,0,0,0,0,0,0
31754,52,2,0,0,0,0,0,0
31754,52,2,0,0,0,0,0,0
0,0,0,0,0,0,0,0,0
0,0,0,0,0,0,0,0,0
31754,52,2,0,0,0,0,0,0
31754,52,2,0,0,0,0,0,0
0,0,0,0,0,0,0,0,0
31754,52,2,0,0,0,0,0,0
0,0,0,0,0,0,0,0,0
31754,52,2,0,0,0,0,0,0
144747,62,4,3,3,0,2,1,0
144747,62,4,3,3,0,2,1,0
144747,62,4,3,3,0,2,1,0
0,0,0,0,0,0,0,0,0
0,0,0,0,0,0,0,0,0
0,0,0,0,0,0,0,0,0
0,0,0,0,0,0,0,0,0
0,0,0,0,0,0,0,0,0
0,0,0,0,0,0,0,0,0
0,0,0,0,0,0,0,0,0
0,0,0,0,0,0,0,0,0
0,0,0,0,0,0,0,0,0
0,0,0,0,0,0,0,0,0
0,0,0,0,0,0,0,0,0
0,0,0,0,0,0,0,0,0
0,0,0,0,0,0,0,0,0
0,0,0,0,0,0,0,0,0
0,0,0,0,0,0,0,0,0
0,0,0,0,0,0,0,0,0
0,0,0,0,0,0,0,0,0
0,0,0,0,0,0,0,0,0
0,0,0,0,0,0,0,0,0
0,0,0,0,0,0,0,0,0
0,0,0,0,0,0,0,0,0
0,0,0,0,0,0,0,0,0
0,0,0,0,0,0,0,0,0
0,0,0,0,0,0,0,0,0
0,0,0,0,0,0,0,0,0
0,0,0,0,0,0,0,0,0
0,0,0,0,0,0,0,0,0
20336,204,4,21,21,0,2,0,0
20783,206,4,21,21,0,2,0,0
0,0,0,0,0,0,0,0,0
0,0,0,0,0,0,0,0,0
10031,148,5,11,11,0,0,1,0
10031,148,5,11,11,0,0,1,0
0,0,0,0,0,0,0,0,0
0,0,0,0,0,0,0,0,0
0,0,0,0,0,0,0,0,0
0,0,0,0,0,0,0,0,0
34469,50,2,0,0,0,2,0,0
0,0,0,0,0,0,0,0,0
0,0,0,0,0,0,0,0,0
0,0,0,0,0,0,0,0,0
0,0,0,0,0,0,0,0,0
0,0,0,0,0,0,0,0,0
0,0,0,0,0,0,0,0,0
14123,142,0,56,52,4,0,0,0
0,0,0,0,0,0,0,0,0
0,0,0,0,0,0,0,0,0
0,0,0,0,0,0,0,0,0
0,0,0,0,0,0,0,0,0
0,0,0,0,0,0,0,0,0
12406,28,1,2,2,0,0,0,0
63044,166,2,21,21,0,2,1,0
9690,28,1,2,2,0,0,0,0
9687,28,1,2,2,0,0,0,0
2673,21,2,1,0,1,0,0,0
0,0,0,0,0,0,0,0,0
11330,266,3,24,24,0,1,1,0
9250,130,0,18,1,17,9,0,0
65941,50,3,0,0,0,0,0,0
135555,320,8,27,24,3,19,1,0
0,0,0,0,0,0,0,0,0
0,0,0,0,0,0,0,0,0
0,0,0,0,0,0,0,0,0
0,0,0,0,0,0,0,0,0
0,0,0,0,0,0,0,0,0
0,0,0,0,0,0,0,0,0
0,0,0,0,0,0,0,0,0
0,0,0,0,0,0,0,0,0
0,0,0,0,0,0,0,0,0
1537,16,0,0,0,0,0,0,0
14975,28,1,2,2,0,0,0,0
0,0,0,0,0,0,0,0,0
0,0,0,0,0,0,0,0,0
0,0,0,0,0,0,0,0,0
672637,542,0,4,4,0,2,1,1
0,0,0,0,0,0,0,0,0
672349,556,0,4,4,0,2,1,1
0,0,0,0,0,0,0,0,0
0,0,0,0,0,0,0,0,0
0,0,0,0,0,0,0,0,0
0,0,0,0,0,0,0,0,0
0,0,0,0,0,0,0,0,0
0,0,0,0,0,0,0,0,0
0,0,0,0,0,0,0,0,0
0,0,0,0,0,0,0,0,0
0,0,0,0,0,0,0,0,0
0,0,0,0,0,0,0,0,0
0,0,0,0,0,0,0,0,0
0,0,0,0,0,0,0,0,0
0,0,0,0,0,0,0,0,0
0,0,0,0,0,0,0,0,0
0,0,0,0,0,0,0,0,0
0,0,0,0,0,0,0,0,0
0,0,0,0,0,0,0,0,0
0,0,0,0,0,0,0,0,0
0,0,0,0,0,0,0,0,0
0,0,0,0,0,0,0,0,0
0,0,0,0,0,0,0,0,0
0,0,0,0,0,0,0,0,0
0,0,0,0,0,0,0,0,0
0,0,0,0,0,0,0,0,0
0,0,0,0,0,0,0,0,0
0,0,0,0,0,0,0,0,0
0,0,0,0,0,0,0,0,0
0,0,0,0,0,0,0,0,0
0,0,0,0,0,0,0,0,0
0,0,0,0,0,0,0,0,0
0,0,0,0,0,0,0,0,0
0,0,0,0,0,0,0,0,0
0,0,0,0,0,0,0,0,0
0,0,0,0,0,0,0,0,0
33622,46,2,0,0,0,2,0,0
33622,46,2,0,0,0,2,0,0
0,0,0,0,0,0,0,0,0
0,0,0,0,0,0,0,0,0
0,0,0,0,0,0,0,0,0
0,0,0,0,0,0,0,0,0
0,0,0,0,0,0,0,0,0
135968,42,4,1,1,0,2,0,0
135968,42,4,1,1,0,2,0,0
135968,42,4,1,1,0,2,0,0
0,0,0,0,0,0,0,0,0
0,0,0,0,0,0,0,0,0
0,0,0,0,0,0,0,0,0
0,0,0,0,0,0,0,0,0
0,0,0,0,0,0,0,0,0
0,0,0,0,0,0,0,0,0
0,0,0,0,0,0,0,0,0
0,0,0,0,0,0,0,0,0
0,0,0,0,0,0,0,0,0
0,0,0,0,0,0,0,0,0
0,0,0,0,0,0,0,0,0
0,0,0,0,0,0,0,0,0
145738,72,4,3,3,0,2,1,0
0,0,0,0,0,0,0,0,0
0,0,0,0,0,0,0,0,0
0,0,0,0,0,0,0,0,0
0,0,0,0,0,0,0,0,0
0,0,0,0,0,0,0,0,0
0,0,0,0,0,0,0,0,0
0,0,0,0,0,0,0,0,0
0,0,0,0,0,0,0,0,0
0,0,0,0,0,0,0,0,0
0,0,0,0,0,0,0,0,0
0,0,0,0,0,0,0,0,0
144400,42,4,1,1,0,2,0,0
144400,42,4,1,1,0,2,0,0
0,0,0,0,0,0,0,0,0
0,0,0,0,0,0,0,0,0
0,0,0,0,0,0,0,0,0
0,0,0,0,0,0,0,0,0
0,0,0,0,0,0,0,0,0
327208,60,4,3,3,0,2,1,0
327208,60,4,3,3,0,2,1,0
327208,60,4,3,3,0,2,1,0
0,0,0,0,0,0,0,0,0
327208,60,4,3,3,0,2,1,0
0,0,0,0,0,0,0,0,0
0,0,0,0,0,0,0,0,0
0,0,0,0,0,0,0,0,0
0,0,0,0,0,0,0,0,0
0,0,0,0,0,0,0,0,0
29852,70,1,0,0,0,1,0,0
1026053,104,0,17,3,14,2,1,0
1026053,104,0,17,3,14,2,1,0
0,0,0,0,0,0,0,0,0
0,0,0,0,0,0,0,0,0
129547,766,7,17,11,6,4,1,0
129555,766,7,17,11,6,4,1,0
0,0,0,0,0,0,0,0,0
0,0,0,0,0,0,0,0,0
0,0,0,0,0,0,0,0,0
15016,142,0,56,51,5,0,0,0
0,0,0,0,0,0,0,0,0
102670,76,4,6,6,0,5,1,0
0,0,0,0,0,0,0,0,0
0,0,0,0,0,0,0,0,0
2673,21,2,1,0,1,0,0,0
0,0,0,0,0,0,0,0,0
70077,12,0,0,0,0,0,0,0
0,0,0,0,0,0,0,0,0
0,0,0,0,0,0,0,0,0
0,0,0,0,0,0,0,0,0
0,0,0,0,0,0,0,0,0
38206,141,1,4,2,2,0,0,0
0,0,0,0,0,0,0,0,0
13028,108,1,5,5,0,0,1,0
0,0,0,0,0,0,0,0,0
0,0,0,0,0,0,0,0,0
134349,317,8,27,24,3,19,1,0
63491,366,6,70,56,14,2,1,0
0,0,0,0,0,0,0,0,0
3105,23,2,1,0,1,0,0,0
0,0,0,0,0,0,0,0,0
0,0,0,0,0,0,0,0,0
0,0,0,0,0,0,0,0,0
0,0,0,0,0,0,0,0,0
0,0,0,0,0,0,0,0,0
65953,50,3,0,0,0,0,0,0
106068,588,10,16,4,12,1,1,0
0,0,0,0,0,0,0,0,0
0,0,0,0,0,0,0,0,0
52029,83,1,0,0,0,1,0,0
52029,83,1,0,0,0,1,0,0
13141,29,1,0,0,0,3,0,0
13141,29,1,0,0,0,3,0,0
0,0,0,0,0,0,0,0,0
0,0,0,0,0,0,0,0,0
0,0,0,0,0,0,0,0,0
0,0,0,0,0,0,0,0,0
0,0,0,0,0,0,0,0,0
0,0,0,0,0,0,0,0,0
0,0,0,0,0,0,0,0,0
0,0,0,0,0,0,0,0,0
0,0,0,0,0,0,0,0,0
0,0,0,0,0,0,0,0,0
0,0,0,0,0,0,0,0,0
0,0,0,0,0,0,0,0,0
0,0,0,0,0,0,0,0,0
0,0,0,0,0,0,0,0,0
0,0,0,0,0,0,0,0,0
0,0,0,0,0,0,0,0,0
51854,51,3,0,0,0,2,0,0
51854,51,3,0,0,0,2,0,0
0,0,0,0,0,0,0,0,0
0,0,0,0,0,0,0,0,0
0,0,0,0,0,0,0,0,0
0,0,0,0,0,0,0,0,0
0,0,0,0,0,0,0,0,0
0,0,0,0,0,0,0,0,0
0,0,0,0,0,0,0,0,0
0,0,0,0,0,0,0,0,0
0,0,0,0,0,0,0,0,0
0,0,0,0,0,0,0,0,0
0,0,0,0,0,0,0,0,0
0,0,0,0,0,0,0,0,0
26054,206,2,50,49,1,0,1,0
26054,206,2,50,49,1,0,1,0
26054,206,2,50,49,1,0,1,0
26054,206,2,50,49,1,0,1,0
26054,206,2,50,49,1,0,1,0
0,0,0,0,0,0,0,0,0
0,0,0,0,0,0,0,0,0
0,0,0,0,0,0,0,0,0
0,0,0,0,0,0,0,0,0
0,0,0,0,0,0,0,0,0
0,0,0,0,0,0,0,0,0
0,0,0,0,0,0,0,0,0
0,0,0,0,0,0,0,0,0
0,0,0,0,0,0,0,0,0
0,0,0,0,0,0,0,0,0
0,0,0,0,0,0,0,0,0
0,0,0,0,0,0,0,0,0
0,0,0,0,0,0,0,0,0
0,0,0,0,0,0,0,0,0
0,0,0,0,0,0,0,0,0
0,0,0,0,0,0,0,0,0
0,0,0,0,0,0,0,0,0
0,0,0,0,0,0,0,0,0
0,0,0,0,0,0,0,0,0
0,0,0,0,0,0,0,0,0
0,0,0,0,0,0,0,0,0
0,0,0,0,0,0,0,0,0
0,0,0,0,0,0,0,0,0
0,0,0,0,0,0,0,0,0
6978,50,2,1,1,0,0,1,0
0,0,0,0,0,0,0,0,0
6978,50,2,1,1,0,0,1,0
6978,50,2,1,1,0,0,1,0
0,0,0,0,0,0,0,0,0
327211,60,4,3,3,0,2,1,0
327211,60,4,3,3,0,2,1,0
327211,60,4,3,3,0,2,1,0
327211,60,4,3,3,0,2,1,0
327211,60,4,3,3,0,2,1,0
6978,50,2,1,1,0,0,1,0
6978,50,2,1,1,0,0,1,0
0,0,0,0,0,0,0,0,0
6978,50,2,1,1,0,0,1,0
0,0,0,0,0,0,0,0,0
0,0,0,0,0,0,0,0,0
0,0,0,0,0,0,0,0,0
6978,50,2,1,1,0,0,1,0
6978,50,2,1,1,0,0,1,0
0,0,0,0,0,0,0,0,0
0,0,0,0,0,0,0,0,0
6978,50,2,1,1,0,0,1,0
6978,50,2,1,1,0,0,1,0
0,0,0,0,0,0,0,0,0
0,0,0,0,0,0,0,0,0
0,0,0,0,0,0,0,0,0
0,0,0,0,0,0,0,0,0
0,0,0,0,0,0,0,0,0
0,0,0,0,0,0,0,0,0
111075,361,16,28,24,4,2,1,0
111075,361,16,28,24,4,2,1,0
0,0,0,0,0,0,0,0,0
0,0,0,0,0,0,0,0,0
0,0,0,0,0,0,0,0,0
0,0,0,0,0,0,0,0,0
0,0,0,0,0,0,0,0,0
0,0,0,0,0,0,0,0,0
0,0,0,0,0,0,0,0,0
0,0,0,0,0,0,0,0,0
1181385,9366,5,2033,1969,64,4,1,0
0,0,0,0,0,0,0,0,0
0,0,0,0,0,0,0,0,0
0,0,0,0,0,0,0,0,0
0,0,0,0,0,0,0,0,0
0,0,0,0,0,0,0,0,0
0,0,0,0,0,0,0,0,0
0,0,0,0,0,0,0,0,0
0,0,0,0,0,0,0,0,0
0,0,0,0,0,0,0,0,0
0,0,0,0,0,0,0,0,0
0,0,0,0,0,0,0,0,0
0,0,0,0,0,0,0,0,0
0,0,0,0,0,0,0,0,0
33197,155,3,8,3,5,9,1,0
0,0,0,0,0,0,0,0,0
140733,409,8,27,24,3,34,1,0
0,0,0,0,0,0,0,0,0
2673,21,2,1,0,1,0,0,0
0,0,0,0,0,0,0,0,0
0,0,0,0,0,0,0,0,0
21890,202,0,0,0,0,1,1,0
0,0,0,0,0,0,0,0,0
0,0,0,0,0,0,0,0,0
0,0,0,0,0,0,0,0,0
0,0,0,0,0,0,0,0,0
335365,3234,13,652,601,51,21,1,0
12768,217,0,72,2,70,0,1,0
0,0,0,0,0,0,0,0,0
17096,77,2,1,1,0,0,0,0
0,0,0,0,0,0,0,0,0
29336,63,3,1,1,0,0,0,0
58226,392,4,56,10,46,0,1,0
0,0,0,0,0,0,0,0,0
2487,39,1,7,7,0,0,0,0
2487,39,1,7,7,0,0,0,0
0,0,0,0,0,0,0,0,0
0,0,0,0,0,0,0,0,0
0,0,0,0,0,0,0,0,0
0,0,0,0,0,0,0,0,0
0,0,0,0,0,0,0,0,0
0,0,0,0,0,0,0,0,0
0,0,0,0,0,0,0,0,0
0,0,0,0,0,0,0,0,0
0,0,0,0,0,0,0,0,0
0,0,0,0,0,0,0,0,0
0,0,0,0,0,0,0,0,0
0,0,0,0,0,0,0,0,0
36408,50,2,0,0,0,2,0,0
0,0,0,0,0,0,0,0,0
0,0,0,0,0,0,0,0,0
0,0,0,0,0,0,0,0,0
0,0,0,0,0,0,0,0,0
283212,196,6,1,1,0,0,1,0
0,0,0,0,0,0,0,0,0
0,0,0,0,0,0,0,0,0
0,0,0,0,0,0,0,0,0
0,0,0,0,0,0,0,0,0
0,0,0,0,0,0,0,0,0
0,0,0,0,0,0,0,0,0
0,0,0,0,0,0,0,0,0
0,0,0,0,0,0,0,0,0
0,0,0,0,0,0,0,0,0
0,0,0,0,0,0,0,0,0
0,0,0,0,0,0,0,0,0
0,0,0,0,0,0,0,0,0
0,0,0,0,0,0,0,0,0
80606,134,6,8,7,1,8,1,0
0,0,0,0,0,0,0,0,0
12768,217,0,72,2,70,0,1,0
0,0,0,0,0,0,0,0,0
681571,557,0,4,0,4,2,1,1
0,0,0,0,0,0,0,0,0
0,0,0,0,0,0,0,0,0
66096,50,3,0,0,0,0,0,0
0,0,0,0,0,0,0,0,0
0,0,0,0,0,0,0,0,0
0,0,0,0,0,0,0,0,0
678892,557,0,4,4,0,2,1,1
0,0,0,0,0,0,0,0,0
0,0,0,0,0,0,0,0,0
2014,100,0,15,15,0,0,0,0
2014,100,0,15,15,0,0,0,0
0,0,0,0,0,0,0,0,0
0,0,0,0,0,0,0,0,0
0,0,0,0,0,0,0,0,0
0,0,0,0,0,0,0,0,0
0,0,0,0,0,0,0,0,0
0,0,0,0,0,0,0,0,0
0,0,0,0,0,0,0,0,0
0,0,0,0,0,0,0,0,0
0,0,0,0,0,0,0,0,0
0,0,0,0,0,0,0,0,0
0,0,0,0,0,0,0,0,0
0,0,0,0,0,0,0,0,0
13173,142,0,56,52,4,0,0,0
14123,142,0,56,52,4,0,0,0
0,0,0,0,0,0,0,0,0
0,0,0,0,0,0,0,0,0
0,0,0,0,0,0,0,0,0
0,0,0,0,0,0,0,0,0
0,0,0,0,0,0,0,0,0
0,0,0,0,0,0,0,0,0
0,0,0,0,0,0,0,0,0
2673,21,2,1,0,1,0,0,0
0,0,0,0,0,0,0,0,0
12768,217,0,72,72,0,0,1,0
12768,217,0,72,72,0,0,1,0
0,0,0,0,0,0,0,0,0
0,0,0,0,0,0,0,0,0
0,0,0,0,0,0,0,0,0
0,0,0,0,0,0,0,0,0
0,0,0,0,0,0,0,0,0
0,0,0,0,0,0,0,0,0
0,0,0,0,0,0,0,0,0
0,0,0,0,0,0,0,0,0
0,0,0,0,0,0,0,0,0
0,0,0,0,0,0,0,0,0
0,0,0,0,0,0,0,0,0
0,0,0,0,0,0,0,0,0
0,0,0,0,0,0,0,0,0
0,0,0,0,0,0,0,0,0
0,0,0,0,0,0,0,0,0
0,0,0,0,0,0,0,0,0
0,0,0,0,0,0,0,0,0
0,0,0,0,0,0,0,0,0
10871,33,1,0,0,0,1,0,0
0,0,0,0,0,0,0,0,0
0,0,0,0,0,0,0,0,0
0,0,0,0,0,0,0,0,0
0,0,0,0,0,0,0,0,0
6277,46,1,0,0,0,0,0,0
6277,46,1,0,0,0,0,0,0
6267,46,1,0,0,0,1,0,0
6283,46,1,0,0,0,1,0,0
6267,46,1,0,0,0,1,0,0
0,0,0,0,0,0,0,0,0
0,0,0,0,0,0,0,0,0
0,0,0,0,0,0,0,0,0
0,0,0,0,0,0,0,0,0
0,0,0,0,0,0,0,0,0
0,0,0,0,0,0,0,0,0
0,0,0,0,0,0,0,0,0
0,0,0,0,0,0,0,0,0
0,0,0,0,0,0,0,0,0
0,0,0,0,0,0,0,0,0
0,0,0,0,0,0,0,0,0
0,0,0,0,0,0,0,0,0
0,0,0,0,0,0,0,0,0
0,0,0,0,0,0,0,0,0
0,0,0,0,0,0,0,0,0
0,0,0,0,0,0,0,0,0
0,0,0,0,0,0,0,0,0
0,0,0,0,0,0,0,0,0
0,0,0,0,0,0,0,0,0
0,0,0,0,0,0,0,0,0
0,0,0,0,0,0,0,0,0
0,0,0,0,0,0,0,0,0
0,0,0,0,0,0,0,0,0
0,0,0,0,0,0,0,0,0
5406,45,4,0,0,0,3,0,0
327220,60,4,3,3,0,2,1,0
327220,60,4,3,3,0,2,1,0
5406,45,4,0,0,0,3,0,0
5406,45,4,0,0,0,3,0,0
5406,45,4,0,0,0,3,0,0
0,0,0,0,0,0,0,0,0
0,0,0,0,0,0,0,0,0
327220,60,4,3,3,0,2,1,0
327220,60,4,3,3,0,2,1,0
0,0,0,0,0,0,0,0,0
0,0,0,0,0,0,0,0,0
0,0,0,0,0,0,0,0,0
0,0,0,0,0,0,0,0,0
0,0,0,0,0,0,0,0,0
0,0,0,0,0,0,0,0,0
0,0,0,0,0,0,0,0,0
0,0,0,0,0,0,0,0,0
0,0,0,0,0,0,0,0,0
0,0,0,0,0,0,0,0,0
0,0,0,0,0,0,0,0,0
0,0,0,0,0,0,0,0,0
0,0,0,0,0,0,0,0,0
0,0,0,0,0,0,0,0,0
0,0,0,0,0,0,0,0,0
0,0,0,0,0,0,0,0,0
0,0,0,0,0,0,0,0,0
0,0,0,0,0,0,0,0,0
0,0,0,0,0,0,0,0,0
10594,64,4,0,0,0,2,0,0
10594,64,4,0,0,0,2,0,0
0,0,0,0,0,0,0,0,0
98962,66,4,0,0,0,2,1,0
10594,64,4,0,0,0,2,0,0
0,0,0,0,0,0,0,0,0
8250,146,0,15,15,0,5,1,0
8250,146,0,15,15,0,5,1,0
0,0,0,0,0,0,0,0,0
0,0,0,0,0,0,0,0,0
77798,101,1,4,2,2,0,0,0
411857,207,6,2,1,1,0,1,0
137791,394,8,27,24,3,33,1,0
0,0,0,0,0,0,0,0,0
0,0,0,0,0,0,0,0,0
0,0,0,0,0,0,0,0,0
0,0,0,0,0,0,0,0,0
0,0,0,0,0,0,0,0,0
0,0,0,0,0,0,0,0,0
0,0,0,0,0,0,0,0,0
0,0,0,0,0,0,0,0,0
0,0,0,0,0,0,0,0,0
0,0,0,0,0,0,0,0,0
87675,310,5,23,0,23,2,1,0
0,0,0,0,0,0,0,0,0
0,0,0,0,0,0,0,0,0
0,0,0,0,0,0,0,0,0
0,0,0,0,0,0,0,0,0
0,0,0,0,0,0,0,0,0
674731,543,0,4,4,0,2,1,1
0,0,0,0,0,0,0,0,0
37962,176,6,7,5,2,1,0,0
0,0,0,0,0,0,0,0,0
0,0,0,0,0,0,0,0,0
1171559,3194,11,155,141,14,20,1,0
2214,16,0,0,0,0,0,0,0
0,0,0,0,0,0,0,0,0
0,0,0,0,0,0,0,0,0
287100,187,4,1,1,0,0,1,0
0,0,0,0,0,0,0,0,0
581011,207,6,1,1,0,0,1,0
293845,186,4,1,1,0,0,1,0
0,0,0,0,0,0,0,0,0
0,0,0,0,0,0,0,0,0
0,0,0,0,0,0,0,0,0
0,0,0,0,0,0,0,0,0
0,0,0,0,0,0,0,0,0
0,0,0,0,0,0,0,0,0
0,0,0,0,0,0,0,0,0
0,0,0,0,0,0,0,0,0
0,0,0,0,0,0,0,0,0
35077,481,7,65,64,1,1,1,0
50999,730,2,134,131,3,0,1,0
0,0,0,0,0,0,0,0,0
0,0,0,0,0,0,0,0,0
0,0,0,0,0,0,0,0,0
0,0,0,0,0,0,0,0,0
0,0,0,0,0,0,0,0,0
0,0,0,0,0,0,0,0,0
0,0,0,0,0,0,0,0,0
0,0,0,0,0,0,0,0,0
159369,1390,7,171,156,15,1,1,0
0,0,0,0,0,0,0,0,0
0,0,0,0,0,0,0,0,0
0,0,0,0,0,0,0,0,0
0,0,0,0,0,0,0,0,0
0,0,0,0,0,0,0,0,0
0,0,0,0,0,0,0,0,0
67521,81,3,0,0,0,4,0,0
0,0,0,0,0,0,0,0,0
0,0,0,0,0,0,0,0,0
0,0,0,0,0,0,0,0,0
0,0,0,0,0,0,0,0,0
0,0,0,0,0,0,0,0,0
0,0,0,0,0,0,0,0,0
67521,81,3,0,0,0,4,0,0
0,0,0,0,0,0,0,0,0
0,0,0,0,0,0,0,0,0
0,0,0,0,0,0,0,0,0
0,0,0,0,0,0,0,0,0
0,0,0,0,0,0,0,0,0
0,0,0,0,0,0,0,0,0
0,0,0,0,0,0,0,0,0
0,0,0,0,0,0,0,0,0
0,0,0,0,0,0,0,0,0
0,0,0,0,0,0,0,0,0
10981,56,3,0,0,0,2,0,0
10981,56,3,0,0,0,2,0,0
0,0,0,0,0,0,0,0,0
0,0,0,0,0,0,0,0,0
0,0,0,0,0,0,0,0,0
39972,52,2,2,2,0,3,0,0
0,0,0,0,0,0,0,0,0
0,0,0,0,0,0,0,0,0
10981,56,3,0,0,0,2,0,0
10981,56,3,0,0,0,2,0,0
10981,56,3,0,0,0,2,0,0
0,0,0,0,0,0,0,0,0
56662,56,0,0,0,0,0,1,0
0,0,0,0,0,0,0,0,0
0,0,0,0,0,0,0,0,0
0,0,0,0,0,0,0,0,0
0,0,0,0,0,0,0,0,0
0,0,0,0,0,0,0,0,0
77742,101,1,4,2,2,0,0,0
22963,205,2,11,11,0,3,1,0
0,0,0,0,0,0,0,0,0
35784,158,3,8,4,4,10,1,0
5894,91,6,19,19,0,0,0,0
0,0,0,0,0,0,0,0,0
276373,1135,15,81,76,5,3,1,0
0,0,0,0,0,0,0,0,0
332518,60,4,3,3,0,2,1,0
0,0,0,0,0,0,0,0,0
0,0,0,0,0,0,0,0,0
1245989,188,3,25,3,22,4,1,0
0,0,0,0,0,0,0,0,0
0,0,0,0,0,0,0,0,0
53223,174,3,8,6,2,0,0,0
0,0,0,0,0,0,0,0,0
304571,240,4,1,1,0,0,1,0
0,0,0,0,0,0,0,0,0
0,0,0,0,0,0,0,0,0
0,0,0,0,0,0,0,0,0
0,0,0,0,0,0,0,0,0
0,0,0,0,0,0,0,0,0
0,0,0,0,0,0,0,0,0
0,0,0,0,0,0,0,0,0
0,0,0,0,0,0,0,0,0
0,0,0,0,0,0,0,0,0
0,0,0,0,0,0,0,0,0
0,0,0,0,0,0,0,0,0
0,0,0,0,0,0,0,0,0
0,0,0,0,0,0,0,0,0
49437,240,2,1,1,0,1,0,0
0,0,0,0,0,0,0,0,0
677195,557,0,4,4,0,2,1,1
2673,21,2,1,0,1,0,0,0
0,0,0,0,0,0,0,0,0
0,0,0,0,0,0,0,0,0
10301,95,1,0,0,0,0,0,0
27315,36,0,3,1,2,0,0,0
0,0,0,0,0,0,0,0,0
0,0,0,0,0,0,0,0,0
20594,37,0,0,0,0,0,0,0
63884,50,3,0,0,0,0,0,0
1094690,117,2,4,0,4,0,1,0
0,0,0,0,0,0,0,0,0
181349,113,2,7,0,7,1,1,0
14975,28,1,2,2,0,0,0,0
9502,84,1,0,0,0,0,0,0
676913,557,0,4,4,0,2,1,1
120046,816,17,36,27,9,8,1,0
0,0,0,0,0,0,0,0,0
0,0,0,0,0,0,0,0,0
0,0,0,0,0,0,0,0,0
0,0,0,0,0,0,0,0,0
0,0,0,0,0,0,0,0,0
98116,597,9,84,75,9,1,1,0
0,0,0,0,0,0,0,0,0
0,0,0,0,0,0,0,0,0
592194,72,3,2,1,1,1,1,0
0,0,0,0,0,0,0,0,0
0,0,0,0,0,0,0,0,0
3406,49,4,0,0,0,0,0,0
0,0,0,0,0,0,0,0,0
0,0,0,0,0,0,0,0,0
0,0,0,0,0,0,0,0,0
0,0,0,0,0,0,0,0,0
0,0,0,0,0,0,0,0,0
0,0,0,0,0,0,0,0,0
0,0,0,0,0,0,0,0,0
15889,259,3,53,52,1,1,1,0
15889,259,3,53,52,1,1,1,0
0,0,0,0,0,0,0,0,0
0,0,0,0,0,0,0,0,0
0,0,0,0,0,0,0,0,0
0,0,0,0,0,0,0,0,0
430145,1544,2,196,194,2,25,1,0
0,0,0,0,0,0,0,0,0
568598,48,2,0,0,0,2,0,0
0,0,0,0,0,0,0,0,0
0,0,0,0,0,0,0,0,0
0,0,0,0,0,0,0,0,0
0,0,0,0,0,0,0,0,0
0,0,0,0,0,0,0,0,0
0,0,0,0,0,0,0,0,0
0,0,0,0,0,0,0,0,0
0,0,0,0,0,0,0,0,0
0,0,0,0,0,0,0,0,0
568598,48,2,0,0,0,2,0,0
0,0,0,0,0,0,0,0,0
16622,63,4,9,9,0,2,0,0
0,0,0,0,0,0,0,0,0
0,0,0,0,0,0,0,0,0
0,0,0,0,0,0,0,0,0
0,0,0,0,0,0,0,0,0
0,0,0,0,0,0,0,0,0
0,0,0,0,0,0,0,0,0
0,0,0,0,0,0,0,0,0
0,0,0,0,0,0,0,0,0
0,0,0,0,0,0,0,0,0
0,0,0,0,0,0,0,0,0
0,0,0,0,0,0,0,0,0
0,0,0,0,0,0,0,0,0
0,0,0,0,0,0,0,0,0
106559,49,3,0,0,0,3,0,0
0,0,0,0,0,0,0,0,0
0,0,0,0,0,0,0,0,0
0,0,0,0,0,0,0,0,0
0,0,0,0,0,0,0,0,0
106555,49,3,0,0,0,3,0,0
106548,49,3,0,0,0,3,0,0
0,0,0,0,0,0,0,0,0
106548,49,3,0,0,0,3,0,0
327097,60,4,3,3,0,2,1,0
415465,62,4,3,3,0,2,1,0
0,0,0,0,0,0,0,0,0
0,0,0,0,0,0,0,0,0
0,0,0,0,0,0,0,0,0
327097,60,4,3,3,0,2,1,0
327097,60,4,3,3,0,2,1,0
327097,60,4,3,3,0,2,1,0
327097,60,4,3,3,0,2,1,0
327097,60,4,3,3,0,2,1,0
0,0,0,0,0,0,0,0,0
0,0,0,0,0,0,0,0,0
0,0,0,0,0,0,0,0,0
0,0,0,0,0,0,0,0,0
0,0,0,0,0,0,0,0,0
0,0,0,0,0,0,0,0,0
0,0,0,0,0,0,0,0,0
0,0,0,0,0,0,0,0,0
0,0,0,0,0,0,0,0,0
0,0,0,0,0,0,0,0,0
0,0,0,0,0,0,0,0,0
0,0,0,0,0,0,0,0,0
0,0,0,0,0,0,0,0,0
0,0,0,0,0,0,0,0,0
0,0,0,0,0,0,0,0,0
0,0,0,0,0,0,0,0,0
0,0,0,0,0,0,0,0,0
0,0,0,0,0,0,0,0,0
0,0,0,0,0,0,0,0,0
0,0,0,0,0,0,0,0,0
0,0,0,0,0,0,0,0,0
0,0,0,0,0,0,0,0,0
0,0,0,0,0,0,0,0,0
0,0,0,0,0,0,0,0,0
188544,218,0,52,51,1,1,1,0
77730,101,1,4,2,2,0,0,0
222226,92,1,4,1,3,0,0,0
193740,92,1,3,1,2,5,0,0
0,0,0,0,0,0,0,0,0
0,0,0,0,0,0,0,0,0
0,0,0,0,0,0,0,0,0
0,0,0,0,0,0,0,0,0
15098,162,3,0,0,0,2,1,0
0,0,0,0,0,0,0,0,0
0,0,0,0,0,0,0,0,0
0,0,0,0,0,0,0,0,0
0,0,0,0,0,0,0,0,0
0,0,0,0,0,0,0,0,0
5081,74,2,6,6,0,0,0,0
0,0,0,0,0,0,0,0,0
0,0,0,0,0,0,0,0,0
0,0,0,0,0,0,0,0,0
0,0,0,0,0,0,0,0,0
0,0,0,0,0,0,0,0,0
0,0,0,0,0,0,0,0,0
0,0,0,0,0,0,0,0,0
0,0,0,0,0,0,0,0,0
0,0,0,0,0,0,0,0,0
0,0,0,0,0,0,0,0,0
0,0,0,0,0,0,0,0,0
0,0,0,0,0,0,0,0,0
0,0,0,0,0,0,0,0,0
103527,1437,8,386,386,0,3,1,0
0,0,0,0,0,0,0,0,0
0,0,0,0,0,0,0,0,0
0,0,0,0,0,0,0,0,0
0,0,0,0,0,0,0,0,0
16335,89,0,15,1,14,0,1,0
0,0,0,0,0,0,0,0,0
0,0,0,0,0,0,0,0,0
0,0,0,0,0,0,0,0,0
0,0,0,0,0,0,0,0,0
0,0,0,0,0,0,0,0,0
82623,238,3,20,17,3,0,0,0
0,0,0,0,0,0,0,0,0
0,0,0,0,0,0,0,0,0
50999,730,2,134,131,3,0,1,0
261399,646,0,0,0,0,0,1,0
677082,557,0,4,4,0,2,1,1
0,0,0,0,0,0,0,0,0
118194,719,0,151,149,2,14,1,0
225523,1573,4,38,31,7,0,1,0
52383,360,6,70,56,14,2,1,0
0,0,0,0,0,0,0,0,0
0,0,0,0,0,0,0,0,0
143403,259,1,20,7,13,7,1,0
0,0,0,0,0,0,0,0,0
138496,394,8,26,24,2,32,1,0
0,0,0,0,0,0,0,0,0
0,0,0,0,0,0,0,0,0
104307,85,0,13,13,0,6,0,0
94325,84,0,15,15,0,6,0,0
103783,86,0,13,13,0,6,0,0
0,0,0,0,0,0,0,0,0
224359,690,3,3,3,0,26,1,0
88196,543,9,46,45,1,2,1,0
13468,113,1,0,0,0,0,0,0
0,0,0,0,0,0,0,0,0
0,0,0,0,0,0,0,0,0
0,0,0,0,0,0,0,0,0
0,0,0,0,0,0,0,0,0
0,0,0,0,0,0,0,0,0
0,0,0,0,0,0,0,0,0
0,0,0,0,0,0,0,0,0
0,0,0,0,0,0,0,0,0
0,0,0,0,0,0,0,0,0
0,0,0,0,0,0,0,0,0
0,0,0,0,0,0,0,0,0
0,0,0,0,0,0,0,0,0
0,0,0,0,0,0,0,0,0
0,0,0,0,0,0,0,0,0
0,0,0,0,0,0,0,0,0
36414,50,2,0,0,0,2,0,0
12216,51,3,0,0,0,2,0,0
0,0,0,0,0,0,0,0,0
36414,50,2,0,0,0,2,0,0
0,0,0,0,0,0,0,0,0
0,0,0,0,0,0,0,0,0
0,0,0,0,0,0,0,0,0
0,0,0,0,0,0,0,0,0
0,0,0,0,0,0,0,0,0
0,0,0,0,0,0,0,0,0
0,0,0,0,0,0,0,0,0
0,0,0,0,0,0,0,0,0
0,0,0,0,0,0,0,0,0
0,0,0,0,0,0,0,0,0
0,0,0,0,0,0,0,0,0
0,0,0,0,0,0,0,0,0
0,0,0,0,0,0,0,0,0
0,0,0,0,0,0,0,0,0
0,0,0,0,0,0,0,0,0
0,0,0,0,0,0,0,0,0
0,0,0,0,0,0,0,0,0
0,0,0,0,0,0,0,0,0
0,0,0,0,0,0,0,0,0
0,0,0,0,0,0,0,0,0
0,0,0,0,0,0,0,0,0
0,0,0,0,0,0,0,0,0
0,0,0,0,0,0,0,0,0
0,0,0,0,0,0,0,0,0
0,0,0,0,0,0,0,0,0
0,0,0,0,0,0,0,0,0
0,0,0,0,0,0,0,0,0
0,0,0,0,0,0,0,0,0
0,0,0,0,0,0,0,0,0
0,0,0,0,0,0,0,0,0
0,0,0,0,0,0,0,0,0
0,0,0,0,0,0,0,0,0
0,0,0,0,0,0,0,0,0
0,0,0,0,0,0,0,0,0
0,0,0,0,0,0,0,0,0
0,0,0,0,0,0,0,0,0
0,0,0,0,0,0,0,0,0
0,0,0,0,0,0,0,0,0
0,0,0,0,0,0,0,0,0
0,0,0,0,0,0,0,0,0
0,0,0,0,0,0,0,0,0
0,0,0,0,0,0,0,0,0
0,0,0,0,0,0,0,0,0
0,0,0,0,0,0,0,0,0
0,0,0,0,0,0,0,0,0
0,0,0,0,0,0,0,0,0
0,0,0,0,0,0,0,0,0
0,0,0,0,0,0,0,0,0
0,0,0,0,0,0,0,0,0
0,0,0,0,0,0,0,0,0
0,0,0,0,0,0,0,0,0
0,0,0,0,0,0,0,0,0
0,0,0,0,0,0,0,0,0
0,0,0,0,0,0,0,0,0
0,0,0,0,0,0,0,0,0
0,0,0,0,0,0,0,0,0
0,0,0,0,0,0,0,0,0
0,0,0,0,0,0,0,0,0
0,0,0,0,0,0,0,0,0
0,0,0,0,0,0,0,0,0
0,0,0,0,0,0,0,0,0
0,0,0,0,0,0,0,0,0
0,0,0,0,0,0,0,0,0
0,0,0,0,0,0,0,0,0
0,0,0,0,0,0,0,0,0
135993,42,4,1,1,0,2,0,0
0,0,0,0,0,0,0,0,0
0,0,0,0,0,0,0,0,0
0,0,0,0,0,0,0,0,0
0,0,0,0,0,0,0,0,0
0,0,0,0,0,0,0,0,0
0,0,0,0,0,0,0,0,0
28052,97,0,2,0,2,2,0,0
0,0,0,0,0,0,0,0,0
112082,1446,2,14,1,13,0,0,0
0,0,0,0,0,0,0,0,0
0,0,0,0,0,0,0,0,0
0,0,0,0,0,0,0,0,0
0,0,0,0,0,0,0,0,0
77790,101,1,4,2,2,0,0,0
77768,101,1,4,2,2,0,0,0
0,0,0,0,0,0,0,0,0
0,0,0,0,0,0,0,0,0
0,0,0,0,0,0,0,0,0
0,0,0,0,0,0,0,0,0
0,0,0,0,0,0,0,0,0
0,0,0,0,0,0,0,0,0
0,0,0,0,0,0,0,0,0
0,0,0,0,0,0,0,0,0
0,0,0,0,0,0,0,0,0
0,0,0,0,0,0,0,0,0
0,0,0,0,0,0,0,0,0
0,0,0,0,0,0,0,0,0
508520,48,2,2,2,0,2,0,0
0,0,0,0,0,0,0,0,0
0,0,0,0,0,0,0,0,0
0,0,0,0,0,0,0,0,0
0,0,0,0,0,0,0,0,0
0,0,0,0,0,0,0,0,0
0,0,0,0,0,0,0,0,0
0,0,0,0,0,0,0,0,0
0,0,0,0,0,0,0,0,0
0,0,0,0,0,0,0,0,0
0,0,0,0,0,0,0,0,0
0,0,0,0,0,0,0,0,0
0,0,0,0,0,0,0,0,0
0,0,0,0,0,0,0,0,0
0,0,0,0,0,0,0,0,0
0,0,0,0,0,0,0,0,0
0,0,0,0,0,0,0,0,0
0,0,0,0,0,0,0,0,0
0,0,0,0,0,0,0,0,0
0,0,0,0,0,0,0,0,0
0,0,0,0,0,0,0,0,0
0,0,0,0,0,0,0,0,0
0,0,0,0,0,0,0,0,0
0,0,0,0,0,0,0,0,0
0,0,0,0,0,0,0,0,0
0,0,0,0,0,0,0,0,0
0,0,0,0,0,0,0,0,0
0,0,0,0,0,0,0,0,0
0,0,0,0,0,0,0,0,0
0,0,0,0,0,0,0,0,0
275009,1129,15,81,76,5,3,1,0
0,0,0,0,0,0,0,0,0
0,0,0,0,0,0,0,0,0
0,0,0,0,0,0,0,0,0
0,0,0,0,0,0,0,0,0
303008,295,4,11,6,5,0,1,0
0,0,0,0,0,0,0,0,0
0,0,0,0,0,0,0,0,0
1711658,53,1,5,4,1,2,1,0
0,0,0,0,0,0,0,0,0
46670,203,2,1,1,0,1,0,0
49302,235,2,1,0,1,2,0,0
7740,58,4,7,1,6,0,0,0
0,0,0,0,0,0,0,0,0
3644,47,1,2,2,0,0,0,0
0,0,0,0,0,0,0,0,0
9643,28,1,2,2,0,0,0,0
63884,50,3,0,0,0,0,0,0
0,0,0,0,0,0,0,0,0
94236,214,4,0,0,0,1,0,0
0,0,0,0,0,0,0,0,0
28319,377,1,17,17,0,0,1,0
0,0,0,0,0,0,0,0,0
0,0,0,0,0,0,0,0,0
55642,73,1,8,2,6,0,0,0
0,0,0,0,0,0,0,0,0
0,0,0,0,0,0,0,0,0
0,0,0,0,0,0,0,0,0
22083,33,0,1,1,0,0,1,0
0,0,0,0,0,0,0,0,0
55654,73,1,8,2,6,0,0,0
123823,1499,11,278,267,11,19,1,0
78265,260,1,10,10,0,0,0,0
0,0,0,0,0,0,0,0,0
0,0,0,0,0,0,0,0,0
0,0,0,0,0,0,0,0,0
0,0,0,0,0,0,0,0,0
0,0,0,0,0,0,0,0,0
147665,921,13,41,36,5,0,1,0
0,0,0,0,0,0,0,0,0
0,0,0,0,0,0,0,0,0
0,0,0,0,0,0,0,0,0
0,0,0,0,0,0,0,0,0
0,0,0,0,0,0,0,0,0
186644,208,0,52,51,1,0,1,0
186644,208,0,52,51,1,0,1,0
0,0,0,0,0,0,0,0,0
0,0,0,0,0,0,0,0,0
186644,208,0,52,51,1,0,1,0
0,0,0,0,0,0,0,0,0
186644,208,0,52,51,1,0,1,0
186644,208,0,52,51,1,0,1,0
0,0,0,0,0,0,0,0,0
0,0,0,0,0,0,0,0,0
0,0,0,0,0,0,0,0,0
0,0,0,0,0,0,0,0,0
0,0,0,0,0,0,0,0,0
0,0,0,0,0,0,0,0,0
0,0,0,0,0,0,0,0,0
0,0,0,0,0,0,0,0,0
0,0,0,0,0,0,0,0,0
0,0,0,0,0,0,0,0,0
0,0,0,0,0,0,0,0,0
0,0,0,0,0,0,0,0,0
0,0,0,0,0,0,0,0,0
0,0,0,0,0,0,0,0,0
0,0,0,0,0,0,0,0,0
0,0,0,0,0,0,0,0,0
0,0,0,0,0,0,0,0,0
0,0,0,0,0,0,0,0,0
0,0,0,0,0,0,0,0,0
0,0,0,0,0,0,0,0,0
0,0,0,0,0,0,0,0,0
0,0,0,0,0,0,0,0,0
0,0,0,0,0,0,0,0,0
0,0,0,0,0,0,0,0,0
0,0,0,0,0,0,0,0,0
0,0,0,0,0,0,0,0,0
0,0,0,0,0,0,0,0,0
0,0,0,0,0,0,0,0,0
0,0,0,0,0,0,0,0,0
0,0,0,0,0,0,0,0,0
0,0,0,0,0,0,0,0,0
0,0,0,0,0,0,0,0,0
0,0,0,0,0,0,0,0,0
0,0,0,0,0,0,0,0,0
0,0,0,0,0,0,0,0,0
0,0,0,0,0,0,0,0,0
0,0,0,0,0,0,0,0,0
0,0,0,0,0,0,0,0,0
0,0,0,0,0,0,0,0,0
0,0,0,0,0,0,0,0,0
0,0,0,0,0,0,0,0,0
0,0,0,0,0,0,0,0,0
127634,68,3,1,0,1,0,1,0
127634,68,3,1,0,1,0,1,0
0,0,0,0,0,0,0,0,0
0,0,0,0,0,0,0,0,0
0,0,0,0,0,0,0,0,0
0,0,0,0,0,0,0,0,0
0,0,0,0,0,0,0,0,0
0,0,0,0,0,0,0,0,0
0,0,0,0,0,0,0,0,0
24542,67,2,1,1,0,2,0,0
0,0,0,0,0,0,0,0,0
0,0,0,0,0,0,0,0,0
0,0,0,0,0,0,0,0,0
0,0,0,0,0,0,0,0,0
0,0,0,0,0,0,0,0,0
0,0,0,0,0,0,0,0,0
24542,67,2,1,1,0,2,0,0
24542,67,2,1,1,0,2,0,0
327095,60,4,3,3,0,2,1,0
327095,60,4,3,3,0,2,1,0
0,0,0,0,0,0,0,0,0
0,0,0,0,0,0,0,0,0
0,0,0,0,0,0,0,0,0
0,0,0,0,0,0,0,0,0
144742,62,4,3,3,0,2,1,0
0,0,0,0,0,0,0,0,0
0,0,0,0,0,0,0,0,0
0,0,0,0,0,0,0,0,0
0,0,0,0,0,0,0,0,0
0,0,0,0,0,0,0,0,0
0,0,0,0,0,0,0,0,0
0,0,0,0,0,0,0,0,0
0,0,0,0,0,0,0,0,0
0,0,0,0,0,0,0,0,0
0,0,0,0,0,0,0,0,0
0,0,0,0,0,0,0,0,0
0,0,0,0,0,0,0,0,0
0,0,0,0,0,0,0,0,0
0,0,0,0,0,0,0,0,0
0,0,0,0,0,0,0,0,0
0,0,0,0,0,0,0,0,0
0,0,0,0,0,0,0,0,0
0,0,0,0,0,0,0,0,0
0,0,0,0,0,0,0,0,0
0,0,0,0,0,0,0,0,0
0,0,0,0,0,0,0,0,0
0,0,0,0,0,0,0,0,0
327095,60,4,3,3,0,2,1,0
327095,60,4,3,3,0,2,1,0
0,0,0,0,0,0,0,0,0
0,0,0,0,0,0,0,0,0
0,0,0,0,0,0,0,0,0
77798,101,1,4,2,2,0,0,0
193740,92,1,3,1,2,5,0,0
0,0,0,0,0,0,0,0,0
0,0,0,0,0,0,0,0,0
0,0,0,0,0,0,0,0,0
718977,180,1,4,0,4,1,0,0
0,0,0,0,0,0,0,0,0
0,0,0,0,0,0,0,0,0
53729,93,3,8,6,2,0,0,0
0,0,0,0,0,0,0,0,0
0,0,0,0,0,0,0,0,0
0,0,0,0,0,0,0,0,0
0,0,0,0,0,0,0,0,0
0,0,0,0,0,0,0,0,0
0,0,0,0,0,0,0,0,0
0,0,0,0,0,0,0,0,0
0,0,0,0,0,0,0,0,0
0,0,0,0,0,0,0,0,0
0,0,0,0,0,0,0,0,0
0,0,0,0,0,0,0,0,0
0,0,0,0,0,0,0,0,0
0,0,0,0,0,0,0,0,0
0,0,0,0,0,0,0,0,0
0,0,0,0,0,0,0,0,0
0,0,0,0,0,0,0,0,0
0,0,0,0,0,0,0,0,0
0,0,0,0,0,0,0,0,0
0,0,0,0,0,0,0,0,0
0,0,0,0,0,0,0,0,0
45933,325,7,36,25,11,2,1,0
301818,956,8,98,97,1,13,1,0
0,0,0,0,0,0,0,0,0
0,0,0,0,0,0,0,0,0
0,0,0,0,0,0,0,0,0
0,0,0,0,0,0,0,0,0
0,0,0,0,0,0,0,0,0
676998,557,0,4,4,0,2,1,1
0,0,0,0,0,0,0,0,0
0,0,0,0,0,0,0,0,0
0,0,0,0,0,0,0,0,0
118192,719,0,151,149,2,14,1,0
23705,113,3,8,8,0,0,0,0
23705,113,3,8,8,0,0,0,0
17885,173,0,0,0,0,0,0,0
47025,203,2,1,1,0,1,0,0
0,0,0,0,0,0,0,0,0
0,0,0,0,0,0,0,0,0
0,0,0,0,0,0,0,0,0
0,0,0,0,0,0,0,0,0
0,0,0,0,0,0,0,0,0
0,0,0,0,0,0,0,0,0
1099734,409,9,45,36,9,1,1,0
0,0,0,0,0,0,0,0,0
0,0,0,0,0,0,0,0,0
0,0,0,0,0,0,0,0,0
0,0,0,0,0,0,0,0,0
0,0,0,0,0,0,0,0,0
0,0,0,0,0,0,0,0,0
0,0,0,0,0,0,0,0,0
317187,2153,11,169,125,44,1,1,0
143051,258,1,20,7,13,7,1,0
0,0,0,0,0,0,0,0,0
0,0,0,0,0,0,0,0,0
0,0,0,0,0,0,0,0,0
0,0,0,0,0,0,0,0,0
0,0,0,0,0,0,0,0,0
0,0,0,0,0,0,0,0,0
0,0,0,0,0,0,0,0,0
0,0,0,0,0,0,0,0,0
0,0,0,0,0,0,0,0,0
0,0,0,0,0,0,0,0,0
47284,204,2,2,2,0,1,0,0
422670,63,6,1,1,0,2,0,0
422670,63,6,1,1,0,2,0,0
422670,63,6,1,1,0,2,0,0
422670,63,6,1,1,0,2,0,0
422670,63,6,1,1,0,2,0,0
422670,63,6,1,1,0,2,0,0
422670,63,6,1,1,0,2,0,0
0,0,0,0,0,0,0,0,0
0,0,0,0,0,0,0,0,0
0,0,0,0,0,0,0,0,0
0,0,0,0,0,0,0,0,0
0,0,0,0,0,0,0,0,0
0,0,0,0,0,0,0,0,0
73020,160,2,30,7,23,0,1,0
73020,160,2,30,7,23,0,1,0
73020,160,2,30,7,23,0,1,0
23304,210,1,51,50,1,0,1,0
23304,210,1,51,50,1,0,1,0
0,0,0,0,0,0,0,0,0
0,0,0,0,0,0,0,0,0
0,0,0,0,0,0,0,0,0
0,0,0,0,0,0,0,0,0
0,0,0,0,0,0,0,0,0
0,0,0,0,0,0,0,0,0
4599,53,0,1,1,0,0,0,0
0,0,0,0,0,0,0,0,0
0,0,0,0,0,0,0,0,0
4599,53,0,1,1,0,0,0,0
4599,53,0,1,1,0,0,0,0
330677,84,4,1,1,0,5,1,0
330677,84,4,1,1,0,5,1,0
330677,84,4,1,1,0,5,1,0
0,0,0,0,0,0,0,0,0
77746,101,1,4,2,2,0,0,0
0,0,0,0,0,0,0,0,0
709,37,0,6,6,0,0,0,0
709,37,0,6,6,0,0,0,0
0,0,0,0,0,0,0,0,0
67302,58,3,1,1,0,4,1,0
0,0,0,0,0,0,0,0,0
15334,142,0,56,52,4,0,0,0
7056,81,1,8,8,0,0,0,0
0,0,0,0,0,0,0,0,0
15334,142,0,56,52,4,0,0,0
0,0,0,0,0,0,0,0,0
0,0,0,0,0,0,0,0,0
55200,401,7,23,17,6,6,1,0
308,6,1,0,0,0,0,0,0
1612,21,4,1,0,1,0,0,0
34564,223,2,16,8,8,6,1,0
0,0,0,0,0,0,0,0,0
210506,997,4,186,42,144,15,1,0
0,0,0,0,0,0,0,0,0
0,0,0,0,0,0,0,0,0
16251,57,0,2,1,1,0,1,0
0,0,0,0,0,0,0,0,0
0,0,0,0,0,0,0,0,0
14652,123,8,5,2,3,2,0,0
0,0,0,0,0,0,0,0,0
0,0,0,0,0,0,0,0,0
0,0,0,0,0,0,0,0,0
0,0,0,0,0,0,0,0,0
0,0,0,0,0,0,0,0,0
36407,50,2,0,0,0,2,0,0
36407,50,2,0,0,0,2,0,0
36407,50,2,0,0,0,2,0,0
36407,50,2,0,0,0,2,0,0
23304,210,1,51,50,1,0,1,0
23304,210,1,51,50,1,0,1,0
36407,50,2,0,0,0,2,0,0
23304,210,1,51,50,1,0,1,0
23304,210,1,51,50,1,0,1,0
23304,210,1,51,50,1,0,1,0
109931,49,3,0,0,0,0,0,0
109931,49,3,0,0,0,0,0,0
109931,49,3,0,0,0,0,0,0
109931,49,3,0,0,0,0,0,0
109931,49,3,0,0,0,0,0,0
0,0,0,0,0,0,0,0,0
0,0,0,0,0,0,0,0,0
0,0,0,0,0,0,0,0,0
0,0,0,0,0,0,0,0,0
0,0,0,0,0,0,0,0,0
0,0,0,0,0,0,0,0,0
0,0,0,0,0,0,0,0,0
0,0,0,0,0,0,0,0,0
0,0,0,0,0,0,0,0,0
0,0,0,0,0,0,0,0,0
0,0,0,0,0,0,0,0,0
12168,122,0,5,0,5,0,0,0
12168,122,0,5,0,5,0,0,0
0,0,0,0,0,0,0,0,0
0,0,0,0,0,0,0,0,0
0,0,0,0,0,0,0,0,0
0,0,0,0,0,0,0,0,0
0,0,0,0,0,0,0,0,0
77710,101,1,4,2,2,0,0,0
0,0,0,0,0,0,0,0,0
0,0,0,0,0,0,0,0,0
0,0,0,0,0,0,0,0,0
13173,142,0,56,52,4,0,0,0
0,0,0,0,0,0,0,0,0
185268,1235,13,151,148,3,1,0,0
0,0,0,0,0,0,0,0,0
0,0,0,0,0,0,0,0,0
3736,24,0,1,0,1,0,1,0
1738,25,0,0,0,0,0,0,0
13063,142,0,56,51,5,0,0,0
54633,230,9,44,43,1,2,0,0
0,0,0,0,0,0,0,0,0
12768,217,0,72,72,0,0,1,0
4118,52,0,1,0,1,1,0,0
0,0,0,0,0,0,0,0,0
0,0,0,0,0,0,0,0,0
0,0,0,0,0,0,0,0,0
3405,46,4,3,2,1,0,1,0
0,0,0,0,0,0,0,0,0
0,0,0,0,0,0,0,0,0
0,0,0,0,0,0,0,0,0
0,0,0,0,0,0,0,0,0
0,0,0,0,0,0,0,0,0
80595,134,6,8,7,1,8,1,0
0,0,0,0,0,0,0,0,0
0,0,0,0,0,0,0,0,0
0,0,0,0,0,0,0,0,0
0,0,0,0,0,0,0,0,0
0,0,0,0,0,0,0,0,0
0,0,0,0,0,0,0,0,0
0,0,0,0,0,0,0,0,0
0,0,0,0,0,0,0,0,0
0,0,0,0,0,0,0,0,0
0,0,0,0,0,0,0,0,0
0,0,0,0,0,0,0,0,0
0,0,0,0,0,0,0,0,0
0,0,0,0,0,0,0,0,0
0,0,0,0,0,0,0,0,0
0,0,0,0,0,0,0,0,0
0,0,0,0,0,0,0,0,0
0,0,0,0,0,0,0,0,0
0,0,0,0,0,0,0,0,0
0,0,0,0,0,0,0,0,0
0,0,0,0,0,0,0,0,0
0,0,0,0,0,0,0,0,0
0,0,0,0,0,0,0,0,0
12003,47,3,5,5,0,1,0,0
12003,47,3,5,5,0,1,0,0
12003,47,3,5,5,0,1,0,0
0,0,0,0,0,0,0,0,0
327174,60,4,3,3,0,2,1,0
327174,60,4,3,3,0,2,1,0
0,0,0,0,0,0,0,0,0
0,0,0,0,0,0,0,0,0
327174,60,4,3,3,0,2,1,0
327174,60,4,3,3,0,2,1,0
327174,60,4,3,3,0,2,1,0
327174,60,4,3,3,0,2,1,0
327174,60,4,3,3,0,2,1,0
0,0,0,0,0,0,0,0,0
0,0,0,0,0,0,0,0,0
0,0,0,0,0,0,0,0,0
0,0,0,0,0,0,0,0,0
0,0,0,0,0,0,0,0,0
0,0,0,0,0,0,0,0,0
0,0,0,0,0,0,0,0,0
0,0,0,0,0,0,0,0,0
0,0,0,0,0,0,0,0,0
0,0,0,0,0,0,0,0,0
0,0,0,0,0,0,0,0,0
0,0,0,0,0,0,0,0,0
25093,67,2,1,1,0,2,0,0
0,0,0,0,0,0,0,0,0
25093,67,2,1,1,0,2,0,0
0,0,0,0,0,0,0,0,0
25093,67,2,1,1,0,2,0,0
0,0,0,0,0,0,0,0,0
0,0,0,0,0,0,0,0,0
0,0,0,0,0,0,0,0,0
0,0,0,0,0,0,0,0,0
0,0,0,0,0,0,0,0,0
0,0,0,0,0,0,0,0,0
0,0,0,0,0,0,0,0,0
0,0,0,0,0,0,0,0,0
46972,444,3,105,34,71,8,1,0
77710,101,1,4,2,2,0,0,0
0,0,0,0,0,0,0,0,0
24886,82,1,7,3,4,3,0,0
222226,92,1,4,1,3,0,0,0
193728,92,1,3,1,2,5,0,0
57195,147,2,4,3,1,0,0,0
0,0,0,0,0,0,0,0,0
0,0,0,0,0,0,0,0,0
0,0,0,0,0,0,0,0,0
0,0,0,0,0,0,0,0,0
12435,142,0,56,52,4,0,0,0
0,0,0,0,0,0,0,0,0
0,0,0,0,0,0,0,0,0
0,0,0,0,0,0,0,0,0
0,0,0,0,0,0,0,0,0
0,0,0,0,0,0,0,0,0
0,0,0,0,0,0,0,0,0
0,0,0,0,0,0,0,0,0
0,0,0,0,0,0,0,0,0
0,0,0,0,0,0,0,0,0
0,0,0,0,0,0,0,0,0
0,0,0,0,0,0,0,0,0
0,0,0,0,0,0,0,0,0
0,0,0,0,0,0,0,0,0
0,0,0,0,0,0,0,0,0
0,0,0,0,0,0,0,0,0
0,0,0,0,0,0,0,0,0
0,0,0,0,0,0,0,0,0
0,0,0,0,0,0,0,0,0
0,0,0,0,0,0,0,0,0
0,0,0,0,0,0,0,0,0
0,0,0,0,0,0,0,0,0
0,0,0,0,0,0,0,0,0
0,0,0,0,0,0,0,0,0
0,0,0,0,0,0,0,0,0
118192,719,0,151,10,141,14,1,0
0,0,0,0,0,0,0,0,0
0,0,0,0,0,0,0,0,0
2797,40,1,1,0,1,0,0,1
28304,44,0,4,3,1,0,0,0
0,0,0,0,0,0,0,0,0
63731,657,9,49,35,14,6,1,0
0,0,0,0,0,0,0,0,0
0,0,0,0,0,0,0,0,0
0,0,0,0,0,0,0,0,0
118192,719,0,151,149,2,14,1,0
96513,438,10,33,33,0,0,1,0
0,0,0,0,0,0,0,0,0
0,0,0,0,0,0,0,0,0
0,0,0,0,0,0,0,0,0
0,0,0,0,0,0,0,0,0
0,0,0,0,0,0,0,0,0
0,0,0,0,0,0,0,0,0
0,0,0,0,0,0,0,0,0
0,0,0,0,0,0,0,0,0
0,0,0,0,0,0,0,0,0
0,0,0,0,0,0,0,0,0
0,0,0,0,0,0,0,0,0
169241,2241,8,106,78,28,25,1,0
0,0,0,0,0,0,0,0,0
0,0,0,0,0,0,0,0,0
0,0,0,0,0,0,0,0,0
0,0,0,0,0,0,0,0,0
0,0,0,0,0,0,0,0,0
21792,33,0,1,1,0,0,1,0
28052,97,0,2,0,2,2,0,0
580953,84,3,1,1,0,3,1,0
580942,84,3,1,1,0,3,1,0
580949,84,3,1,1,0,3,1,0
580942,84,3,1,1,0,3,1,0
580942,84,3,1,1,0,3,1,0
43441,64,4,9,9,0,2,0,0
135990,42,4,1,1,0,2,0,0
0,0,0,0,0,0,0,0,0
0,0,0,0,0,0,0,0,0
36407,50,2,0,0,0,2,0,0
36407,50,2,0,0,0,2,0,0
0,0,0,0,0,0,0,0,0
0,0,0,0,0,0,0,0,0
0,0,0,0,0,0,0,0,0
2276652,547,0,1,0,1,4,0,0
2276652,547,0,1,0,1,4,0,0
2276652,547,0,1,0,1,4,0,0
2276652,547,0,1,0,1,4,0,0
2276652,547,0,1,0,1,4,0,0
0,0,0,0,0,0,0,0,0
0,0,0,0,0,0,0,0,0
0,0,0,0,0,0,0,0,0
0,0,0,0,0,0,0,0,0
25481,48,3,1,1,0,2,0,0
25481,48,3,1,1,0,2,0,0
0,0,0,0,0,0,0,0,0
0,0,0,0,0,0,0,0,0
0,0,0,0,0,0,0,0,0
0,0,0,0,0,0,0,0,0
294435,739,0,59,10,49,0,1,0
294436,739,0,59,10,49,0,1,0
0,0,0,0,0,0,0,0,0
0,0,0,0,0,0,0,0,0
294436,739,0,59,10,49,0,1,0
294436,739,0,59,10,49,0,1,0
294436,739,0,59,10,49,0,1,0
294436,739,0,59,10,49,0,1,0
0,0,0,0,0,0,0,0,0
295054,739,0,59,10,49,0,1,0
0,0,0,0,0,0,0,0,0
0,0,0,0,0,0,0,0,0
0,0,0,0,0,0,0,0,0
0,0,0,0,0,0,0,0,0
0,0,0,0,0,0,0,0,0
0,0,0,0,0,0,0,0,0
0,0,0,0,0,0,0,0,0
0,0,0,0,0,0,0,0,0
0,0,0,0,0,0,0,0,0
0,0,0,0,0,0,0,0,0
0,0,0,0,0,0,0,0,0
0,0,0,0,0,0,0,0,0
0,0,0,0,0,0,0,0,0
0,0,0,0,0,0,0,0,0
0,0,0,0,0,0,0,0,0
0,0,0,0,0,0,0,0,0
0,0,0,0,0,0,0,0,0
0,0,0,0,0,0,0,0,0
0,0,0,0,0,0,0,0,0
0,0,0,0,0,0,0,0,0
0,0,0,0,0,0,0,0,0
0,0,0,0,0,0,0,0,0
0,0,0,0,0,0,0,0,0
0,0,0,0,0,0,0,0,0
0,0,0,0,0,0,0,0,0
0,0,0,0,0,0,0,0,0
0,0,0,0,0,0,0,0,0
0,0,0,0,0,0,0,0,0
0,0,0,0,0,0,0,0,0
0,0,0,0,0,0,0,0,0
0,0,0,0,0,0,0,0,0
0,0,0,0,0,0,0,0,0
0,0,0,0,0,0,0,0,0
0,0,0,0,0,0,0,0,0
0,0,0,0,0,0,0,0,0
0,0,0,0,0,0,0,0,0
0,0,0,0,0,0,0,0,0
77734,101,1,4,2,2,0,0,0
77730,101,1,4,2,2,0,0,0
77758,101,1,4,2,2,0,0,0
0,0,0,0,0,0,0,0,0
70840,250,8,21,21,0,2,0,0
0,0,0,0,0,0,0,0,0
0,0,0,0,0,0,0,0,0
0,0,0,0,0,0,0,0,0
0,0,0,0,0,0,0,0,0
0,0,0,0,0,0,0,0,0
0,0,0,0,0,0,0,0,0
0,0,0,0,0,0,0,0,0
0,0,0,0,0,0,0,0,0
0,0,0,0,0,0,0,0,0
0,0,0,0,0,0,0,0,0
0,0,0,0,0,0,0,0,0
0,0,0,0,0,0,0,0,0
0,0,0,0,0,0,0,0,0
0,0,0,0,0,0,0,0,0
0,0,0,0,0,0,0,0,0
0,0,0,0,0,0,0,0,0
0,0,0,0,0,0,0,0,0
0,0,0,0,0,0,0,0,0
55178,609,5,27,16,11,0,1,0
0,0,0,0,0,0,0,0,0
0,0,0,0,0,0,0,0,0
0,0,0,0,0,0,0,0,0
0,0,0,0,0,0,0,0,0
0,0,0,0,0,0,0,0,0
0,0,0,0,0,0,0,0,0
15040,120,4,0,0,0,0,1,0
0,0,0,0,0,0,0,0,0
0,0,0,0,0,0,0,0,0
243972,28,1,2,2,0,0,1,0
0,0,0,0,0,0,0,0,0
0,0,0,0,0,0,0,0,0
0,0,0,0,0,0,0,0,0
0,0,0,0,0,0,0,0,0
7636,85,4,9,4,5,1,0,0
6330,64,2,6,4,2,0,1,0
0,0,0,0,0,0,0,0,0
0,0,0,0,0,0,0,0,0
0,0,0,0,0,0,0,0,0
4842,78,3,8,8,0,3,0,0
0,0,0,0,0,0,0,0,0
0,0,0,0,0,0,0,0,0
0,0,0,0,0,0,0,0,0
0,0,0,0,0,0,0,0,0
394825,85,3,6,5,1,0,1,0
0,0,0,0,0,0,0,0,0
0,0,0,0,0,0,0,0,0
0,0,0,0,0,0,0,0,0
0,0,0,0,0,0,0,0,0
0,0,0,0,0,0,0,0,0
0,0,0,0,0,0,0,0,0
0,0,0,0,0,0,0,0,0
0,0,0,0,0,0,0,0,0
0,0,0,0,0,0,0,0,0
0,0,0,0,0,0,0,0,0
0,0,0,0,0,0,0,0,0
0,0,0,0,0,0,0,0,0
0,0,0,0,0,0,0,0,0
0,0,0,0,0,0,0,0,0
0,0,0,0,0,0,0,0,0
0,0,0,0,0,0,0,0,0
0,0,0,0,0,0,0,0,0
0,0,0,0,0,0,0,0,0
0,0,0,0,0,0,0,0,0
0,0,0,0,0,0,0,0,0
32256,37,1,0,0,0,1,0,0
32256,37,1,0,0,0,1,0,0
32256,37,1,0,0,0,1,0,0
32256,37,1,0,0,0,1,0,0
0,0,0,0,0,0,0,0,0
0,0,0,0,0,0,0,0,0
32256,37,1,0,0,0,1,0,0
0,0,0,0,0,0,0,0,0
0,0,0,0,0,0,0,0,0
0,0,0,0,0,0,0,0,0
144499,62,4,3,3,0,2,1,0
0,0,0,0,0,0,0,0,0
127634,68,3,1,0,1,0,1,0
127634,68,3,1,0,1,0,1,0
127634,68,3,1,0,1,0,1,0
127634,68,3,1,0,1,0,1,0
81336,45,1,0,0,0,0,0,0
81336,45,1,0,0,0,0,0,0
81336,45,1,0,0,0,0,0,0
81336,45,1,0,0,0,0,0,0
81336,45,1,0,0,0,0,0,0
73017,160,2,30,7,23,0,1,0
73017,160,2,30,7,23,0,1,0
73017,160,2,30,7,23,0,1,0
0,0,0,0,0,0,0,0,0
0,0,0,0,0,0,0,0,0
0,0,0,0,0,0,0,0,0
11587,57,3,0,0,0,3,1,0
0,0,0,0,0,0,0,0,0
11587,57,3,0,0,0,3,1,0
0,0,0,0,0,0,0,0,0
11587,57,3,0,0,0,3,1,0
11587,57,3,0,0,0,3,1,0
11587,57,3,0,0,0,3,1,0
0,0,0,0,0,0,0,0,0
0,0,0,0,0,0,0,0,0
0,0,0,0,0,0,0,0,0
0,0,0,0,0,0,0,0,0
0,0,0,0,0,0,0,0,0
110247,173,1,20,0,20,1,0,0
110247,173,1,20,0,20,1,0,0
0,0,0,0,0,0,0,0,0
0,0,0,0,0,0,0,0,0
110247,173,1,20,0,20,1,0,0
16638,63,4,9,9,0,2,0,0
0,0,0,0,0,0,0,0,0
0,0,0,0,0,0,0,0,0
0,0,0,0,0,0,0,0,0
0,0,0,0,0,0,0,0,0
0,0,0,0,0,0,0,0,0
0,0,0,0,0,0,0,0,0
0,0,0,0,0,0,0,0,0
0,0,0,0,0,0,0,0,0
0,0,0,0,0,0,0,0,0
0,0,0,0,0,0,0,0,0
0,0,0,0,0,0,0,0,0
0,0,0,0,0,0,0,0,0
0,0,0,0,0,0,0,0,0
0,0,0,0,0,0,0,0,0
0,0,0,0,0,0,0,0,0
0,0,0,0,0,0,0,0,0
0,0,0,0,0,0,0,0,0
0,0,0,0,0,0,0,0,0
0,0,0,0,0,0,0,0,0
0,0,0,0,0,0,0,0,0
327105,60,4,3,3,0,2,1,0
327105,60,4,3,3,0,2,1,0
0,0,0,0,0,0,0,0,0
0,0,0,0,0,0,0,0,0
0,0,0,0,0,0,0,0,0
0,0,0,0,0,0,0,0,0
327105,60,4,3,3,0,2,1,0
0,0,0,0,0,0,0,0,0
327105,60,4,3,3,0,2,1,0
55825,73,4,0,0,0,0,1,0
55825,73,4,0,0,0,0,1,0
55825,73,4,0,0,0,0,1,0
0,0,0,0,0,0,0,0,0
0,0,0,0,0,0,0,0,0
0,0,0,0,0,0,0,0,0
0,0,0,0,0,0,0,0,0
0,0,0,0,0,0,0,0,0
0,0,0,0,0,0,0,0,0
0,0,0,0,0,0,0,0,0
0,0,0,0,0,0,0,0,0
0,0,0,0,0,0,0,0,0
0,0,0,0,0,0,0,0,0
0,0,0,0,0,0,0,0,0
0,0,0,0,0,0,0,0,0
0,0,0,0,0,0,0,0,0
0,0,0,0,0,0,0,0,0
0,0,0,0,0,0,0,0,0
0,0,0,0,0,0,0,0,0
4125,11,0,0,0,0,0,0,0
0,0,0,0,0,0,0,0,0
0,0,0,0,0,0,0,0,0
0,0,0,0,0,0,0,0,0
0,0,0,0,0,0,0,0,0
0,0,0,0,0,0,0,0,0
4751759,106,4,5,5,0,3,1,0
0,0,0,0,0,0,0,0,0
419002,182,5,2,2,0,0,1,0
0,0,0,0,0,0,0,0,0
0,0,0,0,0,0,0,0,0
0,0,0,0,0,0,0,0,0
0,0,0,0,0,0,0,0,0
0,0,0,0,0,0,0,0,0
0,0,0,0,0,0,0,0,0
0,0,0,0,0,0,0,0,0
0,0,0,0,0,0,0,0,0
0,0,0,0,0,0,0,0,0
0,0,0,0,0,0,0,0,0
0,0,0,0,0,0,0,0,0
0,0,0,0,0,0,0,0,0
2673,21,2,1,0,1,0,0,0
0,0,0,0,0,0,0,0,0
16669,31,0,1,1,0,0,1,0
118194,719,0,151,149,2,14,1,0
3020,33,0,1,1,0,0,0,0
0,0,0,0,0,0,0,0,0
0,0,0,0,0,0,0,0,0
0,0,0,0,0,0,0,0,0
14119,142,0,56,52,4,0,0,0
0,0,0,0,0,0,0,0,0
55919,509,10,68,59,9,0,1,0
0,0,0,0,0,0,0,0,0
0,0,0,0,0,0,0,0,0
0,0,0,0,0,0,0,0,0
0,0,0,0,0,0,0,0,0
0,0,0,0,0,0,0,0,0
0,0,0,0,0,0,0,0,0
0,0,0,0,0,0,0,0,0
2673,21,2,1,0,1,0,0,0
0,0,0,0,0,0,0,0,0
0,0,0,0,0,0,0,0,0
185425,1268,9,107,25,82,6,1,0
10724,28,1,2,2,0,0,0,0
93892,211,4,0,0,0,1,0,0
0,0,0,0,0,0,0,0,0
0,0,0,0,0,0,0,0,0
110247,173,1,20,0,20,1,0,0
0,0,0,0,0,0,0,0,0
0,0,0,0,0,0,0,0,0
0,0,0,0,0,0,0,0,0
0,0,0,0,0,0,0,0,0
0,0,0,0,0,0,0,0,0
0,0,0,0,0,0,0,0,0
0,0,0,0,0,0,0,0,0
0,0,0,0,0,0,0,0,0
91094,211,4,0,0,0,1,0,0
0,0,0,0,0,0,0,0,0
91242,211,4,0,0,0,1,0,0
91242,211,4,0,0,0,1,0,0
90535,209,4,0,0,0,1,0,0
91271,211,4,0,0,0,1,0,0
91332,211,4,0,0,0,1,0,0
0,0,0,0,0,0,0,0,0
0,0,0,0,0,0,0,0,0
91021,209,4,0,0,0,1,0,0
91243,211,4,0,0,0,1,0,0
90906,211,4,0,0,0,1,0,0
91563,211,4,0,0,0,1,0,0
91208,211,4,0,0,0,1,0,0
91451,211,4,0,0,0,1,0,0
91078,211,4,0,0,0,1,0,0
91580,211,4,0,0,0,1,0,0
0,0,0,0,0,0,0,0,0
91406,211,4,0,0,0,1,0,0
91211,211,4,0,0,0,1,0,0
90902,211,4,0,0,0,1,0,0
0,0,0,0,0,0,0,0,0
93200,211,4,0,0,0,1,0,0
92049,214,4,0,0,0,1,0,0
96618,211,4,0,0,0,1,0,0
96618,211,4,0,0,0,1,0,0
93118,211,4,0,0,0,1,0,0
93118,211,4,0,0,0,1,0,0
92168,214,4,0,0,0,1,0,0
92975,223,4,0,0,0,1,0,0
92975,223,4,0,0,0,1,0,0
93788,224,4,0,0,0,1,0,0
93788,224,4,0,0,0,1,0,0
90864,211,4,0,0,0,1,0,0
90864,211,4,0,0,0,1,0,0
91894,212,4,0,0,0,1,0,0
92286,214,4,0,0,0,1,0,0
0,0,0,0,0,0,0,0,0
93238,211,4,0,0,0,1,0,0
93238,211,4,0,0,0,1,0,0
0,0,0,0,0,0,0,0,0
0,0,0,0,0,0,0,0,0
0,0,0,0,0,0,0,0,0
0,0,0,0,0,0,0,0,0
91151,211,4,0,0,0,1,0,0
91306,211,4,0,0,0,1,0,0
93129,214,4,0,0,0,1,0,0
91140,211,4,0,0,0,1,0,0
91137,212,4,0,0,0,1,0,0
91346,211,4,0,0,0,1,0,0
91100,212,4,0,0,0,1,0,0
91125,212,4,0,0,0,1,0,0
91217,211,4,0,0,0,1,0,0
91618,211,4,0,0,0,1,0,0
91618,211,4,0,0,0,1,0,0
91151,212,4,0,0,0,1,0,0
91064,212,4,0,0,0,1,0,0
90972,212,4,0,0,0,1,0,0
91517,211,4,0,0,0,1,0,0
91517,211,4,0,0,0,1,0,0
91139,212,4,0,0,0,1,0,0
91109,212,4,0,0,0,1,0,0
0,0,0,0,0,0,0,0,0
93074,212,4,0,0,0,1,0,0
91184,211,4,0,0,0,1,0,0
91468,211,4,0,0,0,1,0,0
91631,211,4,0,0,0,1,0,0
91122,212,4,0,0,0,1,0,0
90991,211,4,0,0,0,1,0,0
91001,212,4,0,0,0,1,0,0
91853,211,4,0,0,0,1,0,0
91238,212,4,0,0,0,1,0,0
91316,211,4,0,0,0,1,0,0
91316,211,4,0,0,0,1,0,0
91189,211,4,0,0,0,1,0,0
91075,212,4,0,0,0,1,0,0
90747,211,4,0,0,0,1,0,0
91051,212,4,0,0,0,1,0,0
91080,212,4,0,0,0,1,0,0
93468,214,4,0,0,0,1,0,0
91430,212,4,0,0,0,1,0,0
91130,211,4,0,0,0,1,0,0
0,0,0,0,0,0,0,0,0
90906,212,4,0,0,0,1,0,0
91121,212,4,0,0,0,1,0,0
91109,212,4,0,0,0,1,0,0
90891,210,4,0,0,0,1,0,0
91135,212,4,0,0,0,1,0,0
91443,211,4,0,0,0,1,0,0
91443,211,4,0,0,0,1,0,0
91213,211,4,0,0,0,1,0,0
0,0,0,0,0,0,0,0,0
91611,211,4,0,0,0,1,0,0
90996,212,4,0,0,0,1,0,0
91137,211,4,0,0,0,1,0,0
92572,212,4,0,0,0,1,0,0
91106,212,4,0,0,0,1,0,0
91109,212,4,0,0,0,1,0,0
91089,212,4,0,0,0,1,0,0
0,0,0,0,0,0,0,0,0
89891,211,4,0,0,0,1,0,0
92137,211,4,0,0,0,1,0,0
91926,209,4,0,0,0,1,0,0
92042,211,4,0,0,0,1,0,0
92039,211,4,0,0,0,1,0,0
92112,211,4,0,0,0,1,0,0
92074,211,4,0,0,0,1,0,0
92060,211,4,0,0,0,1,0,0
91685,211,4,0,0,0,1,0,0
92204,211,4,0,0,0,1,0,0
92129,211,4,0,0,0,1,0,0
91562,211,4,0,0,0,1,0,0
91562,211,4,0,0,0,1,0,0
89536,211,4,0,0,0,1,0,0
107123,229,4,0,0,0,1,0,0
107123,229,4,0,0,0,1,0,0
91793,214,4,0,0,0,1,0,0
92213,214,4,0,0,0,1,0,0
92289,214,4,0,0,0,1,0,0
92059,214,4,0,0,0,1,0,0
92068,214,4,0,0,0,1,0,0
92068,214,4,0,0,0,1,0,0
0,0,0,0,0,0,0,0,0
92855,214,4,0,0,0,1,0,0
93254,214,4,0,0,0,1,0,0
92911,214,4,0,0,0,1,0,0
93338,214,4,0,0,0,1,0,0
93338,214,4,0,0,0,1,0,0
93257,214,4,0,0,0,1,0,0
93306,214,4,0,0,0,1,0,0
93306,214,4,0,0,0,1,0,0
92814,214,4,0,0,0,1,0,0
91553,211,4,0,0,0,1,0,0
91434,211,4,0,0,0,1,0,0
91047,211,4,0,0,0,1,0,0
91069,211,4,0,0,0,1,0,0
91260,211,4,0,0,0,1,0,0
3772,44,0,2,0,2,1,0,0
0,0,0,0,0,0,0,0,0
91480,211,4,0,0,0,1,0,0
90934,210,4,0,0,0,1,0,0
91135,211,4,0,0,0,1,0,0
91034,212,4,0,0,0,1,0,0
91052,212,4,0,0,0,1,0,0
91435,212,4,0,0,0,1,0,0
91040,212,4,0,0,0,1,0,0
91137,212,4,0,0,0,1,0,0
91141,212,4,0,0,0,1,0,0
91072,212,4,0,0,0,1,0,0
91009,212,4,0,0,0,1,0,0
91710,211,4,0,0,0,1,0,0
91035,212,4,0,0,0,1,0,0
90445,209,4,0,0,0,1,0,0
91038,212,4,0,0,0,1,0,0
91122,212,4,0,0,0,1,0,0
91026,212,4,0,0,0,1,0,0
0,0,0,0,0,0,0,0,0
0,0,0,0,0,0,0,0,0
0,0,0,0,0,0,0,0,0
0,0,0,0,0,0,0,0,0
0,0,0,0,0,0,0,0,0
13838,69,0,6,2,4,0,1,0
13838,69,0,6,2,4,0,1,0
13838,69,0,6,2,4,0,1,0
0,0,0,0,0,0,0,0,0
0,0,0,0,0,0,0,0,0
0,0,0,0,0,0,0,0,0
0,0,0,0,0,0,0,0,0
0,0,0,0,0,0,0,0,0
0,0,0,0,0,0,0,0,0
8235,146,0,15,15,0,5,1,0
8235,146,0,15,15,0,5,1,0
13838,69,0,6,2,4,0,1,0
8235,146,0,15,15,0,5,1,0
0,0,0,0,0,0,0,0,0
8235,146,0,15,15,0,5,1,0
0,0,0,0,0,0,0,0,0
0,0,0,0,0,0,0,0,0
0,0,0,0,0,0,0,0,0
34489,50,2,0,0,0,2,0,0
0,0,0,0,0,0,0,0,0
0,0,0,0,0,0,0,0,0
0,0,0,0,0,0,0,0,0
13838,69,0,6,2,4,0,1,0
0,0,0,0,0,0,0,0,0
34489,50,2,0,0,0,2,0,0
0,0,0,0,0,0,0,0,0
34489,50,2,0,0,0,2,0,0
0,0,0,0,0,0,0,0,0
0,0,0,0,0,0,0,0,0
0,0,0,0,0,0,0,0,0
0,0,0,0,0,0,0,0,0
0,0,0,0,0,0,0,0,0
0,0,0,0,0,0,0,0,0
0,0,0,0,0,0,0,0,0
0,0,0,0,0,0,0,0,0
0,0,0,0,0,0,0,0,0
0,0,0,0,0,0,0,0,0
0,0,0,0,0,0,0,0,0
0,0,0,0,0,0,0,0,0
0,0,0,0,0,0,0,0,0
0,0,0,0,0,0,0,0,0
97070,250,0,0,0,0,0,0,0
0,0,0,0,0,0,0,0,0
0,0,0,0,0,0,0,0,0
0,0,0,0,0,0,0,0,0
0,0,0,0,0,0,0,0,0
0,0,0,0,0,0,0,0,0
556490,70,3,2,1,1,2,1,0
556490,70,3,2,1,1,2,1,0
64133,80,3,0,0,0,4,0,0
0,0,0,0,0,0,0,0,0
0,0,0,0,0,0,0,0,0
0,0,0,0,0,0,0,0,0
0,0,0,0,0,0,0,0,0
0,0,0,0,0,0,0,0,0
0,0,0,0,0,0,0,0,0
0,0,0,0,0,0,0,0,0
0,0,0,0,0,0,0,0,0
0,0,0,0,0,0,0,0,0
0,0,0,0,0,0,0,0,0
0,0,0,0,0,0,0,0,0
0,0,0,0,0,0,0,0,0
0,0,0,0,0,0,0,0,0
0,0,0,0,0,0,0,0,0
0,0,0,0,0,0,0,0,0
0,0,0,0,0,0,0,0,0
0,0,0,0,0,0,0,0,0
0,0,0,0,0,0,0,0,0
0,0,0,0,0,0,0,0,0
77735,101,1,4,2,2,0,0,0
0,0,0,0,0,0,0,0,0
0,0,0,0,0,0,0,0,0
77786,101,1,4,2,2,0,0,0
77738,101,1,4,2,2,0,0,0
77706,101,1,4,2,2,0,0,0
0,0,0,0,0,0,0,0,0
0,0,0,0,0,0,0,0,0
0,0,0,0,0,0,0,0,0
0,0,0,0,0,0,0,0,0
0,0,0,0,0,0,0,0,0
0,0,0,0,0,0,0,0,0
33569,259,4,22,20,2,3,1,0
33569,259,4,22,20,2,3,1,0
0,0,0,0,0,0,0,0,0
0,0,0,0,0,0,0,0,0
84870,79,1,8,0,8,0,1,0
0,0,0,0,0,0,0,0,0
0,0,0,0,0,0,0,0,0
0,0,0,0,0,0,0,0,0
22114,35,0,1,1,0,0,1,0
28243,42,0,2,1,1,0,0,0
0,0,0,0,0,0,0,0,0
0,0,0,0,0,0,0,0,0
0,0,0,0,0,0,0,0,0
0,0,0,0,0,0,0,0,0
0,0,0,0,0,0,0,0,0
0,0,0,0,0,0,0,0,0
0,0,0,0,0,0,0,0,0
0,0,0,0,0,0,0,0,0
0,0,0,0,0,0,0,0,0
0,0,0,0,0,0,0,0,0
0,0,0,0,0,0,0,0,0
47504,296,5,23,9,14,0,0,0
29316,140,5,17,11,6,0,0,0
1605,44,0,3,2,1,0,0,0
1584,49,0,1,1,0,0,0,0
0,0,0,0,0,0,0,0,0
0,0,0,0,0,0,0,0,0
98511,284,0,0,0,0,0,0,0
63561,162,1,5,1,4,0,0,0
25940,346,1,2,1,1,1,0,0
4009,101,0,9,9,0,0,0,0
3972,101,0,9,9,0,0,0,0
3972,101,0,9,9,0,0,0,0
21343,199,5,3,2,1,3,1,0
97070,250,0,0,0,0,0,0,0
47504,296,5,23,9,14,0,0,0
20286,251,3,65,63,2,1,1,0
0,0,0,0,0,0,0,0,0
14642,271,1,2,2,0,0,1,0
15087,129,1,6,5,1,2,1,0
43474,178,3,1,1,0,2,1,0
101940,317,0,1,1,0,0,0,0
82599,211,0,24,23,1,6,1,0
12363,75,1,6,0,6,1,0,0
87106,226,0,0,0,0,0,0,0
99871,284,0,0,0,0,0,0,0
12952,123,5,1,0,1,3,0,0
99632,299,0,1,1,0,0,1,0
89825,217,0,0,0,0,0,0,0
85694,215,0,0,0,0,0,0,0
91232,246,0,0,0,0,0,0,0
17770,167,5,2,1,1,1,1,0
25995,346,1,2,1,1,2,0,0
94143,234,0,0,0,0,0,0,0
2864,28,2,1,0,1,0,0,0
46718,6537,0,1,1,0,0,0,0
46718,6537,0,1,1,0,0,0,0
0,0,0,0,0,0,0,0,0
91587,222,0,0,0,0,0,0,0
92151,239,0,0,0,0,0,0,0
124413,394,0,5,5,0,0,0,0
94199,234,0,0,0,0,0,0,0
22892,330,6,24,20,4,0,1,0
11999,133,3,0,0,0,0,1,0
15614,245,5,30,28,2,0,1,0
0,0,0,0,0,0,0,0,0
91401,244,0,0,0,0,0,0,0
0,0,0,0,0,0,0,0,0
0,0,0,0,0,0,0,0,0
7882,77,0,10,9,1,0,1,0
23601,269,3,16,15,1,0,1,0
420,10,0,0,0,0,0,0,0
3183,72,1,1,1,0,0,0,0
3183,72,1,1,1,0,0,0,0
192409,297,1,0,0,0,0,1,0
48931,129,0,5,5,0,1,0,0
12418,127,0,26,24,2,2,1,0
4632,69,4,9,5,4,0,1,0
0,0,0,0,0,0,0,0,0
0,0,0,0,0,0,0,0,0
0,0,0,0,0,0,0,0,0
5051,81,0,15,14,1,0,1,0
44635,248,5,15,4,11,1,0,0
13809,54,0,0,0,0,0,0,0
75646,226,4,2,1,1,3,0,0
0,0,0,0,0,0,0,0,0
81402,92,1,23,22,1,0,1,0
0,0,0,0,0,0,0,0,0
49017,233,0,11,2,9,5,1,0
0,0,0,0,0,0,0,0,0
0,0,0,0,0,0,0,0,0
0,0,0,0,0,0,0,0,0
0,0,0,0,0,0,0,0,0
13854,54,0,0,0,0,0,0,0
0,0,0,0,0,0,0,0,0
675650,556,0,4,4,0,2,1,1
0,0,0,0,0,0,0,0,0
0,0,0,0,0,0,0,0,0
0,0,0,0,0,0,0,0,0
0,0,0,0,0,0,0,0,0
0,0,0,0,0,0,0,0,0
4435,85,0,3,3,0,0,0,0
0,0,0,0,0,0,0,0,0
4302,50,0,9,9,0,0,0,0
4302,50,0,9,9,0,0,0,0
0,0,0,0,0,0,0,0,0
59251,443,2,19,19,0,1,0,0
20286,251,3,65,63,2,1,1,0
13004,184,1,64,60,4,0,1,0
0,0,0,0,0,0,0,0,0
0,0,0,0,0,0,0,0,0
0,0,0,0,0,0,0,0,0
0,0,0,0,0,0,0,0,0
54997,140,0,1,1,0,3,0,0
0,0,0,0,0,0,0,0,0
0,0,0,0,0,0,0,0,0
0,0,0,0,0,0,0,0,0
0,0,0,0,0,0,0,0,0
0,0,0,0,0,0,0,0,0
0,0,0,0,0,0,0,0,0
5502,203,0,47,47,0,0,1,0
5502,203,0,47,47,0,0,1,0
5502,203,0,47,47,0,0,1,0
5502,203,0,47,47,0,0,1,0
0,0,0,0,0,0,0,0,0
115464,633,2,64,0,64,0,1,0
0,0,0,0,0,0,0,0,0
14428,159,8,13,9,4,1,1,0
12398,94,6,7,5,2,2,1,0
0,0,0,0,0,0,0,0,0
431323,701,7,119,46,73,5,1,0
5077,47,4,0,0,0,0,1,0
15014,120,4,1,1,0,0,1,0
93638,552,2,55,1,54,0,1,0
0,0,0,0,0,0,0,0,0
0,0,0,0,0,0,0,0,0
0,0,0,0,0,0,0,0,0
0,0,0,0,0,0,0,0,0
111847,82,0,3,2,1,0,1,0
3105,23,2,1,0,1,0,0,0
0,0,0,0,0,0,0,0,0
0,0,0,0,0,0,0,0,0
215036,172,3,2,1,1,2,0,0
10010,38,4,0,0,0,0,1,0
60050,75,3,4,1,3,0,1,0
31266,481,3,31,31,0,18,1,0
79415,529,3,86,10,76,18,0,0
11120,64,4,9,9,0,2,0,0
11120,64,4,9,9,0,2,0,0
79409,529,3,86,10,76,18,0,0
0,0,0,0,0,0,0,0,0
0,0,0,0,0,0,0,0,0
9840,77,6,5,4,1,0,0,0
9840,77,6,5,4,1,0,0,0
7830,27,2,0,0,0,0,0,1
15287,231,7,38,31,7,3,0,0
0,0,0,0,0,0,0,0,0
4725,31,2,0,0,0,0,0,0
4279,45,3,3,0,3,0,0,0
13910,41,1,1,0,1,0,0,0
4259,81,2,1,0,1,0,0,0
0,0,0,0,0,0,0,0,0
0,0,0,0,0,0,0,0,0
26779,129,0,21,21,0,0,0,0
0,0,0,0,0,0,0,0,0
52946,47,3,5,1,4,0,0,0
0,0,0,0,0,0,0,0,0
39784,261,6,42,35,7,0,1,0
115464,633,2,64,0,64,0,1,0
99637,299,0,1,1,0,0,1,0
85692,215,0,0,0,0,0,0,0
0,0,0,0,0,0,0,0,0
0,0,0,0,0,0,0,0,0
0,0,0,0,0,0,0,0,0
0,0,0,0,0,0,0,0,0
0,0,0,0,0,0,0,0,0
0,0,0,0,0,0,0,0,0
0,0,0,0,0,0,0,0,0
0,0,0,0,0,0,0,0,0
0,0,0,0,0,0,0,0,0
628227,1823,12,51,48,3,20,1,0
39860,168,7,2,1,1,0,0,0
112067,691,3,18,12,6,1,0,0
95285,578,3,20,7,13,1,0,0
0,0,0,0,0,0,0,0,0
60788,35,0,0,0,0,0,1,0
64438,56,0,2,0,2,0,1,0
201982,300,0,16,4,12,0,1,0
4725,31,2,0,0,0,0,0,0
4725,31,2,0,0,0,0,0,0
0,0,0,0,0,0,0,0,0
0,0,0,0,0,0,0,0,0
674094,556,0,4,4,0,2,1,1
676521,557,0,4,4,0,2,1,1
0,0,0,0,0,0,0,0,0
641545,2836,7,168,163,5,6,1,0
7882,77,0,10,9,1,0,1,0
3195,52,3,0,0,0,0,0,0
0,0,0,0,0,0,0,0,0
9058,57,5,2,2,0,0,0,0
11586,216,4,33,30,3,0,1,0
0,0,0,0,0,0,0,0,0
674628,556,0,4,4,0,2,1,1
675105,557,0,4,4,0,2,1,1
4131,52,0,1,0,1,1,0,0
3782,68,2,2,2,0,1,0,0
0,0,0,0,0,0,0,0,0
0,0,0,0,0,0,0,0,0
0,0,0,0,0,0,0,0,0
672268,556,0,4,4,0,2,1,1
0,0,0,0,0,0,0,0,0
50268,250,5,53,52,1,3,1,0
670258,542,0,4,4,0,2,1,1
0,0,0,0,0,0,0,0,0
0,0,0,0,0,0,0,0,0
131391,981,12,119,116,3,1,0,0
166780,1105,1,0,0,0,0,0,0
0,0,0,0,0,0,0,0,0
673894,557,0,4,4,0,2,1,1
693,22,0,3,3,0,0,0,0
0,0,0,0,0,0,0,0,0
47754,512,7,82,82,0,7,1,0
47684,512,7,82,82,0,7,1,0
674235,557,0,4,4,0,2,1,1
0,0,0,0,0,0,0,0,0
45174,176,2,0,0,0,2,0,0
45218,176,2,0,0,0,2,0,0
672403,556,0,4,4,0,2,1,1
0,0,0,0,0,0,0,0,0
672685,542,0,4,4,0,2,1,1
0,0,0,0,0,0,0,0,0
24625,122,5,21,16,5,9,0,0
672030,542,0,4,4,0,2,1,1
670328,542,0,4,4,0,2,1,1
672289,556,0,4,4,0,2,1,1
673615,557,0,4,4,0,2,1,1
0,0,0,0,0,0,0,0,0
672836,542,0,4,4,0,2,1,1
701164,553,0,5,5,0,2,1,1
672492,556,0,4,4,0,2,1,1
674580,556,0,4,4,0,2,1,1
676909,557,0,4,4,0,2,1,1
673981,556,0,4,4,0,2,1,1
73736,87,1,5,4,1,0,0,0
73736,87,1,5,4,1,0,0,0
45748,183,2,1,1,0,2,0,0
0,0,0,0,0,0,0,0,0
60727,35,0,0,0,0,0,1,0
15287,231,7,38,31,7,3,0,0
0,0,0,0,0,0,0,0,0
4725,31,2,0,0,0,0,0,0
0,0,0,0,0,0,0,0,0
120617,247,3,6,5,1,2,1,0
10499,77,4,1,1,0,2,1,0
0,0,0,0,0,0,0,0,0
86019,540,9,119,97,22,2,1,0
0,0,0,0,0,0,0,0,0
25390,306,6,38,5,33,6,1,0
0,0,0,0,0,0,0,0,0
0,0,0,0,0,0,0,0,0
0,0,0,0,0,0,0,0,0
0,0,0,0,0,0,0,0,0
227547,624,9,125,101,24,2,1,0
227547,624,9,125,101,24,2,1,0
227546,624,9,125,101,24,2,1,0
227557,624,9,125,101,24,2,1,0
54583,504,2,46,17,29,0,0,0
54583,504,2,46,17,29,0,0,0
674960,556,0,4,4,0,2,1,1
670241,542,0,4,4,0,2,1,1
673085,542,0,4,4,0,2,1,1
0,0,0,0,0,0,0,0,0
0,0,0,0,0,0,0,0,0
0,0,0,0,0,0,0,0,0
0,0,0,0,0,0,0,0,0
87382,366,5,26,17,9,29,1,0
267082,353,7,10,5,5,4,0,0
24307,71,4,2,2,0,0,0,0
676608,557,0,4,4,0,2,1,1
677021,557,0,4,4,0,2,1,1
54016,276,2,2,1,1,1,0,0
675889,556,0,4,4,0,2,1,1
4868,77,0,15,2,13,0,1,0
4868,77,0,15,2,13,0,1,0
0,0,0,0,0,0,0,0,0
32392,204,0,47,45,2,1,1,0
0,0,0,0,0,0,0,0,0
0,0,0,0,0,0,0,0,0
0,0,0,0,0,0,0,0,0
672774,556,0,4,4,0,2,1,1
97953,216,4,0,0,0,1,0,0
2970,59,1,3,2,1,0,1,0
10411,117,1,4,4,0,0,0,0
0,0,0,0,0,0,0,0,0
8945,257,0,16,16,0,0,1,0
8945,257,0,16,16,0,0,1,0
8945,257,0,16,16,0,0,1,0
23805,189,0,3,0,3,2,0,0
23805,189,0,3,0,3,2,0,0
23805,189,0,3,0,3,2,0,0
54669,302,1,12,9,3,0,0,0
677413,557,0,4,4,0,2,1,1
115171,70,0,7,2,5,0,1,0
0,0,0,0,0,0,0,0,0
670883,542,0,4,4,0,2,1,1
23805,189,0,3,0,3,2,0,0
675470,556,0,4,4,0,2,1,1
675685,556,0,4,4,0,2,1,1
675607,556,0,4,4,0,2,1,1
673082,556,0,4,4,0,2,1,1
0,0,0,0,0,0,0,0,0
677192,557,0,4,4,0,2,1,1
671240,542,0,4,4,0,2,1,1
2459,35,2,1,1,0,0,0,0
2459,35,2,1,1,0,0,0,0
0,0,0,0,0,0,0,0,0
675214,557,0,4,4,0,2,1,1
673234,556,0,4,4,0,2,1,1
78263,248,0,4,2,2,0,1,0
5010,164,1,22,22,0,0,0,0
5010,164,1,22,22,0,0,0,0
0,0,0,0,0,0,0,0,0
0,0,0,0,0,0,0,0,0
56453,293,2,14,12,2,3,0,0
0,0,0,0,0,0,0,0,0
0,0,0,0,0,0,0,0,0
1084,28,0,3,3,0,0,0,0
1084,28,0,3,3,0,0,0,0
1084,28,0,3,3,0,0,0,0
8459,217,1,5,5,0,0,0,0
8459,217,1,5,5,0,0,0,0
2170,39,4,3,3,0,0,0,0
0,0,0,0,0,0,0,0,0
4658,133,0,3,3,0,0,0,0
17173,109,1,7,6,1,0,0,0
5010,164,1,22,22,0,0,0,0
0,0,0,0,0,0,0,0,0
0,0,0,0,0,0,0,0,0
100163,173,1,17,17,0,0,1,0
2044,38,1,0,0,0,0,0,0
9179,139,2,0,0,0,0,0,0
0,0,0,0,0,0,0,0,0
9825,156,2,0,0,0,0,0,0
0,0,0,0,0,0,0,0,0
5387,165,0,22,22,0,0,0,0
8459,217,1,5,5,0,0,0,0
8459,217,1,5,5,0,0,0,0
0,0,0,0,0,0,0,0,0
6769,126,1,0,0,0,0,0,0
147640,924,8,77,63,14,3,1,0
1880,52,1,6,6,0,0,0,0
48931,129,0,5,5,0,1,0,0
0,0,0,0,0,0,0,0,0
0,0,0,0,0,0,0,0,0
0,0,0,0,0,0,0,0,0
0,0,0,0,0,0,0,0,0
0,0,0,0,0,0,0,0,0
9825,156,2,0,0,0,0,0,0
6927,138,1,0,0,0,0,0,0
6927,138,1,0,0,0,0,0,0
6769,126,1,0,0,0,0,0,0
0,0,0,0,0,0,0,0,0
672216,556,0,4,4,0,2,1,1
65427,326,7,8,4,4,1,0,0
19953,250,3,65,63,2,1,1,0
3140,43,0,6,3,3,0,0,0
9825,156,2,0,0,0,0,0,0
5010,164,1,22,22,0,0,0,0
3140,43,0,6,3,3,0,0,0
6769,126,1,0,0,0,0,0,0
100163,173,1,17,17,0,0,1,0
94284,55,1,6,6,0,0,1,0
6769,126,1,0,0,0,0,0,0
1880,52,1,6,6,0,0,0,0
9825,156,2,0,0,0,0,0,0
0,0,0,0,0,0,0,0,0
1880,52,1,6,6,0,0,0,0
2170,39,4,3,3,0,0,0,0
100163,173,1,17,17,0,0,1,0
100163,173,1,17,17,0,0,1,0
0,0,0,0,0,0,0,0,0
5387,165,0,22,22,0,0,0,0
5387,165,0,22,22,0,0,0,0
6927,138,1,0,0,0,0,0,0
0,0,0,0,0,0,0,0,0
0,0,0,0,0,0,0,0,0
0,0,0,0,0,0,0,0,0
0,0,0,0,0,0,0,0,0
0,0,0,0,0,0,0,0,0
673544,556,0,4,4,0,2,1,1
8711,75,5,2,2,0,0,0,0
8711,75,5,2,2,0,0,0,0
8945,257,0,16,16,0,0,1,0
1068,28,0,2,2,0,0,0,0
1068,28,0,2,2,0,0,0,0
1068,28,0,2,2,0,0,0,0
672703,556,0,4,4,0,2,1,1
1068,28,0,2,2,0,0,0,0
0,0,0,0,0,0,0,0,0
0,0,0,0,0,0,0,0,0
11113,77,3,1,1,0,2,1,0
11099,77,3,1,1,0,2,1,0
11099,77,3,1,1,0,2,1,0
0,0,0,0,0,0,0,0,0
0,0,0,0,0,0,0,0,0
0,0,0,0,0,0,0,0,0
0,0,0,0,0,0,0,0,0
0,0,0,0,0,0,0,0,0
676809,557,0,4,4,0,2,1,1
2455,64,0,2,2,0,0,0,0
2455,64,0,2,2,0,0,0,0
674846,556,0,4,4,0,2,1,1
674964,556,0,4,4,0,2,1,1
4142,52,0,1,0,1,1,0,0
10441,138,0,19,19,0,0,0,0
14793,137,3,4,4,0,0,0,0
1858,48,1,9,6,3,0,0,0
7517,136,0,19,2,17,0,0,0
7517,136,0,19,2,17,0,0,0
7966,142,0,16,1,15,0,1,0
0,0,0,0,0,0,0,0,0
0,0,0,0,0,0,0,0,0
0,0,0,0,0,0,0,0,0
60107,113,0,5,1,4,1,0,0
4712,68,0,20,20,0,0,0,0
58099,110,0,4,1,3,1,0,0
0,0,0,0,0,0,0,0,0
672532,556,0,4,4,0,2,1,1
48755,216,2,3,3,0,1,0,0
672172,542,0,4,4,0,2,1,1
0,0,0,0,0,0,0,0,0
673187,556,0,4,4,0,2,1,1
5090,165,0,22,22,0,0,0,0
674875,556,0,4,0,4,2,1,1
45706,183,2,1,1,0,2,0,0
0,0,0,0,0,0,0,0,0
0,0,0,0,0,0,0,0,0
0,0,0,0,0,0,0,0,0
40294,52,2,2,2,0,0,1,0
2976,56,1,2,2,0,0,0,0
95380,59,1,2,2,0,0,1,0
0,0,0,0,0,0,0,0,0
0,0,0,0,0,0,0,0,0
675617,556,0,4,4,0,2,1,1
673056,556,0,4,4,0,2,1,1
0,0,0,0,0,0,0,0,0
0,0,0,0,0,0,0,0,0
676839,556,0,4,4,0,2,1,1
2455,64,0,2,2,0,0,0,0
2455,64,0,2,2,0,0,0,0
0,0,0,0,0,0,0,0,0
69497,235,5,17,8,9,23,0,0
0,0,0,0,0,0,0,0,0
10441,138,0,19,19,0,0,0,0
675738,556,0,4,4,0,2,1,1
675609,556,0,4,4,0,2,1,1
10591,163,2,2,2,0,0,0,0
10591,163,2,2,2,0,0,0,0
0,0,0,0,0,0,0,0,0
0,0,0,0,0,0,0,0,0
0,0,0,0,0,0,0,0,0
0,0,0,0,0,0,0,0,0
40294,52,2,2,2,0,0,1,0
0,0,0,0,0,0,0,0,0
5094,165,1,22,22,0,0,0,0
5092,165,1,22,22,0,0,0,0
5094,165,1,22,22,0,0,0,0
5092,165,1,22,22,0,0,0,0
5094,165,1,22,22,0,0,0,0
5092,165,1,22,22,0,0,0,0
11305,107,4,15,14,1,0,0,0
84457,519,4,119,109,10,0,1,0
1858,48,1,9,6,3,0,0,0
0,0,0,0,0,0,0,0,0
672562,556,0,4,0,4,2,1,1
13931,122,2,4,4,0,0,0,0
48833,237,2,2,1,1,1,0,0
2650,111,0,41,41,0,0,1,0
3119,24,0,1,1,0,0,0,0
3119,24,0,1,1,0,0,0,0
674313,556,0,4,4,0,2,1,1
5094,165,1,22,22,0,0,0,0
0,0,0,0,0,0,0,0,0
5092,165,1,22,22,0,0,0,0
0,0,0,0,0,0,0,0,0
0,0,0,0,0,0,0,0,0
0,0,0,0,0,0,0,0,0
0,0,0,0,0,0,0,0,0
1854,44,0,2,2,0,0,0,0
10837,124,5,7,6,1,0,0,0
3140,43,0,6,3,3,0,0,0
10591,163,2,2,2,0,0,0,0
1854,44,0,2,2,0,0,0,0
0,0,0,0,0,0,0,0,0
10441,138,0,19,19,0,0,0,0
95380,59,1,2,2,0,0,1,0
3140,43,0,6,3,3,0,0,0
0,0,0,0,0,0,0,0,0
2259,63,0,5,5,0,0,0,0
0,0,0,0,0,0,0,0,0
0,0,0,0,0,0,0,0,0
10084,83,4,2,1,1,0,0,0
16100,35,0,5,1,4,0,0,0
0,0,0,0,0,0,0,0,0
0,0,0,0,0,0,0,0,0
0,0,0,0,0,0,0,0,0
0,0,0,0,0,0,0,0,0
0,0,0,0,0,0,0,0,0
15744,345,4,52,52,0,2,1,0
0,0,0,0,0,0,0,0,0
788372,405,1,63,38,25,0,0,0
0,0,0,0,0,0,0,0,0
674899,556,0,4,4,0,2,1,1
159211,435,2,6,5,1,21,0,0
3049,92,0,17,17,0,0,0,0
20578,94,0,2,2,0,0,0,0
20578,94,0,2,2,0,0,0,0
0,0,0,0,0,0,0,0,0
0,0,0,0,0,0,0,0,0
52726,250,2,2,1,1,1,0,0
6586,58,1,1,1,0,0,0,0
0,0,0,0,0,0,0,0,0
0,0,0,0,0,0,0,0,0
0,0,0,0,0,0,0,0,0
0,0,0,0,0,0,0,0,0
54316,258,2,3,2,1,1,0,0
58564,300,2,5,5,0,9,1,0
0,0,0,0,0,0,0,0,0
127372,117,2,1,1,0,5,0,0
127215,116,2,1,0,1,5,0,0
0,0,0,0,0,0,0,0,0
19513,94,2,1,1,0,0,0,0
121955,154,2,2,1,1,8,0,0
0,0,0,0,0,0,0,0,0
0,0,0,0,0,0,0,0,0
164189,632,17,36,32,4,2,1,0
0,0,0,0,0,0,0,0,0
0,0,0,0,0,0,0,0,0
48361,220,2,1,0,1,1,0,0
10449,122,2,6,6,0,0,1,0
16664,75,2,1,1,0,0,0,0
26651,129,0,21,21,0,0,0,0
26775,129,0,21,21,0,0,0,0
26815,129,0,21,21,0,0,0,0
673050,556,0,4,4,0,2,1,1
5613,66,1,1,0,1,1,0,0
0,0,0,0,0,0,0,0,0
34514,290,0,26,0,26,2,0,0
47031,204,2,2,1,1,1,0,0
131838,206,3,4,2,2,8,0,0
0,0,0,0,0,0,0,0,0
0,0,0,0,0,0,0,0,0
33747,286,0,25,0,25,2,0,0
0,0,0,0,0,0,0,0,0
2637,27,3,0,0,0,0,0,0
1623,30,4,1,1,0,0,0,0
119604,244,0,38,34,4,2,1,0
0,0,0,0,0,0,0,0,0
0,0,0,0,0,0,0,0,0
103068,377,4,45,6,39,0,1,0
0,0,0,0,0,0,0,0,0
0,0,0,0,0,0,0,0,0
0,0,0,0,0,0,0,0,0
0,0,0,0,0,0,0,0,0
8928,51,3,2,1,1,0,0,0
0,0,0,0,0,0,0,0,0
0,0,0,0,0,0,0,0,0
0,0,0,0,0,0,0,0,0
0,0,0,0,0,0,0,0,0
29747,201,1,21,4,17,2,0,0
0,0,0,0,0,0,0,0,0
0,0,0,0,0,0,0,0,0
8737,54,0,1,0,1,0,0,0
0,0,0,0,0,0,0,0,0
0,0,0,0,0,0,0,0,0
0,0,0,0,0,0,0,0,0
0,0,0,0,0,0,0,0,0
0,0,0,0,0,0,0,0,0
157999,302,1,5,1,4,44,1,0
157999,302,1,5,1,4,44,1,0
121078,140,2,1,0,1,8,0,0
121076,140,2,1,0,1,8,0,0
0,0,0,0,0,0,0,0,0
218238,238,0,2,2,0,0,1,0
288949,377,1,15,4,11,2,0,0
44955,174,2,1,0,1,1,0,0
0,0,0,0,0,0,0,0,0
0,0,0,0,0,0,0,0,0
0,0,0,0,0,0,0,0,0
0,0,0,0,0,0,0,0,0
0,0,0,0,0,0,0,0,0
0,0,0,0,0,0,0,0,0
0,0,0,0,0,0,0,0,0
24424,78,1,3,2,1,0,1,0
0,0,0,0,0,0,0,0,0
48098,220,2,1,0,1,1,0,0
137032,438,6,2,1,1,8,0,0
0,0,0,0,0,0,0,0,0
0,0,0,0,0,0,0,0,0
50699,209,2,3,1,2,1,0,0
40399,425,1,15,4,11,0,1,0
0,0,0,0,0,0,0,0,0
84766,963,0,61,33,28,2,1,0
121386,143,2,2,0,2,8,0,0
81805,197,3,13,8,5,5,1,0
0,0,0,0,0,0,0,0,0
0,0,0,0,0,0,0,0,0
0,0,0,0,0,0,0,0,0
126843,182,2,3,2,1,11,0,0
672681,556,0,4,4,0,2,1,1
47212,207,2,2,2,0,1,0,0
47654,213,2,1,0,1,1,0,0
677085,557,0,4,4,0,2,1,1
47048,203,2,2,1,1,1,0,0
36652,422,8,38,1,37,7,1,0
0,0,0,0,0,0,0,0,0
0,0,0,0,0,0,0,0,0
0,0,0,0,0,0,0,0,0
0,0,0,0,0,0,0,0,0
0,0,0,0,0,0,0,0,0
0,0,0,0,0,0,0,0,0
0,0,0,0,0,0,0,0,0
29480,89,1,3,3,0,2,0,0
29666,91,1,3,3,0,2,0,0
10834,72,0,0,0,0,0,0,0
0,0,0,0,0,0,0,0,0
0,0,0,0,0,0,0,0,0
0,0,0,0,0,0,0,0,0
0,0,0,0,0,0,0,0,0
49048,211,2,2,1,1,1,0,0
0,0,0,0,0,0,0,0,0
17745,61,3,2,2,0,2,1,0
1339,17,1,0,0,0,0,0,0
0,0,0,0,0,0,0,0,0
0,0,0,0,0,0,0,0,0
0,0,0,0,0,0,0,0,0
0,0,0,0,0,0,0,0,0
9336,58,0,0,0,0,0,0,0
9336,58,0,0,0,0,0,0,0
144734,552,1,25,14,11,4,1,0
0,0,0,0,0,0,0,0,0
0,0,0,0,0,0,0,0,0
0,0,0,0,0,0,0,0,0
0,0,0,0,0,0,0,0,0
101875,588,4,42,42,0,10,0,0
2930,56,0,1,1,0,0,0,0
79196,1623,6,730,730,0,1,1,0
32634,222,3,0,0,0,0,1,0
250,8,0,0,0,0,0,0,0
675090,556,0,4,4,0,2,1,1
14291,120,2,0,0,0,0,0,0
124184,180,2,1,0,1,8,0,0
0,0,0,0,0,0,0,0,0
3338,28,1,0,0,0,0,0,0
0,0,0,0,0,0,0,0,0
0,0,0,0,0,0,0,0,0
0,0,0,0,0,0,0,0,0
0,0,0,0,0,0,0,0,0
0,0,0,0,0,0,0,0,0
32631,805,6,114,113,1,4,1,0
46077,182,3,0,0,0,2,0,0
46076,182,3,0,0,0,2,0,0
8714,97,3,16,10,6,1,1,0
0,0,0,0,0,0,0,0,0
363,10,0,1,0,1,0,0,0
51353,236,2,2,2,0,1,1,0
48482,198,2,2,2,0,1,0,0
0,0,0,0,0,0,0,0,0
121931,146,2,3,1,2,8,0,0
0,0,0,0,0,0,0,0,0
0,0,0,0,0,0,0,0,0
10289,42,0,0,0,0,0,0,0
10289,42,0,0,0,0,0,0,0
0,0,0,0,0,0,0,0,0
0,0,0,0,0,0,0,0,0
47493,210,2,1,0,1,1,0,0
0,0,0,0,0,0,0,0,0
17745,61,3,2,2,0,2,1,0
0,0,0,0,0,0,0,0,0
0,0,0,0,0,0,0,0,0
0,0,0,0,0,0,0,0,0
0,0,0,0,0,0,0,0,0
0,0,0,0,0,0,0,0,0
0,0,0,0,0,0,0,0,0
0,0,0,0,0,0,0,0,0
0,0,0,0,0,0,0,0,0
0,0,0,0,0,0,0,0,0
0,0,0,0,0,0,0,0,0
0,0,0,0,0,0,0,0,0
0,0,0,0,0,0,0,0,0
0,0,0,0,0,0,0,0,0
0,0,0,0,0,0,0,0,0
0,0,0,0,0,0,0,0,0
25661,61,2,0,0,0,0,0,0
25661,61,2,0,0,0,0,0,0
0,0,0,0,0,0,0,0,0
220906,278,0,4,0,4,0,1,0
0,0,0,0,0,0,0,0,0
0,0,0,0,0,0,0,0,0
0,0,0,0,0,0,0,0,0
0,0,0,0,0,0,0,0,0
0,0,0,0,0,0,0,0,0
0,0,0,0,0,0,0,0,0
0,0,0,0,0,0,0,0,0
672743,556,0,4,4,0,2,1,1
70914,111,3,7,2,5,3,1,0
70914,111,3,7,6,1,3,1,0
50251,125,0,14,11,3,0,0,0
0,0,0,0,0,0,0,0,0
0,0,0,0,0,0,0,0,0
5546,43,2,0,0,0,0,0,0
0,0,0,0,0,0,0,0,0
20320,149,1,13,8,5,5,0,0
20320,149,1,13,8,5,5,0,0
0,0,0,0,0,0,0,0,0
0,0,0,0,0,0,0,0,0
0,0,0,0,0,0,0,0,0
0,0,0,0,0,0,0,0,0
0,0,0,0,0,0,0,0,0
0,0,0,0,0,0,0,0,0
33556,210,0,51,51,0,0,1,0
0,0,0,0,0,0,0,0,0
338027,43,4,1,1,0,2,0,0
338027,43,4,1,1,0,2,0,0
0,0,0,0,0,0,0,0,0
674775,557,0,4,4,0,2,1,1
0,0,0,0,0,0,0,0,0
17745,61,3,2,2,0,2,1,0
17745,61,3,2,2,0,2,1,0
0,0,0,0,0,0,0,0,0
0,0,0,0,0,0,0,0,0
0,0,0,0,0,0,0,0,0
26119,138,3,7,4,3,1,0,0
458564,2972,3,344,12,332,4,0,0
464790,2977,3,344,12,332,4,0,0
0,0,0,0,0,0,0,0,0
0,0,0,0,0,0,0,0,0
677993,556,0,4,0,4,2,1,1
0,0,0,0,0,0,0,0,0
0,0,0,0,0,0,0,0,0
0,0,0,0,0,0,0,0,0
2289,29,0,0,0,0,0,0,0
2602,38,0,0,0,0,0,0,0
105729,377,3,27,2,25,3,1,0
84457,519,4,119,109,10,0,1,0
0,0,0,0,0,0,0,0,0
94536,948,5,228,206,22,4,1,0
0,0,0,0,0,0,0,0,0
0,0,0,0,0,0,0,0,0
0,0,0,0,0,0,0,0,0
84668,414,8,25,22,3,3,1,0
674417,556,0,4,4,0,2,1,1
161016,107,3,18,9,9,4,1,0
0,0,0,0,0,0,0,0,0
0,0,0,0,0,0,0,0,0
0,0,0,0,0,0,0,0,0
0,0,0,0,0,0,0,0,0
0,0,0,0,0,0,0,0,0
0,0,0,0,0,0,0,0,0
0,0,0,0,0,0,0,0,0
0,0,0,0,0,0,0,0,0
0,0,0,0,0,0,0,0,0
0,0,0,0,0,0,0,0,0
0,0,0,0,0,0,0,0,0
0,0,0,0,0,0,0,0,0
9364,49,5,0,0,0,3,1,0
0,0,0,0,0,0,0,0,0
0,0,0,0,0,0,0,0,0
0,0,0,0,0,0,0,0,0
0,0,0,0,0,0,0,0,0
0,0,0,0,0,0,0,0,0
0,0,0,0,0,0,0,0,0
0,0,0,0,0,0,0,0,0
0,0,0,0,0,0,0,0,0
0,0,0,0,0,0,0,0,0
54304,822,4,163,27,136,3,1,0
54501,823,4,163,27,136,3,1,0
0,0,0,0,0,0,0,0,0
0,0,0,0,0,0,0,0,0
0,0,0,0,0,0,0,0,0
0,0,0,0,0,0,0,0,0
298340,471,9,59,52,7,3,1,0
0,0,0,0,0,0,0,0,0
37478,445,5,81,78,3,2,1,0
0,0,0,0,0,0,0,0,0
4394,25,0,1,0,1,0,0,0
215583,122,4,2,1,1,0,0,0
674476,556,0,4,4,0,2,1,1
1691,65,0,16,16,0,0,1,0
0,0,0,0,0,0,0,0,0
0,0,0,0,0,0,0,0,0
675552,556,0,4,4,0,2,1,1
4153,40,0,2,1,1,1,0,0
0,0,0,0,0,0,0,0,0
219933,794,3,93,22,71,6,1,0
221066,797,3,93,21,72,6,1,0
7033,55,0,2,2,0,0,0,0
7033,55,0,2,2,0,0,0,0
676411,557,0,4,4,0,2,1,1
43735,30,1,0,0,0,0,0,0
97705,770,2,7,7,0,1,0,0
33948,168,6,6,4,2,1,0,0
0,0,0,0,0,0,0,0,0
0,0,0,0,0,0,0,0,0
32392,204,0,47,45,2,1,1,0
26000,149,6,4,3,1,1,0,0
0,0,0,0,0,0,0,0,0
0,0,0,0,0,0,0,0,0
23507,108,6,5,5,0,2,0,0
673882,556,0,4,4,0,2,1,1
0,0,0,0,0,0,0,0,0
0,0,0,0,0,0,0,0,0
18712,90,1,2,1,1,0,1,0
0,0,0,0,0,0,0,0,0
0,0,0,0,0,0,0,0,0
0,0,0,0,0,0,0,0,0
47098,202,2,1,0,1,1,0,0
15030,77,1,2,0,2,0,0,0
69395,98,3,4,2,2,3,1,0
113813,840,8,127,125,2,4,1,0
113804,842,8,127,125,2,4,1,0
0,0,0,0,0,0,0,0,0
319102,213,1,10,6,4,2,0,0
0,0,0,0,0,0,0,0,0
128022,358,5,0,0,0,5,0,0
0,0,0,0,0,0,0,0,0
16057,162,5,30,28,2,0,1,0
0,0,0,0,0,0,0,0,0
0,0,0,0,0,0,0,0,0
8974,65,3,0,0,0,0,0,0
0,0,0,0,0,0,0,0,0
675907,557,0,4,0,4,2,1,1
72035,283,10,11,0,11,5,1,0
696347,2586,2,300,258,42,38,1,0
696347,2586,2,300,258,42,38,1,0
2012,20,0,4,0,4,0,0,0
57488,883,4,163,26,137,3,1,0
0,0,0,0,0,0,0,0,0
0,0,0,0,0,0,0,0,0
14346,98,1,1,1,0,3,0,0
639083,107,4,4,4,0,4,1,0
0,0,0,0,0,0,0,0,0
0,0,0,0,0,0,0,0,0
0,0,0,0,0,0,0,0,0
0,0,0,0,0,0,0,0,0
639099,107,4,4,4,0,4,1,0
28914,160,6,1,0,1,1,0,0
0,0,0,0,0,0,0,0,0
0,0,0,0,0,0,0,0,0
0,0,0,0,0,0,0,0,0
0,0,0,0,0,0,0,0,0
0,0,0,0,0,0,0,0,0
674926,556,0,4,4,0,2,1,1
34446,219,3,44,36,8,0,0,0
46903,199,2,1,0,1,1,0,0
133952,236,2,26,25,1,5,1,0
673913,557,0,4,4,0,2,1,1
96230,529,10,18,12,6,2,1,0
0,0,0,0,0,0,0,0,0
0,0,0,0,0,0,0,0,0
700893,552,0,5,5,0,2,1,1
0,0,0,0,0,0,0,0,0
8545,57,4,2,2,0,2,1,0
8545,57,4,2,2,0,2,1,0
0,0,0,0,0,0,0,0,0
675797,556,0,4,4,0,2,1,1
385,23,0,4,4,0,0,0,0
0,0,0,0,0,0,0,0,0
321037,523,3,63,49,14,3,1,0
19608,372,8,34,32,2,0,1,0
38034,486,7,99,90,9,0,1,0
9973,69,4,4,0,4,0,0,0
4114,52,0,1,0,1,1,0,0
0,0,0,0,0,0,0,0,0
80258,583,8,37,31,6,4,1,0
114779,171,0,10,7,3,1,1,0
79764,191,3,12,11,1,5,1,0
0,0,0,0,0,0,0,0,0
675316,556,0,4,4,0,2,1,1
277402,1865,12,321,307,14,4,1,0
2119,40,2,5,3,2,0,0,0
61581,317,2,5,5,0,11,1,0
0,0,0,0,0,0,0,0,0
14214,34,0,1,1,0,1,0,0
66469,632,3,119,71,48,0,1,0
107685,356,7,24,1,23,5,0,0
66044,626,3,118,71,47,0,1,0
211760,46,5,0,0,0,0,0,0
0,0,0,0,0,0,0,0,0
0,0,0,0,0,0,0,0,0
79490,569,7,55,42,13,3,0,0
149287,679,9,42,41,1,1,0,0
0,0,0,0,0,0,0,0,0
0,0,0,0,0,0,0,0,0
0,0,0,0,0,0,0,0,0
0,0,0,0,0,0,0,0,0
36746,588,4,75,72,3,0,1,0
0,0,0,0,0,0,0,0,0
48746,141,9,13,5,8,0,0,0
44692,45,6,1,1,0,1,0,0
184787,2265,1,243,164,79,4,1,0
21144,244,5,22,11,11,0,1,0
82768,667,9,140,21,119,9,1,0
79545,181,3,10,8,2,6,1,0
127863,369,5,2,2,0,5,0,0
0,0,0,0,0,0,0,0,0
0,0,0,0,0,0,0,0,0
0,0,0,0,0,0,0,0,0
0,0,0,0,0,0,0,0,0
76520,908,3,80,76,4,5,1,0
61533,315,2,5,5,0,11,1,0
0,0,0,0,0,0,0,0,0
0,0,0,0,0,0,0,0,0
0,0,0,0,0,0,0,0,0
138248,447,6,2,1,1,8,0,0
19239,218,5,40,40,0,0,0,0
0,0,0,0,0,0,0,0,0
88324,564,6,93,88,5,2,1,0
0,0,0,0,0,0,0,0,0
0,0,0,0,0,0,0,0,0
0,0,0,0,0,0,0,0,0
60142,521,7,130,118,12,2,0,0
31759,121,1,3,3,0,0,0,0
7910,52,6,1,1,0,0,0,0
188512,111,2,0,0,0,0,0,0
0,0,0,0,0,0,0,0,0
121692,146,2,3,1,2,8,0,0
48074,220,2,1,1,0,1,0,0
0,0,0,0,0,0,0,0,0
108952,2509,3,364,264,100,0,1,0
593,11,0,0,0,0,0,0,0
72192,481,6,25,20,5,2,1,0
0,0,0,0,0,0,0,0,0
639,6,0,0,0,0,0,0,0
0,0,0,0,0,0,0,0,0
0,0,0,0,0,0,0,0,0
17885,173,0,0,0,0,0,0,0
13711,332,2,77,77,0,1,0,0
168454,631,2,45,21,24,0,1,0
0,0,0,0,0,0,0,0,0
0,0,0,0,0,0,0,0,0
0,0,0,0,0,0,0,0,0
53239,264,3,31,22,9,6,0,0
53239,264,3,31,22,9,6,0,0
53239,264,3,31,22,9,6,0,0
0,0,0,0,0,0,0,0,0
127487,361,5,1,1,0,5,0,0
0,0,0,0,0,0,0,0,0
0,0,0,0,0,0,0,0,0
0,0,0,0,0,0,0,0,0
0,0,0,0,0,0,0,0,0
0,0,0,0,0,0,0,0,0
339755,652,3,88,85,3,7,1,0
0,0,0,0,0,0,0,0,0
127517,359,5,1,1,0,5,0,0
0,0,0,0,0,0,0,0,0
37110,154,2,3,1,2,1,1,0
28265,233,5,46,37,9,2,1,0
799668,177,0,0,0,0,1,1,0
127518,359,5,1,0,1,5,0,0
0,0,0,0,0,0,0,0,0
0,0,0,0,0,0,0,0,0
674849,556,0,4,4,0,2,1,1
4547,35,0,2,2,0,0,0,0
0,0,0,0,0,0,0,0,0
0,0,0,0,0,0,0,0,0
0,0,0,0,0,0,0,0,0
0,0,0,0,0,0,0,0,0
0,0,0,0,0,0,0,0,0
0,0,0,0,0,0,0,0,0
0,0,0,0,0,0,0,0,0
0,0,0,0,0,0,0,0,0
0,0,0,0,0,0,0,0,0
0,0,0,0,0,0,0,0,0
0,0,0,0,0,0,0,0,0
0,0,0,0,0,0,0,0,0
0,0,0,0,0,0,0,0,0
0,0,0,0,0,0,0,0,0
0,0,0,0,0,0,0,0,0
0,0,0,0,0,0,0,0,0
0,0,0,0,0,0,0,0,0
0,0,0,0,0,0,0,0,0
0,0,0,0,0,0,0,0,0
0,0,0,0,0,0,0,0,0
0,0,0,0,0,0,0,0,0
0,0,0,0,0,0,0,0,0
0,0,0,0,0,0,0,0,0
0,0,0,0,0,0,0,0,0
0,0,0,0,0,0,0,0,0
0,0,0,0,0,0,0,0,0
0,0,0,0,0,0,0,0,0
0,0,0,0,0,0,0,0,0
0,0,0,0,0,0,0,0,0
0,0,0,0,0,0,0,0,0
0,0,0,0,0,0,0,0,0
0,0,0,0,0,0,0,0,0
0,0,0,0,0,0,0,0,0
0,0,0,0,0,0,0,0,0
0,0,0,0,0,0,0,0,0
0,0,0,0,0,0,0,0,0
0,0,0,0,0,0,0,0,0
0,0,0,0,0,0,0,0,0
0,0,0,0,0,0,0,0,0
0,0,0,0,0,0,0,0,0
0,0,0,0,0,0,0,0,0
0,0,0,0,0,0,0,0,0
0,0,0,0,0,0,0,0,0
0,0,0,0,0,0,0,0,0
0,0,0,0,0,0,0,0,0
0,0,0,0,0,0,0,0,0
0,0,0,0,0,0,0,0,0
0,0,0,0,0,0,0,0,0
0,0,0,0,0,0,0,0,0
0,0,0,0,0,0,0,0,0
36136,166,6,3,1,2,1,0,0
672365,542,0,4,4,0,2,1,1
416497,1119,0,1,0,1,0,0,0
0,0,0,0,0,0,0,0,0
143115,749,8,93,92,1,6,1,0
0,0,0,0,0,0,0,0,0
330724,1552,5,150,10,140,0,1,0
0,0,0,0,0,0,0,0,0
3691,50,3,6,6,0,0,0,0
0,0,0,0,0,0,0,0,0
162455,599,12,20,18,2,3,1,0
0,0,0,0,0,0,0,0,0
128025,363,5,2,2,0,5,0,0
12852,63,2,0,0,0,0,0,0
33078,284,2,6,5,1,3,0,0
672677,556,0,4,4,0,2,1,1
407996,704,6,63,12,51,2,1,0
675872,556,0,4,4,0,2,1,1
255101,685,7,106,5,101,7,1,0
0,0,0,0,0,0,0,0,0
106719,1058,9,312,305,7,1,1,0
2135405,264,4,6,6,0,0,1,0
0,0,0,0,0,0,0,0,0
0,0,0,0,0,0,0,0,0
0,0,0,0,0,0,0,0,0
0,0,0,0,0,0,0,0,0
5570,30,0,0,0,0,0,0,0
2790,19,0,0,0,0,0,0,0
6631,63,6,4,0,4,0,0,0
6631,63,6,4,3,1,0,0,0
674812,556,0,4,4,0,2,1,1
13796,49,0,0,0,0,2,1,0
54451,58,1,1,1,0,6,0,0
207163,1415,9,334,330,4,2,1,0
13942,138,7,2,1,1,0,0,0
0,0,0,0,0,0,0,0,0
54452,58,1,1,1,0,6,0,0
127484,359,5,1,1,0,5,0,0
0,0,0,0,0,0,0,0,0
0,0,0,0,0,0,0,0,0
9526,180,5,34,31,3,0,1,0
672267,556,0,4,0,4,2,1,1
672369,556,0,4,0,4,2,1,1
0,0,0,0,0,0,0,0,0
127650,363,5,2,0,2,5,0,0
673378,542,0,4,0,4,2,1,1
287661,953,4,6,0,6,5,0,0
33196,278,1,29,24,5,0,0,0
33196,278,1,29,24,5,0,0,0
0,0,0,0,0,0,0,0,0
4223044,264,4,6,6,0,0,1,0
5554,30,0,0,0,0,0,0,0
8704,70,2,0,0,0,0,0,0
0,0,0,0,0,0,0,0,0
0,0,0,0,0,0,0,0,0
12877,53,0,0,0,0,0,0,0
1275,29,0,2,1,1,0,0,0
0,0,0,0,0,0,0,0,0
75088,945,4,249,244,5,3,1,0
11647,125,0,1,0,1,0,0,0
24204,363,7,58,55,3,2,0,0
0,0,0,0,0,0,0,0,0
3201,28,0,2,0,2,0,0,0
48210,214,2,2,2,0,1,0,0
0,0,0,0,0,0,0,0,0
0,0,0,0,0,0,0,0,0
0,0,0,0,0,0,0,0,0
0,0,0,0,0,0,0,0,0
0,0,0,0,0,0,0,0,0
0,0,0,0,0,0,0,0,0
0,0,0,0,0,0,0,0,0
0,0,0,0,0,0,0,0,0
10546,75,0,0,0,0,0,0,0
106845,939,3,2,1,1,220,0,0
0,0,0,0,0,0,0,0,0
0,0,0,0,0,0,0,0,0
460414,833,9,124,102,22,7,1,0
0,0,0,0,0,0,0,0,0
433248,629,9,104,83,21,8,1,0
55,3,0,0,0,0,0,0,0
2033702,3046,5,154,138,16,0,1,0
0,0,0,0,0,0,0,0,0
16228,247,3,11,2,9,0,1,0
169989,747,0,71,4,67,1,1,1
786613,173,0,0,0,0,1,1,0
12108,178,1,9,9,0,0,1,0
94104,378,5,34,31,3,1,1,0
94107,378,5,34,31,3,1,1,0
0,0,0,0,0,0,0,0,0
0,0,0,0,0,0,0,0,0
4281,36,1,0,0,0,0,0,0
35078,348,12,90,78,12,0,1,0
286222,1155,3,203,104,99,4,1,0
0,0,0,0,0,0,0,0,0
6909,94,1,4,3,1,0,0,0
0,0,0,0,0,0,0,0,0
0,0,0,0,0,0,0,0,0
676104,557,0,4,4,0,2,1,1
0,0,0,0,0,0,0,0,0
7457,29,4,1,1,0,0,0,0
64591,466,6,73,68,5,1,0,0
42208,205,5,34,28,6,0,0,0
116981,719,0,151,10,141,14,1,0
64939,320,1,5,5,0,0,0,0
467817,739,8,90,81,9,5,1,0
145116,536,6,2,1,1,8,0,0
0,0,0,0,0,0,0,0,0
0,0,0,0,0,0,0,0,0
0,0,0,0,0,0,0,0,0
0,0,0,0,0,0,0,0,0
48012,220,2,1,1,0,1,0,0
0,0,0,0,0,0,0,0,0
0,0,0,0,0,0,0,0,0
0,0,0,0,0,0,0,0,0
0,0,0,0,0,0,0,0,0
48216,214,2,2,2,0,1,0,0
0,0,0,0,0,0,0,0,0
54307,57,1,1,1,0,5,0,0
7492,57,6,3,2,1,0,0,0
676156,557,0,4,4,0,2,1,1
0,0,0,0,0,0,0,0,0
0,0,0,0,0,0,0,0,0
0,0,0,0,0,0,0,0,0
0,0,0,0,0,0,0,0,0
0,0,0,0,0,0,0,0,0
0,0,0,0,0,0,0,0,0
0,0,0,0,0,0,0,0,0
0,0,0,0,0,0,0,0,0
0,0,0,0,0,0,0,0,0
578950,60,4,3,3,0,2,1,0
0,0,0,0,0,0,0,0,0
0,0,0,0,0,0,0,0,0
0,0,0,0,0,0,0,0,0
69764,192,0,33,29,4,0,0,0
57798,772,7,96,84,12,0,1,0
673072,542,0,4,4,0,2,1,1
0,0,0,0,0,0,0,0,0
127570,362,5,1,1,0,5,0,0
0,0,0,0,0,0,0,0,0
0,0,0,0,0,0,0,0,0
63132,617,3,2,2,0,2,0,0
675398,557,0,4,0,4,2,1,1
2021926,3046,5,154,138,16,0,1,0
0,0,0,0,0,0,0,0,0
0,0,0,0,0,0,0,0,0
59375,297,1,5,5,0,0,0,0
0,0,0,0,0,0,0,0,0
35006,252,11,32,28,4,0,0,0
0,0,0,0,0,0,0,0,0
0,0,0,0,0,0,0,0,0
0,0,0,0,0,0,0,0,0
46539,195,2,2,1,1,1,0,0
0,0,0,0,0,0,0,0,0
38852,211,7,23,23,0,0,1,0
0,0,0,0,0,0,0,0,0
0,0,0,0,0,0,0,0,0
32530,206,0,48,46,2,1,1,0
134005,236,2,26,25,1,5,1,0
0,0,0,0,0,0,0,0,0
0,0,0,0,0,0,0,0,0
0,0,0,0,0,0,0,0,0
171464,708,10,65,54,11,0,1,0
0,0,0,0,0,0,0,0,0
880367,2936,5,547,441,106,1,1,0
0,0,0,0,0,0,0,0,0
0,0,0,0,0,0,0,0,0
933,5,0,0,0,0,0,0,0
933,5,0,0,0,0,0,0,0
0,0,0,0,0,0,0,0,0
0,0,0,0,0,0,0,0,0
2190,29,7,1,1,0,0,0,0
209511,668,14,61,40,21,6,1,0
209758,668,14,61,12,49,6,1,0
880367,2936,5,547,441,106,1,1,0
0,0,0,0,0,0,0,0,0
5103,57,6,3,2,1,0,0,0
0,0,0,0,0,0,0,0,0
0,0,0,0,0,0,0,0,0
672717,556,0,4,4,0,2,1,1
221788,189,2,6,3,3,1,0,0
672273,556,0,4,4,0,2,1,1
0,0,0,0,0,0,0,0,0
0,0,0,0,0,0,0,0,0
0,0,0,0,0,0,0,0,0
2010417,175,1,3,0,3,2,1,0
52581,353,9,80,40,40,7,1,0
0,0,0,0,0,0,0,0,0
0,0,0,0,0,0,0,0,0
0,0,0,0,0,0,0,0,0
7238,35,2,0,0,0,0,0,0
4155,40,0,2,1,1,1,0,0
0,0,0,0,0,0,0,0,0
674829,556,0,4,4,0,2,1,1
0,0,0,0,0,0,0,0,0
31951,57,1,4,4,0,0,0,0
0,0,0,0,0,0,0,0,0
24080,177,1,19,19,0,1,0,0
13415,149,0,7,5,2,4,1,0
83551,571,13,75,5,70,4,1,0
0,0,0,0,0,0,0,0,0
0,0,0,0,0,0,0,0,0
0,0,0,0,0,0,0,0,0
0,0,0,0,0,0,0,0,0
0,0,0,0,0,0,0,0,0
46258,365,2,0,0,0,12,1,0
0,0,0,0,0,0,0,0,0
0,0,0,0,0,0,0,0,0
287464,1160,3,203,28,175,4,1,0
0,0,0,0,0,0,0,0,0
21028,231,0,23,11,12,0,1,0
678148,557,0,4,0,4,2,1,1
54263,287,1,5,5,0,0,0,0
0,0,0,0,0,0,0,0,0
19782,209,7,20,20,0,0,1,0
0,0,0,0,0,0,0,0,0
0,0,0,0,0,0,0,0,0
131361,204,3,3,3,0,8,0,0
28579,144,3,2,0,2,8,0,0
0,0,0,0,0,0,0,0,0
672163,556,0,4,4,0,2,1,1
26521,315,7,57,57,0,0,0,0
0,0,0,0,0,0,0,0,0
0,0,0,0,0,0,0,0,0
0,0,0,0,0,0,0,0,0
0,0,0,0,0,0,0,0,0
0,0,0,0,0,0,0,0,0
0,0,0,0,0,0,0,0,0
0,0,0,0,0,0,0,0,0
0,0,0,0,0,0,0,0,0
152852,154,6,0,0,0,0,0,0
675086,556,0,4,4,0,2,1,1
0,0,0,0,0,0,0,0,0
0,0,0,0,0,0,0,0,0
116221,698,16,68,62,6,7,1,0
0,0,0,0,0,0,0,0,0
0,0,0,0,0,0,0,0,0
0,0,0,0,0,0,0,0,0
0,0,0,0,0,0,0,0,0
0,0,0,0,0,0,0,0,0
0,0,0,0,0,0,0,0,0
0,0,0,0,0,0,0,0,0
1761,28,0,1,0,1,0,0,0
1761,28,0,1,0,1,0,0,0
0,0,0,0,0,0,0,0,0
0,0,0,0,0,0,0,0,0
0,0,0,0,0,0,0,0,0
0,0,0,0,0,0,0,0,0
0,0,0,0,0,0,0,0,0
2123,40,2,5,3,2,0,0,0
671872,556,0,4,4,0,2,1,1
220081,1667,8,583,533,50,7,1,0
0,0,0,0,0,0,0,0,0
7722,52,2,0,0,0,0,0,0
7722,52,2,0,0,0,0,0,0
644841,80,0,2,1,1,1,1,0
644841,80,0,2,1,1,1,1,0
673660,556,0,4,4,0,2,1,1
0,0,0,0,0,0,0,0,0
0,0,0,0,0,0,0,0,0
0,0,0,0,0,0,0,0,0
0,0,0,0,0,0,0,0,0
674078,556,0,4,0,4,2,1,1
39371,221,2,73,72,1,4,1,0
0,0,0,0,0,0,0,0,0
0,0,0,0,0,0,0,0,0
0,0,0,0,0,0,0,0,0
0,0,0,0,0,0,0,0,0
0,0,0,0,0,0,0,0,0
0,0,0,0,0,0,0,0,0
0,0,0,0,0,0,0,0,0
0,0,0,0,0,0,0,0,0
0,0,0,0,0,0,0,0,0
0,0,0,0,0,0,0,0,0
0,0,0,0,0,0,0,0,0
0,0,0,0,0,0,0,0,0
0,0,0,0,0,0,0,0,0
674433,556,0,4,4,0,2,1,1
59862,414,3,137,6,131,5,0,1
83666,179,3,8,6,2,6,1,0
0,0,0,0,0,0,0,0,0
0,0,0,0,0,0,0,0,0
288137,762,3,224,113,111,0,1,0
0,0,0,0,0,0,0,0,0
45419,46,1,0,0,0,1,0,0
45419,46,1,0,0,0,1,0,0
0,0,0,0,0,0,0,0,0
0,0,0,0,0,0,0,0,0
0,0,0,0,0,0,0,0,0
0,0,0,0,0,0,0,0,0
0,0,0,0,0,0,0,0,0
0,0,0,0,0,0,0,0,0
0,0,0,0,0,0,0,0,0
0,0,0,0,0,0,0,0,0
0,0,0,0,0,0,0,0,0
0,0,0,0,0,0,0,0,0
0,0,0,0,0,0,0,0,0
0,0,0,0,0,0,0,0,0
0,0,0,0,0,0,0,0,0
0,0,0,0,0,0,0,0,0
0,0,0,0,0,0,0,0,0
0,0,0,0,0,0,0,0,0
88357,913,1,257,221,36,2,0,0
205387,1063,1,259,220,39,3,0,0
0,0,0,0,0,0,0,0,0
136322,318,11,12,11,1,2,0,0
123767,771,9,61,53,8,0,1,0
0,0,0,0,0,0,0,0,0
0,0,0,0,0,0,0,0,0
0,0,0,0,0,0,0,0,0
0,0,0,0,0,0,0,0,0
0,0,0,0,0,0,0,0,0
45703,475,3,57,57,0,2,0,0
0,0,0,0,0,0,0,0,0
266809,2346,7,538,536,2,0,1,0
0,0,0,0,0,0,0,0,0
1867,36,2,0,0,0,2,0,0
1867,36,2,0,0,0,2,0,0
76532,908,3,80,76,4,5,1,0
0,0,0,0,0,0,0,0,0
0,0,0,0,0,0,0,0,0
933,5,0,0,0,0,0,0,0
933,5,0,0,0,0,0,0,0
0,0,0,0,0,0,0,0,0
0,0,0,0,0,0,0,0,0
3771,75,0,10,10,0,0,0,0
76532,908,3,80,76,4,5,1,0
0,0,0,0,0,0,0,0,0
0,0,0,0,0,0,0,0,0
49044,804,5,100,98,2,1,0,0
0,0,0,0,0,0,0,0,0
95705,127,0,11,4,7,0,1,0
8911,34,0,2,2,0,0,0,0
15231,35,0,2,2,0,0,0,0
8911,34,0,2,2,0,0,0,0
25955,28,0,1,0,1,0,0,0
25955,28,0,1,0,1,0,0,0
25955,28,0,1,0,1,0,0,0
25955,28,0,1,0,1,0,0,0
0,0,0,0,0,0,0,0,0
0,0,0,0,0,0,0,0,0
60025,369,1,6,4,2,0,0,0
0,0,0,0,0,0,0,0,0
8911,34,0,2,2,0,0,0,0
0,0,0,0,0,0,0,0,0
0,0,0,0,0,0,0,0,0
0,0,0,0,0,0,0,0,0
0,0,0,0,0,0,0,0,0
0,0,0,0,0,0,0,0,0
274547,1109,15,66,64,2,2,1,0
678791,557,0,4,0,4,2,1,1
674183,556,0,4,0,4,2,1,1
0,0,0,0,0,0,0,0,0
0,0,0,0,0,0,0,0,0
62812,35,0,0,0,0,0,1,0
0,0,0,0,0,0,0,0,0
7722,52,2,0,0,0,0,0,0
7722,52,2,0,0,0,0,0,0
0,0,0,0,0,0,0,0,0
0,0,0,0,0,0,0,0,0
0,0,0,0,0,0,0,0,0
0,0,0,0,0,0,0,0,0
0,0,0,0,0,0,0,0,0
0,0,0,0,0,0,0,0,0
0,0,0,0,0,0,0,0,0
0,0,0,0,0,0,0,0,0
3385,41,0,6,0,6,0,0,0
0,0,0,0,0,0,0,0,0
45352,338,3,8,6,2,1,0,0
136596,44,4,1,1,0,2,0,0
4125,11,0,0,0,0,0,0,0
8911,34,0,2,2,0,0,0,0
0,0,0,0,0,0,0,0,0
0,0,0,0,0,0,0,0,0
10765,87,1,10,6,4,3,1,0
5088,89,3,20,16,4,1,1,0
148367,424,2,21,17,4,0,1,0
0,0,0,0,0,0,0,0,0
81363,191,3,12,7,5,5,1,0
0,0,0,0,0,0,0,0,0
0,0,0,0,0,0,0,0,0
20862,141,2,12,10,2,3,1,0
4394,25,0,1,0,1,0,0,0
4394,25,0,1,0,1,0,0,0
0,0,0,0,0,0,0,0,0
0,0,0,0,0,0,0,0,0
0,0,0,0,0,0,0,0,0
49361,583,6,80,69,11,0,1,0
0,0,0,0,0,0,0,0,0
0,0,0,0,0,0,0,0,0
5773,32,0,1,1,0,2,0,0
3713,46,0,0,0,0,0,0,0
0,0,0,0,0,0,0,0,0
0,0,0,0,0,0,0,0,0
0,0,0,0,0,0,0,0,0
0,0,0,0,0,0,0,0,0
0,0,0,0,0,0,0,0,0
0,0,0,0,0,0,0,0,0
0,0,0,0,0,0,0,0,0
0,0,0,0,0,0,0,0,0
0,0,0,0,0,0,0,0,0
673932,557,0,4,4,0,2,1,1
0,0,0,0,0,0,0,0,0
678793,557,0,4,0,4,2,1,1
249749,1530,1,290,243,47,1,1,0
249750,1530,1,290,243,47,1,1,0
0,0,0,0,0,0,0,0,0
0,0,0,0,0,0,0,0,0
0,0,0,0,0,0,0,0,0
88357,913,1,257,221,36,2,0,0
88357,913,1,257,225,32,2,0,0
0,0,0,0,0,0,0,0,0
249750,1530,1,290,243,47,1,1,0
249750,1530,1,290,243,47,1,1,0
0,0,0,0,0,0,0,0,0
0,0,0,0,0,0,0,0,0
2678,43,3,1,0,1,0,0,0
2678,43,3,1,0,1,0,0,0
0,0,0,0,0,0,0,0,0
2678,43,3,1,0,1,0,0,0
0,0,0,0,0,0,0,0,0
2678,43,3,1,0,1,0,0,0
0,0,0,0,0,0,0,0,0
2678,43,3,1,0,1,0,0,0
2678,43,3,1,0,1,0,0,0
2678,43,3,1,0,1,0,0,0
10970,75,0,0,0,0,0,0,0
108959,84,0,4,3,1,0,1,0
15297,50,2,0,0,0,2,0,0
7217,35,2,0,0,0,0,0,0
0,0,0,0,0,0,0,0,0
34415,50,2,0,0,0,2,0,0
0,0,0,0,0,0,0,0,0
0,0,0,0,0,0,0,0,0
7722,52,2,0,0,0,0,0,0
7722,52,2,0,0,0,0,0,0
7722,52,2,0,0,0,0,0,0
7722,52,2,0,0,0,0,0,0
7722,52,2,0,0,0,0,0,0
7722,52,2,0,0,0,0,0,0
7722,52,2,0,0,0,0,0,0
7722,52,2,0,0,0,0,0,0
7722,52,2,0,0,0,0,0,0
7722,52,2,0,0,0,0,0,0
0,0,0,0,0,0,0,0,0
0,0,0,0,0,0,0,0,0
0,0,0,0,0,0,0,0,0
0,0,0,0,0,0,0,0,0
0,0,0,0,0,0,0,0,0
0,0,0,0,0,0,0,0,0
0,0,0,0,0,0,0,0,0
7195,35,2,0,0,0,0,0,0
0,0,0,0,0,0,0,0,0
0,0,0,0,0,0,0,0,0
0,0,0,0,0,0,0,0,0
36627,51,3,0,0,0,2,0,0
74517,289,1,0,0,0,7,0,0
0,0,0,0,0,0,0,0,0
0,0,0,0,0,0,0,0,0
0,0,0,0,0,0,0,0,0
0,0,0,0,0,0,0,0,0
0,0,0,0,0,0,0,0,0
0,0,0,0,0,0,0,0,0
117563,696,8,32,11,21,1,0,0
2934098,265,4,6,6,0,1,1,0
0,0,0,0,0,0,0,0,0
0,0,0,0,0,0,0,0,0
139339,220,3,3,2,1,9,0,0
0,0,0,0,0,0,0,0,0
0,0,0,0,0,0,0,0,0
0,0,0,0,0,0,0,0,0
0,0,0,0,0,0,0,0,0
0,0,0,0,0,0,0,0,0
0,0,0,0,0,0,0,0,0
0,0,0,0,0,0,0,0,0
0,0,0,0,0,0,0,0,0
64591,466,6,73,68,5,1,0,0
127542,365,5,2,0,2,5,0,0
48635,210,2,0,0,0,3,0,0
129864,228,0,16,14,2,1,1,0
45336,180,2,1,0,1,1,0,0
0,0,0,0,0,0,0,0,0
28679,42,3,0,0,0,2,0,0
211760,46,5,0,0,0,0,0,0
205387,1063,1,259,221,38,3,0,0
0,0,0,0,0,0,0,0,0
88805,982,2,194,193,1,2,1,0
0,0,0,0,0,0,0,0,0
58857,900,4,163,1,162,3,1,0
0,0,0,0,0,0,0,0,0
0,0,0,0,0,0,0,0,0
43680,536,3,65,10,55,3,1,0
677589,558,0,4,4,0,2,1,1
0,0,0,0,0,0,0,0,0
124445,491,5,10,8,2,4,1,0
205387,1063,1,259,224,35,3,0,0
88839,915,1,257,220,37,3,0,0
205387,1063,1,259,221,38,3,0,0
88839,915,1,257,220,37,3,0,0
0,0,0,0,0,0,0,0,0
676551,557,0,4,4,0,2,1,1
0,0,0,0,0,0,0,0,0
0,0,0,0,0,0,0,0,0
0,0,0,0,0,0,0,0,0
0,0,0,0,0,0,0,0,0
10453,75,0,0,0,0,0,0,0
0,0,0,0,0,0,0,0,0
0,0,0,0,0,0,0,0,0
0,0,0,0,0,0,0,0,0
0,0,0,0,0,0,0,0,0
0,0,0,0,0,0,0,0,0
0,0,0,0,0,0,0,0,0
172581,243,7,4,2,2,2,0,0
0,0,0,0,0,0,0,0,0
46920,191,2,2,2,0,2,0,0
502083,82,3,0,0,0,1,0,0
0,0,0,0,0,0,0,0,0
0,0,0,0,0,0,0,0,0
0,0,0,0,0,0,0,0,0
0,0,0,0,0,0,0,0,0
47413,203,2,2,2,0,1,0,0
1332172,33,4,0,0,0,0,1,0
0,0,0,0,0,0,0,0,0
0,0,0,0,0,0,0,0,0
0,0,0,0,0,0,0,0,0
0,0,0,0,0,0,0,0,0
0,0,0,0,0,0,0,0,0
0,0,0,0,0,0,0,0,0
0,0,0,0,0,0,0,0,0
0,0,0,0,0,0,0,0,0
7183,103,1,5,0,5,3,1,0
440201,854,0,25,23,2,2,1,0
17959,33,0,2,1,1,0,1,0
0,0,0,0,0,0,0,0,0
676425,543,0,4,4,0,2,1,1
2081,18,0,0,0,0,0,1,0
0,0,0,0,0,0,0,0,0
0,0,0,0,0,0,0,0,0
0,0,0,0,0,0,0,0,0
6643,117,1,3,1,2,0,1,0
0,0,0,0,0,0,0,0,0
0,0,0,0,0,0,0,0,0
0,0,0,0,0,0,0,0,0
0,0,0,0,0,0,0,0,0
0,0,0,0,0,0,0,0,0
42907,475,3,7,7,0,0,0,0
22894,37,0,2,1,1,0,1,0
0,0,0,0,0,0,0,0,0
0,0,0,0,0,0,0,0,0
0,0,0,0,0,0,0,0,0
0,0,0,0,0,0,0,0,0
0,0,0,0,0,0,0,0,0
0,0,0,0,0,0,0,0,0
0,0,0,0,0,0,0,0,0
0,0,0,0,0,0,0,0,0
0,0,0,0,0,0,0,0,0
0,0,0,0,0,0,0,0,0
0,0,0,0,0,0,0,0,0
0,0,0,0,0,0,0,0,0
173208,1473,6,164,154,10,1,0,0
0,0,0,0,0,0,0,0,0
0,0,0,0,0,0,0,0,0
0,0,0,0,0,0,0,0,0
0,0,0,0,0,0,0,0,0
672587,556,0,4,4,0,2,1,1
12377,100,4,6,6,0,0,0,0
0,0,0,0,0,0,0,0,0
18189,220,2,10,10,0,0,1,0
0,0,0,0,0,0,0,0,0
0,0,0,0,0,0,0,0,0
87513,2049,2,605,605,0,0,1,0
0,0,0,0,0,0,0,0,0
0,0,0,0,0,0,0,0,0
17476,127,1,22,17,5,2,1,0
1781,23,0,0,0,0,0,0,0
38688,143,3,7,6,1,0,0,0
0,0,0,0,0,0,0,0,0
578950,60,4,3,3,0,2,1,0
0,0,0,0,0,0,0,0,0
7397,48,4,2,2,0,0,0,0
9715,213,0,52,51,1,0,1,0
37966,242,2,0,0,0,4,0,0
37160,164,3,8,4,4,9,1,0
674767,556,0,4,4,0,2,1,1
87074,497,2,21,21,0,1,0,0
54494,58,1,1,1,0,6,0,0
0,0,0,0,0,0,0,0,0
0,0,0,0,0,0,0,0,0
0,0,0,0,0,0,0,0,0
0,0,0,0,0,0,0,0,0
419302,1389,12,31,14,17,30,1,0
0,0,0,0,0,0,0,0,0
221424,725,4,148,143,5,20,1,0
0,0,0,0,0,0,0,0,0
81211,193,3,13,8,5,5,1,0
0,0,0,0,0,0,0,0,0
0,0,0,0,0,0,0,0,0
0,0,0,0,0,0,0,0,0
0,0,0,0,0,0,0,0,0
0,0,0,0,0,0,0,0,0
0,0,0,0,0,0,0,0,0
7489,49,0,3,0,3,1,0,1
0,0,0,0,0,0,0,0,0
0,0,0,0,0,0,0,0,0
0,0,0,0,0,0,0,0,0
0,0,0,0,0,0,0,0,0
0,0,0,0,0,0,0,0,0
0,0,0,0,0,0,0,0,0
0,0,0,0,0,0,0,0,0
0,0,0,0,0,0,0,0,0
81211,193,3,13,8,5,5,1,0
676156,556,0,4,4,0,2,1,1
676663,542,0,4,4,0,2,1,1
0,0,0,0,0,0,0,0,0
0,0,0,0,0,0,0,0,0
0,0,0,0,0,0,0,0,0
0,0,0,0,0,0,0,0,0
0,0,0,0,0,0,0,0,0
0,0,0,0,0,0,0,0,0
0,0,0,0,0,0,0,0,0
0,0,0,0,0,0,0,0,0
151079,404,6,26,24,2,1,1,0
48240,220,2,1,1,0,1,0,0
0,0,0,0,0,0,0,0,0
0,0,0,0,0,0,0,0,0
0,0,0,0,0,0,0,0,0
0,0,0,0,0,0,0,0,0
0,0,0,0,0,0,0,0,0
0,0,0,0,0,0,0,0,0
1154803,102,3,6,4,2,0,1,0
52768,92,3,8,6,2,0,0,0
33207,155,3,8,4,4,9,1,0
701043,553,0,5,0,5,2,1,1
678240,557,0,4,0,4,2,1,1
126103,797,10,82,71,11,1,1,0
8583,63,1,2,2,0,0,0,1
0,0,0,0,0,0,0,0,0
12423,181,9,20,18,2,3,1,0
232705,343,0,17,4,13,0,1,0
230642,344,0,17,4,13,0,1,0
0,0,0,0,0,0,0,0,0
155096,1211,10,56,48,8,2,1,0
176474,1475,9,222,221,1,3,1,0
0,0,0,0,0,0,0,0,0
0,0,0,0,0,0,0,0,0
0,0,0,0,0,0,0,0,0
0,0,0,0,0,0,0,0,0
933,5,0,0,0,0,0,0,0
3447,6,0,0,0,0,0,0,0
3448,6,0,0,0,0,0,0,0
3448,6,0,0,0,0,0,0,0
3448,6,0,0,0,0,0,0,0
3448,6,0,0,0,0,0,0,0
3448,6,0,0,0,0,0,0,0
0,0,0,0,0,0,0,0,0
172,4,0,0,0,0,0,0,1
0,0,0,0,0,0,0,0,0
0,0,0,0,0,0,0,0,0
0,0,0,0,0,0,0,0,0
0,0,0,0,0,0,0,0,0
0,0,0,0,0,0,0,0,0
8645,25,0,0,0,0,2,0,0
35662,158,3,8,4,4,10,1,0
304917,1040,0,88,48,40,0,0,0
304916,1040,0,88,79,9,0,0,0
13408,173,5,24,0,24,0,1,0
123922,266,6,55,55,0,3,1,0
687698,942,3,59,34,25,40,1,0
0,0,0,0,0,0,0,0,0
50418,175,1,7,4,3,0,0,0
684866,558,0,4,0,4,2,1,1
3519,36,2,0,0,0,0,0,0
3445,10,0,1,0,1,0,1,0
13377,50,2,0,0,0,2,0,0
0,0,0,0,0,0,0,0,0
0,0,0,0,0,0,0,0,0
0,0,0,0,0,0,0,0,0
0,0,0,0,0,0,0,0,0
0,0,0,0,0,0,0,0,0
0,0,0,0,0,0,0,0,0
22934,63,0,3,0,3,3,1,0
23474,313,0,54,48,6,0,1,0
0,0,0,0,0,0,0,0,0
0,0,0,0,0,0,0,0,0
66605,56,0,0,0,0,0,1,0
66666,56,0,0,0,0,0,1,0
0,0,0,0,0,0,0,0,0
0,0,0,0,0,0,0,0,0
0,0,0,0,0,0,0,0,0
0,0,0,0,0,0,0,0,0
0,0,0,0,0,0,0,0,0
0,0,0,0,0,0,0,0,0
2630,40,1,2,1,1,0,0,0
676913,556,0,4,4,0,2,1,1
1318,30,2,0,0,0,0,0,0
1452,32,2,0,0,0,0,0,0
2663,34,2,0,0,0,0,0,0
0,0,0,0,0,0,0,0,0
0,0,0,0,0,0,0,0,0
0,0,0,0,0,0,0,0,0
0,0,0,0,0,0,0,0,0
0,0,0,0,0,0,0,0,0
70068,112,2,5,3,2,0,1,0
57363,572,5,23,15,8,0,1,0
0,0,0,0,0,0,0,0,0
23232,525,4,63,63,0,0,1,0
0,0,0,0,0,0,0,0,0
0,0,0,0,0,0,0,0,0
97923,41,2,0,0,0,1,0,0
0,0,0,0,0,0,0,0,0
933,5,0,0,0,0,0,0,0
933,5,0,0,0,0,0,0,0
55757,481,2,105,21,84,6,1,0
0,0,0,0,0,0,0,0,0
88805,982,2,194,193,1,2,1,0
44981,313,7,21,14,7,3,0,0
46439,67,3,0,0,0,0,1,0
15005,54,1,1,1,0,0,0,0
3457,6,0,0,0,0,0,0,0
3457,6,0,0,0,0,0,0,0
46565,376,5,81,29,52,1,1,0
0,0,0,0,0,0,0,0,0
50050,136,0,7,1,6,0,0,0
0,0,0,0,0,0,0,0,0
5550,50,0,1,0,1,0,0,0
0,0,0,0,0,0,0,0,0
0,0,0,0,0,0,0,0,0
0,0,0,0,0,0,0,0,0
2790,26,2,0,0,0,0,0,0
0,0,0,0,0,0,0,0,0
152992,290,4,10,9,1,1,1,0
153002,290,4,10,9,1,1,1,0
70274,835,7,186,183,3,6,0,0
5410,85,1,0,0,0,0,0,0
7109,55,0,2,2,0,0,0,0
7078,55,0,2,2,0,0,0,0
9378,49,5,0,0,0,3,1,0
0,0,0,0,0,0,0,0,0
0,0,0,0,0,0,0,0,0
3463,6,0,0,0,0,0,0,0
3463,6,0,0,0,0,0,0,0
0,0,0,0,0,0,0,0,0
31119,98,0,3,0,3,0,0,0
113979,776,16,30,4,26,3,1,0
313439,2300,10,308,287,21,7,0,0
675304,556,0,4,4,0,2,1,1
0,0,0,0,0,0,0,0,0
122640,145,2,2,0,2,8,0,0
0,0,0,0,0,0,0,0,0
1107944,7420,18,1924,1920,4,8,1,0
97404,897,11,129,126,3,10,1,0
0,0,0,0,0,0,0,0,0
0,0,0,0,0,0,0,0,0
12160,50,3,0,0,0,2,0,0
396050,4307,5,327,183,144,0,1,0
31659,86,2,0,0,0,1,0,0
4404,73,0,2,1,1,0,0,0
4404,73,0,2,1,1,0,0,0
4404,73,0,2,1,1,0,0,0
4404,73,0,2,1,1,0,0,0
4410,73,0,2,1,1,0,0,0
4410,73,0,2,1,1,0,0,0
4410,73,0,2,1,1,0,0,0
4410,73,0,2,1,1,0,0,0
4410,73,0,2,1,1,0,0,0
4410,73,0,2,1,1,0,0,0
4410,73,0,2,1,1,0,0,0
4410,73,0,2,1,1,0,0,0
4404,73,0,2,1,1,0,0,0
4404,73,0,2,1,1,0,0,0
0,0,0,0,0,0,0,0,0
4404,73,0,2,1,1,0,0,0
4404,73,0,2,1,1,0,0,0
4404,73,0,2,1,1,0,0,0
8911,34,0,2,2,0,0,0,0
0,0,0,0,0,0,0,0,0
0,0,0,0,0,0,0,0,0
681857,543,0,4,0,4,2,1,1
87146,597,9,29,17,12,1,0,0
55208,288,1,5,5,0,0,0,0
0,0,0,0,0,0,0,0,0
0,0,0,0,0,0,0,0,0
0,0,0,0,0,0,0,0,0
0,0,0,0,0,0,0,0,0
0,0,0,0,0,0,0,0,0
88095,2013,5,593,592,1,69,1,0
0,0,0,0,0,0,0,0,0
0,0,0,0,0,0,0,0,0
106474,432,3,138,6,132,4,0,1
0,0,0,0,0,0,0,0,0
10449,29,0,0,0,0,0,0,0
0,0,0,0,0,0,0,0,0
0,0,0,0,0,0,0,0,0
0,0,0,0,0,0,0,0,0
0,0,0,0,0,0,0,0,0
0,0,0,0,0,0,0,0,0
0,0,0,0,0,0,0,0,0
0,0,0,0,0,0,0,0,0
0,0,0,0,0,0,0,0,0
0,0,0,0,0,0,0,0,0
0,0,0,0,0,0,0,0,0
0,0,0,0,0,0,0,0,0
0,0,0,0,0,0,0,0,0
0,0,0,0,0,0,0,0,0
0,0,0,0,0,0,0,0,0
0,0,0,0,0,0,0,0,0
0,0,0,0,0,0,0,0,0
0,0,0,0,0,0,0,0,0
14888,43,4,0,0,0,0,0,0
73606,1126,8,40,34,6,21,1,0
0,0,0,0,0,0,0,0,0
5983,54,1,0,0,0,0,0,0
0,0,0,0,0,0,0,0,0
0,0,0,0,0,0,0,0,0
1537,16,0,0,0,0,0,0,0
86619,183,8,21,14,7,6,1,0
0,0,0,0,0,0,0,0,0
0,0,0,0,0,0,0,0,0
0,0,0,0,0,0,0,0,0
0,0,0,0,0,0,0,0,0
0,0,0,0,0,0,0,0,0
0,0,0,0,0,0,0,0,0
0,0,0,0,0,0,0,0,0
0,0,0,0,0,0,0,0,0
0,0,0,0,0,0,0,0,0
0,0,0,0,0,0,0,0,0
0,0,0,0,0,0,0,0,0
0,0,0,0,0,0,0,0,0
0,0,0,0,0,0,0,0,0
0,0,0,0,0,0,0,0,0
0,0,0,0,0,0,0,0,0
0,0,0,0,0,0,0,0,0
4411,57,2,3,3,0,0,0,0
0,0,0,0,0,0,0,0,0
60843,69,1,7,5,2,0,0,0
9376,49,5,0,0,0,3,1,0
0,0,0,0,0,0,0,0,0
0,0,0,0,0,0,0,0,0
0,0,0,0,0,0,0,0,0
0,0,0,0,0,0,0,0,0
0,0,0,0,0,0,0,0,0
0,0,0,0,0,0,0,0,0
205387,1063,1,259,221,38,3,0,0
674912,556,0,4,4,0,2,1,1
0,0,0,0,0,0,0,0,0
0,0,0,0,0,0,0,0,0
0,0,0,0,0,0,0,0,0
0,0,0,0,0,0,0,0,0
653,15,0,0,0,0,0,0,0
653,15,0,0,0,0,0,0,0
0,0,0,0,0,0,0,0,0
0,0,0,0,0,0,0,0,0
6135,76,2,5,5,0,0,1,0
0,0,0,0,0,0,0,0,0
0,0,0,0,0,0,0,0,0
0,0,0,0,0,0,0,0,0
0,0,0,0,0,0,0,0,0
59857,414,3,137,6,131,5,0,1
0,0,0,0,0,0,0,0,0
0,0,0,0,0,0,0,0,0
0,0,0,0,0,0,0,0,0
15957,224,5,35,34,1,0,1,0
0,0,0,0,0,0,0,0,0
0,0,0,0,0,0,0,0,0
114433,455,5,54,34,20,6,0,0
1131,20,1,0,0,0,0,0,0
0,0,0,0,0,0,0,0,0
0,0,0,0,0,0,0,0,0
0,0,0,0,0,0,0,0,0
0,0,0,0,0,0,0,0,0
0,0,0,0,0,0,0,0,0
0,0,0,0,0,0,0,0,0
0,0,0,0,0,0,0,0,0
0,0,0,0,0,0,0,0,0
0,0,0,0,0,0,0,0,0
168435,726,0,68,4,64,0,1,1
92288,70,1,9,9,0,6,0,0
0,0,0,0,0,0,0,0,0
0,0,0,0,0,0,0,0,0
0,0,0,0,0,0,0,0,0
0,0,0,0,0,0,0,0,0
933,5,0,0,0,0,0,0,0
933,5,0,0,0,0,0,0,0
0,0,0,0,0,0,0,0,0
0,0,0,0,0,0,0,0,0
0,0,0,0,0,0,0,0,0
137014,69,3,2,1,1,2,1,0
161342,218,4,26,18,8,2,1,0
0,0,0,0,0,0,0,0,0
0,0,0,0,0,0,0,0,0
205387,1063,1,259,220,39,3,0,0
88357,913,1,257,220,37,2,0,0
0,0,0,0,0,0,0,0,0
0,0,0,0,0,0,0,0,0
304916,1040,0,88,48,40,0,0,0
0,0,0,0,0,0,0,0,0
494382,1768,0,16,8,8,12,0,0
0,0,0,0,0,0,0,0,0
0,0,0,0,0,0,0,0,0
0,0,0,0,0,0,0,0,0
0,0,0,0,0,0,0,0,0
0,0,0,0,0,0,0,0,0
0,0,0,0,0,0,0,0,0
304916,1040,0,88,48,40,0,0,0
304916,1040,0,88,79,9,0,0,0
0,0,0,0,0,0,0,0,0
0,0,0,0,0,0,0,0,0
0,0,0,0,0,0,0,0,0
3777,44,0,2,0,2,1,0,0
12002,47,3,5,5,0,1,0,0
0,0,0,0,0,0,0,0,0
0,0,0,0,0,0,0,0,0
0,0,0,0,0,0,0,0,0
0,0,0,0,0,0,0,0,0
0,0,0,0,0,0,0,0,0
0,0,0,0,0,0,0,0,0
0,0,0,0,0,0,0,0,0
35909,49,1,1,0,1,0,1,0
35909,49,1,1,0,1,0,1,0
0,0,0,0,0,0,0,0,0
61696,605,3,130,125,5,2,1,0
50044,69,5,2,2,0,0,0,0
50085,69,5,2,1,1,0,0,0
685967,1109,2,265,258,7,14,1,0
0,0,0,0,0,0,0,0,0
0,0,0,0,0,0,0,0,0
0,0,0,0,0,0,0,0,0
0,0,0,0,0,0,0,0,0
0,0,0,0,0,0,0,0,0
0,0,0,0,0,0,0,0,0
0,0,0,0,0,0,0,0,0
0,0,0,0,0,0,0,0,0
0,0,0,0,0,0,0,0,0
0,0,0,0,0,0,0,0,0
1331153,3248,5,32,17,15,0,1,0
0,0,0,0,0,0,0,0,0
15791,79,8,4,4,0,2,1,0
37092,51,5,1,1,0,1,1,0
0,0,0,0,0,0,0,0,0
0,0,0,0,0,0,0,0,0
0,0,0,0,0,0,0,0,0
0,0,0,0,0,0,0,0,0
0,0,0,0,0,0,0,0,0
0,0,0,0,0,0,0,0,0
0,0,0,0,0,0,0,0,0
0,0,0,0,0,0,0,0,0
0,0,0,0,0,0,0,0,0
0,0,0,0,0,0,0,0,0
0,0,0,0,0,0,0,0,0
0,0,0,0,0,0,0,0,0
0,0,0,0,0,0,0,0,0
0,0,0,0,0,0,0,0,0
52253,269,1,5,5,0,0,0,0
0,0,0,0,0,0,0,0,0
0,0,0,0,0,0,0,0,0
0,0,0,0,0,0,0,0,0
0,0,0,0,0,0,0,0,0
0,0,0,0,0,0,0,0,0
16148,89,3,7,3,4,0,1,0
0,0,0,0,0,0,0,0,0
0,0,0,0,0,0,0,0,0
0,0,0,0,0,0,0,0,0
0,0,0,0,0,0,0,0,0
0,0,0,0,0,0,0,0,0
0,0,0,0,0,0,0,0,0
0,0,0,0,0,0,0,0,0
0,0,0,0,0,0,0,0,0
0,0,0,0,0,0,0,0,0
0,0,0,0,0,0,0,0,0
17447,59,1,14,11,3,0,0,0
17431,59,1,14,11,3,0,0,0
0,0,0,0,0,0,0,0,0
0,0,0,0,0,0,0,0,0
0,0,0,0,0,0,0,0,0
0,0,0,0,0,0,0,0,0
0,0,0,0,0,0,0,0,0
0,0,0,0,0,0,0,0,0
0,0,0,0,0,0,0,0,0
0,0,0,0,0,0,0,0,0
0,0,0,0,0,0,0,0,0
0,0,0,0,0,0,0,0,0
46506,191,2,2,1,1,1,0,0
0,0,0,0,0,0,0,0,0
0,0,0,0,0,0,0,0,0
32410,85,5,1,1,0,8,1,0
42402,82,5,0,0,0,0,0,0
0,0,0,0,0,0,0,0,0
0,0,0,0,0,0,0,0,0
0,0,0,0,0,0,0,0,0
0,0,0,0,0,0,0,0,0
0,0,0,0,0,0,0,0,0
0,0,0,0,0,0,0,0,0
0,0,0,0,0,0,0,0,0
124760,905,8,85,80,5,4,1,0
0,0,0,0,0,0,0,0,0
0,0,0,0,0,0,0,0,0
9428,102,1,2,0,2,0,0,0
703237,539,0,5,0,5,2,1,1
676105,555,0,4,0,4,2,1,1
0,0,0,0,0,0,0,0,0
0,0,0,0,0,0,0,0,0
122023,76,2,1,1,0,0,1,0
0,0,0,0,0,0,0,0,0
1192700,227,3,50,50,0,1,1,0
0,0,0,0,0,0,0,0,0
0,0,0,0,0,0,0,0,0
0,0,0,0,0,0,0,0,0
0,0,0,0,0,0,0,0,0
0,0,0,0,0,0,0,0,0
0,0,0,0,0,0,0,0,0
0,0,0,0,0,0,0,0,0
0,0,0,0,0,0,0,0,0
0,0,0,0,0,0,0,0,0
1819261,53,2,1,1,0,0,1,0
0,0,0,0,0,0,0,0,0
0,0,0,0,0,0,0,0,0
12079,57,0,0,0,0,0,0,0
0,0,0,0,0,0,0,0,0
0,0,0,0,0,0,0,0,0
0,0,0,0,0,0,0,0,0
0,0,0,0,0,0,0,0,0
0,0,0,0,0,0,0,0,0
341234,176,4,5,0,5,0,1,0
436885,52,2,1,1,0,0,1,0
0,0,0,0,0,0,0,0,0
0,0,0,0,0,0,0,0,0
0,0,0,0,0,0,0,0,0
0,0,0,0,0,0,0,0,0
48243,211,2,2,1,1,1,0,0
27839,155,5,5,2,3,1,0,0
674228,543,0,4,4,0,2,1,1
0,0,0,0,0,0,0,0,0
0,0,0,0,0,0,0,0,0
79761,69,2,5,4,1,2,1,0
218125,1076,8,123,120,3,4,1,0
29792,175,5,7,1,6,1,0,0
0,0,0,0,0,0,0,0,0
0,0,0,0,0,0,0,0,0
0,0,0,0,0,0,0,0,0
0,0,0,0,0,0,0,0,0
0,0,0,0,0,0,0,0,0
0,0,0,0,0,0,0,0,0
3292,37,0,1,1,0,0,0,0
3292,37,0,1,1,0,0,0,0
0,0,0,0,0,0,0,0,0
0,0,0,0,0,0,0,0,0
0,0,0,0,0,0,0,0,0
0,0,0,0,0,0,0,0,0
0,0,0,0,0,0,0,0,0
0,0,0,0,0,0,0,0,0
0,0,0,0,0,0,0,0,0
0,0,0,0,0,0,0,0,0
0,0,0,0,0,0,0,0,0
0,0,0,0,0,0,0,0,0
0,0,0,0,0,0,0,0,0
0,0,0,0,0,0,0,0,0
0,0,0,0,0,0,0,0,0
0,0,0,0,0,0,0,0,0
0,0,0,0,0,0,0,0,0
0,0,0,0,0,0,0,0,0
0,0,0,0,0,0,0,0,0
0,0,0,0,0,0,0,0,0
0,0,0,0,0,0,0,0,0
0,0,0,0,0,0,0,0,0
0,0,0,0,0,0,0,0,0
0,0,0,0,0,0,0,0,0
0,0,0,0,0,0,0,0,0
26216,35,4,0,0,0,3,0,0
26111,35,4,0,0,0,3,0,0
88792,60,0,5,5,0,0,1,0
1041712,183,1,17,14,3,0,1,0
0,0,0,0,0,0,0,0,0
118438,90,2,3,2,1,3,1,0
65394,245,0,46,24,22,0,1,1
65395,245,0,46,24,22,0,1,1
0,0,0,0,0,0,0,0,0
0,0,0,0,0,0,0,0,0
0,0,0,0,0,0,0,0,0
0,0,0,0,0,0,0,0,0
0,0,0,0,0,0,0,0,0
0,0,0,0,0,0,0,0,0
0,0,0,0,0,0,0,0,0
0,0,0,0,0,0,0,0,0
0,0,0,0,0,0,0,0,0
0,0,0,0,0,0,0,0,0
0,0,0,0,0,0,0,0,0
0,0,0,0,0,0,0,0,0
0,0,0,0,0,0,0,0,0
0,0,0,0,0,0,0,0,0
0,0,0,0,0,0,0,0,0
0,0,0,0,0,0,0,0,0
0,0,0,0,0,0,0,0,0
0,0,0,0,0,0,0,0,0
0,0,0,0,0,0,0,0,0
0,0,0,0,0,0,0,0,0
0,0,0,0,0,0,0,0,0
0,0,0,0,0,0,0,0,0
0,0,0,0,0,0,0,0,0
0,0,0,0,0,0,0,0,0
0,0,0,0,0,0,0,0,0
0,0,0,0,0,0,0,0,0
0,0,0,0,0,0,0,0,0
0,0,0,0,0,0,0,0,0
0,0,0,0,0,0,0,0,0
0,0,0,0,0,0,0,0,0
55757,481,2,105,21,84,6,1,0
0,0,0,0,0,0,0,0,0
0,0,0,0,0,0,0,0,0
0,0,0,0,0,0,0,0,0
0,0,0,0,0,0,0,0,0
0,0,0,0,0,0,0,0,0
13130,29,1,0,0,0,3,0,0
0,0,0,0,0,0,0,0,0
0,0,0,0,0,0,0,0,0
0,0,0,0,0,0,0,0,0
0,0,0,0,0,0,0,0,0
0,0,0,0,0,0,0,0,0
0,0,0,0,0,0,0,0,0
196104,2336,4,427,6,421,4,1,0
0,0,0,0,0,0,0,0,0
0,0,0,0,0,0,0,0,0
0,0,0,0,0,0,0,0,0
0,0,0,0,0,0,0,0,0
0,0,0,0,0,0,0,0,0
0,0,0,0,0,0,0,0,0
0,0,0,0,0,0,0,0,0
0,0,0,0,0,0,0,0,0
8316,123,1,3,1,2,0,1,0
8316,123,1,3,1,2,0,1,0
5871,43,3,4,4,0,0,0,0
0,0,0,0,0,0,0,0,0
0,0,0,0,0,0,0,0,0
0,0,0,0,0,0,0,0,0
0,0,0,0,0,0,0,0,0
0,0,0,0,0,0,0,0,0
0,0,0,0,0,0,0,0,0
0,0,0,0,0,0,0,0,0
0,0,0,0,0,0,0,0,0
0,0,0,0,0,0,0,0,0
0,0,0,0,0,0,0,0,0
778,15,0,2,0,2,0,0,0
0,0,0,0,0,0,0,0,0
35714,171,6,4,1,3,1,0,0
0,0,0,0,0,0,0,0,0
0,0,0,0,0,0,0,0,0
0,0,0,0,0,0,0,0,0
0,0,0,0,0,0,0,0,0
0,0,0,0,0,0,0,0,0
0,0,0,0,0,0,0,0,0
0,0,0,0,0,0,0,0,0
0,0,0,0,0,0,0,0,0
0,0,0,0,0,0,0,0,0
0,0,0,0,0,0,0,0,0
0,0,0,0,0,0,0,0,0
3385,41,0,6,0,6,0,0,0
0,0,0,0,0,0,0,0,0
0,0,0,0,0,0,0,0,0
0,0,0,0,0,0,0,0,0
5612,39,1,0,0,0,1,0,0
5612,39,1,0,0,0,1,0,0
0,0,0,0,0,0,0,0,0
0,0,0,0,0,0,0,0,0
0,0,0,0,0,0,0,0,0
0,0,0,0,0,0,0,0,0
0,0,0,0,0,0,0,0,0
0,0,0,0,0,0,0,0,0
24239,426,3,87,85,2,1,1,0
0,0,0,0,0,0,0,0,0
0,0,0,0,0,0,0,0,0
45504,440,2,19,8,11,0,1,0
0,0,0,0,0,0,0,0,0
0,0,0,0,0,0,0,0,0
0,0,0,0,0,0,0,0,0
42402,82,5,0,0,0,0,0,0
0,0,0,0,0,0,0,0,0
0,0,0,0,0,0,0,0,0
0,0,0,0,0,0,0,0,0
677096,557,0,4,4,0,2,1,1
0,0,0,0,0,0,0,0,0
127626,364,5,1,1,0,5,0,0
0,0,0,0,0,0,0,0,0
3385,41,0,6,0,6,0,0,0
0,0,0,0,0,0,0,0,0
0,0,0,0,0,0,0,0,0
0,0,0,0,0,0,0,0,0
0,0,0,0,0,0,0,0,0
0,0,0,0,0,0,0,0,0
0,0,0,0,0,0,0,0,0
0,0,0,0,0,0,0,0,0
562057,434,5,21,20,1,0,1,0
0,0,0,0,0,0,0,0,0
0,0,0,0,0,0,0,0,0
42257,463,2,66,3,63,2,0,0
0,0,0,0,0,0,0,0,0
0,0,0,0,0,0,0,0,0
0,0,0,0,0,0,0,0,0
0,0,0,0,0,0,0,0,0
0,0,0,0,0,0,0,0,0
56726,290,1,6,4,2,0,0,0
0,0,0,0,0,0,0,0,0
0,0,0,0,0,0,0,0,0
250306,179,4,26,18,8,2,1,0
0,0,0,0,0,0,0,0,0
0,0,0,0,0,0,0,0,0
0,0,0,0,0,0,0,0,0
0,0,0,0,0,0,0,0,0
0,0,0,0,0,0,0,0,0
0,0,0,0,0,0,0,0,0
0,0,0,0,0,0,0,0,0
0,0,0,0,0,0,0,0,0
0,0,0,0,0,0,0,0,0
0,0,0,0,0,0,0,0,0
32219,44,1,0,0,0,0,0,0
39072,380,3,33,18,15,4,1,0
39072,380,3,33,24,9,4,1,0
0,0,0,0,0,0,0,0,0
0,0,0,0,0,0,0,0,0
933,5,0,0,0,0,0,0,0
933,5,0,0,0,0,0,0,0
0,0,0,0,0,0,0,0,0
0,0,0,0,0,0,0,0,0
0,0,0,0,0,0,0,0,0
0,0,0,0,0,0,0,0,0
0,0,0,0,0,0,0,0,0
0,0,0,0,0,0,0,0,0
0,0,0,0,0,0,0,0,0
10340,69,0,1,1,0,0,0,0
10340,69,0,1,1,0,0,0,0
0,0,0,0,0,0,0,0,0
22601,34,0,1,1,0,0,1,0
0,0,0,0,0,0,0,0,0
0,0,0,0,0,0,0,0,0
0,0,0,0,0,0,0,0,0
0,0,0,0,0,0,0,0,0
0,0,0,0,0,0,0,0,0
0,0,0,0,0,0,0,0,0
0,0,0,0,0,0,0,0,0
0,0,0,0,0,0,0,0,0
0,0,0,0,0,0,0,0,0
0,0,0,0,0,0,0,0,0
0,0,0,0,0,0,0,0,0
0,0,0,0,0,0,0,0,0
0,0,0,0,0,0,0,0,0
0,0,0,0,0,0,0,0,0
0,0,0,0,0,0,0,0,0
0,0,0,0,0,0,0,0,0
0,0,0,0,0,0,0,0,0
2318,49,0,1,1,0,0,0,0
2318,49,0,1,1,0,0,0,0
39075,380,3,33,18,15,4,1,0
39072,380,3,33,24,9,4,1,0
0,0,0,0,0,0,0,0,0
0,0,0,0,0,0,0,0,0
0,0,0,0,0,0,0,0,0
0,0,0,0,0,0,0,0,0
0,0,0,0,0,0,0,0,0
0,0,0,0,0,0,0,0,0
0,0,0,0,0,0,0,0,0
0,0,0,0,0,0,0,0,0
0,0,0,0,0,0,0,0,0
0,0,0,0,0,0,0,0,0
20385,145,3,8,3,5,2,0,0
0,0,0,0,0,0,0,0,0
0,0,0,0,0,0,0,0,0
20385,145,3,8,3,5,2,0,0
20385,145,3,8,3,5,2,0,0
0,0,0,0,0,0,0,0,0
0,0,0,0,0,0,0,0,0
0,0,0,0,0,0,0,0,0
0,0,0,0,0,0,0,0,0
0,0,0,0,0,0,0,0,0
0,0,0,0,0,0,0,0,0
1017951,864,0,244,239,5,0,1,0
0,0,0,0,0,0,0,0,0
0,0,0,0,0,0,0,0,0
0,0,0,0,0,0,0,0,0
199767,55,6,1,1,0,0,0,0
779472,671,1,14,14,0,0,1,0
0,0,0,0,0,0,0,0,0
0,0,0,0,0,0,0,0,0
0,0,0,0,0,0,0,0,0
250306,179,4,26,18,8,2,1,0
656794,1119,5,298,296,2,11,1,0
0,0,0,0,0,0,0,0,0
0,0,0,0,0,0,0,0,0
0,0,0,0,0,0,0,0,0
0,0,0,0,0,0,0,0,0
0,0,0,0,0,0,0,0,0
0,0,0,0,0,0,0,0,0
16152,35,0,5,1,4,0,0,0
0,0,0,0,0,0,0,0,0
0,0,0,0,0,0,0,0,0
0,0,0,0,0,0,0,0,0
0,0,0,0,0,0,0,0,0
0,0,0,0,0,0,0,0,0
0,0,0,0,0,0,0,0,0
0,0,0,0,0,0,0,0,0
0,0,0,0,0,0,0,0,0
0,0,0,0,0,0,0,0,0
0,0,0,0,0,0,0,0,0
0,0,0,0,0,0,0,0,0
0,0,0,0,0,0,0,0,0
0,0,0,0,0,0,0,0,0
0,0,0,0,0,0,0,0,0
0,0,0,0,0,0,0,0,0
0,0,0,0,0,0,0,0,0
0,0,0,0,0,0,0,0,0
0,0,0,0,0,0,0,0,0
0,0,0,0,0,0,0,0,0
0,0,0,0,0,0,0,0,0
72595,139,2,2,2,0,4,0,0
0,0,0,0,0,0,0,0,0
0,0,0,0,0,0,0,0,0
0,0,0,0,0,0,0,0,0
13378,26,0,1,0,1,0,0,0
13378,26,0,1,0,1,0,0,0
0,0,0,0,0,0,0,0,0
92467,1041,2,60,33,27,2,1,0
28595,45,0,4,1,3,0,0,0
0,0,0,0,0,0,0,0,0
0,0,0,0,0,0,0,0,0
0,0,0,0,0,0,0,0,0
9641,62,0,0,0,0,0,0,0
0,0,0,0,0,0,0,0,0
0,0,0,0,0,0,0,0,0
105650,733,12,31,27,4,3,1,0
0,0,0,0,0,0,0,0,0
408926,98,7,0,0,0,3,0,0
0,0,0,0,0,0,0,0,0
0,0,0,0,0,0,0,0,0
0,0,0,0,0,0,0,0,0
21198,214,4,22,19,3,1,0,0
21198,214,4,22,19,3,1,0,0
0,0,0,0,0,0,0,0,0
0,0,0,0,0,0,0,0,0
0,0,0,0,0,0,0,0,0
13101,150,1,4,0,4,0,1,0
54242,486,5,21,13,8,0,1,0
0,0,0,0,0,0,0,0,0
0,0,0,0,0,0,0,0,0
0,0,0,0,0,0,0,0,0
0,0,0,0,0,0,0,0,0
53257,274,1,25,5,20,18,1,0
0,0,0,0,0,0,0,0,0
0,0,0,0,0,0,0,0,0
1555,27,1,7,2,5,0,1,0
394493,3101,9,684,679,5,4,1,0
88484,474,10,77,54,23,0,0,0
57609,612,6,130,129,1,6,1,0
0,0,0,0,0,0,0,0,0
27321,146,6,6,3,3,1,0,0
5333,55,1,0,0,0,1,0,0
5333,55,1,0,0,0,1,0,0
0,0,0,0,0,0,0,0,0
0,0,0,0,0,0,0,0,0
0,0,0,0,0,0,0,0,0
0,0,0,0,0,0,0,0,0
0,0,0,0,0,0,0,0,0
0,0,0,0,0,0,0,0,0
0,0,0,0,0,0,0,0,0
0,0,0,0,0,0,0,0,0
0,0,0,0,0,0,0,0,0
0,0,0,0,0,0,0,0,0
0,0,0,0,0,0,0,0,0
0,0,0,0,0,0,0,0,0
0,0,0,0,0,0,0,0,0
120552,924,10,88,71,17,3,1,0
0,0,0,0,0,0,0,0,0
0,0,0,0,0,0,0,0,0
0,0,0,0,0,0,0,0,0
0,0,0,0,0,0,0,0,0
0,0,0,0,0,0,0,0,0
0,0,0,0,0,0,0,0,0
0,0,0,0,0,0,0,0,0
36407,309,8,26,23,3,9,1,1
0,0,0,0,0,0,0,0,0
0,0,0,0,0,0,0,0,0
0,0,0,0,0,0,0,0,0
0,0,0,0,0,0,0,0,0
28452,152,5,11,7,4,0,1,0
0,0,0,0,0,0,0,0,0
25914,99,3,3,3,0,1,0,0
6334,74,0,4,1,3,0,0,0
0,0,0,0,0,0,0,0,0
0,0,0,0,0,0,0,0,0
0,0,0,0,0,0,0,0,0
0,0,0,0,0,0,0,0,0
0,0,0,0,0,0,0,0,0
0,0,0,0,0,0,0,0,0
0,0,0,0,0,0,0,0,0
0,0,0,0,0,0,0,0,0
2318,49,0,1,1,0,0,0,0
2318,49,0,1,1,0,0,0,0
0,0,0,0,0,0,0,0,0
0,0,0,0,0,0,0,0,0
0,0,0,0,0,0,0,0,0
0,0,0,0,0,0,0,0,0
229452,1263,11,171,157,14,4,0,0
0,0,0,0,0,0,0,0,0
64146,419,11,54,51,3,2,0,0
55731,459,1,15,14,1,2,1,0
419579,6425,4,1058,12,1046,5,1,0
676647,557,0,4,4,0,2,1,1
66067,245,0,46,24,22,0,1,1
66065,245,0,46,24,22,0,1,1
0,0,0,0,0,0,0,0,0
0,0,0,0,0,0,0,0,0
0,0,0,0,0,0,0,0,0
0,0,0,0,0,0,0,0,0
0,0,0,0,0,0,0,0,0
0,0,0,0,0,0,0,0,0
0,0,0,0,0,0,0,0,0
0,0,0,0,0,0,0,0,0
0,0,0,0,0,0,0,0,0
81598,191,3,12,7,5,5,1,0
0,0,0,0,0,0,0,0,0
0,0,0,0,0,0,0,0,0
0,0,0,0,0,0,0,0,0
0,0,0,0,0,0,0,0,0
0,0,0,0,0,0,0,0,0
0,0,0,0,0,0,0,0,0
2752355,34,4,0,0,0,0,1,0
0,0,0,0,0,0,0,0,0
0,0,0,0,0,0,0,0,0
0,0,0,0,0,0,0,0,0
0,0,0,0,0,0,0,0,0
0,0,0,0,0,0,0,0,0
0,0,0,0,0,0,0,0,0
0,0,0,0,0,0,0,0,0
0,0,0,0,0,0,0,0,0
0,0,0,0,0,0,0,0,0
0,0,0,0,0,0,0,0,0
0,0,0,0,0,0,0,0,0
0,0,0,0,0,0,0,0,0
0,0,0,0,0,0,0,0,0
0,0,0,0,0,0,0,0,0
19084,299,3,47,47,0,2,1,0
48216,579,10,80,78,2,0,1,0
56459,695,1,98,70,28,11,0,0
6696,46,4,1,1,0,2,1,0
441806,261,9,6,1,5,8,1,0
0,0,0,0,0,0,0,0,0
25149,306,6,38,5,33,6,1,0
0,0,0,0,0,0,0,0,0
167387,1513,16,299,290,9,6,1,0
0,0,0,0,0,0,0,0,0
0,0,0,0,0,0,0,0,0
0,0,0,0,0,0,0,0,0
0,0,0,0,0,0,0,0,0
0,0,0,0,0,0,0,0,0
16100,35,0,5,1,4,0,0,0
0,0,0,0,0,0,0,0,0
0,0,0,0,0,0,0,0,0
14874,163,0,12,0,12,2,1,0
0,0,0,0,0,0,0,0,0
83137,646,11,67,5,62,2,1,0
0,0,0,0,0,0,0,0,0
66540,345,1,5,5,0,0,0,0
13110,108,1,0,0,0,0,0,0
0,0,0,0,0,0,0,0,0
0,0,0,0,0,0,0,0,0
0,0,0,0,0,0,0,0,0
0,0,0,0,0,0,0,0,0
0,0,0,0,0,0,0,0,0
0,0,0,0,0,0,0,0,0
0,0,0,0,0,0,0,0,0
366472,69,3,0,0,0,0,0,0
366408,69,3,0,0,0,0,0,0
0,0,0,0,0,0,0,0,0
840,26,0,0,0,0,0,0,0
134351,879,7,160,154,6,13,1,0
171771,172,0,6,6,0,1,1,1
674614,556,0,4,0,4,2,1,1
4134,52,0,1,0,1,1,0,0
59869,414,3,137,6,131,5,0,1
0,0,0,0,0,0,0,0,0
34456,245,8,24,13,11,0,1,0
56506,695,1,98,70,28,11,0,0
56470,695,1,98,70,28,11,0,0
47676,231,8,5,4,1,0,0,0
135325,919,6,35,35,0,2,1,0
0,0,0,0,0,0,0,0,0
0,0,0,0,0,0,0,0,0
51870,503,0,41,34,7,0,1,0
0,0,0,0,0,0,0,0,0
0,0,0,0,0,0,0,0,0
0,0,0,0,0,0,0,0,0
0,0,0,0,0,0,0,0,0
0,0,0,0,0,0,0,0,0
0,0,0,0,0,0,0,0,0
0,0,0,0,0,0,0,0,0
0,0,0,0,0,0,0,0,0
0,0,0,0,0,0,0,0,0
0,0,0,0,0,0,0,0,0
0,0,0,0,0,0,0,0,0
0,0,0,0,0,0,0,0,0
943,5,0,0,0,0,0,0,0
943,5,0,0,0,0,0,0,0
926,5,0,0,0,0,0,0,0
926,5,0,0,0,0,0,0,0
0,0,0,0,0,0,0,0,0
0,0,0,0,0,0,0,0,0
0,0,0,0,0,0,0,0,0
51864,503,0,41,34,7,0,1,0
447429,214,2,50,50,0,1,1,0
0,0,0,0,0,0,0,0,0
0,0,0,0,0,0,0,0,0
0,0,0,0,0,0,0,0,0
0,0,0,0,0,0,0,0,0
13110,108,1,0,0,0,0,0,0
0,0,0,0,0,0,0,0,0
13110,108,1,0,0,0,0,0,0
13110,108,1,0,0,0,0,0,0
0,0,0,0,0,0,0,0,0
13110,108,1,0,0,0,0,0,0
0,0,0,0,0,0,0,0,0
0,0,0,0,0,0,0,0,0
48403,705,4,163,26,137,3,1,0
0,0,0,0,0,0,0,0,0
0,0,0,0,0,0,0,0,0
0,0,0,0,0,0,0,0,0
23010,37,0,2,1,1,0,1,0
0,0,0,0,0,0,0,0,0
0,0,0,0,0,0,0,0,0
0,0,0,0,0,0,0,0,0
0,0,0,0,0,0,0,0,0
0,0,0,0,0,0,0,0,0
5702,53,0,2,0,2,0,0,0
199048,62,6,1,1,0,2,0,0
0,0,0,0,0,0,0,0,0
0,0,0,0,0,0,0,0,0
0,0,0,0,0,0,0,0,0
0,0,0,0,0,0,0,0,0
0,0,0,0,0,0,0,0,0
0,0,0,0,0,0,0,0,0
0,0,0,0,0,0,0,0,0
0,0,0,0,0,0,0,0,0
174506,199,3,18,8,10,0,1,0
28995,144,2,2,0,2,1,1,0
56137,161,2,5,3,2,1,1,0
41173,184,2,6,2,4,0,1,0
0,0,0,0,0,0,0,0,0
0,0,0,0,0,0,0,0,0
0,0,0,0,0,0,0,0,0
0,0,0,0,0,0,0,0,0
122086,518,2,44,42,2,8,1,0
0,0,0,0,0,0,0,0,0
11873,156,5,22,21,1,0,1,0
0,0,0,0,0,0,0,0,0
0,0,0,0,0,0,0,0,0
61088,184,3,1,1,0,0,0,0
0,0,0,0,0,0,0,0,0
0,0,0,0,0,0,0,0,0
44800,277,6,30,29,1,8,1,0
35589,127,10,4,4,0,0,1,0
93420,211,4,0,0,0,1,0,0
686231,1109,2,265,258,7,14,1,0
142497,1214,9,292,289,3,1,0,0
0,0,0,0,0,0,0,0,0
13792,116,1,0,0,0,0,0,0
0,0,0,0,0,0,0,0,0
0,0,0,0,0,0,0,0,0
1844,26,2,1,1,0,0,0,0
681526,557,0,4,4,0,2,1,1
0,0,0,0,0,0,0,0,0
0,0,0,0,0,0,0,0,0
0,0,0,0,0,0,0,0,0
0,0,0,0,0,0,0,0,0
0,0,0,0,0,0,0,0,0
0,0,0,0,0,0,0,0,0
3987,184,0,27,27,0,0,0,0
144946,257,0,47,5,42,1,1,1
0,0,0,0,0,0,0,0,0
0,0,0,0,0,0,0,0,0
686231,1109,2,265,258,7,14,1,0
0,0,0,0,0,0,0,0,0
0,0,0,0,0,0,0,0,0
0,0,0,0,0,0,0,0,0
1834,25,0,1,0,1,0,0,0
1834,25,0,1,0,1,0,0,0
91431,211,4,0,0,0,1,0,0
91431,211,4,0,0,0,1,0,0
90873,211,4,0,0,0,1,0,0
90873,211,4,0,0,0,1,0,0
91957,211,4,0,0,0,1,0,0
91474,211,4,0,0,0,1,0,0
91474,211,4,0,0,0,1,0,0
47446,207,2,1,0,1,1,0,0
6124,190,0,0,0,0,0,0,0
0,0,0,0,0,0,0,0,0
415431,213,4,3,1,2,0,1,0
0,0,0,0,0,0,0,0,0
44870,278,11,22,17,5,4,0,0
0,0,0,0,0,0,0,0,0
0,0,0,0,0,0,0,0,0
0,0,0,0,0,0,0,0,0
677578,557,0,4,4,0,2,1,1
4893173,64,4,0,0,0,0,1,0
16793,92,0,16,3,13,0,1,0
0,0,0,0,0,0,0,0,0
0,0,0,0,0,0,0,0,0
0,0,0,0,0,0,0,0,0
0,0,0,0,0,0,0,0,0
0,0,0,0,0,0,0,0,0
0,0,0,0,0,0,0,0,0
0,0,0,0,0,0,0,0,0
6124,190,0,0,0,0,0,0,0
0,0,0,0,0,0,0,0,0
387650,5639,8,1013,885,128,13,1,0
84729,963,0,61,33,28,2,1,0
0,0,0,0,0,0,0,0,0
263638,512,4,49,46,3,7,1,0
38586,343,5,23,14,9,0,1,0
18681,171,7,48,46,2,5,1,0
677144,556,0,4,4,0,2,1,1
0,0,0,0,0,0,0,0,0
0,0,0,0,0,0,0,0,0
0,0,0,0,0,0,0,0,0
0,0,0,0,0,0,0,0,0
0,0,0,0,0,0,0,0,0
0,0,0,0,0,0,0,0,0
5461,60,2,1,1,0,0,0,0
0,0,0,0,0,0,0,0,0
0,0,0,0,0,0,0,0,0
0,0,0,0,0,0,0,0,0
0,0,0,0,0,0,0,0,0
0,0,0,0,0,0,0,0,0
1790,23,0,0,0,0,0,0,0
1790,23,0,0,0,0,0,0,0
360973,1416,9,49,28,21,0,0,0
0,0,0,0,0,0,0,0,0
0,0,0,0,0,0,0,0,0
33871,147,5,0,0,0,0,0,0
0,0,0,0,0,0,0,0,0
154189,199,5,9,4,5,0,0,0
0,0,0,0,0,0,0,0,0
0,0,0,0,0,0,0,0,0
0,0,0,0,0,0,0,0,0
0,0,0,0,0,0,0,0,0
0,0,0,0,0,0,0,0,0
63545,600,5,22,19,3,4,0,0
88884,734,5,22,19,3,4,0,0
48353,216,2,2,2,0,1,1,0
0,0,0,0,0,0,0,0,0
0,0,0,0,0,0,0,0,0
33871,147,5,0,0,0,0,0,0
2830,21,2,0,0,0,0,0,0
0,0,0,0,0,0,0,0,0
0,0,0,0,0,0,0,0,0
2621,38,0,1,1,0,0,0,0
2621,38,0,1,1,0,0,0,0
10629,153,3,18,18,0,4,1,0
10629,153,3,18,18,0,4,1,0
130034,35,2,1,1,0,0,0,0
0,0,0,0,0,0,0,0,0
105505,807,15,35,23,12,3,1,0
2145,35,0,1,0,1,0,1,0
2145,35,0,1,0,1,0,1,0
149097,561,7,58,46,12,0,0,0
0,0,0,0,0,0,0,0,0
0,0,0,0,0,0,0,0,0
16152,35,0,5,1,4,0,0,0
9651,61,2,0,0,0,0,0,0
683110,558,0,4,0,4,2,1,1
0,0,0,0,0,0,0,0,0
0,0,0,0,0,0,0,0,0
0,0,0,0,0,0,0,0,0
0,0,0,0,0,0,0,0,0
0,0,0,0,0,0,0,0,0
0,0,0,0,0,0,0,0,0
0,0,0,0,0,0,0,0,0
0,0,0,0,0,0,0,0,0
0,0,0,0,0,0,0,0,0
0,0,0,0,0,0,0,0,0
0,0,0,0,0,0,0,0,0
0,0,0,0,0,0,0,0,0
81541,191,3,12,7,5,5,1,0
0,0,0,0,0,0,0,0,0
0,0,0,0,0,0,0,0,0
0,0,0,0,0,0,0,0,0
0,0,0,0,0,0,0,0,0
2830,21,2,0,0,0,0,0,0
135938,218,4,26,18,8,2,1,0
0,0,0,0,0,0,0,0,0
0,0,0,0,0,0,0,0,0
0,0,0,0,0,0,0,0,0
0,0,0,0,0,0,0,0,0
0,0,0,0,0,0,0,0,0
0,0,0,0,0,0,0,0,0
0,0,0,0,0,0,0,0,0
0,0,0,0,0,0,0,0,0
0,0,0,0,0,0,0,0,0
0,0,0,0,0,0,0,0,0
0,0,0,0,0,0,0,0,0
0,0,0,0,0,0,0,0,0
0,0,0,0,0,0,0,0,0
0,0,0,0,0,0,0,0,0
0,0,0,0,0,0,0,0,0
0,0,0,0,0,0,0,0,0
16152,35,0,5,1,4,0,0,0
490654,189,5,45,32,13,0,1,0
0,0,0,0,0,0,0,0,0
0,0,0,0,0,0,0,0,0
0,0,0,0,0,0,0,0,0
0,0,0,0,0,0,0,0,0
0,0,0,0,0,0,0,0,0
0,0,0,0,0,0,0,0,0
0,0,0,0,0,0,0,0,0
0,0,0,0,0,0,0,0,0
0,0,0,0,0,0,0,0,0
0,0,0,0,0,0,0,0,0
191891,705,9,135,116,19,1,1,0
56655,144,1,11,5,6,6,0,0
0,0,0,0,0,0,0,0,0
0,0,0,0,0,0,0,0,0
225804,119,0,15,6,9,0,1,0
53277,465,8,102,93,9,0,1,0
0,0,0,0,0,0,0,0,0
0,0,0,0,0,0,0,0,0
933,5,0,0,0,0,0,0,0
933,5,0,0,0,0,0,0,0
2416,43,1,0,0,0,0,0,0
2416,43,1,0,0,0,0,0,0
0,0,0,0,0,0,0,0,0
0,0,0,0,0,0,0,0,0
0,0,0,0,0,0,0,0,0
0,0,0,0,0,0,0,0,0
0,0,0,0,0,0,0,0,0
29500,475,6,44,43,1,2,1,0
0,0,0,0,0,0,0,0,0
0,0,0,0,0,0,0,0,0
0,0,0,0,0,0,0,0,0
0,0,0,0,0,0,0,0,0
0,0,0,0,0,0,0,0,0
0,0,0,0,0,0,0,0,0
0,0,0,0,0,0,0,0,0
0,0,0,0,0,0,0,0,0
0,0,0,0,0,0,0,0,0
0,0,0,0,0,0,0,0,0
0,0,0,0,0,0,0,0,0
0,0,0,0,0,0,0,0,0
0,0,0,0,0,0,0,0,0
0,0,0,0,0,0,0,0,0
0,0,0,0,0,0,0,0,0
0,0,0,0,0,0,0,0,0
0,0,0,0,0,0,0,0,0
0,0,0,0,0,0,0,0,0
0,0,0,0,0,0,0,0,0
0,0,0,0,0,0,0,0,0
0,0,0,0,0,0,0,0,0
0,0,0,0,0,0,0,0,0
239921,102,4,5,5,0,3,1,0
309700,179,4,26,18,8,2,1,0
0,0,0,0,0,0,0,0,0
0,0,0,0,0,0,0,0,0
4138,34,2,0,0,0,0,0,0
0,0,0,0,0,0,0,0,0
0,0,0,0,0,0,0,0,0
151408,890,1,134,86,48,1,0,0
135849,768,1,133,84,49,1,0,0
211,8,0,1,1,0,0,0,0
0,0,0,0,0,0,0,0,0
0,0,0,0,0,0,0,0,0
128967,200,2,1,0,1,12,0,0
9548,59,2,0,0,0,0,0,0
53692,93,3,8,6,2,0,0,0
0,0,0,0,0,0,0,0,0
43023,371,14,45,42,3,0,0,0
16620,31,0,1,1,0,0,1,0
0,0,0,0,0,0,0,0,0
13589,73,6,3,3,0,0,0,0
64862,481,7,52,26,26,5,1,0
64384,481,7,52,26,26,4,1,0
0,0,0,0,0,0,0,0,0
0,0,0,0,0,0,0,0,0
225804,119,0,15,6,9,0,1,0
0,0,0,0,0,0,0,0,0
0,0,0,0,0,0,0,0,0
0,0,0,0,0,0,0,0,0
0,0,0,0,0,0,0,0,0
0,0,0,0,0,0,0,0,0
0,0,0,0,0,0,0,0,0
0,0,0,0,0,0,0,0,0
0,0,0,0,0,0,0,0,0
0,0,0,0,0,0,0,0,0
0,0,0,0,0,0,0,0,0
0,0,0,0,0,0,0,0,0
0,0,0,0,0,0,0,0,0
0,0,0,0,0,0,0,0,0
0,0,0,0,0,0,0,0,0
0,0,0,0,0,0,0,0,0
0,0,0,0,0,0,0,0,0
0,0,0,0,0,0,0,0,0
4818,63,3,7,3,4,0,1,0
0,0,0,0,0,0,0,0,0
0,0,0,0,0,0,0,0,0
0,0,0,0,0,0,0,0,0
0,0,0,0,0,0,0,0,0
0,0,0,0,0,0,0,0,0
0,0,0,0,0,0,0,0,0
3970,67,3,0,0,0,0,0,0
3970,67,3,0,0,0,0,0,0
13657,117,2,16,16,0,4,0,0
13657,117,2,16,16,0,4,0,0
0,0,0,0,0,0,0,0,0
110505,394,7,36,35,1,0,1,0
0,0,0,0,0,0,0,0,0
0,0,0,0,0,0,0,0,0
2145,35,0,1,0,1,0,1,0
2145,35,0,1,0,1,0,1,0
0,0,0,0,0,0,0,0,0
0,0,0,0,0,0,0,0,0
0,0,0,0,0,0,0,0,0
13657,117,2,16,16,0,4,0,0
0,0,0,0,0,0,0,0,0
46689,194,2,2,1,1,1,0,0
0,0,0,0,0,0,0,0,0
0,0,0,0,0,0,0,0,0
0,0,0,0,0,0,0,0,0
464,6,0,0,0,0,0,0,0
0,0,0,0,0,0,0,0,0
0,0,0,0,0,0,0,0,0
0,0,0,0,0,0,0,0,0
0,0,0,0,0,0,0,0,0
738868,174,0,0,0,0,1,1,0
942826,937,0,39,16,23,4,1,0
110591,91,4,6,2,4,0,0,0
110591,91,4,6,2,4,0,0,0
0,0,0,0,0,0,0,0,0
12968,91,3,3,2,1,0,0,0
0,0,0,0,0,0,0,0,0
0,0,0,0,0,0,0,0,0
680148,558,0,4,4,0,2,1,1
36852,161,3,8,4,4,9,1,0
0,0,0,0,0,0,0,0,0
0,0,0,0,0,0,0,0,0
0,0,0,0,0,0,0,0,0
0,0,0,0,0,0,0,0,0
0,0,0,0,0,0,0,0,0
0,0,0,0,0,0,0,0,0
81581,193,3,13,8,5,5,1,0
15069,142,0,56,51,5,0,0,0
138503,257,1,20,7,13,7,1,0
0,0,0,0,0,0,0,0,0
0,0,0,0,0,0,0,0,0
0,0,0,0,0,0,0,0,0
0,0,0,0,0,0,0,0,0
84766,963,0,61,33,28,2,1,0
35074,248,5,47,4,43,5,1,0
0,0,0,0,0,0,0,0,0
50363,586,6,205,201,4,1,0,0
0,0,0,0,0,0,0,0,0
0,0,0,0,0,0,0,0,0
0,0,0,0,0,0,0,0,0
13687,38,2,0,0,0,2,0,0
0,0,0,0,0,0,0,0,0
2145,35,0,1,0,1,0,1,0
2145,35,0,1,0,1,0,1,0
2204,34,0,1,0,1,0,1,0
2204,34,0,1,0,1,0,1,0
0,0,0,0,0,0,0,0,0
0,0,0,0,0,0,0,0,0
27559,275,11,24,21,3,2,1,0
0,0,0,0,0,0,0,0,0
0,0,0,0,0,0,0,0,0
0,0,0,0,0,0,0,0,0
1825,23,0,0,0,0,0,0,0
0,0,0,0,0,0,0,0,0
138842,259,1,20,7,13,7,1,0
152538,754,10,31,27,4,0,1,0
0,0,0,0,0,0,0,0,0
0,0,0,0,0,0,0,0,0
0,0,0,0,0,0,0,0,0
0,0,0,0,0,0,0,0,0
72369,467,14,41,35,6,0,1,0
0,0,0,0,0,0,0,0,0
28637,45,0,4,1,3,0,0,0
0,0,0,0,0,0,0,0,0
33434,326,7,37,35,2,1,1,0
0,0,0,0,0,0,0,0,0
0,0,0,0,0,0,0,0,0
0,0,0,0,0,0,0,0,0
0,0,0,0,0,0,0,0,0
0,0,0,0,0,0,0,0,0
117523,696,8,32,10,22,1,0,0
3385,41,0,6,0,6,0,0,0
0,0,0,0,0,0,0,0,0
0,0,0,0,0,0,0,0,0
13345,145,1,10,5,5,0,0,0
0,0,0,0,0,0,0,0,0
0,0,0,0,0,0,0,0,0
0,0,0,0,0,0,0,0,0
0,0,0,0,0,0,0,0,0
0,0,0,0,0,0,0,0,0
0,0,0,0,0,0,0,0,0
0,0,0,0,0,0,0,0,0
0,0,0,0,0,0,0,0,0
0,0,0,0,0,0,0,0,0
0,0,0,0,0,0,0,0,0
0,0,0,0,0,0,0,0,0
33844,46,2,0,0,0,2,0,0
0,0,0,0,0,0,0,0,0
677022,557,0,4,4,0,2,1,1
0,0,0,0,0,0,0,0,0
0,0,0,0,0,0,0,0,0
26188,236,1,31,31,0,0,1,0
0,0,0,0,0,0,0,0,0
0,0,0,0,0,0,0,0,0
0,0,0,0,0,0,0,0,0
145201,263,1,20,7,13,7,1,0
0,0,0,0,0,0,0,0,0
0,0,0,0,0,0,0,0,0
677049,557,0,4,4,0,2,1,1
0,0,0,0,0,0,0,0,0
0,0,0,0,0,0,0,0,0
94468,405,8,98,33,65,10,1,0
0,0,0,0,0,0,0,0,0
0,0,0,0,0,0,0,0,0
0,0,0,0,0,0,0,0,0
0,0,0,0,0,0,0,0,0
149670,587,6,62,45,17,6,1,0
0,0,0,0,0,0,0,0,0
23357,226,3,24,1,23,0,1,0
0,0,0,0,0,0,0,0,0
0,0,0,0,0,0,0,0,0
0,0,0,0,0,0,0,0,0
761014,2124,0,29,17,12,10,0,0
16152,35,0,5,1,4,0,0,0
0,0,0,0,0,0,0,0,0
0,0,0,0,0,0,0,0,0
0,0,0,0,0,0,0,0,0
843187,505,7,26,17,9,4,1,0
115073,538,17,19,19,0,2,1,0
0,0,0,0,0,0,0,0,0
0,0,0,0,0,0,0,0,0
92467,1041,2,60,33,27,2,1,0
0,0,0,0,0,0,0,0,0
0,0,0,0,0,0,0,0,0
0,0,0,0,0,0,0,0,0
0,0,0,0,0,0,0,0,0
0,0,0,0,0,0,0,0,0
0,0,0,0,0,0,0,0,0
0,0,0,0,0,0,0,0,0
0,0,0,0,0,0,0,0,0
0,0,0,0,0,0,0,0,0
0,0,0,0,0,0,0,0,0
0,0,0,0,0,0,0,0,0
4640,61,0,1,1,0,0,0,0
4640,61,0,1,1,0,0,0,0
0,0,0,0,0,0,0,0,0
0,0,0,0,0,0,0,0,0
0,0,0,0,0,0,0,0,0
91890,212,4,0,0,0,1,0,0
91688,211,4,0,0,0,1,0,0
91688,211,4,0,0,0,1,0,0
0,0,0,0,0,0,0,0,0
91815,209,4,0,0,0,1,0,0
91327,211,4,0,0,0,1,0,0
91269,211,4,0,0,0,1,0,0
91268,211,4,0,0,0,1,0,0
91057,209,4,0,0,0,1,0,0
92430,1041,2,60,37,23,2,1,0
0,0,0,0,0,0,0,0,0
0,0,0,0,0,0,0,0,0
0,0,0,0,0,0,0,0,0
0,0,0,0,0,0,0,0,0
0,0,0,0,0,0,0,0,0
0,0,0,0,0,0,0,0,0
0,0,0,0,0,0,0,0,0
0,0,0,0,0,0,0,0,0
0,0,0,0,0,0,0,0,0
0,0,0,0,0,0,0,0,0
0,0,0,0,0,0,0,0,0
0,0,0,0,0,0,0,0,0
199471,1897,10,290,210,80,12,1,0
674892,543,0,4,4,0,2,1,1
0,0,0,0,0,0,0,0,0
0,0,0,0,0,0,0,0,0
0,0,0,0,0,0,0,0,0
0,0,0,0,0,0,0,0,0
0,0,0,0,0,0,0,0,0
0,0,0,0,0,0,0,0,0
0,0,0,0,0,0,0,0,0
0,0,0,0,0,0,0,0,0
78686,191,3,12,7,5,5,1,0
0,0,0,0,0,0,0,0,0
0,0,0,0,0,0,0,0,0
13491,114,1,0,0,0,0,0,0
0,0,0,0,0,0,0,0,0
0,0,0,0,0,0,0,0,0
304957,1855,12,48,42,6,2,1,0
0,0,0,0,0,0,0,0,0
0,0,0,0,0,0,0,0,0
0,0,0,0,0,0,0,0,0
0,0,0,0,0,0,0,0,0
0,0,0,0,0,0,0,0,0
0,0,0,0,0,0,0,0,0
0,0,0,0,0,0,0,0,0
0,0,0,0,0,0,0,0,0
0,0,0,0,0,0,0,0,0
0,0,0,0,0,0,0,0,0
0,0,0,0,0,0,0,0,0
861650,186,1,4,0,4,1,0,0
0,0,0,0,0,0,0,0,0
0,0,0,0,0,0,0,0,0
180137,1687,1,181,180,1,1,1,0
0,0,0,0,0,0,0,0,0
0,0,0,0,0,0,0,0,0
0,0,0,0,0,0,0,0,0
18961,14,0,1,1,0,0,0,0
0,0,0,0,0,0,0,0,0
0,0,0,0,0,0,0,0,0
3385,41,0,6,0,6,0,0,0
0,0,0,0,0,0,0,0,0
0,0,0,0,0,0,0,0,0
0,0,0,0,0,0,0,0,0
0,0,0,0,0,0,0,0,0
0,0,0,0,0,0,0,0,0
0,0,0,0,0,0,0,0,0
0,0,0,0,0,0,0,0,0
0,0,0,0,0,0,0,0,0
682428,557,0,4,0,4,2,1,1
16152,35,0,5,1,4,0,0,0
311552,891,3,103,81,22,5,1,0
3385,41,0,6,0,6,0,0,0
3385,41,0,6,0,6,0,0,0
0,0,0,0,0,0,0,0,0
0,0,0,0,0,0,0,0,0
0,0,0,0,0,0,0,0,0
0,0,0,0,0,0,0,0,0
17236,134,1,11,11,0,0,1,0
17236,134,1,11,11,0,0,1,0
0,0,0,0,0,0,0,0,0
0,0,0,0,0,0,0,0,0
0,0,0,0,0,0,0,0,0
0,0,0,0,0,0,0,0,0
0,0,0,0,0,0,0,0,0
0,0,0,0,0,0,0,0,0
0,0,0,0,0,0,0,0,0
0,0,0,0,0,0,0,0,0
0,0,0,0,0,0,0,0,0
0,0,0,0,0,0,0,0,0
0,0,0,0,0,0,0,0,0
0,0,0,0,0,0,0,0,0
0,0,0,0,0,0,0,0,0
0,0,0,0,0,0,0,0,0
0,0,0,0,0,0,0,0,0
0,0,0,0,0,0,0,0,0
0,0,0,0,0,0,0,0,0
27166,36,0,3,1,2,0,0,0
322448,1150,12,55,13,42,0,0,0
0,0,0,0,0,0,0,0,0
0,0,0,0,0,0,0,0,0
0,0,0,0,0,0,0,0,0
239739,2123,12,422,419,3,1,1,0
23014,408,4,66,64,2,5,1,0
52221,566,8,74,62,12,4,1,0
0,0,0,0,0,0,0,0,0
6330,64,2,6,4,2,0,1,0
0,0,0,0,0,0,0,0,0
0,0,0,0,0,0,0,0,0
0,0,0,0,0,0,0,0,0
0,0,0,0,0,0,0,0,0
0,0,0,0,0,0,0,0,0
0,0,0,0,0,0,0,0,0
0,0,0,0,0,0,0,0,0
0,0,0,0,0,0,0,0,0
0,0,0,0,0,0,0,0,0
0,0,0,0,0,0,0,0,0
0,0,0,0,0,0,0,0,0
0,0,0,0,0,0,0,0,0
0,0,0,0,0,0,0,0,0
0,0,0,0,0,0,0,0,0
0,0,0,0,0,0,0,0,0
0,0,0,0,0,0,0,0,0
0,0,0,0,0,0,0,0,0
0,0,0,0,0,0,0,0,0
0,0,0,0,0,0,0,0,0
0,0,0,0,0,0,0,0,0
0,0,0,0,0,0,0,0,0
0,0,0,0,0,0,0,0,0
0,0,0,0,0,0,0,0,0
0,0,0,0,0,0,0,0,0
0,0,0,0,0,0,0,0,0
0,0,0,0,0,0,0,0,0
0,0,0,0,0,0,0,0,0
0,0,0,0,0,0,0,0,0
0,0,0,0,0,0,0,0,0
0,0,0,0,0,0,0,0,0
0,0,0,0,0,0,0,0,0
0,0,0,0,0,0,0,0,0
0,0,0,0,0,0,0,0,0
0,0,0,0,0,0,0,0,0
0,0,0,0,0,0,0,0,0
0,0,0,0,0,0,0,0,0
0,0,0,0,0,0,0,0,0
0,0,0,0,0,0,0,0,0
0,0,0,0,0,0,0,0,0
0,0,0,0,0,0,0,0,0
0,0,0,0,0,0,0,0,0
0,0,0,0,0,0,0,0,0
0,0,0,0,0,0,0,0,0
0,0,0,0,0,0,0,0,0
0,0,0,0,0,0,0,0,0
0,0,0,0,0,0,0,0,0
127360,297,7,44,39,5,0,1,0
404402,9929,3,1053,632,421,0,1,0
35930,40,1,0,0,0,0,0,0
0,0,0,0,0,0,0,0,0
0,0,0,0,0,0,0,0,0
0,0,0,0,0,0,0,0,0
0,0,0,0,0,0,0,0,0
115438,572,7,47,45,2,1,1,0
677289,557,0,4,4,0,2,1,1
0,0,0,0,0,0,0,0,0
3385,41,0,6,0,6,0,0,0
4247,40,0,2,1,1,1,0,0
0,0,0,0,0,0,0,0,0
0,0,0,0,0,0,0,0,0
0,0,0,0,0,0,0,0,0
0,0,0,0,0,0,0,0,0
0,0,0,0,0,0,0,0,0
0,0,0,0,0,0,0,0,0
0,0,0,0,0,0,0,0,0
0,0,0,0,0,0,0,0,0
105978,1047,1,180,40,140,3,1,0
0,0,0,0,0,0,0,0,0
0,0,0,0,0,0,0,0,0
3385,41,0,6,0,6,0,0,0
0,0,0,0,0,0,0,0,0
0,0,0,0,0,0,0,0,0
0,0,0,0,0,0,0,0,0
0,0,0,0,0,0,0,0,0
0,0,0,0,0,0,0,0,0
0,0,0,0,0,0,0,0,0
0,0,0,0,0,0,0,0,0
0,0,0,0,0,0,0,0,0
0,0,0,0,0,0,0,0,0
0,0,0,0,0,0,0,0,0
0,0,0,0,0,0,0,0,0
0,0,0,0,0,0,0,0,0
0,0,0,0,0,0,0,0,0
0,0,0,0,0,0,0,0,0
0,0,0,0,0,0,0,0,0
0,0,0,0,0,0,0,0,0
0,0,0,0,0,0,0,0,0
0,0,0,0,0,0,0,0,0
0,0,0,0,0,0,0,0,0
0,0,0,0,0,0,0,0,0
0,0,0,0,0,0,0,0,0
0,0,0,0,0,0,0,0,0
0,0,0,0,0,0,0,0,0
0,0,0,0,0,0,0,0,0
0,0,0,0,0,0,0,0,0
0,0,0,0,0,0,0,0,0
0,0,0,0,0,0,0,0,0
0,0,0,0,0,0,0,0,0
0,0,0,0,0,0,0,0,0
0,0,0,0,0,0,0,0,0
0,0,0,0,0,0,0,0,0
0,0,0,0,0,0,0,0,0
0,0,0,0,0,0,0,0,0
0,0,0,0,0,0,0,0,0
0,0,0,0,0,0,0,0,0
0,0,0,0,0,0,0,0,0
0,0,0,0,0,0,0,0,0
0,0,0,0,0,0,0,0,0
0,0,0,0,0,0,0,0,0
0,0,0,0,0,0,0,0,0
0,0,0,0,0,0,0,0,0
0,0,0,0,0,0,0,0,0
0,0,0,0,0,0,0,0,0
0,0,0,0,0,0,0,0,0
0,0,0,0,0,0,0,0,0
0,0,0,0,0,0,0,0,0
0,0,0,0,0,0,0,0,0
0,0,0,0,0,0,0,0,0
0,0,0,0,0,0,0,0,0
0,0,0,0,0,0,0,0,0
127359,297,7,44,39,5,0,1,0
0,0,0,0,0,0,0,0,0
0,0,0,0,0,0,0,0,0
58684,379,4,55,10,45,0,1,0
675806,556,0,4,4,0,2,1,1
379485,954,5,49,46,3,0,0,0
0,0,0,0,0,0,0,0,0
0,0,0,0,0,0,0,0,0
0,0,0,0,0,0,0,0,0
0,0,0,0,0,0,0,0,0
12855,142,0,56,51,5,0,0,0
6330,64,2,6,4,2,0,1,0
0,0,0,0,0,0,0,0,0
0,0,0,0,0,0,0,0,0
142334,409,8,28,1,27,34,1,0
0,0,0,0,0,0,0,0,0
0,0,0,0,0,0,0,0,0
0,0,0,0,0,0,0,0,0
0,0,0,0,0,0,0,0,0
0,0,0,0,0,0,0,0,0
143783,259,1,20,7,13,7,1,0
0,0,0,0,0,0,0,0,0
676974,557,0,4,4,0,2,1,1
18011,57,1,3,3,0,0,1,0
3385,41,0,6,0,6,0,0,0
3385,41,0,6,0,6,0,0,0
3385,41,0,6,0,6,0,0,0
275049,37,4,0,0,0,2,1,0
0,0,0,0,0,0,0,0,0
0,0,0,0,0,0,0,0,0
0,0,0,0,0,0,0,0,0
2024795,362,0,22,1,21,3,1,0
0,0,0,0,0,0,0,0,0
16098,42,3,0,0,0,2,0,0
16098,42,3,0,0,0,2,0,0
0,0,0,0,0,0,0,0,0
0,0,0,0,0,0,0,0,0
0,0,0,0,0,0,0,0,0
0,0,0,0,0,0,0,0,0
0,0,0,0,0,0,0,0,0
0,0,0,0,0,0,0,0,0
0,0,0,0,0,0,0,0,0
0,0,0,0,0,0,0,0,0
0,0,0,0,0,0,0,0,0
0,0,0,0,0,0,0,0,0
0,0,0,0,0,0,0,0,0
0,0,0,0,0,0,0,0,0
16098,42,3,0,0,0,2,0,0
16098,42,3,0,0,0,2,0,0
0,0,0,0,0,0,0,0,0
0,0,0,0,0,0,0,0,0
0,0,0,0,0,0,0,0,0
0,0,0,0,0,0,0,0,0
0,0,0,0,0,0,0,0,0
431,6,0,0,0,0,0,0,0
0,0,0,0,0,0,0,0,0
0,0,0,0,0,0,0,0,0
0,0,0,0,0,0,0,0,0
143282,259,1,20,7,13,7,1,0
32946,520,7,156,110,46,0,0,0
0,0,0,0,0,0,0,0,0
115510,244,0,38,34,4,2,1,0
0,0,0,0,0,0,0,0,0
8502,73,4,0,0,0,1,0,0
0,0,0,0,0,0,0,0,0
8492,73,4,0,0,0,1,0,0
0,0,0,0,0,0,0,0,0
35473,158,3,8,4,4,10,1,0
0,0,0,0,0,0,0,0,0
0,0,0,0,0,0,0,0,0
36617,311,9,17,16,1,1,1,0
222062,1862,4,134,132,2,9,1,0
366305,2866,11,104,104,0,4,1,0
677094,557,0,4,4,0,2,1,1
105322,720,15,49,29,20,0,1,0
0,0,0,0,0,0,0,0,0
3385,41,0,6,0,6,0,0,0
0,0,0,0,0,0,0,0,0
0,0,0,0,0,0,0,0,0
0,0,0,0,0,0,0,0,0
0,0,0,0,0,0,0,0,0
0,0,0,0,0,0,0,0,0
7009,113,1,5,0,5,2,1,0
0,0,0,0,0,0,0,0,0
0,0,0,0,0,0,0,0,0
0,0,0,0,0,0,0,0,0
0,0,0,0,0,0,0,0,0
0,0,0,0,0,0,0,0,0
0,0,0,0,0,0,0,0,0
0,0,0,0,0,0,0,0,0
0,0,0,0,0,0,0,0,0
16098,42,3,0,0,0,2,0,0
16098,42,3,0,0,0,2,0,0
16098,42,3,0,0,0,2,0,0
16098,42,3,0,0,0,2,0,0
2486,42,3,0,0,0,0,0,0
2486,42,3,0,0,0,0,0,0
0,0,0,0,0,0,0,0,0
0,0,0,0,0,0,0,0,0
0,0,0,0,0,0,0,0,0
6147,49,2,1,0,1,0,1,0
0,0,0,0,0,0,0,0,0
3385,41,0,6,0,6,0,0,0
3385,41,0,6,0,6,0,0,0
176409,709,8,44,20,24,22,1,0
0,0,0,0,0,0,0,0,0
0,0,0,0,0,0,0,0,0
0,0,0,0,0,0,0,0,0
0,0,0,0,0,0,0,0,0
0,0,0,0,0,0,0,0,0
0,0,0,0,0,0,0,0,0
3385,41,0,6,0,6,0,0,0
21953,33,0,1,1,0,0,1,0
0,0,0,0,0,0,0,0,0
0,0,0,0,0,0,0,0,0
0,0,0,0,0,0,0,0,0
23209,48,0,7,2,5,0,0,0
0,0,0,0,0,0,0,0,0
0,0,0,0,0,0,0,0,0
0,0,0,0,0,0,0,0,0
917,5,0,0,0,0,0,0,0
917,5,0,0,0,0,0,0,0
6942,51,1,2,1,1,0,0,0
4628,36,2,1,1,0,0,0,0
0,0,0,0,0,0,0,0,0
0,0,0,0,0,0,0,0,0
0,0,0,0,0,0,0,0,0
0,0,0,0,0,0,0,0,0
0,0,0,0,0,0,0,0,0
0,0,0,0,0,0,0,0,0
0,0,0,0,0,0,0,0,0
0,0,0,0,0,0,0,0,0
0,0,0,0,0,0,0,0,0
0,0,0,0,0,0,0,0,0
0,0,0,0,0,0,0,0,0
0,0,0,0,0,0,0,0,0
0,0,0,0,0,0,0,0,0
0,0,0,0,0,0,0,0,0
0,0,0,0,0,0,0,0,0
0,0,0,0,0,0,0,0,0
0,0,0,0,0,0,0,0,0
22563,33,0,1,1,0,0,1,0
16685,31,0,1,1,0,0,1,0
701992,539,0,5,5,0,2,1,1
145845,70,0,9,4,5,6,0,0
0,0,0,0,0,0,0,0,0
69145,179,3,18,11,7,0,1,0
8189,123,7,11,11,0,0,1,0
3013,18,1,0,0,0,0,0,0
0,0,0,0,0,0,0,0,0
0,0,0,0,0,0,0,0,0
0,0,0,0,0,0,0,0,0
0,0,0,0,0,0,0,0,0
0,0,0,0,0,0,0,0,0
46696,671,4,163,26,137,3,1,0
0,0,0,0,0,0,0,0,0
0,0,0,0,0,0,0,0,0
0,0,0,0,0,0,0,0,0
0,0,0,0,0,0,0,0,0
0,0,0,0,0,0,0,0,0
0,0,0,0,0,0,0,0,0
0,0,0,0,0,0,0,0,0
0,0,0,0,0,0,0,0,0
0,0,0,0,0,0,0,0,0
3385,41,0,6,0,6,0,0,0
0,0,0,0,0,0,0,0,0
0,0,0,0,0,0,0,0,0
0,0,0,0,0,0,0,0,0
0,0,0,0,0,0,0,0,0
16152,35,0,5,1,4,0,0,0
0,0,0,0,0,0,0,0,0
0,0,0,0,0,0,0,0,0
0,0,0,0,0,0,0,0,0
0,0,0,0,0,0,0,0,0
0,0,0,0,0,0,0,0,0
0,0,0,0,0,0,0,0,0
0,0,0,0,0,0,0,0,0
0,0,0,0,0,0,0,0,0
0,0,0,0,0,0,0,0,0
0,0,0,0,0,0,0,0,0
0,0,0,0,0,0,0,0,0
0,0,0,0,0,0,0,0,0
0,0,0,0,0,0,0,0,0
0,0,0,0,0,0,0,0,0
0,0,0,0,0,0,0,0,0
0,0,0,0,0,0,0,0,0
0,0,0,0,0,0,0,0,0
15314,203,3,5,5,0,2,0,0
70020,452,2,15,10,5,2,0,0
12119,85,4,1,1,0,5,0,0
53756,438,3,10,7,3,6,1,0
0,0,0,0,0,0,0,0,0
0,0,0,0,0,0,0,0,0
0,0,0,0,0,0,0,0,0
271757,93,2,1,0,1,0,0,0
271757,93,2,1,0,1,0,0,0
84975,948,5,119,113,6,0,0,0
145965,483,3,18,10,8,20,1,0
0,0,0,0,0,0,0,0,0
0,0,0,0,0,0,0,0,0
0,0,0,0,0,0,0,0,0
0,0,0,0,0,0,0,0,0
0,0,0,0,0,0,0,0,0
0,0,0,0,0,0,0,0,0
0,0,0,0,0,0,0,0,0
0,0,0,0,0,0,0,0,0
0,0,0,0,0,0,0,0,0
0,0,0,0,0,0,0,0,0
0,0,0,0,0,0,0,0,0
0,0,0,0,0,0,0,0,0
0,0,0,0,0,0,0,0,0
0,0,0,0,0,0,0,0,0
7926,54,0,1,0,1,0,0,0
0,0,0,0,0,0,0,0,0
0,0,0,0,0,0,0,0,0
0,0,0,0,0,0,0,0,0
0,0,0,0,0,0,0,0,0
143154,258,1,20,7,13,7,1,0
0,0,0,0,0,0,0,0,0
53273,102,5,6,5,1,0,0,0
23819,35,0,2,1,1,0,1,0
0,0,0,0,0,0,0,0,0
0,0,0,0,0,0,0,0,0
0,0,0,0,0,0,0,0,0
0,0,0,0,0,0,0,0,0
0,0,0,0,0,0,0,0,0
0,0,0,0,0,0,0,0,0
0,0,0,0,0,0,0,0,0
0,0,0,0,0,0,0,0,0
0,0,0,0,0,0,0,0,0
2062,33,0,1,0,1,0,0,0
2062,33,0,1,0,1,0,0,0
26868,34,0,2,1,1,0,0,0
0,0,0,0,0,0,0,0,0
16152,35,0,5,1,4,0,0,0
0,0,0,0,0,0,0,0,0
0,0,0,0,0,0,0,0,0
37370,249,8,10,10,0,0,1,0
89114,67,0,9,9,0,5,0,0
63980,209,3,3,2,1,3,0,0
0,0,0,0,0,0,0,0,0
0,0,0,0,0,0,0,0,0
0,0,0,0,0,0,0,0,0
9528,68,2,4,4,0,0,0,0
0,0,0,0,0,0,0,0,0
0,0,0,0,0,0,0,0,0
0,0,0,0,0,0,0,0,0
195235,433,6,52,52,0,0,1,0
143550,260,1,20,7,13,7,1,0
0,0,0,0,0,0,0,0,0
5641,70,7,0,0,0,0,0,0
0,0,0,0,0,0,0,0,0
675342,543,0,4,4,0,2,1,1
9346,68,2,4,4,0,0,0,0
0,0,0,0,0,0,0,0,0
92111,813,14,181,177,4,1,1,0
0,0,0,0,0,0,0,0,0
0,0,0,0,0,0,0,0,0
10572,64,4,0,0,0,2,0,0
0,0,0,0,0,0,0,0,0
0,0,0,0,0,0,0,0,0
0,0,0,0,0,0,0,0,0
0,0,0,0,0,0,0,0,0
0,0,0,0,0,0,0,0,0
0,0,0,0,0,0,0,0,0
31871,392,3,93,91,2,2,1,0
0,0,0,0,0,0,0,0,0
0,0,0,0,0,0,0,0,0
0,0,0,0,0,0,0,0,0
0,0,0,0,0,0,0,0,0
0,0,0,0,0,0,0,0,0
0,0,0,0,0,0,0,0,0
0,0,0,0,0,0,0,0,0
16098,42,3,0,0,0,2,0,0
16098,42,3,0,0,0,2,0,0
16098,42,3,0,0,0,2,0,0
16098,42,3,0,0,0,2,0,0
16098,42,3,0,0,0,2,0,0
16098,42,3,0,0,0,2,0,0
0,0,0,0,0,0,0,0,0
0,0,0,0,0,0,0,0,0
0,0,0,0,0,0,0,0,0
0,0,0,0,0,0,0,0,0
0,0,0,0,0,0,0,0,0
0,0,0,0,0,0,0,0,0
0,0,0,0,0,0,0,0,0
0,0,0,0,0,0,0,0,0
0,0,0,0,0,0,0,0,0
0,0,0,0,0,0,0,0,0
0,0,0,0,0,0,0,0,0
0,0,0,0,0,0,0,0,0
0,0,0,0,0,0,0,0,0
0,0,0,0,0,0,0,0,0
0,0,0,0,0,0,0,0,0
0,0,0,0,0,0,0,0,0
0,0,0,0,0,0,0,0,0
0,0,0,0,0,0,0,0,0
0,0,0,0,0,0,0,0,0
0,0,0,0,0,0,0,0,0
0,0,0,0,0,0,0,0,0
734491,2086,3,127,55,72,2,0,0
16693,92,0,16,3,13,0,1,0
59806,190,2,13,0,13,0,1,0
0,0,0,0,0,0,0,0,0
0,0,0,0,0,0,0,0,0
32578,520,7,156,110,46,0,0,0
16152,35,0,5,1,4,0,0,0
16152,35,0,5,1,4,0,0,0
177848,584,4,12,8,4,3,1,0
32394,520,7,156,110,46,0,0,0
54399,166,7,1,0,1,0,0,0
0,0,0,0,0,0,0,0,0
37640,348,3,39,15,24,0,1,0
0,0,0,0,0,0,0,0,0
0,0,0,0,0,0,0,0,0
0,0,0,0,0,0,0,0,0
0,0,0,0,0,0,0,0,0
0,0,0,0,0,0,0,0,0
0,0,0,0,0,0,0,0,0
2752359,34,4,0,0,0,0,1,0
0,0,0,0,0,0,0,0,0
938021,361,0,22,1,21,3,1,0
0,0,0,0,0,0,0,0,0
66851,615,12,122,24,98,2,1,0
16098,42,3,0,0,0,2,0,0
16098,42,3,0,0,0,2,0,0
16098,42,3,0,0,0,2,0,0
16098,42,3,0,0,0,2,0,0
0,0,0,0,0,0,0,0,0
0,0,0,0,0,0,0,0,0
0,0,0,0,0,0,0,0,0
0,0,0,0,0,0,0,0,0
0,0,0,0,0,0,0,0,0
0,0,0,0,0,0,0,0,0
0,0,0,0,0,0,0,0,0
0,0,0,0,0,0,0,0,0
0,0,0,0,0,0,0,0,0
0,0,0,0,0,0,0,0,0
14794,28,0,0,0,0,0,0,0
66851,615,12,122,24,98,2,1,0
39474,259,4,39,15,24,9,1,0
0,0,0,0,0,0,0,0,0
8491,73,4,0,0,0,1,0,0
59875,190,2,13,0,13,0,1,0
0,0,0,0,0,0,0,0,0
0,0,0,0,0,0,0,0,0
92467,1041,2,60,33,27,2,1,0
0,0,0,0,0,0,0,0,0
677085,557,0,4,4,0,2,1,1
0,0,0,0,0,0,0,0,0
0,0,0,0,0,0,0,0,0
0,0,0,0,0,0,0,0,0
5735,91,0,7,6,1,0,0,0
0,0,0,0,0,0,0,0,0
0,0,0,0,0,0,0,0,0
0,0,0,0,0,0,0,0,0
678406,558,0,4,4,0,2,1,1
0,0,0,0,0,0,0,0,0
0,0,0,0,0,0,0,0,0
0,0,0,0,0,0,0,0,0
0,0,0,0,0,0,0,0,0
0,0,0,0,0,0,0,0,0
0,0,0,0,0,0,0,0,0
0,0,0,0,0,0,0,0,0
0,0,0,0,0,0,0,0,0
0,0,0,0,0,0,0,0,0
0,0,0,0,0,0,0,0,0
16098,42,3,0,0,0,2,0,0
16098,42,3,0,0,0,2,0,0
0,0,0,0,0,0,0,0,0
0,0,0,0,0,0,0,0,0
0,0,0,0,0,0,0,0,0
16152,35,0,5,1,4,0,0,0
35085,482,6,84,78,6,0,1,0
0,0,0,0,0,0,0,0,0
0,0,0,0,0,0,0,0,0
164130,1499,4,158,121,37,0,1,0
76875,345,8,25,19,6,1,0,0
143036,258,1,20,7,13,7,1,0
82407,893,4,76,25,51,4,1,0
0,0,0,0,0,0,0,0,0
0,0,0,0,0,0,0,0,0
0,0,0,0,0,0,0,0,0
280312,492,4,49,46,3,2,1,0
0,0,0,0,0,0,0,0,0
1179134,1271,1,44,33,11,7,1,0
0,0,0,0,0,0,0,0,0
263103,100,4,5,5,0,3,1,0
313977,187,4,26,18,8,2,1,0
313901,187,4,26,18,8,2,1,0
0,0,0,0,0,0,0,0,0
0,0,0,0,0,0,0,0,0
0,0,0,0,0,0,0,0,0
0,0,0,0,0,0,0,0,0
704176,553,0,5,5,0,2,1,1
0,0,0,0,0,0,0,0,0
0,0,0,0,0,0,0,0,0
0,0,0,0,0,0,0,0,0
0,0,0,0,0,0,0,0,0
0,0,0,0,0,0,0,0,0
0,0,0,0,0,0,0,0,0
0,0,0,0,0,0,0,0,0
0,0,0,0,0,0,0,0,0
0,0,0,0,0,0,0,0,0
0,0,0,0,0,0,0,0,0
0,0,0,0,0,0,0,0,0
0,0,0,0,0,0,0,0,0
0,0,0,0,0,0,0,0,0
0,0,0,0,0,0,0,0,0
0,0,0,0,0,0,0,0,0
0,0,0,0,0,0,0,0,0
0,0,0,0,0,0,0,0,0
67175,16,0,1,0,1,0,0,0
67175,16,0,1,0,1,0,0,0
0,0,0,0,0,0,0,0,0
0,0,0,0,0,0,0,0,0
4419,30,0,2,2,0,0,1,0
0,0,0,0,0,0,0,0,0
0,0,0,0,0,0,0,0,0
0,0,0,0,0,0,0,0,0
80176,692,10,158,148,10,1,1,0
0,0,0,0,0,0,0,0,0
0,0,0,0,0,0,0,0,0
0,0,0,0,0,0,0,0,0
0,0,0,0,0,0,0,0,0
3732,24,2,0,0,0,0,0,0
0,0,0,0,0,0,0,0,0
3385,41,0,6,0,6,0,0,0
0,0,0,0,0,0,0,0,0
3385,41,0,6,0,6,0,0,0
0,0,0,0,0,0,0,0,0
314001,187,4,26,18,8,2,1,0
639083,107,4,4,4,0,4,1,0
0,0,0,0,0,0,0,0,0
0,0,0,0,0,0,0,0,0
0,0,0,0,0,0,0,0,0
0,0,0,0,0,0,0,0,0
0,0,0,0,0,0,0,0,0
0,0,0,0,0,0,0,0,0
0,0,0,0,0,0,0,0,0
0,0,0,0,0,0,0,0,0
102926,611,10,36,27,9,4,0,0
0,0,0,0,0,0,0,0,0
0,0,0,0,0,0,0,0,0
55312,403,5,48,43,5,0,1,0
0,0,0,0,0,0,0,0,0
2003,32,5,1,1,0,0,0,0
2003,32,5,1,1,0,0,0,0
2003,32,5,1,1,0,0,0,0
0,0,0,0,0,0,0,0,0
0,0,0,0,0,0,0,0,0
0,0,0,0,0,0,0,0,0
0,0,0,0,0,0,0,0,0
0,0,0,0,0,0,0,0,0
0,0,0,0,0,0,0,0,0
0,0,0,0,0,0,0,0,0
0,0,0,0,0,0,0,0,0
0,0,0,0,0,0,0,0,0
0,0,0,0,0,0,0,0,0
0,0,0,0,0,0,0,0,0
0,0,0,0,0,0,0,0,0
0,0,0,0,0,0,0,0,0
0,0,0,0,0,0,0,0,0
0,0,0,0,0,0,0,0,0
450148,1396,1,98,74,24,18,1,0
0,0,0,0,0,0,0,0,0
4511,71,4,6,1,5,1,1,0
0,0,0,0,0,0,0,0,0
0,0,0,0,0,0,0,0,0
0,0,0,0,0,0,0,0,0
0,0,0,0,0,0,0,0,0
0,0,0,0,0,0,0,0,0
0,0,0,0,0,0,0,0,0
0,0,0,0,0,0,0,0,0
0,0,0,0,0,0,0,0,0
0,0,0,0,0,0,0,0,0
0,0,0,0,0,0,0,0,0
0,0,0,0,0,0,0,0,0
0,0,0,0,0,0,0,0,0
0,0,0,0,0,0,0,0,0
0,0,0,0,0,0,0,0,0
0,0,0,0,0,0,0,0,0
13501,8,0,0,0,0,0,0,0
0,0,0,0,0,0,0,0,0
0,0,0,0,0,0,0,0,0
0,0,0,0,0,0,0,0,0
0,0,0,0,0,0,0,0,0
4653,41,0,18,16,2,0,0,0
0,0,0,0,0,0,0,0,0
0,0,0,0,0,0,0,0,0
0,0,0,0,0,0,0,0,0
0,0,0,0,0,0,0,0,0
0,0,0,0,0,0,0,0,0
707514,3055,4,78,51,27,39,0,0
0,0,0,0,0,0,0,0,0
0,0,0,0,0,0,0,0,0
0,0,0,0,0,0,0,0,0
0,0,0,0,0,0,0,0,0
92998,545,7,82,79,3,2,1,0
0,0,0,0,0,0,0,0,0
0,0,0,0,0,0,0,0,0
0,0,0,0,0,0,0,0,0
0,0,0,0,0,0,0,0,0
0,0,0,0,0,0,0,0,0
0,0,0,0,0,0,0,0,0
36907,162,3,8,4,4,10,1,0
35716,159,3,8,4,4,10,1,0
201679,1022,5,166,117,49,6,1,0
0,0,0,0,0,0,0,0,0
0,0,0,0,0,0,0,0,0
0,0,0,0,0,0,0,0,0
0,0,0,0,0,0,0,0,0
783056,55,0,10,10,0,0,0,0
783056,55,0,10,10,0,0,0,0
0,0,0,0,0,0,0,0,0
0,0,0,0,0,0,0,0,0
0,0,0,0,0,0,0,0,0
0,0,0,0,0,0,0,0,0
0,0,0,0,0,0,0,0,0
0,0,0,0,0,0,0,0,0
131656,315,5,25,25,0,3,0,0
0,0,0,0,0,0,0,0,0
181179,1116,7,58,38,20,3,1,0
0,0,0,0,0,0,0,0,0
146669,840,11,49,38,11,2,0,0
0,0,0,0,0,0,0,0,0
113876,1679,4,336,332,4,6,1,0
0,0,0,0,0,0,0,0,0
79192,409,9,40,36,4,0,1,0
0,0,0,0,0,0,0,0,0
0,0,0,0,0,0,0,0,0
0,0,0,0,0,0,0,0,0
92562,84,0,15,15,0,6,0,0
0,0,0,0,0,0,0,0,0
0,0,0,0,0,0,0,0,0
0,0,0,0,0,0,0,0,0
0,0,0,0,0,0,0,0,0
0,0,0,0,0,0,0,0,0
0,0,0,0,0,0,0,0,0
0,0,0,0,0,0,0,0,0
143288,259,1,20,7,13,7,1,0
0,0,0,0,0,0,0,0,0
0,0,0,0,0,0,0,0,0
28845,44,0,4,3,1,0,0,0
0,0,0,0,0,0,0,0,0
0,0,0,0,0,0,0,0,0
0,0,0,0,0,0,0,0,0
0,0,0,0,0,0,0,0,0
38759,49,2,3,3,0,0,0,0
0,0,0,0,0,0,0,0,0
0,0,0,0,0,0,0,0,0
0,0,0,0,0,0,0,0,0
0,0,0,0,0,0,0,0,0
1405,21,2,3,3,0,0,1,0
0,0,0,0,0,0,0,0,0
4750,31,0,2,2,0,0,1,0
22744,38,0,2,2,0,0,1,0
0,0,0,0,0,0,0,0,0
3385,41,0,6,0,6,0,0,0
0,0,0,0,0,0,0,0,0
0,0,0,0,0,0,0,0,0
0,0,0,0,0,0,0,0,0
0,0,0,0,0,0,0,0,0
836,21,0,8,8,0,0,0,0
11642,50,0,5,1,4,0,0,0
23357,226,3,24,24,0,0,1,0
7704,101,3,14,1,13,2,0,0
7704,101,3,14,11,3,2,0,0
7704,101,3,14,11,3,2,0,0
0,0,0,0,0,0,0,0,0
0,0,0,0,0,0,0,0,0
0,0,0,0,0,0,0,0,0
0,0,0,0,0,0,0,0,0
65855,247,0,46,24,22,0,1,1
0,0,0,0,0,0,0,0,0
0,0,0,0,0,0,0,0,0
0,0,0,0,0,0,0,0,0
0,0,0,0,0,0,0,0,0
0,0,0,0,0,0,0,0,0
0,0,0,0,0,0,0,0,0
0,0,0,0,0,0,0,0,0
0,0,0,0,0,0,0,0,0
0,0,0,0,0,0,0,0,0
0,0,0,0,0,0,0,0,0
0,0,0,0,0,0,0,0,0
0,0,0,0,0,0,0,0,0
0,0,0,0,0,0,0,0,0
0,0,0,0,0,0,0,0,0
0,0,0,0,0,0,0,0,0
0,0,0,0,0,0,0,0,0
143346,259,1,20,7,13,7,1,0
0,0,0,0,0,0,0,0,0
706264,554,0,5,5,0,2,1,1
0,0,0,0,0,0,0,0,0
0,0,0,0,0,0,0,0,0
0,0,0,0,0,0,0,0,0
0,0,0,0,0,0,0,0,0
0,0,0,0,0,0,0,0,0
9995,65,0,3,3,0,0,0,0
0,0,0,0,0,0,0,0,0
2728,18,1,0,0,0,0,0,0
85603,520,10,35,31,4,5,1,0
35409,158,3,8,4,4,10,1,0
35683,159,3,8,4,4,9,1,0
6451,25,1,0,0,0,0,0,0
313631,2401,10,344,338,6,5,1,0
0,0,0,0,0,0,0,0,0
0,0,0,0,0,0,0,0,0
0,0,0,0,0,0,0,0,0
0,0,0,0,0,0,0,0,0
0,0,0,0,0,0,0,0,0
0,0,0,0,0,0,0,0,0
0,0,0,0,0,0,0,0,0
0,0,0,0,0,0,0,0,0
0,0,0,0,0,0,0,0,0
0,0,0,0,0,0,0,0,0
74738,651,4,32,21,11,2,1,0
42176,78,4,0,0,0,0,0,0
22562,39,0,3,1,2,0,1,0
3385,41,0,6,0,6,0,0,0
3385,41,0,6,0,6,0,0,0
0,0,0,0,0,0,0,0,0
0,0,0,0,0,0,0,0,0
0,0,0,0,0,0,0,0,0
0,0,0,0,0,0,0,0,0
36148,212,2,51,50,1,1,1,0
27925,35,1,0,0,0,1,0,0
0,0,0,0,0,0,0,0,0
0,0,0,0,0,0,0,0,0
0,0,0,0,0,0,0,0,0
0,0,0,0,0,0,0,0,0
23357,226,3,24,1,23,0,1,0
0,0,0,0,0,0,0,0,0
0,0,0,0,0,0,0,0,0
0,0,0,0,0,0,0,0,0
0,0,0,0,0,0,0,0,0
0,0,0,0,0,0,0,0,0
0,0,0,0,0,0,0,0,0
0,0,0,0,0,0,0,0,0
0,0,0,0,0,0,0,0,0
0,0,0,0,0,0,0,0,0
0,0,0,0,0,0,0,0,0
0,0,0,0,0,0,0,0,0
0,0,0,0,0,0,0,0,0
0,0,0,0,0,0,0,0,0
0,0,0,0,0,0,0,0,0
0,0,0,0,0,0,0,0,0
341014,2081,8,76,72,4,18,1,0
16912,237,5,47,39,8,2,1,0
0,0,0,0,0,0,0,0,0
0,0,0,0,0,0,0,0,0
0,0,0,0,0,0,0,0,0
0,0,0,0,0,0,0,0,0
0,0,0,0,0,0,0,0,0
5910,32,1,2,1,1,0,0,0
0,0,0,0,0,0,0,0,0
0,0,0,0,0,0,0,0,0
0,0,0,0,0,0,0,0,0
22003,33,0,1,1,0,0,1,0
11615,66,4,8,0,8,0,1,0
0,0,0,0,0,0,0,0,0
362057,2222,13,63,39,24,25,1,0
0,0,0,0,0,0,0,0,0
3385,41,0,6,0,6,0,0,0
3385,41,0,6,0,6,0,0,0
0,0,0,0,0,0,0,0,0
313912,187,4,26,18,8,2,1,0
0,0,0,0,0,0,0,0,0
0,0,0,0,0,0,0,0,0
0,0,0,0,0,0,0,0,0
0,0,0,0,0,0,0,0,0
0,0,0,0,0,0,0,0,0
0,0,0,0,0,0,0,0,0
4362,30,0,2,2,0,0,1,0
267240,1528,14,87,83,4,4,1,0
0,0,0,0,0,0,0,0,0
0,0,0,0,0,0,0,0,0
65721,247,0,46,24,22,0,1,1
65709,247,0,46,24,22,0,1,1
0,0,0,0,0,0,0,0,0
0,0,0,0,0,0,0,0,0
0,0,0,0,0,0,0,0,0
0,0,0,0,0,0,0,0,0
0,0,0,0,0,0,0,0,0
0,0,0,0,0,0,0,0,0
0,0,0,0,0,0,0,0,0
0,0,0,0,0,0,0,0,0
0,0,0,0,0,0,0,0,0
0,0,0,0,0,0,0,0,0
267240,1528,14,87,83,4,4,1,0
3141,39,2,1,0,1,0,0,0
0,0,0,0,0,0,0,0,0
0,0,0,0,0,0,0,0,0
0,0,0,0,0,0,0,0,0
0,0,0,0,0,0,0,0,0
0,0,0,0,0,0,0,0,0
0,0,0,0,0,0,0,0,0
0,0,0,0,0,0,0,0,0
0,0,0,0,0,0,0,0,0
0,0,0,0,0,0,0,0,0
0,0,0,0,0,0,0,0,0
0,0,0,0,0,0,0,0,0
0,0,0,0,0,0,0,0,0
0,0,0,0,0,0,0,0,0
0,0,0,0,0,0,0,0,0
93521,84,0,15,15,0,6,0,0
0,0,0,0,0,0,0,0,0
0,0,0,0,0,0,0,0,0
0,0,0,0,0,0,0,0,0
0,0,0,0,0,0,0,0,0
0,0,0,0,0,0,0,0,0
0,0,0,0,0,0,0,0,0
0,0,0,0,0,0,0,0,0
0,0,0,0,0,0,0,0,0
0,0,0,0,0,0,0,0,0
0,0,0,0,0,0,0,0,0
0,0,0,0,0,0,0,0,0
0,0,0,0,0,0,0,0,0
0,0,0,0,0,0,0,0,0
0,0,0,0,0,0,0,0,0
0,0,0,0,0,0,0,0,0
4521,57,4,8,8,0,2,0,0
0,0,0,0,0,0,0,0,0
0,0,0,0,0,0,0,0,0
0,0,0,0,0,0,0,0,0
0,0,0,0,0,0,0,0,0
0,0,0,0,0,0,0,0,0
4194,94,2,3,0,3,0,0,0
0,0,0,0,0,0,0,0,0
0,0,0,0,0,0,0,0,0
0,0,0,0,0,0,0,0,0
0,0,0,0,0,0,0,0,0
0,0,0,0,0,0,0,0,0
0,0,0,0,0,0,0,0,0
183688,180,4,26,18,8,2,1,0
0,0,0,0,0,0,0,0,0
0,0,0,0,0,0,0,0,0
13846,214,1,26,21,5,2,1,0
0,0,0,0,0,0,0,0,0
0,0,0,0,0,0,0,0,0
984,20,0,0,0,0,0,0,0
4391,30,0,2,2,0,0,1,0
0,0,0,0,0,0,0,0,0
0,0,0,0,0,0,0,0,0
0,0,0,0,0,0,0,0,0
0,0,0,0,0,0,0,0,0
0,0,0,0,0,0,0,0,0
0,0,0,0,0,0,0,0,0
0,0,0,0,0,0,0,0,0
0,0,0,0,0,0,0,0,0
0,0,0,0,0,0,0,0,0
0,0,0,0,0,0,0,0,0
0,0,0,0,0,0,0,0,0
7570,120,0,4,1,3,0,0,0
7570,120,0,4,1,3,0,0,0
0,0,0,0,0,0,0,0,0
0,0,0,0,0,0,0,0,0
0,0,0,0,0,0,0,0,0
0,0,0,0,0,0,0,0,0
0,0,0,0,0,0,0,0,0
0,0,0,0,0,0,0,0,0
0,0,0,0,0,0,0,0,0
0,0,0,0,0,0,0,0,0
0,0,0,0,0,0,0,0,0
0,0,0,0,0,0,0,0,0
0,0,0,0,0,0,0,0,0
0,0,0,0,0,0,0,0,0
0,0,0,0,0,0,0,0,0
0,0,0,0,0,0,0,0,0
0,0,0,0,0,0,0,0,0
0,0,0,0,0,0,0,0,0
0,0,0,0,0,0,0,0,0
0,0,0,0,0,0,0,0,0
0,0,0,0,0,0,0,0,0
0,0,0,0,0,0,0,0,0
0,0,0,0,0,0,0,0,0
23357,226,3,24,24,0,0,1,0
0,0,0,0,0,0,0,0,0
267949,185,4,26,18,8,2,1,0
0,0,0,0,0,0,0,0,0
0,0,0,0,0,0,0,0,0
0,0,0,0,0,0,0,0,0
0,0,0,0,0,0,0,0,0
65648,247,0,46,24,22,0,1,1
65649,247,0,46,24,22,0,1,1
65648,247,0,46,24,22,0,1,1
65646,247,0,46,24,22,0,1,1
0,0,0,0,0,0,0,0,0
0,0,0,0,0,0,0,0,0
0,0,0,0,0,0,0,0,0
0,0,0,0,0,0,0,0,0
0,0,0,0,0,0,0,0,0
0,0,0,0,0,0,0,0,0
0,0,0,0,0,0,0,0,0
219828,523,7,56,51,5,0,1,0
66799,312,8,27,24,3,19,1,0
24009,287,9,8,5,3,0,0,0
0,0,0,0,0,0,0,0,0
0,0,0,0,0,0,0,0,0
0,0,0,0,0,0,0,0,0
0,0,0,0,0,0,0,0,0
0,0,0,0,0,0,0,0,0
0,0,0,0,0,0,0,0,0
0,0,0,0,0,0,0,0,0
0,0,0,0,0,0,0,0,0
0,0,0,0,0,0,0,0,0
9233,125,1,5,5,0,0,0,0
0,0,0,0,0,0,0,0,0
0,0,0,0,0,0,0,0,0
0,0,0,0,0,0,0,0,0
414896,1340,1,157,27,130,11,1,0
0,0,0,0,0,0,0,0,0
0,0,0,0,0,0,0,0,0
0,0,0,0,0,0,0,0,0
0,0,0,0,0,0,0,0,0
236087,2883,8,303,289,14,11,0,0
143291,259,1,20,7,13,7,1,0
0,0,0,0,0,0,0,0,0
11666,50,0,5,0,5,0,0,0
0,0,0,0,0,0,0,0,0
0,0,0,0,0,0,0,0,0
23815,163,2,12,1,11,4,1,0
0,0,0,0,0,0,0,0,0
0,0,0,0,0,0,0,0,0
179623,1689,1,181,180,1,1,1,0
180047,1689,1,181,180,1,1,1,0
0,0,0,0,0,0,0,0,0
0,0,0,0,0,0,0,0,0
17393,245,0,5,5,0,6,1,0
0,0,0,0,0,0,0,0,0
0,0,0,0,0,0,0,0,0
0,0,0,0,0,0,0,0,0
0,0,0,0,0,0,0,0,0
0,0,0,0,0,0,0,0,0
0,0,0,0,0,0,0,0,0
0,0,0,0,0,0,0,0,0
0,0,0,0,0,0,0,0,0
0,0,0,0,0,0,0,0,0
0,0,0,0,0,0,0,0,0
0,0,0,0,0,0,0,0,0
0,0,0,0,0,0,0,0,0
0,0,0,0,0,0,0,0,0
0,0,0,0,0,0,0,0,0
0,0,0,0,0,0,0,0,0
0,0,0,0,0,0,0,0,0
0,0,0,0,0,0,0,0,0
0,0,0,0,0,0,0,0,0
0,0,0,0,0,0,0,0,0
26914,37,0,1,0,1,0,0,0
26914,37,0,1,0,1,0,0,0
0,0,0,0,0,0,0,0,0
0,0,0,0,0,0,0,0,0
0,0,0,0,0,0,0,0,0
0,0,0,0,0,0,0,0,0
0,0,0,0,0,0,0,0,0
0,0,0,0,0,0,0,0,0
0,0,0,0,0,0,0,0,0
0,0,0,0,0,0,0,0,0
0,0,0,0,0,0,0,0,0
0,0,0,0,0,0,0,0,0
16312,89,0,15,1,14,0,1,0
0,0,0,0,0,0,0,0,0
0,0,0,0,0,0,0,0,0
21867,33,0,1,1,0,0,1,0
21851,33,0,1,1,0,0,1,0
0,0,0,0,0,0,0,0,0
143269,259,1,20,7,13,7,1,0
0,0,0,0,0,0,0,0,0
680174,543,0,4,0,4,2,1,1
705097,553,0,5,5,0,2,1,1
703178,539,0,5,5,0,2,1,1
675780,543,0,4,4,0,2,1,1
0,0,0,0,0,0,0,0,0
0,0,0,0,0,0,0,0,0
744858,507,4,15,1,14,0,1,0
744858,507,4,15,15,0,0,1,0
0,0,0,0,0,0,0,0,0
0,0,0,0,0,0,0,0,0
0,0,0,0,0,0,0,0,0
682015,557,0,4,0,4,2,1,1
0,0,0,0,0,0,0,0,0
22561,39,0,3,1,2,0,1,0
0,0,0,0,0,0,0,0,0
0,0,0,0,0,0,0,0,0
0,0,0,0,0,0,0,0,0
0,0,0,0,0,0,0,0,0
0,0,0,0,0,0,0,0,0
0,0,0,0,0,0,0,0,0
0,0,0,0,0,0,0,0,0
0,0,0,0,0,0,0,0,0
15086,89,4,9,6,3,2,0,0
47498,143,1,3,0,3,1,0,0
0,0,0,0,0,0,0,0,0
0,0,0,0,0,0,0,0,0
0,0,0,0,0,0,0,0,0
82131,193,3,13,8,5,5,1,0
82131,193,3,13,8,5,5,1,0
584,10,0,0,0,0,0,0,0
584,10,0,0,0,0,0,0,0
0,0,0,0,0,0,0,0,0
3385,41,0,6,0,6,0,0,0
675273,543,0,4,4,0,2,1,1
347079,64,1,5,5,0,0,1,0
0,0,0,0,0,0,0,0,0
249267,430,1,48,0,48,0,1,0
0,0,0,0,0,0,0,0,0
8911,34,0,2,2,0,0,0,0
13976,196,6,19,18,1,0,1,0
0,0,0,0,0,0,0,0,0
0,0,0,0,0,0,0,0,0
13690,38,2,0,0,0,2,0,0
0,0,0,0,0,0,0,0,0
0,0,0,0,0,0,0,0,0
0,0,0,0,0,0,0,0,0
65648,247,0,46,24,22,0,1,1
65647,247,0,46,24,22,0,1,1
0,0,0,0,0,0,0,0,0
65649,247,0,46,24,22,0,1,1
0,0,0,0,0,0,0,0,0
943,5,0,0,0,0,0,0,0
943,5,0,0,0,0,0,0,0
0,0,0,0,0,0,0,0,0
0,0,0,0,0,0,0,0,0
22323,321,6,67,59,8,2,1,0
0,0,0,0,0,0,0,0,0
0,0,0,0,0,0,0,0,0
678127,557,0,4,4,0,2,1,1
0,0,0,0,0,0,0,0,0
0,0,0,0,0,0,0,0,0
0,0,0,0,0,0,0,0,0
706687,553,0,5,5,0,2,1,1
0,0,0,0,0,0,0,0,0
0,0,0,0,0,0,0,0,0
0,0,0,0,0,0,0,0,0
0,0,0,0,0,0,0,0,0
143010,258,1,20,7,13,7,1,0
0,0,0,0,0,0,0,0,0
212357,812,17,45,33,12,8,1,0
0,0,0,0,0,0,0,0,0
103245,677,12,43,40,3,1,0,0
0,0,0,0,0,0,0,0,0
0,0,0,0,0,0,0,0,0
0,0,0,0,0,0,0,0,0
0,0,0,0,0,0,0,0,0
0,0,0,0,0,0,0,0,0
0,0,0,0,0,0,0,0,0
0,0,0,0,0,0,0,0,0
0,0,0,0,0,0,0,0,0
0,0,0,0,0,0,0,0,0
5209,47,4,0,0,0,2,1,0
0,0,0,0,0,0,0,0,0
0,0,0,0,0,0,0,0,0
327879,32,0,0,0,0,0,0,0
3479,48,0,1,1,0,0,0,0
3479,48,0,1,1,0,0,0,0
11486,127,1,16,12,4,1,1,0
11486,127,1,16,12,4,1,1,0
0,0,0,0,0,0,0,0,0
0,0,0,0,0,0,0,0,0
0,0,0,0,0,0,0,0,0
0,0,0,0,0,0,0,0,0
0,0,0,0,0,0,0,0,0
0,0,0,0,0,0,0,0,0
65646,247,0,46,24,22,0,1,1
0,0,0,0,0,0,0,0,0
0,0,0,0,0,0,0,0,0
0,0,0,0,0,0,0,0,0
0,0,0,0,0,0,0,0,0
0,0,0,0,0,0,0,0,0
0,0,0,0,0,0,0,0,0
0,0,0,0,0,0,0,0,0
0,0,0,0,0,0,0,0,0
0,0,0,0,0,0,0,0,0
0,0,0,0,0,0,0,0,0
0,0,0,0,0,0,0,0,0
0,0,0,0,0,0,0,0,0
0,0,0,0,0,0,0,0,0
0,0,0,0,0,0,0,0,0
0,0,0,0,0,0,0,0,0
0,0,0,0,0,0,0,0,0
0,0,0,0,0,0,0,0,0
0,0,0,0,0,0,0,0,0
0,0,0,0,0,0,0,0,0
0,0,0,0,0,0,0,0,0
0,0,0,0,0,0,0,0,0
7513,49,0,3,3,0,1,0,1
86750,693,1,44,7,37,4,1,0
311570,891,3,103,81,22,5,1,0
0,0,0,0,0,0,0,0,0
0,0,0,0,0,0,0,0,0
0,0,0,0,0,0,0,0,0
143317,259,1,20,7,13,7,1,0
1396741,3496,9,561,533,28,1,1,0
0,0,0,0,0,0,0,0,0
33987,236,10,7,7,0,0,1,0
0,0,0,0,0,0,0,0,0
320626,909,4,48,44,4,4,1,0
320626,909,4,48,39,9,4,1,0
0,0,0,0,0,0,0,0,0
136889,569,11,51,49,2,3,1,0
6376,65,7,3,2,1,0,0,0
6376,65,7,3,2,1,0,0,0
0,0,0,0,0,0,0,0,0
3385,41,0,6,0,6,0,0,0
15334,142,0,56,51,5,0,0,0
1813246,81,4,6,6,0,5,0,0
162240,218,4,26,18,8,2,1,0
0,0,0,0,0,0,0,0,0
88501,57,4,5,5,0,2,0,0
0,0,0,0,0,0,0,0,0
0,0,0,0,0,0,0,0,0
167235,450,10,8,8,0,3,1,0
34075,51,3,0,0,0,2,0,0
8242,146,0,15,15,0,5,1,0
1242267,126,2,17,17,0,2,0,0
130276,368,8,31,31,0,2,1,0
0,0,0,0,0,0,0,0,0
133518,821,9,65,56,9,7,1,0
0,0,0,0,0,0,0,0,0
178270,936,11,39,34,5,3,1,0
0,0,0,0,0,0,0,0,0
247182,1728,5,108,101,7,0,1,0
0,0,0,0,0,0,0,0,0
65648,247,0,46,24,22,0,1,1
65650,247,0,46,24,22,0,1,1
66851,253,0,46,24,22,0,1,1
137671,178,0,6,3,3,0,1,0
137671,178,0,6,3,3,0,1,0
14207,83,2,0,0,0,0,0,0
14207,83,2,0,0,0,0,0,0
0,0,0,0,0,0,0,0,0
0,0,0,0,0,0,0,0,0
0,0,0,0,0,0,0,0,0
0,0,0,0,0,0,0,0,0
314650,1723,12,127,69,58,0,1,0
0,0,0,0,0,0,0,0,0
0,0,0,0,0,0,0,0,0
71175,192,0,32,16,16,0,0,0
0,0,0,0,0,0,0,0,0
0,0,0,0,0,0,0,0,0
0,0,0,0,0,0,0,0,0
0,0,0,0,0,0,0,0,0
106795,672,3,140,130,10,8,0,0
35670,158,3,8,4,4,10,1,0
33585,154,3,8,4,4,10,1,0
33660,661,10,120,112,8,0,1,0
33660,661,10,120,112,8,0,1,0
33660,661,10,120,112,8,0,1,0
154638,955,11,118,100,18,3,0,0
0,0,0,0,0,0,0,0,0
0,0,0,0,0,0,0,0,0
6748,91,3,0,0,0,0,0,0
6748,91,3,0,0,0,0,0,0
94407,42,4,0,0,0,2,1,0
0,0,0,0,0,0,0,0,0
0,0,0,0,0,0,0,0,0
0,0,0,0,0,0,0,0,0
0,0,0,0,0,0,0,0,0
0,0,0,0,0,0,0,0,0
1816890,248,4,4,4,0,0,1,0
0,0,0,0,0,0,0,0,0
0,0,0,0,0,0,0,0,0
0,0,0,0,0,0,0,0,0
65648,247,0,46,24,22,0,1,1
0,0,0,0,0,0,0,0,0
0,0,0,0,0,0,0,0,0
0,0,0,0,0,0,0,0,0
0,0,0,0,0,0,0,0,0
0,0,0,0,0,0,0,0,0
0,0,0,0,0,0,0,0,0
8410,74,6,3,2,1,0,0,0
0,0,0,0,0,0,0,0,0
0,0,0,0,0,0,0,0,0
674602,543,0,4,4,0,2,1,1
0,0,0,0,0,0,0,0,0
0,0,0,0,0,0,0,0,0
0,0,0,0,0,0,0,0,0
0,0,0,0,0,0,0,0,0
0,0,0,0,0,0,0,0,0
0,0,0,0,0,0,0,0,0
589310,227,5,29,23,6,0,1,0
0,0,0,0,0,0,0,0,0
0,0,0,0,0,0,0,0,0
0,0,0,0,0,0,0,0,0
0,0,0,0,0,0,0,0,0
0,0,0,0,0,0,0,0,0
0,0,0,0,0,0,0,0,0
0,0,0,0,0,0,0,0,0
0,0,0,0,0,0,0,0,0
0,0,0,0,0,0,0,0,0
0,0,0,0,0,0,0,0,0
0,0,0,0,0,0,0,0,0
0,0,0,0,0,0,0,0,0
0,0,0,0,0,0,0,0,0
0,0,0,0,0,0,0,0,0
0,0,0,0,0,0,0,0,0
0,0,0,0,0,0,0,0,0
0,0,0,0,0,0,0,0,0
0,0,0,0,0,0,0,0,0
0,0,0,0,0,0,0,0,0
3436,54,0,0,0,0,0,1,0
26892,36,0,3,1,2,0,0,0
8189,123,7,11,11,0,0,1,0
11666,50,0,5,0,5,0,0,0
0,0,0,0,0,0,0,0,0
0,0,0,0,0,0,0,0,0
109412,957,6,131,126,5,14,0,0
0,0,0,0,0,0,0,0,0
89678,401,6,70,66,4,31,1,0
