page_len,page_tag_num,page_tech_num,page_domain_type_num,page_like_req_domain_num,page_unlike_req_domain_num,page_hidden_tag_num,page_have_copyright,page_have_redirect
207800,273,0,17,14,3,0,1,0
0,0,0,0,0,0,0,0,0
63294,238,0,46,41,5,0,1,1
109026,391,0,46,40,6,1,1,1
488217,312,2,54,51,3,14,1,1
26940,243,1,13,7,6,9,1,0
414228,1421,1,180,53,127,10,1,0
35496,353,0,7,5,2,4,0,0
752351,2961,1,344,310,34,11,1,0
84629,992,0,329,326,3,0,0,0
0,0,0,0,0,0,0,0,0
211618,277,0,18,10,8,0,1,0
189684,193,3,29,28,1,2,1,0
174258,108,2,6,6,0,2,1,0
348802,857,4,115,12,103,10,1,0
250306,696,4,115,84,31,7,1,0
318189,1339,2,346,98,248,2,1,0
163636,332,1,73,24,49,0,1,0
0,0,0,0,0,0,0,0,0
486086,4007,2,1278,983,295,27,1,0
216664,1759,1,198,38,160,3,1,0
33153,331,3,11,3,8,0,1,0
208502,277,0,18,9,9,0,1,0
0,0,0,0,0,0,0,0,0
0,0,0,0,0,0,0,0,0
107430,240,0,37,33,4,2,1,0
1841984,2126,0,133,15,118,6,0,0
314499,376,0,44,30,14,11,1,1
129,4,0,0,0,0,0,0,1
347828,223,0,0,0,0,0,1,0
348944,212,0,0,0,0,0,1,0
272326,1548,2,343,285,58,4,1,0
0,0,0,0,0,0,0,0,0
216898,277,0,18,9,9,0,1,0
699289,2192,1,302,284,18,11,1,0
345722,646,2,69,39,30,4,1,0
182517,239,1,14,1,13,0,1,0
273806,633,2,122,105,17,0,1,0
214931,234,0,48,32,16,2,1,0
0,0,0,0,0,0,0,0,0
210280,277,0,18,9,9,0,1,0
0,0,0,0,0,0,0,0,0
208491,278,0,18,9,9,0,1,0
849529,4206,1,369,326,43,94,1,0
29239,180,2,8,8,0,0,0,0
210324,277,0,18,11,7,0,1,0
3124,27,0,13,2,11,0,1,0
390938,602,1,20,18,2,0,0,0
301089,1594,1,267,13,254,2,0,0
208552,277,0,18,9,9,0,1,0
0,0,0,0,0,0,0,0,0
0,0,0,0,0,0,0,0,0
254817,819,4,120,94,26,11,1,0
309195,1990,5,220,197,23,6,0,0
207936,277,0,18,9,9,0,1,0
207590,277,0,18,9,9,0,1,0
165705,291,2,16,16,0,0,0,0
704220,541,0,4,0,4,2,1,1
0,0,0,0,0,0,0,0,0
0,0,0,0,0,0,0,0,0
395774,1793,3,45,35,10,2,0,0
148127,556,6,45,20,25,0,1,0
104325,966,3,54,50,4,4,1,0
27061,131,3,11,10,1,3,0,0
744923,2611,5,314,294,20,9,1,0
0,0,0,0,0,0,0,0,0
1648643,1679,2,267,251,16,0,1,0
0,0,0,0,0,0,0,0,0
168197,972,2,118,91,27,0,1,0
56274,394,3,46,44,2,2,0,0
281975,1371,1,281,252,29,0,1,0
208483,277,0,18,12,6,0,1,0
804769,2120,2,129,111,18,0,1,0
113665,105,0,7,6,1,0,1,0
30559,349,3,82,56,26,1,1,0
67121,388,3,35,29,6,3,1,0
207899,273,0,17,9,8,0,1,0
0,0,0,0,0,0,0,0,0
423051,1336,1,208,179,29,5,1,0
208465,277,0,18,13,5,0,1,0
208442,277,0,18,11,7,0,1,0
455148,1436,1,208,153,55,2,1,0
249016,963,0,175,9,166,30,1,0
0,0,0,0,0,0,0,0,0
476183,4735,3,963,910,53,81,1,0
0,0,0,0,0,0,0,0,0
522594,3752,6,557,526,31,7,1,0
210430,277,0,18,10,8,0,1,0
218140,292,3,88,88,0,3,0,0
222082,1638,0,113,101,12,2,1,0
52500,319,0,9,9,0,2,0,0
49254,1261,0,359,357,2,8,1,0
81810,77,0,11,11,0,1,1,0
5636,26,0,2,1,1,0,1,0
333653,1288,4,133,22,111,0,1,0
0,0,0,0,0,0,0,0,0
155484,1236,4,70,63,7,9,1,0
40136,163,4,14,13,1,7,1,0
781731,3034,1,366,329,37,12,1,0
594690,1773,4,295,75,220,4,1,0
358720,2796,0,386,377,9,10,1,0
89334,680,0,147,144,3,4,1,0
165705,291,2,16,16,0,0,0,0
704278,542,0,4,0,4,2,1,1
660015,2578,1,325,290,35,11,1,0
61114,462,2,87,82,5,2,1,0
10541,118,4,16,16,0,3,1,0
3177790,2866,8,435,178,257,36,1,0
0,0,0,0,0,0,0,0,0
357928,5861,4,1388,148,1240,12,0,0
18946,53,1,1,1,0,1,0,0
26942,39,0,2,1,1,0,0,0
53858,831,3,178,135,43,2,1,0
208435,277,0,18,9,9,0,1,0
208477,277,0,18,12,6,0,1,0
262958,579,0,116,110,6,1,0,0
8767,151,0,14,13,1,5,1,0
1157984,1551,3,135,130,5,0,0,0
405182,486,4,40,33,7,7,0,0
90100,433,2,54,33,21,2,1,0
322712,2737,5,674,659,15,2,1,0
0,0,0,0,0,0,0,0,0
0,0,0,0,0,0,0,0,0
160278,2783,3,546,355,191,2,0,0
0,0,0,0,0,0,0,0,0
0,0,0,0,0,0,0,0,0
227263,1177,0,73,50,23,0,1,1
1300668,4365,1,686,627,59,4,1,0
0,0,0,0,0,0,0,0,0
0,0,0,0,0,0,0,0,0
422229,1118,1,347,343,4,0,1,0
77785,267,0,38,35,3,0,1,0
0,0,0,0,0,0,0,0,0
13181,145,0,37,33,4,0,1,0
0,0,0,0,0,0,0,0,0
0,0,0,0,0,0,0,0,0
208535,277,0,18,15,3,0,1,0
707299,2971,6,285,281,4,3,1,0
295242,126,2,7,6,1,0,1,0
643845,2906,1,174,140,34,0,1,0
208075,277,0,18,12,6,0,1,0
210473,277,0,18,15,3,0,1,0
695738,2115,14,127,8,119,1,1,0
32705,123,3,4,2,2,1,0,0
674918,2795,1,206,193,13,8,1,0
1072313,860,7,125,93,32,23,1,0
1582493,1705,1,227,214,13,5,1,0
0,0,0,0,0,0,0,0,0
0,0,0,0,0,0,0,0,0
661717,2237,2,413,358,55,5,1,0
24945,179,0,17,9,8,2,1,0
208352,277,0,18,10,8,0,1,0
210253,277,0,18,12,6,0,1,0
205428,1427,3,404,377,27,4,1,0
0,0,0,0,0,0,0,0,0
0,0,0,0,0,0,0,0,0
207847,273,0,17,11,6,0,1,0
0,0,0,0,0,0,0,0,0
210036,277,0,18,9,9,0,1,0
0,0,0,0,0,0,0,0,0
411370,3606,1,325,325,0,3,1,0
0,0,0,0,0,0,0,0,0
170507,184,0,17,17,0,1,1,0
208259,277,0,18,9,9,0,1,0
25964,105,3,2,2,0,5,0,0
15788,176,2,17,16,1,0,1,0
17528,56,1,0,0,0,0,0,0
229529,1569,8,304,252,52,9,1,0
0,0,0,0,0,0,0,0,0
989104,3450,9,349,316,33,34,1,0
0,0,0,0,0,0,0,0,0
306297,381,1,95,39,56,0,1,0
215539,234,0,50,33,17,2,1,0
1544444,2797,10,322,307,15,8,1,1
6678,67,1,8,6,2,2,0,0
0,0,0,0,0,0,0,0,0
1800611,8763,7,1203,1175,28,29,1,0
510356,1022,1,150,28,122,3,1,0
106578,1267,0,224,213,11,7,1,0
0,0,0,0,0,0,0,0,0
237299,2654,9,402,380,22,17,1,0
288585,1276,6,324,302,22,20,1,0
304602,767,8,114,94,20,19,1,0
0,0,0,0,0,0,0,0,0
114747,740,2,111,67,44,2,1,0
10779,99,2,17,14,3,3,1,0
1187203,3079,7,591,381,210,7,1,0
202653,559,1,64,62,2,0,1,0
161145,148,1,18,18,0,1,0,0
159628,62,0,2,2,0,0,1,0
564406,3920,6,565,352,213,51,1,1
196050,626,1,125,121,4,1,1,0
41367,154,4,13,1,12,2,1,0
413996,2414,2,185,169,16,1,1,0
209075,273,0,17,4,13,0,1,0
1496116,2325,5,198,190,8,1,1,0
1601369,2384,5,201,192,9,4,1,0
0,0,0,0,0,0,0,0,0
277468,2081,8,331,303,28,50,1,0
329874,1573,3,402,390,12,1,1,0
251047,362,3,88,77,11,1,1,0
41583,200,1,24,18,6,2,1,0
62303,471,1,43,34,9,1,1,0
222607,1237,1,194,189,5,3,1,0
383701,1754,1,132,132,0,24,1,0
0,0,0,0,0,0,0,0,0
209196,277,0,18,9,9,0,1,0
997126,2175,5,230,217,13,16,1,0
0,0,0,0,0,0,0,0,0
208881,277,0,18,10,8,0,1,0
0,0,0,0,0,0,0,0,0
1166675,1697,5,279,221,58,19,1,0
181178,1940,4,299,207,92,8,1,0
208231,277,0,18,12,6,0,1,0
0,0,0,0,0,0,0,0,0
272186,1994,5,421,341,80,19,1,0
863470,4340,2,315,303,12,1,1,0
59668,215,2,20,18,2,3,1,0
371078,1069,7,150,128,22,23,1,0
97476,316,2,18,15,3,3,1,0
0,0,0,0,0,0,0,0,0
0,0,0,0,0,0,0,0,0
393582,802,1,73,57,16,0,1,0
6885,75,1,9,9,0,0,0,0
83588,1004,3,347,293,54,0,1,0
14361,99,2,3,3,0,0,0,0
527044,1754,1,298,262,36,12,1,0
2195656,3143,6,433,430,3,8,1,0
48748,146,5,4,4,0,1,0,0
564199,1949,7,212,209,3,6,0,0
103085,279,7,11,11,0,6,0,0
130293,564,12,102,86,16,9,0,0
304347,517,2,39,38,1,3,0,0
64771,744,8,37,37,0,11,1,0
39819,362,7,49,45,4,3,1,0
0,0,0,0,0,0,0,0,0
368821,2157,1,335,152,183,18,0,0
674408,4310,11,721,671,50,27,1,0
0,0,0,0,0,0,0,0,0
381984,2088,4,428,418,10,7,1,0
197227,865,2,158,149,9,0,1,0
210424,277,0,18,12,6,0,1,0
827922,2879,1,429,388,41,12,1,0
408300,1233,1,371,346,25,13,0,0
346739,1535,5,221,195,26,1,1,0
338801,3998,3,1062,1049,13,48,1,0
0,0,0,0,0,0,0,0,0
753605,2823,5,297,268,29,5,1,0
360848,1235,4,136,128,8,0,1,0
377097,1150,5,14,12,2,16,1,0
999544,991,7,201,172,29,18,1,0
1210371,1165,2,156,150,6,0,1,0
288397,1499,1,72,71,1,0,0,0
0,0,0,0,0,0,0,0,0
23019,77,2,0,0,0,0,0,0
97998,742,2,146,124,22,1,1,0
1342509,3510,2,600,271,329,2,1,0
0,0,0,0,0,0,0,0,0
208484,277,0,18,15,3,0,1,0
462483,4090,2,633,368,265,2,1,0
1301,15,0,2,0,2,0,0,0
29256,302,2,43,42,1,2,1,0
19049,52,0,0,0,0,0,0,0
434321,2179,1,655,631,24,1,1,0
156410,1426,11,421,410,11,15,1,0
0,0,0,0,0,0,0,0,0
331068,1092,3,98,88,10,14,1,0
0,0,0,0,0,0,0,0,0
208561,277,0,18,15,3,0,1,0
0,0,0,0,0,0,0,0,0
386187,1166,3,141,138,3,1,0,0
265595,595,3,49,47,2,1,0,0
112534,38,0,1,1,0,2,0,0
348395,1764,8,166,82,84,8,1,0
315258,2509,9,474,462,12,9,1,0
59530,174,9,6,4,2,1,0,0
295694,2168,2,313,308,5,1,1,0
210395,277,0,18,9,9,0,1,0
206933,1353,4,176,151,25,59,1,0
42388,436,3,80,50,30,60,1,0
11077,90,3,22,19,3,0,1,0
22880,192,3,23,17,6,1,1,0
685443,1944,3,179,111,68,3,1,0
0,0,0,0,0,0,0,0,0
0,0,0,0,0,0,0,0,0
112531,38,0,1,1,0,2,0,0
12532,148,1,17,8,9,1,0,0
13680,255,2,37,18,19,9,1,0
208480,277,0,18,9,9,0,1,0
0,0,0,0,0,0,0,0,0
0,0,0,0,0,0,0,0,0
47947,301,2,41,19,22,2,1,0
28169,160,1,13,5,8,2,1,0
648333,2083,3,123,114,9,0,1,0
0,0,0,0,0,0,0,0,0
0,0,0,0,0,0,0,0,0
399892,2869,6,667,529,138,26,1,0
0,0,0,0,0,0,0,0,0
518900,2642,2,389,372,17,37,1,0
44395,461,1,89,73,16,61,1,0
154506,610,3,33,27,6,1,1,0
0,0,0,0,0,0,0,0,0
397867,1406,3,232,222,10,2,0,0
398288,1408,3,232,222,10,2,0,0
450023,1507,7,304,297,7,3,1,0
15321,122,6,11,11,0,4,0,0
0,0,0,0,0,0,0,0,0
210408,277,0,18,12,6,0,1,0
1204674,2870,4,136,110,26,0,1,0
61181,253,9,7,0,7,12,0,0
56838,639,2,160,142,18,0,1,0
700536,2873,6,220,214,6,30,1,1
0,0,0,0,0,0,0,0,0
296100,738,4,57,19,38,4,0,0
212323,225,0,46,31,15,2,1,0
0,0,0,0,0,0,0,0,0
287691,1998,5,669,650,19,12,1,0
250286,1706,4,597,572,25,12,1,0
5987,80,1,9,9,0,2,0,0
0,0,0,0,0,0,0,0,0
0,0,0,0,0,0,0,0,0
760964,1370,4,103,99,4,0,1,0
0,0,0,0,0,0,0,0,0
723792,747,4,75,63,12,6,1,0
31318,40,0,0,0,0,0,0,0
125003,965,6,227,201,26,7,1,0
364380,472,5,41,10,31,17,1,0
0,0,0,0,0,0,0,0,0
425315,1603,1,366,134,232,12,1,0
377515,3180,4,235,228,7,8,1,0
229085,334,4,46,39,7,8,1,0
210399,277,0,18,10,8,0,1,0
1067245,2376,3,215,212,3,0,1,0
0,0,0,0,0,0,0,0,0
0,0,0,0,0,0,0,0,0
5023,63,1,12,9,3,0,0,0
209956,294,0,16,10,6,1,1,0
0,0,0,0,0,0,0,0,0
236706,1176,3,77,73,4,4,1,0
105625,224,4,6,4,2,2,0,0
219847,1115,3,240,222,18,3,1,0
0,0,0,0,0,0,0,0,0
0,0,0,0,0,0,0,0,0
0,0,0,0,0,0,0,0,0
0,0,0,0,0,0,0,0,0
0,0,0,0,0,0,0,0,0
4150034,11978,10,1523,1515,8,16,1,0
67494,807,6,120,21,99,26,1,0
0,0,0,0,0,0,0,0,0
798072,5789,2,1543,1286,257,72,1,0
12575,167,2,24,23,1,2,1,0
0,0,0,0,0,0,0,0,0
208501,277,0,18,14,4,0,1,0
0,0,0,0,0,0,0,0,0
1225881,5112,2,1012,954,58,7,1,0
424425,610,0,35,33,2,0,1,0
417121,953,1,91,59,32,0,1,0
18821,102,0,24,16,8,0,0,0
1055039,4130,1,488,240,248,2,1,0
5902,61,0,3,2,1,0,1,0
122101,601,5,101,91,10,3,1,0
0,0,0,0,0,0,0,0,0
6195,54,1,0,0,0,0,0,1
104950,1295,2,419,409,10,18,1,0
9673,156,0,15,1,14,1,1,0
5843,124,1,10,10,0,1,1,0
208449,277,0,18,9,9,0,1,0
0,0,0,0,0,0,0,0,0
133186,1596,2,580,566,14,52,1,0
904156,4966,4,376,365,11,235,1,0
499990,2640,9,613,360,253,18,1,0
54239,599,6,137,131,6,5,1,0
145092,136,0,8,6,2,0,1,0
137880,670,5,75,58,17,0,0,0
151604,1227,7,67,67,0,10,0,0
153359,1284,9,234,161,73,21,0,0
106349,934,1,41,36,5,4,1,0
210453,277,0,18,9,9,0,1,0
687888,2173,2,494,10,484,15,1,0
208406,277,0,18,9,9,0,1,0
283186,1165,2,284,284,0,10,1,0
59462,358,3,33,24,9,14,1,0
9685,156,0,15,1,14,1,1,0
5843,124,1,10,10,0,1,1,0
563660,2234,5,367,340,27,25,1,0
147200,1172,3,310,260,50,2,1,0
208512,277,0,18,10,8,0,1,0
0,0,0,0,0,0,0,0,0
32042,343,0,105,101,4,0,0,0
58984,561,3,55,53,2,0,1,0
1029354,4200,8,635,628,7,14,1,0
142723,2574,2,505,502,3,1,1,0
513279,2641,5,361,284,77,2,1,0
425781,1102,1,280,190,90,11,1,0
78953,113,2,11,6,5,2,0,0
462307,1254,4,246,228,18,20,1,0
123828,818,11,128,101,27,2,0,0
204843,278,0,18,9,9,0,1,0
166546,773,2,247,230,17,7,1,0
64645,365,0,115,114,1,0,1,0
0,0,0,0,0,0,0,0,0
215893,1860,5,211,208,3,8,1,0
462164,1330,4,209,59,150,5,1,0
115239,1135,6,303,299,4,9,1,0
0,0,0,0,0,0,0,0,0
499684,2529,6,361,339,22,8,1,0
399110,307,7,2,2,0,11,1,0
44163,696,2,162,150,12,1,1,0
123034,1145,3,124,28,96,9,0,0
24184,235,3,23,18,5,5,0,0
128382,2185,3,689,655,34,12,1,0
15444,106,1,16,12,4,0,1,0
0,0,0,0,0,0,0,0,0
0,0,0,0,0,0,0,0,0
0,0,0,0,0,0,0,0,0
208499,277,0,18,13,5,0,1,0
456205,1926,10,447,350,97,13,1,0
520039,2566,5,226,149,77,1,1,0
180019,960,2,161,144,17,15,1,0
113924,840,4,87,53,34,0,1,0
76940,1024,3,6,0,6,2,0,0
63354,238,0,46,25,21,0,1,1
109079,391,0,46,40,6,1,1,1
453143,2115,7,526,452,74,5,1,0
453142,2115,7,526,452,74,5,1,0
73327,791,2,160,145,15,8,1,0
621735,954,5,103,43,60,18,1,0
956308,644,3,70,57,13,4,1,0
210383,277,0,18,9,9,0,1,0
0,0,0,0,0,0,0,0,0
0,0,0,0,0,0,0,0,0
589359,1953,1,160,152,8,1,1,1
264029,122,1,8,5,3,0,1,1
61871,939,0,220,204,16,6,1,0
0,0,0,0,0,0,0,0,0
235720,969,5,263,240,23,59,1,0
208402,277,0,18,10,8,0,1,0
195367,1509,9,316,193,123,8,1,0
64690,186,10,6,3,3,2,0,0
232719,1178,2,226,219,7,0,0,0
929765,2941,6,525,490,35,19,1,0
0,0,0,0,0,0,0,0,0
513334,2555,9,456,412,44,18,1,0
211819,87,0,0,0,0,1,1,0
344919,1853,6,189,173,16,12,1,0
69168,320,6,16,12,4,4,1,0
581173,3446,4,239,212,27,168,1,0
3300328,34834,10,3526,2515,1011,30,1,0
47110,132,8,3,0,3,0,1,0
134355,1269,7,220,74,146,20,1,0
341597,2777,4,714,704,10,34,1,0
126528,463,4,69,60,9,9,1,0
0,0,0,0,0,0,0,0,0
0,0,0,0,0,0,0,0,0
0,0,0,0,0,0,0,0,0
0,0,0,0,0,0,0,0,0
22659,41,0,2,1,1,0,1,0
539562,2412,6,294,256,38,15,0,0
106644,1942,2,86,0,86,24,1,0
208992,277,0,18,10,8,0,1,0
209222,276,0,17,9,8,0,1,0
140899,205,1,0,0,0,2,1,1
137596,156,1,0,0,0,2,1,1
285576,1797,5,427,392,35,11,1,0
0,0,0,0,0,0,0,0,0
0,0,0,0,0,0,0,0,0
0,0,0,0,0,0,0,0,0
1084844,5637,3,255,247,8,3,1,0
808139,3776,3,75,65,10,2,1,0
106294,1342,1,429,227,202,1,0,0
0,0,0,0,0,0,0,0,0
23852,289,3,61,52,9,1,1,0
40472,432,1,9,9,0,9,0,0
11604,89,1,0,0,0,2,0,0
233746,1334,2,105,81,24,0,1,0
5581,29,1,0,0,0,0,0,0
231048,893,3,148,138,10,43,1,0
243825,943,3,115,105,10,40,1,0
682743,3813,3,192,168,24,286,0,0
45378,117,2,7,7,0,0,0,0
296729,1333,5,201,183,18,3,1,1
161382,281,3,10,9,1,0,0,1
234968,1815,6,279,267,12,24,1,0
186763,193,6,2,2,0,3,0,0
0,0,0,0,0,0,0,0,0
19178,93,3,9,7,2,2,0,0
0,0,0,0,0,0,0,0,0
0,0,0,0,0,0,0,0,0
822067,1614,7,159,143,16,16,1,0
0,0,0,0,0,0,0,0,0
6547,117,0,28,27,1,0,0,0
399789,1043,3,206,190,16,9,1,0
241869,1623,4,326,129,197,7,1,0
4373804,3980,8,708,651,57,43,1,0
2545960,582,3,41,23,18,49,1,0
146907,858,6,213,201,12,7,1,0
0,0,0,0,0,0,0,0,0
74320,410,2,64,62,2,3,1,0
433480,1448,8,544,522,22,23,1,0
331367,2722,5,436,396,40,46,0,0
93744,275,0,47,24,23,0,1,1
1079711,1513,4,122,69,53,52,1,0
111170,517,3,105,74,31,7,1,0
132333,308,2,62,42,20,3,1,0
168709,170,0,73,52,21,0,1,0
9038,154,0,15,7,8,0,1,0
5843,124,1,10,10,0,1,1,0
319383,1960,6,283,258,25,3,1,0
311830,1983,8,239,208,31,4,1,0
0,0,0,0,0,0,0,0,0
16174,64,1,5,1,4,0,0,0
792352,5681,1,1275,1001,274,15,1,0
163499,332,1,73,24,49,0,1,0
1131047,4681,17,345,289,56,1,1,0
310718,1676,1,323,318,5,4,1,0
163499,332,1,73,24,49,0,1,0
136574,2929,1,1040,1040,0,70,1,0
16334,306,1,40,39,1,9,0,0
1640312,2350,8,260,226,34,20,1,0
0,0,0,0,0,0,0,0,0
478853,2532,2,753,134,619,6,1,1
139830,221,2,25,19,6,6,1,0
0,0,0,0,0,0,0,0,0
1554601,1231,4,205,198,7,4,1,0
466581,98,0,5,5,0,0,1,0
115232,568,2,82,75,7,24,1,0
331918,2923,10,812,803,9,16,1,0
553869,2379,4,210,199,11,5,1,0
346294,1096,4,58,52,6,7,0,0
292500,1021,3,60,58,2,1,0,0
117584,215,2,13,12,1,1,0,0
1615055,4310,5,273,266,7,0,1,0
0,0,0,0,0,0,0,0,0
50919,452,3,112,85,27,3,1,0
126156,1036,4,140,123,17,3,1,0
44841,190,2,7,6,1,1,0,0
388204,1164,3,107,98,9,6,1,0
136223,323,2,19,19,0,1,0,0
832492,2896,2,401,383,18,16,1,0
451498,2377,9,572,456,116,1,1,0
203299,321,6,33,30,3,4,1,0
1379864,8088,2,672,604,68,250,0,0
1757151,4592,8,632,527,105,7,0,0
208510,277,0,18,9,9,0,1,0
372665,1346,1,252,210,42,10,1,0
35369,341,0,6,4,2,0,0,0
0,0,0,0,0,0,0,0,0
0,0,0,0,0,0,0,0,0
698018,760,8,93,81,12,12,1,0
181575,848,4,116,74,42,3,1,0
10862,99,2,17,14,3,3,1,0
191803,1369,7,266,253,13,49,1,0
699405,5367,9,271,259,12,53,1,0
0,0,0,0,0,0,0,0,0
367002,1537,11,340,291,49,19,1,0
210112,277,0,18,9,9,0,1,0
210347,277,0,18,9,9,0,1,0
589872,2049,2,403,328,75,5,1,0
25538,186,0,21,8,13,2,1,0
0,0,0,0,0,0,0,0,0
436284,2172,1,248,227,21,39,0,0
46585,202,5,11,11,0,4,0,0
181482,1617,3,185,8,177,1,1,0
652203,3523,7,206,187,19,5,1,0
208839,1172,2,96,79,17,1,0,0
220792,1525,5,401,377,24,12,1,0
300791,1288,5,51,51,0,11,1,0
29340,442,3,52,44,8,1,1,0
4557,45,1,6,6,0,0,0,0
82994,500,0,65,58,7,0,1,0
84148,384,0,33,30,3,0,1,0
336172,1255,3,168,144,24,8,1,0
188437,2614,6,358,292,66,16,1,0
840008,2300,4,382,379,3,18,1,0
1243597,1632,7,371,358,13,12,1,0
8366531,764,6,35,24,11,1,1,0
500652,4328,8,1244,1238,6,22,1,0
1315113,1187,2,161,136,25,4,1,0
15362,145,0,35,31,4,2,1,0
251252,762,5,43,42,1,3,1,0
83155,197,2,18,18,0,0,1,0
71931,707,4,124,117,7,13,1,0
0,0,0,0,0,0,0,0,0
0,0,0,0,0,0,0,0,0
482225,294,0,18,9,9,1,1,0
150053,1679,7,383,376,7,9,1,0
313431,1466,6,187,180,7,4,1,0
126929,396,10,60,60,0,3,0,0
0,0,0,0,0,0,0,0,0
0,0,0,0,0,0,0,0,0
637260,1693,3,100,96,4,1,0,0
22918,40,0,1,1,0,0,1,0
256924,2704,3,1032,925,107,13,0,0
0,0,0,0,0,0,0,0,0
361023,1539,8,195,189,6,19,0,0
79871,107,0,15,12,3,2,1,0
212671,886,4,73,49,24,1,1,0
817596,2572,1,497,479,18,2,1,0
175605,1170,5,244,224,20,7,1,0
177279,1122,6,300,288,12,22,1,0
89955,731,1,313,312,1,0,0,0
793052,2707,3,615,564,51,6,1,0
465430,154,5,9,6,3,6,1,0
261037,1853,3,288,248,40,0,0,0
8971,100,0,6,6,0,0,0,0
789100,3357,3,473,464,9,12,1,0
130751,199,1,9,7,2,0,0,0
24724,137,4,10,10,0,2,1,0
391508,2328,5,441,296,145,17,1,0
21961,158,1,6,4,2,1,0,0
2012771,3474,7,514,406,108,20,1,0
324513,3249,5,732,716,16,1,1,0
767,5,0,0,0,0,0,0,0
246576,1362,6,137,116,21,13,1,0
124431,1107,5,229,216,13,5,1,1
663900,4942,5,846,777,69,4,0,0
295110,899,5,70,28,42,12,1,0
111170,463,5,32,29,3,0,1,0
212010,2010,4,237,228,9,30,1,0
36661,429,0,106,26,80,5,1,0
72530,739,2,85,83,2,4,1,0
253258,1802,8,304,273,31,5,1,1
73671,389,0,43,39,4,0,1,1
353566,2454,2,127,121,6,1,0,0
494244,389,3,32,29,3,1,1,0
249523,1737,4,252,216,36,2,0,0
0,0,0,0,0,0,0,0,0
228647,1347,6,169,109,60,5,1,0
346686,305,3,31,23,8,0,1,0
0,0,0,0,0,0,0,0,0
482410,294,0,18,9,9,1,1,0
0,0,0,0,0,0,0,0,0
697126,3629,6,585,526,59,27,1,0
301278,1168,3,406,171,235,7,1,0
29775,173,4,28,28,0,2,1,0
854058,2591,7,510,497,13,5,1,0
613769,1420,7,372,357,15,5,1,0
0,0,0,0,0,0,0,0,0
113366,584,3,56,49,7,12,1,0
54125,290,4,38,29,9,3,1,0
361827,1651,3,73,59,14,2,0,0
414804,1002,8,107,93,14,9,1,0
446029,2413,8,537,405,132,27,1,1
499182,2086,15,406,397,9,54,1,0
128727,385,3,92,85,7,3,1,0
598706,2109,2,402,367,35,5,1,0
24877,179,0,17,8,9,2,1,0
473861,2182,5,151,122,29,6,1,0
0,0,0,0,0,0,0,0,0
955289,2842,6,368,346,22,80,1,0
169727,660,5,118,92,26,5,1,0
195640,787,6,74,64,10,7,1,0
0,0,0,0,0,0,0,0,0
513723,2743,16,357,337,20,23,1,0
47399,310,5,84,80,4,4,1,0
0,0,0,0,0,0,0,0,0
397368,1853,5,321,317,4,12,1,0
44753,608,1,89,65,24,10,1,0
161693,1237,1,168,143,25,1,1,0
0,0,0,0,0,0,0,0,0
1296184,1831,3,88,81,7,4,1,0
382009,83,0,4,4,0,0,1,0
263905,2608,6,143,121,22,1,1,0
128593,165,1,10,4,6,7,1,0
74634,267,9,42,42,0,1,1,0
107711,1016,3,82,73,9,6,1,1
106395,790,4,217,199,18,5,1,1
0,0,0,0,0,0,0,0,0
0,0,0,0,0,0,0,0,0
516528,2431,5,199,191,8,91,1,0
1754147,14655,6,592,583,9,4,1,0
530272,1553,7,59,55,4,10,1,0
66713,1113,3,332,328,4,11,1,0
50657,185,1,4,4,0,0,0,0
269946,787,9,79,78,1,75,1,0
0,0,0,0,0,0,0,0,0
762916,2362,1,376,321,55,4,1,0
528028,1802,5,318,299,19,15,1,0
590277,1184,7,288,275,13,18,1,0
175304,843,0,203,203,0,0,0,0
0,0,0,0,0,0,0,0,0
0,0,0,0,0,0,0,0,0
0,0,0,0,0,0,0,0,0
706698,3232,2,453,358,95,3,1,0
152187,799,5,50,33,17,1,1,0
1178467,7105,6,1588,1429,159,15,1,0
108500,1365,2,232,202,30,2,1,0
158850,583,2,93,72,21,1,1,0
19289,133,3,54,39,15,1,1,0
6607,54,3,4,4,0,0,0,0
0,0,0,0,0,0,0,0,0
470587,967,0,134,118,16,0,1,0
297765,878,10,144,24,120,20,1,0
0,0,0,0,0,0,0,0,0
116424,561,6,35,20,15,3,1,0
782323,3110,15,660,611,49,18,1,1
92420,394,12,4,4,0,7,0,0
148530,2446,6,762,756,6,29,1,0
66704,1380,6,387,381,6,16,1,0
959016,1539,10,204,185,19,23,1,0
417178,1906,5,253,246,7,1,1,0
15630,242,5,33,30,3,2,1,0
0,0,0,0,0,0,0,0,0
0,0,0,0,0,0,0,0,0
0,0,0,0,0,0,0,0,0
85241,71,0,10,10,0,6,0,0
5224,66,6,5,0,5,0,0,0
608160,743,4,73,58,15,1,0,0
7155,50,0,3,0,3,0,0,0
31841,277,8,36,27,9,4,1,0
59922,202,9,37,31,6,5,1,0
70962,536,4,46,13,33,0,0,0
70962,536,4,46,45,1,0,0,0
0,0,0,0,0,0,0,0,0
36005,612,5,227,113,114,10,0,0
0,0,0,0,0,0,0,0,0
519058,2176,2,301,295,6,0,1,0
17677,322,0,74,66,8,0,0,0
23619,112,3,6,2,4,3,0,0
0,0,0,0,0,0,0,0,0
160269,604,1,92,71,21,6,1,0
364599,2264,0,358,331,27,0,1,0
571269,4603,2,1715,1657,58,4,1,0
35154,96,0,3,1,2,2,0,0
202848,1237,6,335,286,49,3,1,0
0,0,0,0,0,0,0,0,0
165525,181,1,22,19,3,0,0,0
316710,2576,7,262,235,27,15,0,0
667669,2025,1,211,204,7,1,1,1
257434,122,1,8,6,2,0,1,1
237017,1727,8,376,202,174,52,1,0
46488,119,6,2,2,0,3,0,0
0,0,0,0,0,0,0,0,0
443094,1112,3,271,258,13,0,1,0
207238,1864,2,406,389,17,2,1,0
0,0,0,0,0,0,0,0,0
1022622,3752,6,246,227,19,9,0,0
25283,122,2,2,2,0,7,0,0
0,0,0,0,0,0,0,0,0
368913,1990,5,223,210,13,5,0,0
32743,142,0,4,2,2,0,0,0
0,0,0,0,0,0,0,0,0
0,0,0,0,0,0,0,0,0
230205,2379,5,331,276,55,13,1,0
58678,822,2,160,152,8,4,1,0
24568,325,1,108,100,8,0,1,0
45368,472,4,101,90,11,15,1,0
3523,47,1,6,6,0,0,0,0
591339,3160,4,644,597,47,15,0,0
197423,1115,3,201,183,18,10,0,0
47641,584,5,44,42,2,0,1,0
264629,2171,0,351,332,19,3,1,0
0,0,0,0,0,0,0,0,0
177312,1792,4,402,400,2,3,1,0
79840,970,5,191,157,34,1,1,0
8541,87,4,2,2,0,0,1,0
1056958,1968,4,682,678,4,5,1,0
565006,1170,4,613,612,1,5,1,0
197223,2409,5,180,98,82,5,1,0
271688,631,2,122,104,18,0,1,0
214859,234,0,48,32,16,2,1,0
0,0,0,0,0,0,0,0,0
527691,2023,5,174,158,16,1,1,0
0,0,0,0,0,0,0,0,0
0,0,0,0,0,0,0,0,0
0,0,0,0,0,0,0,0,0
26346,368,2,20,17,3,33,1,0
152598,1604,3,300,296,4,24,1,0
482339,294,0,18,10,8,1,1,0
1438421,5683,2,1351,1313,38,69,1,0
198581,436,2,103,99,4,0,1,1
0,0,0,0,0,0,0,0,0
1391230,2475,4,306,298,8,12,1,0
245220,2493,5,185,177,8,7,0,0
860232,2726,5,426,417,9,7,1,0
397434,1723,7,288,277,11,28,1,0
118102,96,6,5,5,0,1,1,0
112147,1816,1,299,258,41,2,1,0
43176,454,1,8,7,1,5,1,0
18332,303,2,62,60,2,0,0,0
169269,1831,5,331,312,19,49,0,0
0,0,0,0,0,0,0,0,0
73944,1304,2,417,272,145,11,0,0
1287901,1607,4,248,169,79,9,1,0
935687,546,4,69,54,15,1,1,0
556365,2624,5,410,384,26,10,1,0
516138,838,3,220,17,203,2,1,0
612012,644,1,44,38,6,1,1,0
783395,2291,6,60,54,6,1,1,0
701289,2451,3,44,39,5,2,1,0
465282,1237,7,187,183,4,7,1,0
71613,598,3,160,124,36,0,1,0
1767081,3521,7,263,255,8,26,1,0
365220,427,6,4,4,0,11,1,0
108450,755,7,102,76,26,4,0,0
340946,1887,3,262,235,27,0,0,0
187379,1324,10,297,287,10,13,1,0
0,0,0,0,0,0,0,0,0
0,0,0,0,0,0,0,0,0
0,0,0,0,0,0,0,0,0
0,0,0,0,0,0,0,0,0
0,0,0,0,0,0,0,0,0
219268,1742,2,291,282,9,3,1,0
95419,999,3,209,183,26,10,1,0
245653,2664,11,424,26,398,25,1,0
141347,971,2,185,182,3,0,1,0
85827,176,4,28,25,3,0,1,0
208013,1541,11,308,264,44,42,0,0
0,0,0,0,0,0,0,0,0
7433,129,2,4,4,0,3,1,0
345436,868,7,138,122,16,8,1,0
603251,770,5,133,86,47,2,1,0
12480,108,4,5,3,2,4,1,0
513011,2456,11,236,206,30,29,1,0
24651,303,4,3,2,1,3,1,0
148621,2250,3,650,610,40,2,1,0
15605,252,1,86,86,0,1,0,0
0,0,0,0,0,0,0,0,0
206980,1381,5,159,151,8,1,1,0
96219,450,10,57,54,3,4,1,0
0,0,0,0,0,0,0,0,0
35510,115,2,13,1,12,0,1,0
68562,428,6,51,47,4,2,1,0
48913,386,7,91,43,48,9,1,0
27198,184,7,24,22,2,10,1,0
0,0,0,0,0,0,0,0,0
168496,690,1,225,195,30,0,1,0
0,0,0,0,0,0,0,0,0
773450,5703,9,892,779,113,29,1,0
24219,332,1,57,53,4,0,0,0
33316,88,3,6,6,0,2,1,0
126599,1315,2,266,262,4,0,1,0
54747,675,4,174,126,48,8,1,0
359816,2535,1,559,455,104,24,1,0
0,0,0,0,0,0,0,0,0
45515,283,5,32,32,0,2,1,0
62279,263,6,18,17,1,2,1,0
217769,290,0,15,9,6,1,1,0
0,0,0,0,0,0,0,0,0
550696,2648,2,188,179,9,0,1,0
0,0,0,0,0,0,0,0,0
482937,294,0,18,9,9,1,1,0
0,0,0,0,0,0,0,0,0
1733584,1098,10,202,188,14,30,1,0
0,0,0,0,0,0,0,0,0
170862,574,3,1,1,0,0,0,0
232727,839,5,182,158,24,19,1,0
0,0,0,0,0,0,0,0,0
0,0,0,0,0,0,0,0,0
1107736,3277,4,287,261,26,51,1,0
198668,339,1,46,38,8,0,0,0
403856,1645,5,82,10,72,1,1,0
481820,294,0,18,9,9,1,1,0
160940,331,2,45,43,2,4,0,0
483883,294,0,18,9,9,1,1,0
61454,356,5,74,72,2,5,1,0
467790,2309,5,356,324,32,5,1,0
0,0,0,0,0,0,0,0,0
455018,3890,1,660,440,220,35,1,0
2415259,21064,6,225,213,12,7,1,0
135969,268,2,15,10,5,3,0,0
614028,2853,9,467,458,9,10,1,0
80130,647,8,111,107,4,5,1,0
47684,240,6,45,44,1,8,1,0
0,0,0,0,0,0,0,0,0
0,0,0,0,0,0,0,0,0
119049,437,3,67,65,2,0,1,0
0,0,0,0,0,0,0,0,0
0,0,0,0,0,0,0,0,0
322584,5797,1,1846,1809,37,14,1,0
483960,294,0,18,11,7,1,1,0
845123,981,9,83,73,10,7,1,0
0,0,0,0,0,0,0,0,0
156,5,0,0,0,0,0,0,0
111009,382,1,42,38,4,0,1,0
151271,283,1,33,27,6,1,1,0
97499,725,12,105,0,105,0,1,0
42974,533,3,122,109,13,1,1,0
342560,1122,4,198,197,1,1,1,0
445917,1534,6,196,176,20,22,1,0
524185,2564,3,226,189,37,0,1,0
1341644,10913,11,579,565,14,57,1,0
205139,2823,2,1385,1373,12,5,1,0
2589885,30568,4,2813,1926,887,5,0,0
47110,132,8,3,0,3,0,1,0
141545,2185,0,570,560,10,6,1,0
26076,342,0,5,5,0,0,0,0
184812,1245,6,184,170,14,2,1,0
78755,531,0,19,12,7,15,0,0
0,0,0,0,0,0,0,0,0
0,0,0,0,0,0,0,0,0
420130,1429,7,136,120,16,18,1,0
33309,508,7,51,50,1,3,1,0
163425,682,1,122,104,18,0,1,0
66205,93,0,10,5,5,1,0,0
0,0,0,0,0,0,0,0,0
760163,554,3,62,45,17,4,1,0
0,0,0,0,0,0,0,0,0
918959,2953,8,396,338,58,14,1,0
217733,914,3,291,280,11,7,1,0
116421,162,0,12,5,7,0,1,0
0,0,0,0,0,0,0,0,0
0,0,0,0,0,0,0,0,0
196779,913,4,39,26,13,9,1,0
238584,1591,10,287,270,17,3,1,0
0,0,0,0,0,0,0,0,0
127660,27,0,0,0,0,0,0,0
435274,1770,2,195,185,10,87,1,0
456502,1586,0,578,560,18,1,1,0
68870,168,4,8,6,2,6,0,0
1576796,3372,12,533,457,76,22,1,0
0,0,0,0,0,0,0,0,0
32692,375,8,93,87,6,2,1,0
147922,680,11,71,35,36,0,1,0
115373,429,10,66,30,36,2,1,0
290256,1476,1,341,281,60,0,1,0
175447,830,10,167,42,125,19,1,0
270905,610,0,127,125,2,1,0,0
97849,1297,3,255,241,14,2,1,0
198733,1628,6,292,247,45,2,1,0
143927,465,13,6,6,0,8,1,0
1454598,3268,4,416,398,18,2,1,0
0,0,0,0,0,0,0,0,0
0,0,0,0,0,0,0,0,0
10808,183,1,13,13,0,0,1,0
3301,50,2,4,4,0,0,1,0
174504,820,2,61,0,61,0,1,0
498216,2007,6,266,236,30,92,1,0
481294,294,0,18,10,8,1,1,0
117602,1723,4,433,433,0,2,1,0
2743658,995,8,128,119,9,14,1,0
35390,344,0,6,4,2,0,0,0
696077,4371,2,646,621,25,6,1,0
95376,999,4,201,84,117,9,1,0
392963,1710,14,55,39,16,12,1,0
0,0,0,0,0,0,0,0,0
46699,365,4,69,56,13,2,0,0
168344,626,4,84,82,2,12,0,0
686359,3200,10,580,33,547,15,1,1
2172533,1316,1,124,121,3,2,1,0
803227,3133,1,113,75,38,1,1,0
1002297,2957,7,445,419,26,8,1,0
483872,294,0,18,9,9,1,1,0
1144,13,0,0,0,0,0,0,0
138159,334,2,31,24,7,0,1,0
140175,369,2,31,24,7,0,1,0
457304,7630,2,2129,1993,136,34,0,1
45181,516,2,61,48,13,3,1,0
0,0,0,0,0,0,0,0,0
395644,1941,12,104,11,93,17,1,0
32705,123,3,4,2,2,1,0,0
91734,1066,5,211,203,8,17,0,0
269688,69,0,16,12,4,0,1,0
309183,1990,5,220,8,212,6,0,0
0,0,0,0,0,0,0,0,0
195522,904,5,190,147,43,2,1,0
0,0,0,0,0,0,0,0,0
143712,362,3,37,26,11,3,1,0
1196247,1979,5,312,242,70,14,1,0
2436615,2642,2,496,476,20,0,1,0
36349,183,0,9,2,7,0,1,1
26884,39,0,2,1,1,0,0,0
0,0,0,0,0,0,0,0,0
49496,180,0,31,14,17,4,1,0
124718,479,1,23,1,22,13,1,0
0,0,0,0,0,0,0,0,0
0,0,0,0,0,0,0,0,0
1319268,3676,7,700,684,16,134,1,0
211604,277,0,18,9,9,0,1,0
977739,1875,9,209,204,5,23,1,0
0,0,0,0,0,0,0,0,0
0,0,0,0,0,0,0,0,0
145133,1004,4,208,142,66,4,1,0
48065,328,3,38,22,16,2,0,0
0,0,0,0,0,0,0,0,0
442128,2960,10,619,578,41,39,0,0
329791,1763,11,426,398,28,24,1,0
0,0,0,0,0,0,0,0,0
296861,1577,1,229,223,6,1,0,0
161513,1322,12,314,287,27,1,1,0
59802,517,6,59,52,7,0,1,0
115041,317,7,43,43,0,5,1,0
0,0,0,0,0,0,0,0,0
251027,1453,2,345,262,83,5,1,0
99606,281,0,9,3,6,1,1,0
0,0,0,0,0,0,0,0,0
0,0,0,0,0,0,0,0,0
555575,2467,6,391,379,12,7,1,0
8239,87,3,4,2,2,0,0,0
82364,1557,9,430,317,113,3,1,0
6948,121,2,16,12,4,0,1,0
201916,349,1,49,28,21,0,0,0
226557,1143,3,103,100,3,1,1,0
215034,818,1,72,50,22,8,1,1
208767,277,0,18,10,8,0,1,0
0,0,0,0,0,0,0,0,0
494531,1071,18,82,61,21,19,1,0
0,0,0,0,0,0,0,0,0
0,0,0,0,0,0,0,0,0
0,0,0,0,0,0,0,0,0
0,0,0,0,0,0,0,0,0
0,0,0,0,0,0,0,0,0
0,0,0,0,0,0,0,0,0
0,0,0,0,0,0,0,0,0
0,0,0,0,0,0,0,0,0
0,0,0,0,0,0,0,0,0
231613,818,2,281,201,80,0,1,0
0,0,0,0,0,0,0,0,0
0,0,0,0,0,0,0,0,0
0,0,0,0,0,0,0,0,0
0,0,0,0,0,0,0,0,0
0,0,0,0,0,0,0,0,0
0,0,0,0,0,0,0,0,0
29270,414,5,101,80,21,0,0,0
0,0,0,0,0,0,0,0,0
0,0,0,0,0,0,0,0,0
0,0,0,0,0,0,0,0,0
0,0,0,0,0,0,0,0,0
0,0,0,0,0,0,0,0,0
0,0,0,0,0,0,0,0,0
551007,3400,4,53,49,4,1,0,0
709031,1514,4,101,97,4,3,1,0
0,0,0,0,0,0,0,0,0
0,0,0,0,0,0,0,0,0
208677,277,0,18,9,9,0,1,0
0,0,0,0,0,0,0,0,0
1365007,9950,3,529,504,25,327,0,0
270447,1625,7,149,139,10,19,1,0
78615,451,5,88,80,8,11,1,0
111399,1411,3,230,215,15,5,1,0
208593,277,0,18,12,6,0,1,0
4791,38,2,0,0,0,0,0,0
0,0,0,0,0,0,0,0,0
363157,1350,11,242,200,42,19,1,0
219377,558,5,42,37,5,16,1,0
192864,1039,3,277,235,42,4,0,0
306368,382,1,95,42,53,0,1,0
215515,235,0,50,33,17,2,1,0
0,0,0,0,0,0,0,0,0
60620,636,0,189,186,3,0,0,0
728608,2079,9,178,168,10,25,1,0
1167723,3562,6,249,172,77,4,1,0
6190,72,2,3,3,0,2,1,0
0,0,0,0,0,0,0,0,0
0,0,0,0,0,0,0,0,0
15042,139,2,30,30,0,0,0,0
436104,2245,7,219,200,19,2,1,0
266005,663,8,35,16,19,4,0,0
0,0,0,0,0,0,0,0,0
0,0,0,0,0,0,0,0,0
268584,4411,4,1239,1155,84,16,1,0
0,0,0,0,0,0,0,0,0
153167,2931,2,1072,1061,11,1,1,0
25130,352,3,83,79,4,0,0,0
0,0,0,0,0,0,0,0,0
602153,900,10,90,90,0,32,0,0
254155,1199,3,239,223,16,0,1,0
467429,2164,7,594,529,65,4,1,0
460938,2124,7,527,452,75,4,1,0
441198,964,5,57,48,9,35,1,0
733576,1261,4,192,102,90,17,1,0
542153,3592,4,525,517,8,5,1,0
360804,1201,4,431,423,8,4,1,0
0,0,0,0,0,0,0,0,0
208675,277,0,18,15,3,0,1,0
0,0,0,0,0,0,0,0,0
450459,1779,2,93,60,33,1,0,0
470765,3497,4,426,338,88,2,1,0
290034,1085,4,224,187,37,2,1,0
0,0,0,0,0,0,0,0,0
295934,2797,3,597,593,4,14,0,0
516599,2476,11,300,220,80,4,1,0
290252,934,4,114,66,48,5,1,0
0,0,0,0,0,0,0,0,0
0,0,0,0,0,0,0,0,0
879839,5762,8,838,774,64,14,1,0
626458,2028,1,190,184,6,1,1,1
259594,123,1,8,5,3,0,1,1
0,0,0,0,0,0,0,0,0
11012,149,1,21,19,2,0,1,0
10923,117,4,21,18,3,0,1,0
395653,2191,9,265,253,12,170,1,0
54121,185,5,6,3,3,5,1,0
108287,1840,3,499,494,5,59,0,0
76444,1235,3,265,260,5,13,0,0
196707,685,3,76,72,4,4,1,0
93872,421,4,59,56,3,4,1,0
240922,1436,8,274,260,14,9,1,0
0,0,0,0,0,0,0,0,0
729250,4151,7,215,132,83,49,1,0
780417,3207,7,190,178,12,23,1,0
248108,936,7,69,54,15,29,1,0
372818,1713,7,471,442,29,12,1,0
239106,1575,3,277,268,9,7,1,0
1176638,5317,4,639,540,99,22,1,0
420215,967,4,185,166,19,21,0,0
228263,1615,3,205,185,20,0,0,0
151797,2099,7,639,637,2,5,1,0
4320,49,3,12,8,4,0,0,0
973472,2756,6,222,190,32,7,1,0
0,0,0,0,0,0,0,0,0
435118,1823,6,213,178,35,17,0,0
0,0,0,0,0,0,0,0,0
352565,2576,7,530,401,129,25,1,1
485696,4978,6,1615,1102,513,11,1,0
0,0,0,0,0,0,0,0,0
0,0,0,0,0,0,0,0,0
0,0,0,0,0,0,0,0,0
234276,3004,3,501,498,3,1,1,0
255170,694,2,248,241,7,8,1,0
50440,236,10,58,52,6,4,1,0
252172,3639,5,702,671,31,4,0,0
14478,171,3,30,28,2,2,0,0
975157,4344,4,814,663,151,16,1,0
1063491,4474,4,939,267,672,21,1,0
401132,648,5,64,46,18,6,1,0
49329,482,3,90,78,12,1,1,0
619498,1243,11,91,75,16,21,1,0
941031,3606,5,683,667,16,6,1,0
637806,2220,7,429,392,37,26,1,0
17715,262,2,28,15,13,21,1,0
234872,2419,5,274,260,14,6,1,0
0,0,0,0,0,0,0,0,0
243630,1403,8,121,104,17,5,1,0
637487,279,16,14,5,9,10,1,0
667988,5595,3,1481,1409,72,3,1,0
525853,1512,5,330,280,50,2,1,0
356909,1946,6,311,225,86,57,1,0
817574,2399,16,255,181,74,30,1,0
0,0,0,0,0,0,0,0,0
41186,118,4,23,23,0,0,1,0
306687,664,6,142,136,6,7,1,0
303367,2536,3,173,155,18,1,1,0
210673,277,0,18,9,9,0,1,0
262436,2389,4,459,439,20,8,0,0
662230,1892,0,380,300,80,0,1,0
27150,39,0,2,1,1,0,0,0
0,0,0,0,0,0,0,0,0
349471,2731,3,260,237,23,111,1,0
237580,1458,3,279,227,52,10,1,0
6955,121,2,16,12,4,0,1,0
79350,790,7,78,71,7,5,1,0
256867,1779,3,610,307,303,22,0,0
195851,3046,4,206,148,58,2,1,0
0,0,0,0,0,0,0,0,0
137883,1689,1,529,503,26,1,1,0
295270,1160,4,233,233,0,10,0,0
56231,182,6,11,9,2,4,0,0
0,0,0,0,0,0,0,0,0
0,0,0,0,0,0,0,0,0
0,0,0,0,0,0,0,0,0
443721,2599,2,451,103,348,13,1,0
30205,106,1,13,12,1,5,1,0
0,0,0,0,0,0,0,0,0
249960,2672,2,1247,1061,186,7,0,0
883896,4327,6,112,104,8,291,0,1
190451,1754,10,353,338,15,28,1,0
27879,291,4,65,64,1,10,1,0
15571,222,5,60,57,3,8,1,0
0,0,0,0,0,0,0,0,0
923642,1588,6,145,131,14,32,1,0
0,0,0,0,0,0,0,0,0
15134,68,1,5,1,4,0,0,0
196414,1835,4,507,480,27,1,1,0
27330,39,0,2,1,1,0,0,0
1509854,1335,0,159,117,42,12,1,0
930074,549,0,58,50,8,9,1,0
196329,1468,3,452,101,351,17,0,0
0,0,0,0,0,0,0,0,0
549896,1343,7,258,240,18,7,1,0
7565,79,3,4,2,2,0,0,0
171114,633,1,90,56,34,10,1,0
212596,319,3,18,5,13,7,1,0
359873,1410,6,151,121,30,27,1,0
765844,3141,5,156,28,128,1,1,0
84855,775,7,67,64,3,8,1,0
39138,243,6,13,12,1,3,1,0
0,0,0,0,0,0,0,0,0
0,0,0,0,0,0,0,0,0
0,0,0,0,0,0,0,0,0
92838,810,3,187,153,34,6,1,0
63428,290,2,43,33,10,2,1,0
67494,807,6,120,21,99,26,1,0
0,0,0,0,0,0,0,0,0
957343,1689,6,269,256,13,1,1,0
0,0,0,0,0,0,0,0,0
149521,2095,1,722,680,42,84,1,0
149525,2095,1,722,678,44,84,1,0
171071,900,1,204,176,28,0,1,0
99608,420,2,78,46,32,0,1,0
0,0,0,0,0,0,0,0,0
222818,624,2,96,82,14,4,1,0
449115,1448,0,124,121,3,1,1,1
243491,130,1,8,5,3,0,1,1
0,0,0,0,0,0,0,0,0
0,0,0,0,0,0,0,0,0
205881,1141,7,149,120,29,25,1,0
0,0,0,0,0,0,0,0,0
968894,4862,8,304,223,81,11,1,0
214891,1178,5,217,197,20,1,1,0
39769,515,1,31,28,3,5,0,0
247891,2256,5,395,388,7,17,1,0
226768,1335,9,420,395,25,5,1,0
38522,458,3,184,175,9,8,0,0
16979,196,3,51,51,0,9,0,0
1490682,2182,4,322,316,6,8,1,0
18785,389,3,4,2,2,2,1,0
744549,1476,2,196,190,6,1,1,0
33618,343,3,70,63,7,1,1,0
636243,953,2,189,22,167,12,1,0
0,0,0,0,0,0,0,0,0
0,0,0,0,0,0,0,0,0
0,0,0,0,0,0,0,0,0
36063,155,5,14,11,3,9,1,0
0,0,0,0,0,0,0,0,0
75360,574,8,119,119,0,20,1,0
111428,980,5,182,7,175,10,1,0
7573,75,3,2,2,0,1,0,0
59123,378,7,49,33,16,6,1,0
21076,37,0,1,1,0,0,1,0
137026,1077,5,207,193,14,3,1,0
0,0,0,0,0,0,0,0,0
0,0,0,0,0,0,0,0,0
166504,2360,10,536,526,10,1,1,0
0,0,0,0,0,0,0,0,0
106592,1317,3,444,439,5,3,1,0
0,0,0,0,0,0,0,0,0
73292,320,1,55,47,8,2,0,0
0,0,0,0,0,0,0,0,0
0,0,0,0,0,0,0,0,0
244675,1151,3,158,135,23,12,0,0
128788,1020,3,169,130,39,19,1,0
25572,220,2,9,9,0,1,1,0
0,0,0,0,0,0,0,0,0
0,0,0,0,0,0,0,0,0
0,0,0,0,0,0,0,0,0
0,0,0,0,0,0,0,0,0
0,0,0,0,0,0,0,0,0
164408,698,2,124,99,25,4,1,0
0,0,0,0,0,0,0,0,0
356088,1755,0,299,253,46,1,1,0
314933,1594,2,149,128,21,2,1,0
159562,715,4,52,52,0,0,1,0
201703,989,8,104,92,12,2,1,0
0,0,0,0,0,0,0,0,0
578064,5161,5,629,605,24,112,1,0
440519,4623,12,585,579,6,3,0,0
2550555,8093,6,575,547,28,6,1,0
37996,486,5,29,27,2,20,1,0
638156,6228,8,1703,1661,42,43,1,0
381512,4397,4,1514,1474,40,16,1,0
686037,1707,2,382,358,24,1,1,0
68104,760,1,60,49,11,0,0,0
4248,48,3,1,1,0,4,0,0
128019,985,7,83,74,9,17,0,0
112096,947,3,72,69,3,4,0,0
371706,1133,4,90,64,26,1,1,0
936309,4989,7,365,297,68,27,1,0
69576,363,1,6,4,2,22,0,0
0,0,0,0,0,0,0,0,0
48388,727,3,154,151,3,3,1,0
16218,180,2,55,54,1,0,1,0
1130204,1519,6,140,87,53,27,1,0
571553,1375,4,226,217,9,10,1,0
184377,1284,12,314,294,20,35,1,1
0,0,0,0,0,0,0,0,0
114025,1704,5,426,416,10,1,0,0
13236,170,5,21,21,0,1,0,0
553771,868,5,103,50,53,16,1,0
69474,560,8,48,38,10,4,1,0
0,0,0,0,0,0,0,0,0
0,0,0,0,0,0,0,0,0
162108,560,0,117,115,2,1,1,0
264285,2440,5,626,587,39,14,1,0
24082,459,4,108,102,6,8,1,0
18032,310,4,93,87,6,8,1,0
234644,1282,1,406,398,8,0,1,0
43331,306,2,75,68,7,0,1,0
625447,2953,7,787,722,65,16,1,0
16603,142,2,4,4,0,0,0,0
138806,1197,7,291,286,5,7,1,0
0,0,0,0,0,0,0,0,0
0,0,0,0,0,0,0,0,0
62792,1068,3,402,368,34,2,1,0
1556,11,0,1,1,0,0,0,0
0,0,0,0,0,0,0,0,0
253695,1594,3,441,416,25,181,1,0
0,0,0,0,0,0,0,0,0
0,0,0,0,0,0,0,0,0
61784,412,1,213,201,12,0,1,0
24387,155,1,24,20,4,1,1,0
426418,1312,4,202,9,193,21,1,0
247646,1360,9,168,115,53,6,1,0
143340,515,10,86,77,9,3,1,0
225262,2354,4,280,270,10,0,0,0
111005,1103,3,81,72,9,4,1,0
0,0,0,0,0,0,0,0,0
607436,1481,9,129,106,23,2,1,0
86114,1622,1,496,431,65,0,1,0
0,0,0,0,0,0,0,0,0
27948,45,0,4,1,3,0,0,0
0,0,0,0,0,0,0,0,0
0,0,0,0,0,0,0,0,0
146313,1047,4,228,160,68,4,1,0
51434,376,3,54,36,18,2,0,0
1603348,7580,6,257,233,24,36,1,0
0,0,0,0,0,0,0,0,0
554049,2421,9,514,263,251,30,1,0
382839,2814,7,728,658,70,14,1,0
12976,106,5,15,13,2,2,1,0
0,0,0,0,0,0,0,0,0
3005445,3020,5,311,289,22,14,1,0
0,0,0,0,0,0,0,0,0
559395,2140,11,439,420,19,25,1,0
726167,3675,6,610,541,69,4,0,1
17461,131,2,11,10,1,5,0,0
1063623,1985,4,683,682,1,5,1,0
565957,1170,4,613,612,1,5,1,0
0,0,0,0,0,0,0,0,0
0,0,0,0,0,0,0,0,0
0,0,0,0,0,0,0,0,0
362390,2233,2,353,342,11,2,1,0
0,0,0,0,0,0,0,0,0
91288,428,8,38,29,9,0,1,0
61182,219,9,23,19,4,2,1,0
9038,154,0,15,1,14,0,1,0
5843,124,1,10,10,0,1,1,0
564646,4426,4,324,316,8,6,1,0
123774,704,10,111,95,16,1,1,0
37919,352,0,8,3,5,0,1,1
0,0,0,0,0,0,0,0,0
171367,763,1,75,64,11,0,1,0
5660,29,1,0,0,0,0,0,0
294834,1420,7,259,236,23,8,1,0
0,0,0,0,0,0,0,0,0
0,0,0,0,0,0,0,0,0
1766707,3267,6,337,325,12,37,1,0
0,0,0,0,0,0,0,0,0
3147549,558,5,61,50,11,4,1,0
630429,4275,6,726,636,90,26,1,0
160020,2111,1,304,300,4,20,0,0
27205,39,0,2,1,1,0,0,0
255737,1627,5,433,358,75,4,1,0
0,0,0,0,0,0,0,0,0
0,0,0,0,0,0,0,0,0
0,0,0,0,0,0,0,0,0
594116,2221,4,165,151,14,2,1,0
593102,2372,4,218,206,12,3,0,0
309377,1348,17,217,207,10,15,1,0
402729,2845,3,464,456,8,6,1,0
397182,935,4,170,170,0,10,1,0
9038,154,0,15,1,14,0,1,0
5843,124,1,10,10,0,1,1,0
105149,739,9,131,127,4,5,1,0
356474,1740,7,160,147,13,13,0,0
130905,2401,11,794,773,21,14,1,0
342254,2284,1,410,386,24,0,0,0
979,11,1,1,0,1,1,1,0
720140,2962,12,619,598,21,14,1,0
674721,2973,10,611,592,19,15,1,0
502217,1771,6,122,118,4,0,1,0
412518,1173,5,15,13,2,18,1,0
38864,680,6,136,109,27,1,0,0
756722,1231,2,81,80,1,4,0,0
446702,971,2,45,44,1,6,0,0
368188,3612,3,403,370,33,36,1,0
174024,1384,5,169,136,33,19,1,0
18332,303,2,62,60,2,0,0,0
227777,3510,2,804,499,305,9,1,0
76248,751,9,82,37,45,26,1,0
25033,225,7,27,26,1,11,1,0
122264,1052,4,219,196,23,21,1,0
246543,2910,2,418,408,10,2,1,0
69614,1170,5,332,332,0,0,1,0
7517,150,2,23,23,0,2,1,0
526939,4742,9,574,495,79,71,1,0
238795,1295,3,293,288,5,0,1,0
147987,750,5,171,166,5,0,1,0
344131,941,3,145,123,22,2,1,0
0,0,0,0,0,0,0,0,0
0,0,0,0,0,0,0,0,0
0,0,0,0,0,0,0,0,0
0,0,0,0,0,0,0,0,0
0,0,0,0,0,0,0,0,0
230055,1187,6,117,98,19,2,1,0
0,0,0,0,0,0,0,0,0
172853,1446,5,386,366,20,1,1,0
0,0,0,0,0,0,0,0,0
307656,1418,6,186,173,13,12,0,0
0,0,0,0,0,0,0,0,0
339466,2227,2,111,80,31,45,1,0
53026,280,1,44,22,22,1,1,0
423279,4180,11,311,291,20,30,1,0
14091,76,9,3,3,0,0,0,0
0,0,0,0,0,0,0,0,0
5023,63,1,12,9,3,0,0,0
662997,5626,3,1075,1015,60,28,0,0
364409,2486,5,502,477,25,37,0,0
186416,3094,3,1007,993,14,152,1,0
229754,1040,6,107,99,8,7,1,0
48024,216,6,43,32,11,5,1,0
281579,1713,3,159,142,17,15,1,0
749419,5603,8,637,327,310,5,0,0
284877,706,2,62,17,45,2,0,0
287913,2830,6,513,443,70,12,1,0
436928,777,1,147,138,9,0,1,0
675895,2160,2,391,310,81,6,1,0
24721,178,0,16,7,9,2,1,0
120874,620,6,83,81,2,8,0,0
0,0,0,0,0,0,0,0,0
283804,1175,12,252,237,15,27,1,0
0,0,0,0,0,0,0,0,0
35388,479,3,77,68,9,1,1,0
937844,1554,10,202,197,5,23,1,0
1347161,997,10,115,102,13,19,1,0
51868,255,1,18,13,5,4,1,0
0,0,0,0,0,0,0,0,0
636095,519,4,74,65,9,2,1,0
186032,1759,8,382,372,10,9,1,0
725165,2261,2,261,235,26,28,1,0
241988,282,2,7,7,0,4,1,0
101954,1695,3,354,352,2,6,1,0
42393,669,3,224,222,2,6,1,0
732728,3817,0,470,9,461,52,1,0
6815,69,0,7,6,1,0,1,0
0,0,0,0,0,0,0,0,0
288193,2163,1,277,229,48,1,1,0
19786,124,0,18,8,10,1,1,0
528619,1873,2,360,284,76,5,1,0
25215,181,0,18,7,11,2,1,0
0,0,0,0,0,0,0,0,0
1490572,6072,12,240,18,222,5,1,0
110455,596,11,115,63,52,5,1,0
87819,558,1,42,37,5,32,1,0
308417,178,4,21,13,8,0,0,0
452282,1142,0,147,128,19,0,1,0
44121,349,0,48,21,27,0,1,0
0,0,0,0,0,0,0,0,0
134582,1859,2,249,246,3,5,0,0
219255,1450,7,287,264,23,6,1,0
185637,1034,6,85,69,16,25,0,0
1497770,3682,2,653,645,8,18,1,0
30747,407,3,71,66,5,4,0,0
10823,161,4,26,23,3,2,0,0
1131987,10333,12,606,597,9,5,1,0
86009,581,2,27,22,5,3,0,0
258683,1732,7,302,275,27,49,1,0
45877,493,3,170,131,39,13,1,0
7243,170,2,43,43,0,1,0,0
8014,180,2,44,37,7,1,0,0
441391,4675,4,912,736,176,15,0,0
478769,2974,2,182,167,15,19,0,0
117597,538,3,35,23,12,3,1,0
1476862,3217,2,107,79,28,31,1,0
474856,1645,3,187,75,112,3,1,0
85492,1707,1,658,618,40,0,1,0
0,0,0,0,0,0,0,0,0
28242,363,2,58,45,13,0,1,0
1685882,2971,6,478,352,126,13,1,0
22948,67,3,1,0,1,2,0,0
0,0,0,0,0,0,0,0,0
550241,3075,3,120,98,22,5,1,0
0,0,0,0,0,0,0,0,0
0,0,0,0,0,0,0,0,0
12382,125,0,16,15,1,0,1,0
0,0,0,0,0,0,0,0,0
184963,611,2,93,31,62,1,1,0
196879,895,4,88,74,14,2,1,0
98207,207,2,18,18,0,1,1,0
0,0,0,0,0,0,0,0,0
0,0,0,0,0,0,0,0,0
64560,234,6,31,25,6,0,1,0
4591,64,4,6,6,0,0,0,0
0,0,0,0,0,0,0,0,0
197993,1672,0,266,217,49,5,1,0
196637,1791,9,260,246,14,5,1,0
298713,3355,9,820,635,185,81,1,0
129497,388,3,28,21,7,24,1,0
0,0,0,0,0,0,0,0,0
181535,2121,6,826,821,5,0,1,0
1049309,4204,3,80,64,16,12,1,0
768867,3313,2,39,36,3,0,1,0
478791,2593,5,504,476,28,11,1,0
1279523,10238,4,1076,1066,10,6,1,0
21414,174,6,20,18,2,9,1,0
1016886,1179,3,87,69,18,13,1,0
553929,957,4,63,43,20,16,1,0
135709,1872,2,213,189,24,3,1,0
7085,104,2,7,6,1,1,1,0
353498,902,4,165,140,25,12,1,0
2572795,1001,1,180,173,7,2,1,0
46085,653,3,172,85,87,6,1,0
0,0,0,0,0,0,0,0,0
77049,557,7,91,90,1,0,1,0
0,0,0,0,0,0,0,0,0
0,0,0,0,0,0,0,0,0
239102,2665,3,378,360,18,1,0,0
289473,784,3,104,93,11,14,1,0
62406,878,5,206,194,12,5,1,0
34972,331,3,11,0,11,0,1,0
121194,2149,1,672,643,29,0,1,0
0,0,0,0,0,0,0,0,0
210625,277,0,18,11,7,0,1,0
387721,1071,5,175,165,10,6,1,0
0,0,0,0,0,0,0,0,0
152888,636,3,61,43,18,7,1,0
451268,1675,3,147,44,103,17,1,0
179110,370,1,6,2,4,1,0,0
605150,2672,8,649,625,24,4,1,0
0,0,0,0,0,0,0,0,0
3634123,1252,6,80,59,21,18,1,0
31318,40,0,0,0,0,0,0,0
556705,3955,6,179,164,15,12,1,0
1000218,5146,9,1062,1042,20,86,1,0
0,0,0,0,0,0,0,0,0
0,0,0,0,0,0,0,0,0
52016,557,2,109,95,14,4,1,0
56303,673,2,111,97,14,4,1,0
444696,2270,6,341,315,26,141,1,0
12278,193,3,23,20,3,0,0,0
0,0,0,0,0,0,0,0,0
167270,1081,4,226,207,19,13,1,0
19460,252,4,19,18,1,0,1,0
0,0,0,0,0,0,0,0,0
405218,1478,5,188,180,8,3,1,0
69695,112,3,11,10,1,2,1,0
674802,4357,13,489,447,42,8,0,0
0,0,0,0,0,0,0,0,0
925166,2155,0,177,154,23,3,1,0
432798,3190,12,691,628,63,16,1,0
209973,273,0,17,4,13,0,1,0
186134,847,14,75,61,14,7,0,0
395128,5632,2,480,455,25,34,1,0
19230,384,3,12,8,4,5,1,0
692664,9664,7,666,645,21,23,1,0
108781,273,5,11,7,4,16,1,0
2008049,8415,8,1220,1199,21,36,1,0
160934,574,5,13,7,6,2,1,0
162487,986,2,354,337,17,1,1,0
56631,592,8,71,29,42,0,1,0
186238,455,6,21,20,1,0,1,0
178488,2564,3,355,326,29,4,1,0
37186,275,4,21,19,2,0,1,0
276370,1833,3,239,233,6,0,0,0
0,0,0,0,0,0,0,0,0
967565,5329,7,599,513,86,11,1,0
0,0,0,0,0,0,0,0,0
0,0,0,0,0,0,0,0,0
160863,1443,0,207,195,12,3,1,0
0,0,0,0,0,0,0,0,0
0,0,0,0,0,0,0,0,0
0,0,0,0,0,0,0,0,0
175522,1387,7,317,292,25,12,1,0
20069,73,1,1,1,0,0,0,0
512407,3398,5,974,952,22,2,1,0
279462,2650,7,866,854,12,2,1,0
636034,373,9,41,39,2,6,1,0
456434,232,10,3,3,0,5,1,0
1899699,5212,5,247,193,54,2,1,0
311533,2883,11,285,249,36,16,1,0
98263,545,7,98,92,6,6,1,0
96608,540,7,98,92,6,6,1,0
1535810,1916,8,207,192,15,2,1,0
0,0,0,0,0,0,0,0,0
184849,1797,5,443,428,15,10,1,0
328821,2825,2,174,151,23,0,1,0
15560,89,1,4,1,3,0,0,0
0,0,0,0,0,0,0,0,0
0,0,0,0,0,0,0,0,0
212229,294,0,16,9,7,1,1,0
214085,1933,1,305,299,6,11,1,0
877901,1237,10,154,146,8,23,1,0
539712,1730,5,336,327,9,9,1,0
459030,1233,7,188,178,10,10,1,0
86484,1906,4,351,277,74,0,1,0
267922,1088,1,167,153,14,6,1,0
476437,786,0,135,128,7,0,1,0
0,0,0,0,0,0,0,0,0
331212,2035,5,188,181,7,2,0,0
309699,264,0,15,11,4,2,1,0
152743,334,5,75,72,3,19,1,0
144607,177,7,17,14,3,3,1,0
1670123,16275,5,163,137,26,12,0,0
13119,152,0,3,2,1,15,1,0
1785335,15535,5,503,492,11,12,1,0
822714,3439,4,126,88,38,35,1,0
0,0,0,0,0,0,0,0,0
0,0,0,0,0,0,0,0,0
505756,4507,8,724,705,19,41,1,0
0,0,0,0,0,0,0,0,0
0,0,0,0,0,0,0,0,0
231932,776,1,123,119,4,0,1,0
184348,218,3,7,5,2,9,1,0
1277190,478,4,32,23,9,2,1,0
0,0,0,0,0,0,0,0,0
273777,1464,4,203,198,5,13,1,0
147426,1739,7,87,73,14,14,0,0
16051,111,2,12,0,12,0,0,0
369405,2536,7,423,405,18,19,1,0
70473,1150,1,388,382,6,3,1,0
25785,319,0,75,69,6,0,1,0
0,0,0,0,0,0,0,0,0
0,0,0,0,0,0,0,0,0
217158,1148,3,278,233,45,6,1,0
1263499,4939,1,523,504,19,3,0,0
1263649,4939,1,523,504,19,3,0,0
627843,951,4,103,78,25,21,1,0
135388,1320,3,292,273,19,12,0,0
1453529,1160,3,165,153,12,3,1,0
387145,90,0,5,3,2,0,1,0
0,0,0,0,0,0,0,0,0
221323,1774,5,296,296,0,6,1,0
0,0,0,0,0,0,0,0,0
0,0,0,0,0,0,0,0,0
0,0,0,0,0,0,0,0,0
81344,1263,3,220,197,23,26,1,0
837567,4456,6,1104,1094,10,23,1,0
130235,614,5,94,85,9,16,1,0
157858,817,6,147,108,39,2,1,0
464668,1351,6,224,194,30,5,1,0
19021,99,1,0,0,0,0,0,0
121637,1579,7,220,215,5,1,1,0
20804,119,4,27,24,3,0,1,0
862147,4015,6,190,166,24,9,1,0
594673,2392,6,42,37,5,9,1,0
249555,1451,2,114,103,11,4,1,0
0,0,0,0,0,0,0,0,0
104765,1713,1,211,205,6,1,1,0
0,0,0,0,0,0,0,0,0
0,0,0,0,0,0,0,0,0
613904,2297,8,83,76,7,6,1,0
481079,3729,4,945,796,149,14,1,0
206068,4107,1,670,668,2,3,0,0
7244,28,0,0,0,0,0,0,0
305843,891,10,107,87,20,13,1,0
0,0,0,0,0,0,0,0,0
211363,1035,1,152,151,1,15,1,0
0,0,0,0,0,0,0,0,0
318367,3143,1,723,703,20,28,1,0
0,0,0,0,0,0,0,0,0
0,0,0,0,0,0,0,0,0
516574,2625,12,711,692,19,19,1,0
111041,305,9,13,6,7,16,0,0
190811,752,4,211,211,0,1,1,0
192832,511,4,30,29,1,2,1,0
322600,631,4,113,95,18,3,1,0
0,0,0,0,0,0,0,0,0
0,0,0,0,0,0,0,0,0
387855,1002,0,179,119,60,0,1,0
455008,2355,4,304,251,53,3,1,0
2039594,4985,6,894,610,284,16,1,0
13969,51,0,0,0,0,2,0,0
169211,826,4,144,135,9,14,0,0
263771,3551,1,988,864,124,128,1,0
0,0,0,0,0,0,0,0,0
0,0,0,0,0,0,0,0,0
0,0,0,0,0,0,0,0,0
0,0,0,0,0,0,0,0,0
776715,2355,4,184,171,13,44,0,0
353250,1706,9,541,531,10,6,1,0
11408,61,2,1,0,1,1,0,0
175188,2080,5,359,342,17,18,1,0
1831054,3110,7,400,270,130,21,1,0
618543,1164,5,184,170,14,2,1,0
232601,1590,7,247,237,10,10,0,0
992643,1380,8,229,211,18,73,1,0
106952,298,3,23,14,9,3,0,0
64255,863,2,312,306,6,17,1,0
19865,346,2,124,111,13,1,1,0
692554,1408,6,306,296,10,7,1,0
0,0,0,0,0,0,0,0,0
320253,3477,9,618,338,280,108,1,0
0,0,0,0,0,0,0,0,0
253233,1269,1,154,142,12,4,1,0
7362,46,3,0,0,0,0,1,0
284154,1949,6,290,271,19,44,1,0
6830,54,0,5,3,2,0,1,0
468634,4131,8,868,758,110,59,1,0
0,0,0,0,0,0,0,0,0
390013,2945,8,409,394,15,5,1,1
106263,971,2,79,75,4,3,1,0
0,0,0,0,0,0,0,0,0
0,0,0,0,0,0,0,0,0
588911,1548,1,193,147,46,1,1,0
230619,332,0,14,3,11,0,1,0
11526,138,1,24,11,13,0,0,0
10551,113,1,17,15,2,0,0,0
1001945,7121,4,947,900,47,8,0,0
107225,865,4,172,138,34,9,0,0
0,0,0,0,0,0,0,0,0
0,0,0,0,0,0,0,0,0
1220391,2100,8,159,144,15,37,1,0
1383545,2034,7,216,138,78,42,1,0
43550,294,6,34,32,2,3,1,0
11978,147,5,27,25,2,0,1,0
188973,1020,5,210,166,44,4,1,0
92272,346,4,37,31,6,2,0,0
0,0,0,0,0,0,0,0,0
448665,4745,2,992,952,40,9,0,0
354384,1676,6,178,141,37,2,1,0
359474,885,5,39,33,6,1,0,0
1158763,2840,4,136,16,120,0,1,0
277594,259,7,5,1,4,12,0,0
61739,717,10,141,84,57,7,1,0
34005,38,2,1,0,1,0,1,0
232240,1858,11,318,297,21,65,1,0
136567,422,4,61,26,35,4,1,0
0,0,0,0,0,0,0,0,0
220250,1379,3,289,256,33,25,1,0
0,0,0,0,0,0,0,0,0
126930,1011,1,254,234,20,0,1,0
230144,1091,3,6,5,1,1,0,0
0,0,0,0,0,0,0,0,0
469566,507,6,97,95,2,5,1,0
1666958,3083,4,155,112,43,14,1,0
296291,791,2,82,67,15,39,1,0
181657,371,1,58,47,11,1,1,0
314895,5971,4,1620,1593,27,93,1,0
0,0,0,0,0,0,0,0,0
0,0,0,0,0,0,0,0,0
0,0,0,0,0,0,0,0,0
56332,639,10,148,106,42,1,1,0
150892,2546,2,628,459,169,12,1,0
150327,1222,5,170,145,25,16,0,0
13406,152,0,3,2,1,15,1,0
3937,38,3,0,0,0,0,0,0
511795,785,3,261,259,2,0,1,0
531010,2664,4,510,492,18,0,1,0
35993,294,2,12,11,1,1,0,0
116875,1427,3,411,331,80,7,1,0
770056,1964,5,210,139,71,5,1,0
0,0,0,0,0,0,0,0,0
23049,325,8,56,23,33,1,0,0
32686,146,4,10,10,0,5,1,0
379736,2957,11,503,485,18,9,1,0
83023,324,10,8,8,0,7,0,0
287880,1963,4,148,133,15,4,1,0
285855,814,5,154,142,12,3,1,0
48285,167,4,21,12,9,2,1,0
27674,42,0,2,1,1,0,0,0
422734,3070,2,236,223,13,5,1,0
385841,3185,2,409,149,260,5,1,0
223944,1832,1,295,70,225,3,1,0
25507,233,2,65,57,8,0,1,0
32396,202,1,39,39,0,1,1,0
903892,933,2,117,103,14,2,1,0
214574,1525,11,400,400,0,0,1,0
0,0,0,0,0,0,0,0,0
33183,175,2,15,14,1,1,1,0
306072,1727,6,365,282,83,64,1,0
1810589,2167,14,156,147,9,34,1,0
190298,999,3,187,180,7,10,1,0
110615,2067,2,894,193,701,6,1,0
34670,154,4,40,32,8,0,1,0
23641,191,1,12,1,11,0,1,0
186908,2730,5,656,623,33,4,1,0
223223,1258,2,186,154,32,2,0,0
92153,1214,6,319,316,3,7,1,0
482980,2822,6,464,349,115,52,1,0
414434,6122,6,2520,2118,402,118,1,0
10485,150,3,22,19,3,6,1,0
0,0,0,0,0,0,0,0,0
212620,3163,9,491,481,10,29,1,0
585793,226,9,24,16,8,29,1,0
425281,989,2,153,135,18,0,1,0
231635,356,0,15,9,6,1,1,0
194188,734,4,149,145,4,7,1,0
592181,2194,4,34,29,5,6,0,0
1381901,1605,5,272,265,7,147,1,0
158814,1561,4,152,24,128,11,1,0
45528,189,2,7,6,1,1,0,0
263834,608,1,58,51,7,0,0,0
47857,239,7,39,34,5,2,1,0
1722289,3418,4,529,524,5,7,1,0
473144,918,5,173,168,5,6,1,0
0,0,0,0,0,0,0,0,0
491922,1372,10,251,45,206,23,1,0
261848,1990,4,200,187,13,8,1,0
365704,3894,6,415,407,8,19,1,0
212528,1870,6,301,286,15,33,1,0
7591,85,2,4,4,0,0,0,0
44715,558,2,159,78,81,12,1,0
0,0,0,0,0,0,0,0,0
157786,1607,9,285,248,37,1,0,0
24755,336,7,3,1,2,1,0,0
426654,3576,6,727,701,26,1,1,0
216800,790,6,176,174,2,1,1,0
6341193,1345,4,116,55,61,49,1,0
48650,291,10,31,19,12,1,1,0
0,0,0,0,0,0,0,0,0
740476,3334,4,817,252,565,6,1,1
140677,216,2,24,20,4,5,1,0
190136,467,1,42,38,4,6,1,0
0,0,0,0,0,0,0,0,0
469563,2116,6,222,190,32,15,0,0
99680,305,3,30,29,1,5,0,0
376727,1071,4,187,167,20,37,1,0
1734,29,0,6,0,6,0,0,0
271360,2476,3,231,222,9,0,1,0
232050,358,0,15,8,7,1,1,0
166353,1385,3,343,273,70,0,1,0
18438,172,4,19,11,8,2,1,0
383356,1353,4,336,284,52,4,1,1
303358,704,5,219,183,36,3,1,0
0,0,0,0,0,0,0,0,0
0,0,0,0,0,0,0,0,0
0,0,0,0,0,0,0,0,0
0,0,0,0,0,0,0,0,0
487106,1211,1,120,84,36,4,0,0
67368,242,3,17,9,8,0,1,0
329260,2060,6,72,70,2,4,1,0
321449,1261,7,217,208,9,12,1,0
91337,561,4,146,139,7,1,1,0
1036131,3795,2,327,277,50,1,1,0
284883,1296,3,111,91,20,3,1,0
15095,94,4,11,7,4,0,1,0
0,0,0,0,0,0,0,0,0
475700,3393,9,670,638,32,70,0,0
584590,10791,6,4421,4415,6,7,1,0
110921,1257,6,359,359,0,2,1,0
812640,2060,6,306,289,17,21,1,0
223458,1632,8,192,158,34,9,1,0
639261,2301,2,334,331,3,1,0,0
250916,3060,3,841,592,249,20,1,0
0,0,0,0,0,0,0,0,0
0,0,0,0,0,0,0,0,0
0,0,0,0,0,0,0,0,0
128472,915,5,335,300,35,8,1,0
74730,775,2,103,95,8,5,0,0
116217,1128,2,299,257,42,2,1,0
0,0,0,0,0,0,0,0,0
725058,4585,9,1231,1222,9,21,1,0
459615,2067,6,102,94,8,14,1,0
417565,921,2,141,110,31,2,1,0
166933,443,2,8,7,1,6,0,0
273287,2675,7,563,507,56,6,1,0
65258,511,10,85,75,10,8,1,0
39492,368,5,48,43,5,4,1,0
47061,129,2,5,5,0,9,1,0
199282,750,15,61,1,60,1,1,0
83123,566,4,80,78,2,0,0,0
1047905,1521,7,140,122,18,28,1,0
230254,964,11,113,111,2,17,0,0
191373,2038,7,419,343,76,11,1,0
8209,95,1,8,8,0,1,1,0
64588,695,0,222,212,10,3,1,0
0,0,0,0,0,0,0,0,0
387574,1237,6,197,174,23,14,1,0
31223,771,1,211,211,0,2,1,0
303034,1869,7,438,396,42,8,1,0
142750,486,7,107,95,12,8,1,0
0,0,0,0,0,0,0,0,0
403172,5667,3,1326,1108,218,13,1,0
94042,851,3,148,140,8,13,1,0
367563,3671,3,965,923,42,1,1,1
0,0,0,0,0,0,0,0,0
0,0,0,0,0,0,0,0,0
332582,1398,4,110,93,17,6,1,0
41070,269,4,9,2,7,3,1,0
145281,353,5,57,39,18,3,1,0
49056,402,9,103,87,16,0,1,0
245888,1240,2,184,153,31,17,1,0
505798,1919,6,224,192,32,14,0,0
157075,1858,2,182,168,14,15,1,0
76020,508,5,80,47,33,4,0,0
0,0,0,0,0,0,0,0,0
211444,1693,8,196,184,12,47,1,0
91307,737,8,84,84,0,11,1,0
458365,2115,6,339,273,66,7,1,0
7303,96,1,16,16,0,1,1,0
220771,1276,9,181,177,4,16,1,0
0,0,0,0,0,0,0,0,0
0,0,0,0,0,0,0,0,0
0,0,0,0,0,0,0,0,0
75788,1271,6,90,71,19,0,0,0
724640,4215,7,465,449,16,2,1,0
91093,257,0,48,24,24,0,1,1
0,0,0,0,0,0,0,0,0
1908195,3776,8,532,476,56,29,1,0
569843,945,4,2,0,2,9,1,0
228950,332,0,14,3,11,0,1,0
42820,427,10,68,58,10,5,0,0
224406,3235,5,857,846,11,6,1,0
264107,1182,3,283,256,27,1,1,0
116899,1029,10,130,78,52,1,1,0
0,0,0,0,0,0,0,0,0
0,0,0,0,0,0,0,0,0
55525,330,7,72,60,12,2,1,0
0,0,0,0,0,0,0,0,0
369640,3033,4,535,477,58,5,1,0
29319,180,2,43,15,28,1,1,0
602944,2390,18,339,315,24,44,1,0
81472,199,4,13,11,2,8,1,0
440296,3140,2,343,330,13,3,1,0
40034,396,6,84,44,40,10,1,0
734268,4269,4,803,485,318,53,1,0
0,0,0,0,0,0,0,0,0
0,0,0,0,0,0,0,0,0
664302,5014,4,1189,1180,9,67,1,0
149361,1029,5,138,116,22,6,1,0
242223,2406,2,229,218,11,1,0,0
10126,101,4,3,3,0,0,0,0
0,0,0,0,0,0,0,0,0
276740,1877,14,391,369,22,21,0,0
97739,676,3,94,88,6,0,1,0
34030,282,4,46,40,6,6,1,0
0,0,0,0,0,0,0,0,0
0,0,0,0,0,0,0,0,0
0,0,0,0,0,0,0,0,0
55116,605,4,93,79,14,10,1,0
8761,135,2,23,22,1,0,1,0
30733,435,2,133,110,23,3,1,0
13356,194,2,29,24,5,10,0,0
0,0,0,0,0,0,0,0,0
0,0,0,0,0,0,0,0,0
205018,1061,1,258,236,22,3,0,0
810581,1331,1,211,177,34,1,0,0
232314,800,1,62,51,11,8,1,0
1041926,3078,3,284,268,16,1,1,0
413673,469,2,4,4,0,1,1,0
116672,993,2,268,132,136,2,1,0
0,0,0,0,0,0,0,0,0
91506,676,4,198,180,18,3,1,0
388919,3697,5,821,420,401,40,1,0
176793,1577,1,518,505,13,2,1,0
0,0,0,0,0,0,0,0,0
557752,2406,12,532,511,21,12,1,1
22060,198,5,4,2,2,3,1,0
701914,997,3,117,108,9,0,1,0
195997,676,2,127,114,13,5,1,0
0,0,0,0,0,0,0,0,0
7065,79,0,2,2,0,0,0,0
303286,1959,7,420,395,25,17,1,0
285025,1445,7,84,68,16,5,1,0
1616439,1281,3,169,11,158,4,1,0
379532,93,0,3,3,0,0,1,0
1589235,5360,7,369,175,194,17,1,0
246875,1691,6,403,356,47,14,1,0
0,0,0,0,0,0,0,0,0
240135,789,4,92,84,8,0,1,0
679884,167,0,0,0,0,0,0,0
1649252,6112,4,520,482,38,2,1,0
0,0,0,0,0,0,0,0,0
751750,2345,2,330,314,16,5,1,0
197365,2058,5,848,834,14,9,1,0
11622,111,1,30,30,0,0,1,0
485512,1060,3,126,102,24,4,1,0
15242,101,2,7,7,0,0,0,0
23418,110,0,8,1,7,2,1,0
338215,1555,2,145,137,8,6,1,0
76549,603,8,139,90,49,5,0,0
649211,785,7,124,116,8,4,1,0
415278,124,4,2,2,0,0,0,0
111450,471,4,91,79,12,19,1,0
111790,427,4,64,55,9,25,1,0
108756,1565,3,380,340,40,12,0,0
14655,193,3,10,7,3,6,1,0
9146,127,3,11,8,3,3,1,0
0,0,0,0,0,0,0,0,0
0,0,0,0,0,0,0,0,0
0,0,0,0,0,0,0,0,0
272119,1418,14,242,205,37,25,1,0
0,0,0,0,0,0,0,0,0
71651,925,2,189,187,2,2,0,0
24161,464,2,104,104,0,2,0,0
2904143,4690,12,879,856,23,19,1,0
215930,411,9,6,5,1,21,1,0
128510,1009,8,226,206,20,11,0,0
48423,118,5,12,12,0,0,1,0
29213,241,4,22,20,2,1,1,0
6112,80,6,5,5,0,1,0,0
745200,1530,6,65,29,36,1,1,0
0,0,0,0,0,0,0,0,0
115635,1261,8,311,304,7,11,1,0
351448,2355,8,456,447,9,9,1,0
163695,1351,7,248,239,9,5,1,0
0,0,0,0,0,0,0,0,0
489444,3149,4,250,203,47,8,1,0
524942,2085,4,176,79,97,13,1,0
134381,1113,8,192,128,64,8,1,0
770,16,0,2,2,0,0,0,0
0,0,0,0,0,0,0,0,0
862570,1603,10,142,111,31,21,1,0
0,0,0,0,0,0,0,0,0
400816,1164,8,174,148,26,21,1,0
0,0,0,0,0,0,0,0,0
123544,796,4,120,112,8,1,1,0
118028,1240,7,381,336,45,20,0,0
139751,1316,9,168,154,14,24,1,0
711395,1521,5,90,53,37,2,1,0
216782,1319,2,143,129,14,2,1,0
29804,148,2,5,5,0,0,1,0
526619,1991,12,514,412,102,21,0,0
0,0,0,0,0,0,0,0,0
450522,1467,7,71,66,5,0,1,0
102239,1097,2,163,162,1,6,1,0
63679,944,1,263,259,4,16,1,0
1466583,1206,2,138,126,12,2,1,0
382493,121,0,5,5,0,0,1,0
0,0,0,0,0,0,0,0,0
225452,968,4,117,111,6,10,1,0
0,0,0,0,0,0,0,0,0
462333,2029,10,315,196,119,56,1,0
1827578,289,2,45,39,6,0,1,0
0,0,0,0,0,0,0,0,0
59631,595,8,94,49,45,1,1,0
28305,169,2,21,17,4,3,1,0
0,0,0,0,0,0,0,0,0
204121,884,2,64,63,1,1,1,0
0,0,0,0,0,0,0,0,0
299714,1287,7,208,192,16,14,1,0
523476,1023,7,124,110,14,21,1,0
427417,2075,5,302,270,32,4,1,0
0,0,0,0,0,0,0,0,0
240856,1530,4,165,130,35,15,1,0
0,0,0,0,0,0,0,0,0
164903,1420,2,62,55,7,10,0,0
381803,1743,2,401,300,101,2,1,0
163874,331,1,74,25,49,0,1,0
235573,358,0,15,12,3,1,1,0
492517,830,4,114,104,10,24,1,0
32737,662,4,235,227,8,2,1,0
392605,1266,6,34,24,10,8,1,0
267793,1854,8,146,144,2,60,0,0
352668,3633,5,681,614,67,73,1,0
118994,564,3,99,91,8,21,1,0
198718,852,5,83,69,14,17,1,0
0,0,0,0,0,0,0,0,0
0,0,0,0,0,0,0,0,0
0,0,0,0,0,0,0,0,0
1339166,8463,3,667,461,206,13,1,0
0,0,0,0,0,0,0,0,0
6214,58,0,4,1,3,0,1,0
0,0,0,0,0,0,0,0,0
217673,3456,2,738,734,4,9,1,0
0,0,0,0,0,0,0,0,0
0,0,0,0,0,0,0,0,0
724284,1189,5,123,103,20,3,1,0
239075,822,5,110,87,23,2,1,0
956398,4757,2,442,350,92,189,1,0
9354,102,2,9,9,0,0,0,0
0,0,0,0,0,0,0,0,0
369575,2649,4,352,341,11,4,1,0
827520,4957,7,443,365,78,102,0,0
43299,464,3,65,65,0,0,1,0
0,0,0,0,0,0,0,0,0
231660,2160,6,253,230,23,2,1,0
0,0,0,0,0,0,0,0,0
1127903,6850,8,669,596,73,56,1,0
25428,150,2,13,1,12,2,1,0
210743,1430,1,498,486,12,0,1,0
0,0,0,0,0,0,0,0,0
28816,45,0,4,1,3,0,0,0
15226,327,4,67,27,40,1,1,0
79851,958,2,332,332,0,1,1,0
719686,1518,4,124,99,25,1,0,0
461181,3546,14,594,441,153,314,1,0
290134,3142,7,757,680,77,9,1,0
0,0,0,0,0,0,0,0,0
1489930,1247,3,142,128,14,2,1,0
383390,120,0,4,4,0,0,1,0
0,0,0,0,0,0,0,0,0
489614,2275,4,439,419,20,11,1,0
47963,258,1,97,94,3,2,0,0
0,0,0,0,0,0,0,0,0
77653,567,1,26,14,12,21,1,0
376836,2677,11,562,546,16,28,1,1
0,0,0,0,0,0,0,0,0
0,0,0,0,0,0,0,0,0
0,0,0,0,0,0,0,0,0
1259,23,0,1,1,0,0,0,0
262752,2212,7,413,412,1,0,0,0
94571,284,8,37,36,1,2,0,0
0,0,0,0,0,0,0,0,0
206682,1524,7,394,352,42,12,1,0
449670,3867,6,430,408,22,323,1,0
407361,642,8,78,69,9,0,1,0
0,0,0,0,0,0,0,0,0
1425011,2254,6,114,108,6,15,1,0
0,0,0,0,0,0,0,0,0
1360735,2689,6,381,175,206,42,1,0
83087,1356,1,376,361,15,0,0,0
148369,1674,3,272,259,13,13,1,0
29340,211,2,19,17,2,2,1,0
71715,1095,1,224,178,46,8,1,0
0,0,0,0,0,0,0,0,0
308328,2223,4,443,204,239,4,1,0
61297,144,1,27,18,9,2,1,0
684816,3650,5,955,945,10,1,1,0
288782,1892,2,175,159,16,1,0,0
0,0,0,0,0,0,0,0,0
4171106,218,2,31,27,4,0,1,0
9687,121,3,10,10,0,1,1,0
693094,3243,3,724,518,206,28,1,0
22755,320,2,60,30,30,1,1,0
191620,2944,3,841,835,6,64,1,0
0,0,0,0,0,0,0,0,0
56469,388,2,45,36,9,4,1,0
34837,143,3,6,6,0,0,0,0
424634,6884,5,964,960,4,27,1,1
52285,323,5,8,7,1,0,0,0
187163,1227,5,211,130,81,3,1,0
256256,581,0,109,101,8,0,1,0
741992,1163,3,157,132,25,8,1,0
159423,1917,9,254,157,97,7,1,0
57464,280,8,4,2,2,13,0,0
94511,1096,4,260,251,9,11,0,0
669601,6644,3,468,455,13,18,1,1
118242,840,3,194,162,32,1,1,0
82344,481,4,150,144,6,2,1,0
261455,974,5,115,104,11,27,1,0
430500,2623,7,500,494,6,41,0,0
377368,3760,4,674,502,172,3,1,1
0,0,0,0,0,0,0,0,0
60148,858,8,136,132,4,1,0,0
12845,152,4,11,11,0,2,1,0
0,0,0,0,0,0,0,0,0
0,0,0,0,0,0,0,0,0
0,0,0,0,0,0,0,0,0
0,0,0,0,0,0,0,0,0
0,0,0,0,0,0,0,0,0
0,0,0,0,0,0,0,0,0
0,0,0,0,0,0,0,0,0
21259,36,0,2,1,1,0,1,0
0,0,0,0,0,0,0,0,0
0,0,0,0,0,0,0,0,0
237343,1674,8,575,568,7,0,0,0
130276,2264,4,260,256,4,4,1,0
36319,492,3,164,162,2,1,1,0
0,0,0,0,0,0,0,0,0
0,0,0,0,0,0,0,0,0
0,0,0,0,0,0,0,0,0
353214,1346,4,138,131,7,2,1,0
0,0,0,0,0,0,0,0,0
23404,338,1,57,49,8,1,1,0
217843,1373,4,181,163,18,2,1,0
0,0,0,0,0,0,0,0,0
630183,1809,6,351,332,19,3,1,0
0,0,0,0,0,0,0,0,0
49125,510,4,67,52,15,2,1,0
0,0,0,0,0,0,0,0,0
0,0,0,0,0,0,0,0,0
0,0,0,0,0,0,0,0,0
0,0,0,0,0,0,0,0,0
0,0,0,0,0,0,0,0,0
0,0,0,0,0,0,0,0,0
506560,1133,6,119,112,7,9,1,0
165545,419,2,24,0,24,18,0,0
0,0,0,0,0,0,0,0,0
0,0,0,0,0,0,0,0,0
0,0,0,0,0,0,0,0,0
0,0,0,0,0,0,0,0,0
0,0,0,0,0,0,0,0,0
0,0,0,0,0,0,0,0,0
0,0,0,0,0,0,0,0,0
0,0,0,0,0,0,0,0,0
838153,3099,11,488,416,72,0,1,0
0,0,0,0,0,0,0,0,0
0,0,0,0,0,0,0,0,0
96391,1347,6,145,125,20,7,1,0
0,0,0,0,0,0,0,0,0
0,0,0,0,0,0,0,0,0
0,0,0,0,0,0,0,0,0
45976,141,2,5,0,5,1,0,0
58196,317,1,41,30,11,1,0,0
0,0,0,0,0,0,0,0,0
0,0,0,0,0,0,0,0,0
0,0,0,0,0,0,0,0,0
0,0,0,0,0,0,0,0,0
0,0,0,0,0,0,0,0,0
0,0,0,0,0,0,0,0,0
0,0,0,0,0,0,0,0,0
984096,1260,4,186,172,14,0,1,0
0,0,0,0,0,0,0,0,0
0,0,0,0,0,0,0,0,0
0,0,0,0,0,0,0,0,0
0,0,0,0,0,0,0,0,0
0,0,0,0,0,0,0,0,0
0,0,0,0,0,0,0,0,0
0,0,0,0,0,0,0,0,0
0,0,0,0,0,0,0,0,0
0,0,0,0,0,0,0,0,0
40506,195,4,6,3,3,7,1,0
0,0,0,0,0,0,0,0,0
1100314,4242,1,514,193,321,2,1,0
7162,134,0,49,29,20,1,0,0
363219,5323,2,3246,3219,27,1,1,0
0,0,0,0,0,0,0,0,0
0,0,0,0,0,0,0,0,0
0,0,0,0,0,0,0,0,0
87276,535,0,92,88,4,1,1,0
250006,1749,7,266,237,29,27,1,0
103503,506,9,77,71,6,29,1,0
249334,912,0,136,20,116,17,1,0
111113,581,4,63,54,9,7,0,0
0,0,0,0,0,0,0,0,0
0,0,0,0,0,0,0,0,0
0,0,0,0,0,0,0,0,0
570819,3053,7,203,187,16,2,1,0
293463,941,6,157,137,20,2,1,0
326835,4880,1,1454,1405,49,1,0,0
74459,162,1,14,4,10,1,1,0
452676,896,6,157,151,6,13,0,0
96294,86,2,4,3,1,0,1,0
481850,2714,6,355,355,0,0,1,0
30228,126,7,13,10,3,3,0,0
586744,3945,6,407,387,20,10,1,0
140053,1066,5,200,186,14,84,0,0
137190,978,7,166,141,25,11,1,0
7989,84,5,13,6,7,6,1,0
0,0,0,0,0,0,0,0,0
405,6,0,0,0,0,0,0,0
152451,1641,5,236,211,25,10,1,0
172569,1616,6,370,362,8,10,0,0
172740,1616,6,370,361,9,11,0,0
0,0,0,0,0,0,0,0,0
0,0,0,0,0,0,0,0,0
42980,36,0,1,0,1,0,0,1
0,0,0,0,0,0,0,0,0
0,0,0,0,0,0,0,0,0
986412,3786,14,235,220,15,161,1,0
262619,1387,5,288,274,14,20,1,0
86937,923,3,237,229,8,0,1,0
0,0,0,0,0,0,0,0,0
225243,713,1,146,138,8,1,1,0
47891,164,3,20,12,8,2,1,0
293967,728,3,96,87,9,7,1,0
37372,434,2,159,141,18,21,1,0
6781,83,1,7,7,0,2,1,0
936363,3202,17,506,440,66,31,1,0
53239,819,2,11,2,9,1,0,0
86704,580,4,110,101,9,0,1,0
256317,2120,8,487,433,54,15,1,0
0,0,0,0,0,0,0,0,0
97651,865,10,85,77,8,5,0,0
163033,769,1,64,53,11,0,1,0
271660,1336,5,192,185,7,7,1,0
261728,413,5,41,33,8,7,1,0
555999,3401,11,379,376,3,4,1,1
460061,1499,1,179,35,144,14,1,0
36491,355,0,7,5,2,6,0,0
223676,741,3,120,105,15,30,1,0
44100,637,3,238,232,6,3,0,0
36281,614,3,23,22,1,1,1,0
284568,1516,1,120,114,6,2,1,0
50073,1116,1,318,301,17,0,0,0
232632,338,0,17,11,6,0,1,0
791226,1695,9,285,270,15,9,1,0
362753,2426,6,201,162,39,10,1,0
0,0,0,0,0,0,0,0,0
39098,62,3,0,0,0,2,0,0
672542,541,0,4,0,4,2,1,1
1101556,800,2,54,44,10,6,1,0
367159,956,4,184,157,27,1,1,0
0,0,0,0,0,0,0,0,0
568043,4226,6,439,416,23,5,1,0
471068,1221,3,121,107,14,4,1,0
14535,100,2,7,7,0,0,0,0
68030,510,8,23,19,4,8,0,0
15108,151,12,3,2,1,3,1,0
0,0,0,0,0,0,0,0,0
157701,2072,1,263,222,41,1,1,0
527187,1698,6,88,86,2,3,1,0
424561,1188,6,15,13,2,19,1,0
326721,1342,3,162,126,36,4,1,0
0,0,0,0,0,0,0,0,0
0,0,0,0,0,0,0,0,0
205244,502,1,52,31,21,0,1,0
385650,2429,2,340,338,2,4,0,0
138546,1151,2,152,145,7,10,0,0
52746,698,4,216,190,26,1,1,0
39429,464,6,157,147,10,0,1,0
2054239,7472,2,555,461,94,2,0,0
0,0,0,0,0,0,0,0,0
1992593,3129,4,407,393,14,246,1,0
0,0,0,0,0,0,0,0,0
0,0,0,0,0,0,0,0,0
0,0,0,0,0,0,0,0,0
355974,1545,9,310,265,45,4,1,0
246159,846,9,92,92,0,7,1,0
0,0,0,0,0,0,0,0,0
1305272,3705,6,444,396,48,6,1,0
113853,296,2,56,44,12,0,1,0
15250,221,0,81,81,0,1,1,0
0,0,0,0,0,0,0,0,0
2366082,310,0,14,10,4,0,1,0
47115,410,1,46,29,17,0,1,0
325,7,1,0,0,0,0,0,1
0,0,0,0,0,0,0,0,0
0,0,0,0,0,0,0,0,0
98531,1081,6,233,188,45,5,0,0
649106,1574,4,119,92,27,8,1,0
0,0,0,0,0,0,0,0,0
0,0,0,0,0,0,0,0,0
0,0,0,0,0,0,0,0,0
0,0,0,0,0,0,0,0,0
588264,3953,5,579,542,37,9,0,0
311154,1133,6,237,231,6,9,0,0
646963,6512,5,645,626,19,37,1,0
195690,770,8,95,83,12,15,1,0
60416,124,7,3,3,0,4,0,0
359427,3274,6,886,886,0,0,0,0
47720,412,2,124,119,5,4,1,0
35939,155,2,31,28,3,5,1,0
488523,3632,1,245,226,19,10,1,0
662560,1963,4,252,218,34,3,1,0
0,0,0,0,0,0,0,0,0
269085,985,2,89,86,3,1,0,0
0,0,0,0,0,0,0,0,0
0,0,0,0,0,0,0,0,0
218075,1595,11,314,231,83,26,1,0
180994,867,4,33,20,13,14,0,0
55080,830,1,218,215,3,0,0,0
0,0,0,0,0,0,0,0,0
726995,4397,7,1409,1393,16,70,1,0
457027,2586,6,1212,1196,16,66,1,0
1371765,1208,8,162,142,20,11,1,0
62574,649,3,121,106,15,0,1,0
627856,4278,10,1145,919,226,5,1,0
300585,2201,2,331,313,18,1,1,0
0,0,0,0,0,0,0,0,0
1357650,4732,4,633,459,174,3,1,0
0,0,0,0,0,0,0,0,0
43338,587,2,89,56,33,26,1,0
219909,1341,7,206,195,11,28,1,0
39034,131,5,6,6,0,2,1,0
86822,208,6,30,23,7,2,1,0
228091,1246,9,269,232,37,2,1,0
0,0,0,0,0,0,0,0,0
854773,2914,8,362,254,108,13,1,0
549574,1565,3,131,69,62,2,1,0
1138448,2929,6,293,265,28,18,1,0
491719,2456,9,300,155,145,3,1,0
290441,933,4,114,67,47,5,1,0
0,0,0,0,0,0,0,0,0
1802044,3092,6,382,348,34,14,1,0
30337,137,0,1,1,0,0,0,0
0,0,0,0,0,0,0,0,0
812711,2212,5,317,304,13,9,1,0
963984,1141,9,160,140,20,16,1,0
56388,727,3,92,79,13,8,1,0
0,0,0,0,0,0,0,0,0
798779,2476,5,421,361,60,70,1,0
173766,858,1,187,171,16,6,1,0
0,0,0,0,0,0,0,0,0
1144043,2448,11,368,331,37,71,1,0
58093,127,1,2,2,0,0,0,1
0,0,0,0,0,0,0,0,0
171234,473,6,55,27,28,2,1,0
0,0,0,0,0,0,0,0,0
0,0,0,0,0,0,0,0,0
31618,213,3,31,26,5,1,0,0
878682,4282,9,814,775,39,157,1,0
55121,528,1,103,93,10,4,1,0
0,0,0,0,0,0,0,0,0
287938,1500,5,132,107,25,7,1,0
0,0,0,0,0,0,0,0,0
0,0,0,0,0,0,0,0,0
0,0,0,0,0,0,0,0,0
791065,5923,4,573,573,0,36,1,0
6308,54,5,5,5,0,2,0,0
428360,5779,1,1724,1677,47,1,0,0
137888,1173,0,158,147,11,4,1,0
0,0,0,0,0,0,0,0,0
229031,336,0,16,5,11,0,1,0
0,0,0,0,0,0,0,0,0
456758,1949,12,311,14,297,34,1,0
229558,338,0,17,11,6,0,1,0
0,0,0,0,0,0,0,0,0
0,0,0,0,0,0,0,0,0
494117,2838,9,360,353,7,50,1,0
136010,897,4,54,40,14,2,1,0
12707,113,5,18,16,2,1,1,0
14310,127,5,20,18,2,1,1,0
377472,2112,4,172,163,9,0,1,0
596039,1635,16,264,245,19,47,1,0
0,0,0,0,0,0,0,0,0
8916,155,1,62,40,22,1,1,0
504506,3591,5,1520,1511,9,2,0,0
0,0,0,0,0,0,0,0,0
0,0,0,0,0,0,0,0,0
2651465,6010,4,312,289,23,0,1,0
219853,1012,2,89,70,19,5,1,0
0,0,0,0,0,0,0,0,0
0,0,0,0,0,0,0,0,0
0,0,0,0,0,0,0,0,0
236593,1401,13,282,268,14,7,1,0
12001,79,6,5,5,0,0,0,0
854125,3425,3,628,587,41,5,1,0
194613,873,0,34,14,20,0,1,0
525389,3958,5,207,178,29,4,0,0
266117,1238,9,192,102,90,5,1,0
193253,177,1,21,18,3,0,0,0
0,0,0,0,0,0,0,0,0
345717,3208,3,526,378,148,0,1,0
94132,1722,5,204,180,24,11,1,0
19472,120,4,12,9,3,9,1,0
601180,3086,3,946,944,2,0,1,0
3187053,979,5,167,159,8,5,1,0
502764,139,2,10,10,0,0,1,0
0,0,0,0,0,0,0,0,0
572169,3625,3,474,437,37,5,1,0
101077,781,12,45,33,12,24,1,0
189821,1270,9,280,233,47,8,1,0
39513,187,7,2,2,0,5,0,0
246738,1230,14,238,217,21,13,1,0
358922,4082,9,691,624,67,6,1,0
92152,259,1,48,24,24,0,1,1
285864,957,1,101,91,10,16,1,0
0,0,0,0,0,0,0,0,0
18354,247,4,22,20,2,0,0,0
7740,103,5,1,1,0,2,0,0
46227,548,3,62,49,13,0,0,0
0,0,0,0,0,0,0,0,0
280258,1544,3,116,108,8,3,1,0
164341,654,3,5,5,0,1,1,0
1246008,1203,1,80,41,39,11,1,0
0,0,0,0,0,0,0,0,0
580950,2470,1,207,186,21,44,1,0
586550,4464,8,223,210,13,23,1,0
200770,457,5,93,88,5,0,1,0
239456,1330,1,274,258,16,0,1,0
331364,1440,4,221,220,1,3,1,0
481778,1076,3,122,105,17,4,1,0
15046,100,2,7,7,0,0,0,0
27867,151,4,21,9,12,1,0,0
21204,119,5,15,9,6,3,0,0
0,0,0,0,0,0,0,0,0
0,0,0,0,0,0,0,0,0
39491,440,5,63,57,6,8,1,0
16614,153,4,25,23,2,7,1,0
686084,1585,4,134,93,41,6,1,0
302929,4025,3,1371,1369,2,5,0,0
275172,3335,0,1197,874,323,1,1,0
9548,101,2,16,16,0,0,1,0
3362,34,0,0,0,0,0,0,0
3362,34,0,0,0,0,0,0,0
226015,936,1,160,137,23,21,1,0
0,0,0,0,0,0,0,0,0
162656,832,0,56,45,11,0,1,0
152239,971,1,6,6,0,0,1,0
316786,2147,9,127,112,15,9,0,0
236358,1481,4,189,185,4,0,0,0
0,0,0,0,0,0,0,0,0
1413893,3167,4,193,163,30,2,1,0
74316,322,1,12,10,2,9,1,0
157626,891,7,130,109,21,9,1,0
0,0,0,0,0,0,0,0,0
338944,1947,14,157,142,15,14,1,0
378870,1210,8,206,196,10,8,1,0
233075,336,0,16,3,13,0,1,0
593893,1878,7,218,187,31,9,1,0
217928,1355,7,95,88,7,2,1,0
86222,112,5,4,4,0,6,0,0
3865416,6697,9,1065,1008,57,33,1,0
525554,1706,8,272,272,0,11,1,0
0,0,0,0,0,0,0,0,0
172208,2252,5,218,51,167,17,1,0
48633,668,4,169,149,20,2,1,0
261876,1482,5,277,269,8,7,1,0
64485,557,2,34,31,3,45,1,0
24180,184,3,10,10,0,6,1,0
106119,1199,4,195,76,119,4,1,0
229223,784,4,103,93,10,0,1,0
928506,3055,8,3,3,0,2,0,0
197034,1482,8,218,199,19,6,0,0
83422,1148,4,404,354,50,2,0,0
7703,133,1,5,5,0,0,0,0
744461,3674,10,373,67,306,11,1,0
681422,2817,2,125,104,21,3,1,0
1526797,1173,4,94,94,0,2,1,0
140882,224,6,4,4,0,4,1,0
354315,2512,12,308,293,15,26,1,1
0,0,0,0,0,0,0,0,0
438274,3052,5,299,281,18,2,1,0
191878,1440,5,258,148,110,31,1,0
547036,2022,6,247,226,21,15,0,0
163697,1637,7,325,320,5,24,1,0
11489,98,3,2,2,0,1,0,0
473393,2189,7,344,325,19,13,1,0
54555,161,6,4,4,0,9,0,0
210082,2974,6,415,401,14,13,1,0
36512,442,2,79,73,6,0,1,0
21498,110,4,12,11,1,2,1,0
0,0,0,0,0,0,0,0,0
0,0,0,0,0,0,0,0,0
120029,1505,5,231,229,2,1,1,0
19763,112,4,27,24,3,0,1,0
0,0,0,0,0,0,0,0,0
0,0,0,0,0,0,0,0,0
162217,1181,5,249,243,6,7,1,0
86105,614,15,151,124,27,6,1,0
140898,1047,2,98,77,21,11,0,0
134646,366,2,19,19,0,27,0,0
310255,593,6,3,0,3,1,1,0
0,0,0,0,0,0,0,0,0
78592,1037,2,290,290,0,0,1,0
900522,1552,2,291,264,27,0,1,0
398599,997,5,180,161,19,2,1,0
169943,1911,3,388,365,23,11,1,0
0,0,0,0,0,0,0,0,0
280624,1931,6,388,383,5,7,1,0
253452,1602,6,368,358,10,7,1,0
132336,1364,1,164,155,9,8,1,0
139648,1438,1,164,155,9,8,1,0
0,0,0,0,0,0,0,0,0
0,0,0,0,0,0,0,0,0
33153,319,3,96,80,16,6,1,0
11554,133,3,22,20,2,0,1,0
331371,1666,7,259,225,34,8,1,0
11854,63,1,1,0,1,0,0,0
99577,1244,0,263,249,14,1,1,0
66695,466,4,114,101,13,1,1,0
0,0,0,0,0,0,0,0,0
517162,2150,11,355,346,9,17,0,0
0,0,0,0,0,0,0,0,0
12047,335,1,124,118,6,0,0,0
0,0,0,0,0,0,0,0,0
0,0,0,0,0,0,0,0,0
2174619,173,2,16,15,1,0,1,0
656202,2143,2,272,248,24,5,1,0
0,0,0,0,0,0,0,0,0
341118,1231,14,40,24,16,13,1,0
0,0,0,0,0,0,0,0,0
250185,1034,2,158,148,10,5,0,0
487918,2376,1,428,379,49,1,1,0
382123,1999,0,348,337,11,23,1,0
78317,403,0,50,39,11,21,1,0
194843,2063,5,600,573,27,2,1,0
4607,57,1,10,5,5,0,1,0
196000,676,2,127,105,22,5,1,0
196551,2243,2,510,488,22,14,1,1
2233042,7869,0,459,440,19,0,0,0
0,0,0,0,0,0,0,0,0
3557707,6269,11,216,210,6,29,1,0
400668,2892,8,550,532,18,21,1,0
0,0,0,0,0,0,0,0,0
232651,338,0,17,8,9,0,1,0
245392,870,6,92,52,40,0,1,0
160323,1592,4,310,304,6,4,1,0
166997,1619,4,312,306,6,4,1,0
0,0,0,0,0,0,0,0,0
342842,2017,5,197,174,23,2,1,0
555837,2660,8,262,209,53,17,1,0
26848,316,3,12,3,9,0,1,0
490743,2201,6,260,233,27,22,1,0
278399,1572,9,279,227,52,17,1,0
250094,1057,9,179,156,23,5,1,0
27616,42,0,2,1,1,0,0,0
1387878,9235,3,1130,1105,25,3,1,0
1133283,7488,3,802,775,27,4,1,0
0,0,0,0,0,0,0,0,0
0,0,0,0,0,0,0,0,0
216119,2368,5,472,465,7,5,1,0
1294947,3348,8,147,136,11,18,1,0
43243,120,1,3,0,3,1,1,0
0,0,0,0,0,0,0,0,0
470511,3144,7,393,339,54,10,1,0
146217,378,6,13,3,10,9,0,0
157205,906,5,125,123,2,16,1,0
111866,339,0,70,69,1,0,1,0
0,0,0,0,0,0,0,0,0
112755,622,11,75,70,5,23,1,0
0,0,0,0,0,0,0,0,0
128179,974,9,94,83,11,17,1,0
435166,3014,4,282,270,12,6,1,0
154584,966,8,293,276,17,14,1,0
545432,1386,4,240,224,16,2,1,1
10652,98,3,15,4,11,0,0,0
242854,1710,3,284,254,30,0,0,0
9283,101,0,6,6,0,0,0,0
0,0,0,0,0,0,0,0,0
341524,2347,2,374,351,23,5,1,0
189378,1027,4,220,207,13,5,1,0
663911,6258,3,521,436,85,17,1,1
4100,20,0,0,0,0,0,1,0
69085,1737,1,659,654,5,0,1,0
41121,164,1,23,18,5,0,1,0
64945,99,4,18,17,1,2,1,0
65765,110,4,16,15,1,2,1,0
0,0,0,0,0,0,0,0,0
0,0,0,0,0,0,0,0,0
729353,3381,2,131,87,44,5,1,0
0,0,0,0,0,0,0,0,0
0,0,0,0,0,0,0,0,0
1111625,2185,6,187,134,53,50,1,0
0,0,0,0,0,0,0,0,0
649803,5234,5,1260,1230,30,7,0,0
0,0,0,0,0,0,0,0,0
0,0,0,0,0,0,0,0,0
93311,701,2,121,111,10,5,1,0
94107,810,2,110,92,18,3,1,0
220801,302,5,33,21,12,1,1,0
352695,3036,3,280,273,7,4,1,0
198291,1005,3,38,31,7,4,1,0
571097,2064,11,446,427,19,98,1,0
16558,159,1,38,25,13,0,0,0
9528,108,1,18,14,4,0,0,0
709806,3729,6,894,881,13,4,1,0
440465,1670,2,215,208,7,1,0,0
107650,1437,1,341,339,2,7,1,0
0,0,0,0,0,0,0,0,0
738565,6348,13,1224,1123,101,102,0,1
228528,338,0,17,11,6,0,1,0
442962,994,9,96,79,17,32,1,0
1353626,1732,7,189,151,38,59,1,0
20511,36,0,2,1,1,0,1,0
0,0,0,0,0,0,0,0,0
283245,2165,7,470,417,53,6,1,0
0,0,0,0,0,0,0,0,0
636336,1226,6,114,97,17,30,1,0
403668,1536,2,141,134,7,3,1,0
188390,401,2,62,59,3,3,1,0
71476,501,4,81,68,13,4,1,0
394540,1485,5,328,320,8,1,1,0
280535,1195,6,155,146,9,2,1,0
0,0,0,0,0,0,0,0,0
367242,1018,6,126,94,32,18,1,0
385490,5150,9,532,474,58,14,1,0
46103,397,3,63,53,10,0,1,0
32786,536,6,39,34,5,2,1,0
607587,2730,1,155,133,22,16,1,0
21751,104,4,6,3,3,0,0,0
95235,789,7,142,118,24,16,1,0
19039,235,5,48,24,24,5,1,0
285135,992,4,93,93,0,1,0,0
14715,156,1,14,10,4,4,1,0
497397,1856,6,406,383,23,10,1,0
0,0,0,0,0,0,0,0,0
208580,1479,7,304,293,11,14,1,0
0,0,0,0,0,0,0,0,0
0,0,0,0,0,0,0,0,0
295679,2240,7,403,393,10,10,0,0
95253,489,1,75,4,71,1,1,0
17349,154,1,16,9,7,4,1,0
0,0,0,0,0,0,0,0,0
77387,559,4,84,58,26,0,1,0
0,0,0,0,0,0,0,0,0
168754,1614,4,264,226,38,0,0,0
643846,345,7,3,3,0,3,1,0
48237,505,4,126,122,4,3,1,0
0,0,0,0,0,0,0,0,0
269172,1751,4,481,468,13,2,0,1
372449,2222,2,627,626,1,2,1,0
461352,4560,5,1299,584,715,12,0,0
0,0,0,0,0,0,0,0,0
14628,17,1,0,0,0,0,0,0
0,0,0,0,0,0,0,0,0
0,0,0,0,0,0,0,0,0
233325,338,0,17,9,8,0,1,0
81778,949,7,203,190,13,9,1,0
445353,2187,1,543,527,16,4,1,0
0,0,0,0,0,0,0,0,0
0,0,0,0,0,0,0,0,0
75666,1178,4,305,302,3,1,1,0
464025,2162,16,206,182,24,15,1,0
725557,2685,2,439,439,0,1,1,0
176082,1687,6,405,397,8,14,1,0
140584,177,6,25,22,3,5,1,0
0,0,0,0,0,0,0,0,0
147595,1068,5,231,206,25,6,1,0
352315,2034,11,377,355,22,4,1,0
1209568,3456,5,369,314,55,60,1,0
181087,1423,5,276,272,4,9,1,0
906089,3736,5,292,256,36,7,1,0
472137,934,5,68,52,16,6,1,0
263600,602,3,43,29,14,4,1,0
214028,1317,4,183,160,23,3,1,0
182972,2627,3,409,406,3,3,0,0
39948,304,3,31,30,1,1,0,0
53250,457,5,21,13,8,0,1,0
258661,1792,4,301,276,25,10,1,0
50322,361,3,30,30,0,5,1,0
823,19,0,2,0,2,0,0,0
984330,11369,6,1452,1239,213,30,1,0
355932,1363,0,135,115,20,0,1,0
397399,1381,3,158,142,16,1,1,0
214540,225,3,8,6,2,0,0,0
186237,1725,2,404,404,0,2,0,0
196734,1811,10,294,259,35,18,1,0
113915,474,3,15,13,2,0,1,0
266342,1921,10,330,72,258,22,0,0
228772,336,0,17,11,6,0,1,0
441049,4203,3,1418,1409,9,18,1,0
29693,253,1,56,56,0,6,1,0
0,0,0,0,0,0,0,0,0
1193308,5275,4,1157,1102,55,24,1,0
0,0,0,0,0,0,0,0,0
51960,418,7,78,69,9,3,1,0
1031292,1314,7,183,137,46,25,1,0
116255,103,0,15,8,7,0,1,0
125712,920,8,234,223,11,10,1,1
159864,911,10,182,166,16,26,1,0
263908,3575,1,996,871,125,129,1,0
0,0,0,0,0,0,0,0,0
0,0,0,0,0,0,0,0,0
217357,1193,5,180,15,165,19,1,0
12120,85,2,5,5,0,6,1,0
425936,3319,10,266,247,19,26,1,0
206269,1155,3,414,407,7,6,1,0
0,0,0,0,0,0,0,0,0
234694,2869,10,404,385,19,2,1,0
687543,520,0,3,0,3,2,1,1
191348,386,1,60,57,3,1,1,0
178076,265,0,40,38,2,1,1,0
6760,48,4,4,1,3,2,1,0
6046334,2726,0,0,0,0,1,1,0
236983,2417,2,318,317,1,0,1,0
0,0,0,0,0,0,0,0,0
0,0,0,0,0,0,0,0,0
235098,1116,12,329,325,4,0,1,0
0,0,0,0,0,0,0,0,0
204933,357,1,52,45,7,0,1,0
249210,2445,6,132,125,7,3,1,0
83747,528,6,75,66,9,3,1,0
0,0,0,0,0,0,0,0,0
263594,2000,8,359,336,23,2,1,0
121685,1084,8,208,188,20,0,1,0
18874,98,1,0,0,0,0,0,0
532591,3705,4,596,585,11,3,1,0
0,0,0,0,0,0,0,0,0
105822,352,4,32,18,14,0,1,0
4967,88,0,28,24,4,0,1,0
113848,629,14,92,25,67,7,1,0
95725,460,14,91,80,11,7,1,0
270683,1187,7,228,217,11,12,1,0
126180,1080,6,159,141,18,10,1,0
38786,207,6,19,13,6,2,1,0
921039,3382,7,816,778,38,25,1,0
86136,769,7,131,124,7,18,1,0
230262,334,0,16,3,13,0,1,0
420772,1802,7,209,184,25,14,0,0
269234,3209,9,813,741,72,22,1,0
0,0,0,0,0,0,0,0,0
261596,1441,11,287,287,0,22,1,0
47419,484,5,77,56,21,3,1,0
35378,433,6,89,82,7,9,1,0
234141,369,11,24,20,4,16,0,0
619884,2421,5,594,586,8,7,1,0
595164,1005,1,128,110,18,33,1,0
0,0,0,0,0,0,0,0,0
0,0,0,0,0,0,0,0,0
55304,391,4,67,64,3,2,1,0
366438,2802,5,382,363,19,4,1,0
0,0,0,0,0,0,0,0,0
33396,674,2,198,198,0,2,0,0
0,0,0,0,0,0,0,0,0
0,0,0,0,0,0,0,0,0
719518,3264,6,318,289,29,88,1,0
0,0,0,0,0,0,0,0,0
0,0,0,0,0,0,0,0,0
78346,357,7,42,26,16,10,1,0
74203,346,7,26,12,14,12,1,0
0,0,0,0,0,0,0,0,0
114951,1805,3,513,509,4,1,1,0
0,0,0,0,0,0,0,0,0
511557,1254,3,226,213,13,2,1,0
0,0,0,0,0,0,0,0,0
0,0,0,0,0,0,0,0,0
1014602,2465,4,291,262,29,2,1,0
203231,1273,3,155,136,19,0,0,0
0,0,0,0,0,0,0,0,0
0,0,0,0,0,0,0,0,0
0,0,0,0,0,0,0,0,0
141134,1777,4,453,412,41,11,1,0
7703,133,1,5,5,0,0,0,0
490803,2126,10,389,316,73,8,1,0
0,0,0,0,0,0,0,0,0
0,0,0,0,0,0,0,0,0
0,0,0,0,0,0,0,0,0
5287,75,6,7,4,3,0,0,0
46190,366,3,68,51,17,0,1,0
108173,1185,7,290,273,17,15,1,0
20718,132,4,18,18,0,1,1,0
543921,1106,9,268,255,13,28,1,0
411041,1348,8,229,213,16,14,1,0
143290,902,3,250,139,111,1,1,0
65146,199,2,22,13,9,12,1,0
505227,2864,4,531,391,140,81,1,0
21508,143,3,10,10,0,0,1,0
0,0,0,0,0,0,0,0,0
0,0,0,0,0,0,0,0,0
0,0,0,0,0,0,0,0,0
121004,578,6,89,61,28,17,1,0
11420,81,7,6,6,0,0,1,0
0,0,0,0,0,0,0,0,0
0,0,0,0,0,0,0,0,0
55562,923,3,89,87,2,6,0,0
6844918,39005,12,3647,2121,1526,48,1,0
47109,132,8,3,0,3,0,1,0
34549,427,5,75,74,1,0,0,0
183254,843,9,118,90,28,5,1,0
242172,2508,7,8,5,3,13,1,0
118364,1624,2,199,185,14,32,1,0
0,0,0,0,0,0,0,0,0
0,0,0,0,0,0,0,0,0
91872,501,4,81,43,38,4,1,0
0,0,0,0,0,0,0,0,0
230168,338,0,17,11,6,0,1,0
125830,900,7,37,27,10,2,1,0
80418,452,3,81,33,48,62,1,0
161856,2067,2,561,247,314,3,1,0
0,0,0,0,0,0,0,0,0
0,0,0,0,0,0,0,0,0
686597,3495,5,407,397,10,10,1,0
290972,120,4,2,2,0,2,1,0
0,0,0,0,0,0,0,0,0
228540,1233,7,110,101,9,12,1,0
832762,420,1,57,44,13,0,1,0
589877,2043,7,340,285,55,24,1,0
242793,742,9,131,83,48,8,1,0
819411,6498,6,1177,1039,138,5,1,0
9480,111,1,5,2,3,0,0,0
551651,1314,5,149,136,13,22,1,0
14603,100,2,7,7,0,0,0,0
0,0,0,0,0,0,0,0,0
0,0,0,0,0,0,0,0,0
0,0,0,0,0,0,0,0,0
151240,1309,3,391,370,21,6,0,0
53324,319,8,40,33,7,12,1,0
98951,1450,5,414,413,1,1,0,0
152675,914,5,124,108,16,1,1,0
713846,1970,12,315,253,62,19,1,0
54864,380,10,57,12,45,3,1,0
0,0,0,0,0,0,0,0,0
0,0,0,0,0,0,0,0,0
66293,602,3,114,88,26,13,1,0
6453,109,3,21,16,5,2,1,0
299127,1030,5,121,38,83,1,1,0
229526,338,0,17,9,8,0,1,0
1081756,2097,2,461,405,56,15,1,0
62840,430,3,22,12,10,23,1,0
0,0,0,0,0,0,0,0,0
0,0,0,0,0,0,0,0,0
568937,2181,5,114,102,12,24,1,0
86135,635,5,115,78,37,0,1,0
0,0,0,0,0,0,0,0,0
21333,238,2,30,15,15,0,1,0
0,0,0,0,0,0,0,0,0
1285793,3888,1,302,284,18,35,1,0
0,0,0,0,0,0,0,0,0
131184,1107,4,162,131,31,2,1,0
0,0,0,0,0,0,0,0,0
0,0,0,0,0,0,0,0,0
0,0,0,0,0,0,0,0,0
247989,3317,2,563,521,42,7,1,0
150675,1444,5,284,211,73,2,1,0
14354,152,1,19,16,3,2,1,0
8854,101,1,20,16,4,1,1,0
0,0,0,0,0,0,0,0,0
152930,1350,7,88,76,12,97,1,0
0,0,0,0,0,0,0,0,0
101160,850,4,176,127,49,2,1,0
799570,5447,3,284,274,10,4,1,0
501568,2812,2,179,130,49,2,1,0
40000,254,3,46,37,9,1,1,0
0,0,0,0,0,0,0,0,0
679058,1899,4,78,70,8,14,1,0
712632,1939,8,154,149,5,20,1,0
712632,1939,8,154,149,5,20,1,0
429689,992,11,127,119,8,19,1,0
4455473,1112,3,208,193,15,4,1,0
0,0,0,0,0,0,0,0,0
829267,2332,7,268,260,8,13,1,0
52118,354,14,35,28,7,16,1,0
0,0,0,0,0,0,0,0,0
0,0,0,0,0,0,0,0,0
0,0,0,0,0,0,0,0,0
0,0,0,0,0,0,0,0,0
0,0,0,0,0,0,0,0,0
418304,2194,4,476,11,465,0,1,0
46774,438,2,12,11,1,2,0,0
266704,3696,1,1030,905,125,129,1,0
647256,2450,14,472,467,5,21,1,0
1675,20,0,1,1,0,0,0,0
202210,1819,5,91,71,20,12,0,0
51838,197,4,13,10,3,3,0,0
513825,3118,2,324,309,15,0,1,0
229299,338,0,17,9,8,0,1,0
149710,617,0,67,65,2,0,1,0
83995,72,1,1,1,0,2,1,0
26751,267,3,19,16,3,3,1,0
0,0,0,0,0,0,0,0,0
0,0,0,0,0,0,0,0,0
42389,710,2,82,74,8,3,1,0
8873,107,1,8,8,0,6,0,0
273287,2362,4,456,396,60,7,1,0
383052,672,3,88,70,18,3,1,0
48459,123,1,12,2,10,0,0,0
0,0,0,0,0,0,0,0,0
70449,339,2,105,100,5,4,1,0
605213,4881,5,1030,945,85,3,0,0
109153,1204,0,167,167,0,2,0,0
714439,1934,7,273,226,47,19,1,0
243644,473,7,6,0,6,5,0,0
0,0,0,0,0,0,0,0,0
107730,724,5,120,114,6,7,1,0
357283,1945,8,165,114,51,36,1,0
141417,2856,3,720,714,6,22,1,0
173646,2214,4,270,259,11,8,1,0
0,0,0,0,0,0,0,0,0
142164,1244,2,9,1,8,0,0,0
275882,1619,3,284,247,37,0,0,0
8953,100,0,6,6,0,0,0,0
0,0,0,0,0,0,0,0,0
0,0,0,0,0,0,0,0,0
0,0,0,0,0,0,0,0,0
202458,1033,5,202,197,5,1,1,0
265969,2145,9,580,570,10,34,1,0
25908,218,2,23,22,1,11,1,0
1286822,3675,2,429,426,3,4,1,0
0,0,0,0,0,0,0,0,0
40256,285,5,18,11,7,2,1,0
273211,1799,4,339,331,8,19,1,0
0,0,0,0,0,0,0,0,0
164870,1456,8,357,355,2,5,1,0
0,0,0,0,0,0,0,0,0
3973930,2210,0,89,86,3,0,1,0
65603,304,1,15,12,3,0,1,0
684151,2877,5,444,300,144,14,1,0
7816,126,1,9,1,8,0,0,0
7655,47,0,11,1,10,0,0,0
0,0,0,0,0,0,0,0,0
135636,3049,1,523,523,0,0,0,0
0,0,0,0,0,0,0,0,0
0,0,0,0,0,0,0,0,0
0,0,0,0,0,0,0,0,0
161086,1052,4,313,309,4,1,1,0
486448,1061,8,149,140,9,18,1,0
165775,643,4,110,103,7,1,1,0
92385,217,4,6,6,0,1,0,0
776990,1749,11,186,175,11,20,1,0
162838,730,8,47,24,23,10,0,0
0,0,0,0,0,0,0,0,0
417285,1398,6,179,160,19,0,1,0
501669,1454,6,153,137,16,0,1,0
187147,1178,3,104,20,84,6,1,0
77146,514,8,42,42,0,1,1,0
0,0,0,0,0,0,0,0,0
0,0,0,0,0,0,0,0,0
455898,2519,2,339,315,24,11,1,0
111610,562,3,60,48,12,3,1,0
0,0,0,0,0,0,0,0,0
47462,315,1,70,57,13,1,1,0
600384,3734,3,890,763,127,35,0,0
97396,1147,2,181,162,19,0,1,0
9814,43,1,2,0,2,0,1,0
0,0,0,0,0,0,0,0,0
135385,1126,14,115,107,8,7,1,0
410224,1318,5,254,229,25,31,1,0
108377,272,7,30,28,2,1,1,0
9776,54,0,1,1,0,0,0,0
0,0,0,0,0,0,0,0,0
0,0,0,0,0,0,0,0,0
68126,334,11,55,54,1,24,0,0
64733,229,10,9,7,2,18,0,0
1707776,1859,5,267,251,16,7,1,0
0,0,0,0,0,0,0,0,0
0,0,0,0,0,0,0,0,0
227081,1237,11,166,58,108,3,1,0
0,0,0,0,0,0,0,0,0
0,0,0,0,0,0,0,0,0
387104,1194,2,168,140,28,1,0,0
0,0,0,0,0,0,0,0,0
440810,1736,1,217,207,10,15,0,0
0,0,0,0,0,0,0,0,0
407669,714,0,78,50,28,2,1,0
750163,3787,4,1035,661,374,4,1,0
248841,84,3,7,5,2,4,1,0
231724,340,0,17,12,5,0,1,0
106761,2120,3,722,671,51,0,1,0
1807742,2941,7,401,363,38,24,1,0
64023,83,4,13,11,2,0,0,0
694035,3730,4,770,689,81,13,1,0
241268,730,4,17,11,6,5,1,0
148247,2114,2,194,184,10,8,1,0
0,0,0,0,0,0,0,0,0
193681,1520,6,235,219,16,33,1,0
54819,188,1,19,1,18,1,1,0
0,0,0,0,0,0,0,0,0
1001374,3423,6,414,396,18,122,1,0
0,0,0,0,0,0,0,0,0
105072,668,4,181,180,1,5,1,0
22982,343,3,21,19,2,2,1,0
9850,129,4,21,20,1,2,1,0
0,0,0,0,0,0,0,0,0
508785,4920,2,2287,2276,11,11,1,0
307716,1595,5,278,266,12,3,0,0
0,0,0,0,0,0,0,0,0
0,0,0,0,0,0,0,0,0
436694,1554,4,111,109,2,8,1,0
0,0,0,0,0,0,0,0,0
531903,2433,11,284,276,8,62,1,1
0,0,0,0,0,0,0,0,0
0,0,0,0,0,0,0,0,0
0,0,0,0,0,0,0,0,0
402572,1257,11,37,13,24,11,1,0
0,0,0,0,0,0,0,0,0
0,0,0,0,0,0,0,0,0
625616,648,7,130,72,58,14,1,0
308710,1084,6,218,185,33,1,1,0
160919,565,2,64,20,44,12,1,0
38220,149,2,5,3,2,2,0,0
953294,1783,2,325,297,28,1,1,0
548937,1564,5,340,298,42,2,1,0
153837,618,2,117,99,18,3,0,0
34863,227,4,30,24,6,1,1,0
169050,1523,4,367,341,26,11,1,0
46113,65,1,0,0,0,1,1,0
461201,2882,1,332,327,5,81,1,0
161079,1264,8,281,228,53,5,0,0
256564,1359,7,195,178,17,1,1,0
29623,82,3,8,4,4,1,1,0
89379,549,5,110,103,7,14,1,0
0,0,0,0,0,0,0,0,0
35674,303,2,49,32,17,0,1,0
50636,218,0,76,73,3,0,0,0
47818,587,3,168,156,12,0,1,0
37616,406,4,74,55,19,1,1,0
0,0,0,0,0,0,0,0,0
226732,3898,2,1425,1411,14,77,1,0
0,0,0,0,0,0,0,0,0
55140,339,4,35,35,0,1,0,0
19489,93,5,6,6,0,0,0,0
18153,259,6,31,29,2,0,1,0
23292,173,9,25,23,2,0,1,0
0,0,0,0,0,0,0,0,0
0,0,0,0,0,0,0,0,0
14733,94,3,5,2,3,0,0,0
268393,1241,15,252,105,147,15,1,0
0,0,0,0,0,0,0,0,0
347167,1610,3,163,154,9,12,1,0
184953,382,3,7,6,1,2,0,0
0,0,0,0,0,0,0,0,0
22059,254,3,30,7,23,3,1,0
302307,1836,7,332,323,9,27,1,0
0,0,0,0,0,0,0,0,0
41157,843,1,234,234,0,0,0,0
14322,307,1,13,13,0,0,0,0
148575,968,4,341,101,240,2,1,0
60746,733,5,249,64,185,1,1,0
453574,2106,7,569,469,100,4,1,0
465872,2192,7,524,449,75,4,1,0
0,0,0,0,0,0,0,0,0
0,0,0,0,0,0,0,0,0
0,0,0,0,0,0,0,0,0
0,0,0,0,0,0,0,0,0
224377,267,3,25,19,6,1,1,0
0,0,0,0,0,0,0,0,0
486427,1456,2,201,181,20,0,0,0
526137,2122,11,457,361,96,16,1,1
301962,1224,10,217,199,18,30,1,0
0,0,0,0,0,0,0,0,0
0,0,0,0,0,0,0,0,0
27904,42,0,2,1,1,0,0,0
0,0,0,0,0,0,0,0,0
234251,1421,2,202,176,26,3,0,0
170587,2281,7,341,329,12,111,1,0
358216,2450,6,294,254,40,26,1,1
61906,1144,5,61,57,4,37,0,0
20686,36,0,2,1,1,0,1,0
146999,620,6,126,120,6,5,1,0
178447,1905,5,360,319,41,16,1,0
66495,622,5,187,183,4,8,1,0
488272,1128,9,110,94,16,7,1,0
858374,2659,0,260,236,24,7,1,0
137040,788,3,2,1,1,1,0,0
0,0,0,0,0,0,0,0,0
0,0,0,0,0,0,0,0,0
8861,144,6,12,12,0,0,1,0
64859,674,0,159,157,2,2,1,0
668665,1906,2,156,146,10,12,1,0
287019,186,2,12,11,1,11,1,0
296,13,0,1,1,0,0,0,0
347155,1854,12,200,178,22,23,1,0
0,0,0,0,0,0,0,0,0
0,0,0,0,0,0,0,0,0
42527,503,3,85,76,9,1,1,0
19311,221,3,35,33,2,3,1,0
0,0,0,0,0,0,0,0,0
0,0,0,0,0,0,0,0,0
373177,3239,6,364,353,11,12,1,0
372774,3240,6,363,349,14,11,1,0
0,0,0,0,0,0,0,0,0
102837,310,1,32,26,6,1,0,0
211800,128,1,8,6,2,0,0,0
161851,743,9,133,121,12,6,1,0
593932,5417,9,533,215,318,10,1,0
10150,124,4,28,5,23,2,1,0
196319,1728,7,373,370,3,0,1,0
116307,316,7,51,48,3,1,1,0
36269,92,7,1,1,0,0,0,0
0,0,0,0,0,0,0,0,0
0,0,0,0,0,0,0,0,0
105948,434,1,119,101,18,1,0,0
19627,32,0,1,1,0,0,1,0
0,0,0,0,0,0,0,0,0
0,0,0,0,0,0,0,0,0
80789,317,6,61,45,16,0,1,0
534986,8293,3,1339,1338,1,6,1,0
536005,8294,3,1339,1338,1,6,1,0
0,0,0,0,0,0,0,0,0
1280498,3924,3,405,387,18,333,1,0
317498,1723,9,129,127,2,15,1,0
58515,430,10,80,53,27,1,1,0
0,0,0,0,0,0,0,0,0
479366,2275,5,308,232,76,60,1,0
15346,53,3,0,0,0,0,0,0
0,0,0,0,0,0,0,0,0
58035,396,1,110,5,105,1,1,0
62041,157,3,15,6,9,7,1,0
258221,537,1,38,30,8,3,0,0
1472410,57,1,3,3,0,1,0,0
268332,1798,6,186,117,69,3,1,0
79179,534,6,16,12,4,3,1,0
108859,638,7,109,93,16,7,1,0
1284413,1385,18,69,47,22,5,1,0
0,0,0,0,0,0,0,0,0
757032,6740,7,482,473,9,3,1,1
414050,1630,11,178,121,57,17,1,0
686458,2430,5,428,409,19,4,1,0
635622,2661,5,1257,1234,23,5,1,0
426262,4526,6,1178,1170,8,12,1,0
694607,209,3,28,26,2,2,0,0
82216,861,7,127,114,13,12,0,0
2485854,1891,5,326,314,12,5,1,0
1122113,1487,5,275,263,12,8,1,0
239935,2664,7,434,424,10,12,0,0
214598,2386,7,352,324,28,27,1,0
1027089,3402,3,312,301,11,6,1,0
753845,3155,3,284,270,14,1,1,0
323652,1498,3,268,225,43,4,1,0
109313,1187,9,330,322,8,6,1,0
332924,2584,10,233,209,24,4,0,0
271709,796,2,67,55,12,4,1,0
68829,230,7,23,22,1,2,1,0
0,0,0,0,0,0,0,0,0
0,0,0,0,0,0,0,0,0
0,0,0,0,0,0,0,0,0
231211,338,0,17,10,7,0,1,0
264709,1943,7,497,481,16,12,1,0
547804,785,4,77,77,0,0,0,0
4790,47,1,4,4,0,0,0,0
205993,1570,9,119,90,29,1,1,0
84553,553,9,78,78,0,3,0,0
0,0,0,0,0,0,0,0,0
149158,1514,7,335,326,9,51,1,0
0,0,0,0,0,0,0,0,0
13195,117,6,3,3,0,7,1,0
27553,236,7,52,39,13,4,1,0
487931,689,5,9,5,4,5,1,0
157202,1282,3,309,309,0,49,0,0
55002,851,4,244,243,1,3,1,0
807179,3107,2,474,469,5,6,1,0
115953,154,0,8,8,0,0,1,0
67832,644,7,71,68,3,15,0,0
547571,5474,9,350,332,18,15,1,0
94571,1376,10,137,124,13,11,1,0
138370,673,4,73,72,1,10,0,0
375182,2257,8,230,217,13,3,1,0
93312,259,0,48,24,24,0,1,1
933698,1510,2,300,271,29,0,1,0
550388,1567,5,338,291,47,2,1,0
0,0,0,0,0,0,0,0,0
909937,1862,11,180,168,12,31,1,0
130616,861,8,224,194,30,3,0,0
165961,324,3,51,50,1,4,0,0
58344,855,2,321,217,104,0,1,0
15213,87,2,12,11,1,0,1,0
0,0,0,0,0,0,0,0,0
57221,754,4,160,158,2,21,1,0
20610,220,3,34,34,0,2,1,0
415006,1057,3,111,96,15,4,1,0
14461,100,2,7,7,0,0,0,0
0,0,0,0,0,0,0,0,0
0,0,0,0,0,0,0,0,0
0,0,0,0,0,0,0,0,0
0,0,0,0,0,0,0,0,0
974703,1998,9,316,248,68,6,1,0
859257,1795,9,343,316,27,6,1,0
0,0,0,0,0,0,0,0,0
174591,1236,1,88,77,11,0,1,0
34721,95,5,6,6,0,0,0,0
93677,970,8,175,162,13,8,1,0
0,0,0,0,0,0,0,0,0
0,0,0,0,0,0,0,0,0
2141321,17423,5,2477,1949,528,44,1,0
687711,523,0,5,1,4,2,1,1
708848,2557,10,512,204,308,20,0,0
406527,641,7,58,53,5,4,1,0
0,0,0,0,0,0,0,0,0
228243,1908,6,512,502,10,6,0,0
521983,2843,1,190,163,27,0,1,0
358710,4321,5,1071,1049,22,7,1,0
0,0,0,0,0,0,0,0,0
115362,865,3,131,116,15,9,1,0
25273,122,3,0,0,0,1,1,0
253210,1442,2,162,152,10,1,1,0
47374,159,4,4,4,0,3,0,0
0,0,0,0,0,0,0,0,0
0,0,0,0,0,0,0,0,0
0,0,0,0,0,0,0,0,0
0,0,0,0,0,0,0,0,0
0,0,0,0,0,0,0,0,0
199387,781,9,136,120,16,11,1,0
396550,1830,0,278,260,18,0,0,0
0,0,0,0,0,0,0,0,0
591066,4835,4,425,410,15,14,0,0
113399,743,4,109,99,10,6,0,0
0,0,0,0,0,0,0,0,0
31594,463,4,158,118,40,0,1,0
20422,223,3,33,15,18,3,1,0
258763,961,7,178,161,17,4,1,0
10087,62,3,0,0,0,1,0,0
155429,907,5,183,73,110,0,1,0
154384,1767,9,410,354,56,18,1,0
209996,775,9,135,123,12,6,1,0
0,0,0,0,0,0,0,0,0
0,0,0,0,0,0,0,0,0
231331,338,0,17,9,8,0,1,0
240815,1738,6,350,308,42,5,1,0
16383,161,5,29,20,9,4,1,0
0,0,0,0,0,0,0,0,0
351966,2261,6,298,257,41,1,1,1
1227203,2997,6,397,391,6,14,1,0
11691,78,1,2,2,0,0,0,0
480565,1733,6,201,101,100,2,1,0
232546,1170,4,162,150,12,8,1,0
12689,100,4,18,13,5,0,1,0
304035,1405,9,255,246,9,13,1,0
0,0,0,0,0,0,0,0,0
1615083,1679,7,427,387,40,17,1,0
279954,184,3,5,3,2,10,0,0
707074,1284,11,330,316,14,0,1,0
0,0,0,0,0,0,0,0,0
150902,1517,7,318,296,22,11,1,0
0,0,0,0,0,0,0,0,0
248377,1420,4,171,106,65,4,1,0
0,0,0,0,0,0,0,0,0
229051,338,0,17,9,8,0,1,0
420237,3268,4,521,443,78,2,1,0
0,0,0,0,0,0,0,0,0
96600,1174,10,239,214,25,7,1,0
6920,130,2,20,16,4,0,1,0
0,0,0,0,0,0,0,0,0
495203,1362,2,60,59,1,10,1,0
409796,1032,5,52,49,3,21,1,0
0,0,0,0,0,0,0,0,0
0,0,0,0,0,0,0,0,0
327622,3677,5,596,544,52,13,1,0
1082143,9184,17,487,478,9,21,1,0
0,0,0,0,0,0,0,0,0
1106,14,0,0,0,0,0,1,0
0,0,0,0,0,0,0,0,0
0,0,0,0,0,0,0,0,0
232856,2332,5,312,68,244,12,1,0
0,0,0,0,0,0,0,0,0
213752,1973,6,377,303,74,4,1,0
191329,1127,5,218,205,13,0,1,0
0,0,0,0,0,0,0,0,0
0,0,0,0,0,0,0,0,0
108248,448,10,44,40,4,9,1,0
0,0,0,0,0,0,0,0,0
5866,67,2,6,6,0,1,0,0
397931,2025,4,480,419,61,1,1,1
0,0,0,0,0,0,0,0,0
0,0,0,0,0,0,0,0,0
0,0,0,0,0,0,0,0,0
877751,3776,2,231,215,16,5,1,1
0,0,0,0,0,0,0,0,0
1494216,1045,10,58,47,11,5,1,0
514601,1591,7,121,107,14,19,1,0
205369,868,7,113,109,4,20,1,0
279302,2051,2,353,321,32,3,1,0
56081,370,4,42,36,6,3,1,0
73275,88,5,4,4,0,1,0,0
208729,1634,9,238,232,6,27,1,0
366163,963,6,121,61,60,9,1,0
337865,382,5,90,76,14,3,1,0
0,0,0,0,0,0,0,0,0
40053,396,6,84,44,40,10,1,0
0,0,0,0,0,0,0,0,0
0,0,0,0,0,0,0,0,0
242575,866,6,91,81,10,0,1,0
0,0,0,0,0,0,0,0,0
300950,1190,1,292,275,17,1,1,0
664209,2447,2,491,424,67,2,1,0
816475,2372,6,351,304,47,21,1,0
260604,698,7,6,5,1,5,0,0
452093,1416,1,177,27,150,10,1,0
36150,355,0,7,5,2,6,0,0
0,0,0,0,0,0,0,0,0
114310,1224,4,311,299,12,1,0,0
375339,3192,3,421,413,8,15,1,0
0,0,0,0,0,0,0,0,0
0,0,0,0,0,0,0,0,0
0,0,0,0,0,0,0,0,0
0,0,0,0,0,0,0,0,0
147233,355,6,12,11,1,5,0,0
938,9,0,0,0,0,0,0,0
0,0,0,0,0,0,0,0,0
452527,1308,5,186,157,29,1,1,0
0,0,0,0,0,0,0,0,0
194789,3358,1,623,548,75,12,1,0
154985,1780,9,336,234,102,13,1,0
0,0,0,0,0,0,0,0,0
406569,6485,4,303,219,84,25,1,0
86128,416,4,66,52,14,5,1,0
233909,1719,5,167,136,31,13,0,0
0,0,0,0,0,0,0,0,0
328802,981,9,190,183,7,5,1,0
0,0,0,0,0,0,0,0,0
87813,575,2,34,31,3,41,1,0
127552,1798,4,157,152,5,8,0,0
0,0,0,0,0,0,0,0,0
195747,572,1,41,32,9,2,1,0
323342,349,5,4,1,3,4,0,0
85635,1078,4,251,152,99,2,1,0
144728,1354,1,489,472,17,7,1,0
2795,23,1,0,0,0,0,0,0
0,0,0,0,0,0,0,0,0
587530,2831,4,496,481,15,3,1,0
702092,2999,6,446,404,42,87,1,0
107734,811,6,171,158,13,31,1,0
188961,1995,4,181,171,10,5,0,0
13604,309,2,72,71,1,1,0,0
79660,1012,2,167,129,38,6,1,0
84877,662,3,83,79,4,1,1,0
128789,1140,9,187,177,10,14,0,0
4973,44,4,3,3,0,0,1,0
36274,518,6,127,94,33,1,1,0
49855,439,1,12,10,2,0,1,0
30072,520,2,93,90,3,4,1,0
53265,699,4,87,84,3,1,1,0
153665,747,4,108,102,6,0,1,0
678046,6986,7,1450,537,913,4,1,0
0,0,0,0,0,0,0,0,0
1020418,2061,5,308,307,1,10,1,0
1164823,1913,13,166,152,14,32,1,0
1067971,1898,13,154,106,48,35,1,0
244492,1075,4,96,87,9,14,1,0
0,0,0,0,0,0,0,0,0
0,0,0,0,0,0,0,0,0
480300,3845,3,761,740,21,25,1,0
228383,2752,9,854,851,3,11,1,0
50423,262,11,22,22,0,14,1,0
0,0,0,0,0,0,0,0,0
76881,1125,5,162,147,15,1,0,0
11264,104,3,13,13,0,1,0,0
82522,1041,2,262,254,8,6,1,0
967590,2665,8,570,549,21,82,1,0
0,0,0,0,0,0,0,0,0
562546,875,3,74,58,16,0,1,0
869254,5689,1,309,306,3,0,1,0
15276,97,1,0,0,0,0,0,0
2715,74,0,11,0,11,0,1,0
854642,2184,7,267,252,15,12,1,0
57348,203,2,14,7,7,1,1,0
106589,975,10,204,195,9,42,1,0
28531,379,3,97,88,9,2,1,0
408287,2264,6,420,409,11,0,1,0
900153,2711,9,227,207,20,11,1,0
0,0,0,0,0,0,0,0,0
0,0,0,0,0,0,0,0,0
0,0,0,0,0,0,0,0,0
161676,2286,1,375,374,1,0,1,0
0,0,0,0,0,0,0,0,0
0,0,0,0,0,0,0,0,0
902469,2907,6,344,282,62,5,0,0
0,0,0,0,0,0,0,0,0
19692,34,0,1,1,0,0,1,0
0,0,0,0,0,0,0,0,0
134879,907,17,117,107,10,6,1,0
154800,1510,2,376,369,7,8,0,0
68139,761,2,57,32,25,0,1,0
0,0,0,0,0,0,0,0,0
20711,36,0,2,1,1,0,1,0
195118,945,8,138,131,7,17,1,0
114404,348,7,55,48,7,1,1,0
0,0,0,0,0,0,0,0,0
171166,583,6,51,50,1,4,1,0
23619,439,2,88,87,1,0,0,0
290287,3154,7,1387,1386,1,5,1,0
149479,330,8,36,35,1,9,0,0
0,0,0,0,0,0,0,0,0
160265,529,2,79,72,7,0,0,0
59360,160,2,2,2,0,2,0,0
599904,3916,9,274,114,160,16,1,0
67068,798,5,181,159,22,15,1,0
5806,94,3,17,15,2,1,1,0
296443,1212,3,105,82,23,1,1,0
0,0,0,0,0,0,0,0,0
207132,1590,3,137,113,24,23,1,0
127766,515,3,4,4,0,4,1,0
80841,537,1,41,26,15,0,0,0
129347,456,5,17,14,3,0,0,0
0,0,0,0,0,0,0,0,0
19732,134,2,3,3,0,3,0,0
124086,1594,5,388,367,21,7,0,0
728838,6433,12,1303,1191,112,55,1,0
0,0,0,0,0,0,0,0,0
267731,1427,2,302,237,65,1,1,0
0,0,0,0,0,0,0,0,0
256543,1915,3,273,272,1,17,1,0
720235,2000,2,300,143,157,37,0,0
666708,3240,3,550,533,17,5,1,0
41180,286,2,41,24,17,8,0,0
136864,1063,0,110,104,6,0,1,0
258785,1832,4,213,213,0,7,0,0
0,0,0,0,0,0,0,0,0
0,0,0,0,0,0,0,0,0
318886,5171,4,1285,966,319,14,0,0
18946,53,1,1,1,0,1,0,0
75782,594,5,97,82,15,6,1,0
21046,214,3,26,24,2,3,1,0
269724,728,3,127,118,9,10,1,0
352774,8568,1,2912,2898,14,0,1,0
222832,931,7,123,77,46,5,1,0
8872,123,2,30,1,29,0,1,0
163785,960,7,144,129,15,9,1,0
31942,170,1,54,53,1,0,1,0
76672,280,1,43,43,0,0,1,0
477248,1104,2,112,100,12,20,1,0
113280,250,1,28,21,7,4,1,0
126906,1542,4,299,170,129,0,0,0
800845,2028,3,236,173,63,28,1,0
185304,805,8,101,16,85,7,1,0
178518,1246,2,208,189,19,3,1,0
0,0,0,0,0,0,0,0,0
297272,1584,1,60,53,7,2,1,0
27933,82,2,1,1,0,0,0,0
587070,2086,6,234,98,136,2,1,0
21109,59,1,0,0,0,1,0,0
0,0,0,0,0,0,0,0,0
89318,301,4,37,24,13,1,0,0
35230,128,3,5,4,1,2,0,0
45646,400,0,107,96,11,0,1,0
4506,42,2,3,3,0,0,0,0
0,0,0,0,0,0,0,0,0
115567,1311,2,253,203,50,7,1,0
200832,293,7,41,34,7,3,1,0
103584,182,7,18,18,0,5,0,0
140933,984,5,233,164,69,5,1,0
0,0,0,0,0,0,0,0,0
0,0,0,0,0,0,0,0,0
218997,2087,2,298,252,46,11,1,0
560527,2327,14,395,357,38,40,1,0
0,0,0,0,0,0,0,0,0
354673,2603,8,379,365,14,85,1,0
293820,1306,3,132,124,8,0,0,0
444436,3485,11,990,288,702,75,1,0
11522,118,9,6,6,0,2,1,0
121587,1074,2,383,305,78,12,1,0
0,0,0,0,0,0,0,0,0
263948,1845,5,215,199,16,19,1,0
0,0,0,0,0,0,0,0,0
439158,1615,6,228,193,35,50,1,0
93213,773,11,114,4,110,2,1,0
0,0,0,0,0,0,0,0,0
0,0,0,0,0,0,0,0,0
786672,3427,3,232,223,9,5,1,0
379715,1512,5,250,163,87,31,1,0
16511,86,4,6,6,0,0,0,0
0,0,0,0,0,0,0,0,0
325149,826,4,236,231,5,6,1,0
456819,3424,7,903,879,24,9,1,0
148177,1189,7,339,331,8,5,1,0
50331,277,7,24,19,5,6,1,0
92654,675,1,37,12,25,3,0,0
474324,1660,14,125,116,9,13,1,0
288753,410,11,46,38,8,12,1,0
206919,1660,6,331,326,5,8,1,0
533848,205,3,7,0,7,2,1,0
77066,837,7,70,66,4,7,1,0
0,0,0,0,0,0,0,0,0
0,0,0,0,0,0,0,0,0
795889,5604,4,939,360,579,2,0,0
275129,1751,7,423,414,9,3,1,0
2870,41,2,7,6,1,0,1,0
0,0,0,0,0,0,0,0,0
52232,400,0,93,90,3,0,0,0
27294,421,1,84,78,6,0,1,0
388908,1329,0,173,129,44,0,1,0
357172,1551,6,189,74,115,11,1,0
0,0,0,0,0,0,0,0,0
104303,503,4,85,67,18,1,0,0
33235,246,2,73,73,0,0,1,0
0,0,0,0,0,0,0,0,0
0,0,0,0,0,0,0,0,0
181277,1177,3,211,197,14,0,0,0
8903,100,0,6,6,0,0,0,0
0,0,0,0,0,0,0,0,0
93406,2657,3,1485,782,703,0,1,0
14315,65,2,13,8,5,0,1,0
121741,1196,2,188,181,7,13,1,0
883300,4607,4,921,877,44,6,1,0
0,0,0,0,0,0,0,0,0
192617,2649,4,629,619,10,42,1,0
0,0,0,0,0,0,0,0,0
526864,2546,8,612,482,130,27,1,1
292475,918,2,151,130,21,1,1,0
188381,452,2,58,44,14,0,1,0
55919,346,1,24,15,9,5,1,1
0,0,0,0,0,0,0,0,0
83324,1331,7,337,304,33,13,0,0
604230,1520,3,181,167,14,4,1,0
15241,101,2,7,7,0,0,0,0
610077,3734,3,925,902,23,14,1,0
228483,334,0,16,3,13,0,1,0
0,0,0,0,0,0,0,0,0
0,0,0,0,0,0,0,0,0
219929,1770,4,339,336,3,8,0,1
161861,802,7,141,135,6,20,1,0
0,0,0,0,0,0,0,0,0
43767,340,12,44,37,7,5,1,0
89537,259,0,48,24,24,0,1,1
3115933,3051,5,203,179,24,9,1,0
502787,1728,5,63,62,1,0,0,0
112997,1044,5,194,191,3,9,1,0
440872,2180,5,205,177,28,9,1,0
446361,2216,5,205,173,32,9,1,0
204612,2812,6,522,512,10,3,1,0
48836,581,7,114,107,7,2,1,0
0,0,0,0,0,0,0,0,0
0,0,0,0,0,0,0,0,0
259020,3527,2,853,813,40,2,1,0
348879,1499,12,274,233,41,13,1,0
270742,864,10,219,185,34,8,1,0
76394,1245,2,362,357,5,0,1,0
0,0,0,0,0,0,0,0,0
168616,171,0,73,52,21,0,1,0
191475,876,8,107,9,98,10,1,0
33747,74,3,2,2,0,0,0,0
963450,4228,4,623,168,455,21,1,1
21496,125,5,9,3,6,1,1,0
127368,1011,5,190,105,85,2,1,0
0,0,0,0,0,0,0,0,0
607945,3077,4,282,250,32,23,1,0
80741,417,8,32,25,7,5,1,0
0,0,0,0,0,0,0,0,0
767411,2504,2,276,260,16,7,1,0
70136,1926,2,567,567,0,2,1,0
122715,1601,8,352,342,10,0,1,1
366413,2284,15,321,292,29,64,1,0
0,0,0,0,0,0,0,0,0
45931,348,4,48,27,21,1,0,0
47525,348,4,48,27,21,1,0,0
0,0,0,0,0,0,0,0,0
0,0,0,0,0,0,0,0,0
0,0,0,0,0,0,0,0,0
196945,942,0,144,129,15,0,1,0
117413,1148,4,226,189,37,3,1,0
81111,552,6,155,130,25,3,1,0
0,0,0,0,0,0,0,0,0
1037095,1576,10,229,213,16,21,1,0
0,0,0,0,0,0,0,0,0
600327,1440,6,270,257,13,14,1,0
539156,926,8,131,102,29,13,1,0
272652,913,8,73,61,12,16,1,0
105884,315,7,10,6,4,22,0,0
0,0,0,0,0,0,0,0,0
231422,338,0,17,10,7,0,1,0
311042,1564,4,270,191,79,3,1,0
0,0,0,0,0,0,0,0,0
12342,44,0,3,2,1,0,0,0
222038,377,1,56,14,42,0,0,0
753841,1935,3,229,229,0,100,1,0
187335,576,6,141,138,3,2,1,0
0,0,0,0,0,0,0,0,0
20923,38,0,2,2,0,0,1,0
80172,810,3,96,93,3,7,1,0
198177,1458,9,252,226,26,1,1,0
155292,955,9,188,171,17,3,1,0
186925,908,11,194,190,4,6,1,0
17689,107,6,11,11,0,4,1,0
267160,1226,6,164,162,2,14,0,0
0,0,0,0,0,0,0,0,0
147775,851,3,102,84,18,0,1,0
0,0,0,0,0,0,0,0,0
495968,2294,9,542,534,8,19,1,0
1068717,1171,8,139,139,0,7,1,0
0,0,0,0,0,0,0,0,0
122925,705,7,123,89,34,0,1,0
250993,1515,5,169,157,12,12,1,0
0,0,0,0,0,0,0,0,0
32096,339,3,85,81,4,1,1,0
7580,91,2,10,10,0,1,0,0
204387,1013,6,179,172,7,1,1,0
131309,888,8,194,180,14,13,0,0
0,0,0,0,0,0,0,0,0
382248,3142,5,610,583,27,7,1,0
99338,1510,6,38,28,10,4,1,0
579118,5358,5,834,830,4,75,1,0
201725,943,7,122,121,1,55,1,0
17178,131,5,21,18,3,1,0,0
503090,6430,3,2067,2062,5,3,1,0
35248,295,12,35,35,0,4,1,0
42994,594,10,106,45,61,0,1,0
36503,407,9,97,48,49,0,1,0
50453,535,7,80,53,27,1,1,0
0,0,0,0,0,0,0,0,0
0,0,0,0,0,0,0,0,0
430170,1581,5,308,295,13,1,1,1
187272,1140,2,180,169,11,8,1,0
0,0,0,0,0,0,0,0,0
478414,1930,5,353,322,31,10,1,0
0,0,0,0,0,0,0,0,0
490786,1142,6,197,184,13,1,1,0
277133,195,0,0,0,0,1,1,0
582183,2076,5,364,358,6,4,1,0
263037,1624,4,377,329,48,1,1,0
16059,76,0,2,1,1,0,0,0
93207,999,4,115,14,101,14,1,0
124339,504,2,147,135,12,1,0,0
56422,749,4,153,140,13,0,0,0
174344,305,1,110,76,34,2,1,0
168777,170,0,73,52,21,0,1,0
63923,973,6,234,227,7,2,1,0
634709,1207,3,144,136,8,1,0,0
0,0,0,0,0,0,0,0,0
7102,165,1,52,51,1,1,1,0
0,0,0,0,0,0,0,0,0
524612,1240,15,143,140,3,83,1,0
90841,1307,8,356,319,37,10,1,0
42237,312,10,58,54,4,7,1,0
72071,476,13,68,59,9,3,1,0
0,0,0,0,0,0,0,0,0
101237,792,5,130,124,6,2,1,0
101065,793,5,126,120,6,2,1,0
1042762,1325,6,126,108,18,31,1,0
0,0,0,0,0,0,0,0,0
121541,175,0,8,8,0,0,1,0
122386,199,0,17,15,2,0,1,0
909104,2973,4,158,131,27,3,1,0
0,0,0,0,0,0,0,0,0
26541,269,0,60,58,2,0,0,0
27019,322,4,58,57,1,0,0,0
18603,254,4,52,52,0,0,0,0
231239,939,5,297,286,11,0,1,0
331841,1239,9,104,95,9,2,1,0
212649,1699,4,305,170,135,16,1,0
1118922,3360,7,439,346,93,59,1,0
0,0,0,0,0,0,0,0,0
397965,991,1,170,88,82,9,1,0
79255,112,1,10,1,9,2,0,0
339277,2251,3,236,209,27,7,0,0
0,0,0,0,0,0,0,0,0
0,0,0,0,0,0,0,0,0
0,0,0,0,0,0,0,0,0
683878,2800,5,537,517,20,12,1,0
557367,2069,13,386,382,4,1,1,0
326776,736,14,128,116,12,2,1,0
612152,6055,5,888,601,287,2,1,1
2060,38,1,6,0,6,0,1,0
0,0,0,0,0,0,0,0,0
19674,378,0,102,61,41,0,1,0
761423,2090,7,453,431,22,13,1,0
0,0,0,0,0,0,0,0,0
229523,334,0,16,8,8,0,1,0
486068,1727,8,273,211,62,10,1,0
0,0,0,0,0,0,0,0,0
97856,1112,8,251,227,24,7,1,0
51009,552,8,133,116,17,2,1,0
639791,985,5,112,59,53,27,1,0
178126,1235,5,114,96,18,1,1,0
131358,1449,9,8,8,0,10,0,0
64068,112,0,18,18,0,5,1,0
11268,82,1,6,6,0,1,1,0
169846,1064,2,132,110,22,4,1,0
96825,552,1,78,58,20,4,1,0
0,0,0,0,0,0,0,0,0
861416,1136,3,194,187,7,5,1,0
0,0,0,0,0,0,0,0,0
0,0,0,0,0,0,0,0,0
183527,1719,1,191,187,4,3,1,0
5828,77,3,6,6,0,2,0,0
906701,2410,3,354,321,33,8,1,0
0,0,0,0,0,0,0,0,0
214156,2449,2,638,625,13,10,0,0
141412,903,9,69,35,34,1,0,0
53047,1103,2,275,214,61,1,1,0
34508,401,2,89,51,38,3,1,0
40945,569,6,64,52,12,1,1,0
548940,592,11,98,90,8,15,0,0
287588,995,13,83,69,14,33,1,0
682524,1881,11,10,6,4,24,0,0
167183,726,6,78,32,46,4,1,0
0,0,0,0,0,0,0,0,0
723263,6847,8,519,371,148,611,1,0
400657,4239,5,362,346,16,13,1,0
271036,1335,5,184,174,10,6,1,0
0,0,0,0,0,0,0,0,0
0,0,0,0,0,0,0,0,0
0,0,0,0,0,0,0,0,0
0,0,0,0,0,0,0,0,0
512,14,0,0,0,0,0,0,0
7200,103,3,3,2,1,0,1,0
403724,3055,5,372,246,126,6,1,0
0,0,0,0,0,0,0,0,0
0,0,0,0,0,0,0,0,0
0,0,0,0,0,0,0,0,0
0,0,0,0,0,0,0,0,0
0,0,0,0,0,0,0,0,0
0,0,0,0,0,0,0,0,0
0,0,0,0,0,0,0,0,0
156677,767,0,148,141,7,39,1,0
113575,110,0,8,7,1,0,1,0
0,0,0,0,0,0,0,0,0
1018402,14024,6,3731,3688,43,44,1,0
254327,828,4,120,5,115,11,1,0
79909,1097,4,249,228,21,5,1,0
6783,100,3,8,7,1,0,1,0
0,0,0,0,0,0,0,0,0
0,0,0,0,0,0,0,0,0
59242,696,7,171,118,53,5,1,0
415306,3945,6,1000,943,57,19,1,0
647117,877,8,28,15,13,9,0,0
277740,1370,10,272,261,11,12,1,0
0,0,0,0,0,0,0,0,0
562227,1983,8,199,189,10,54,1,0
288070,863,6,122,113,9,7,1,0
733139,2755,6,437,317,120,55,1,0
33530,485,5,113,44,69,2,1,0
0,0,0,0,0,0,0,0,0
0,0,0,0,0,0,0,0,0
860764,1300,7,96,71,25,29,1,0
0,0,0,0,0,0,0,0,0
362354,3072,3,231,203,28,16,1,0
52148,90,0,6,4,2,0,1,0
2837,38,0,0,0,0,0,0,0
0,0,0,0,0,0,0,0,0
0,0,0,0,0,0,0,0,0
92238,317,5,74,72,2,6,1,0
0,0,0,0,0,0,0,0,0
313616,2111,10,283,224,59,9,1,0
0,0,0,0,0,0,0,0,0
199115,916,11,152,146,6,17,1,0
1105496,2639,8,136,110,26,1,1,0
550586,603,7,87,80,7,1,1,0
874796,2971,6,345,180,165,30,0,0
182183,2114,4,572,545,27,7,1,0
972432,1788,16,307,302,5,31,1,1
973279,1793,16,307,302,5,27,1,1
0,0,0,0,0,0,0,0,0
824249,2288,5,324,291,33,17,1,0
250948,545,7,6,5,1,5,0,0
0,0,0,0,0,0,0,0,0
0,0,0,0,0,0,0,0,0
1591902,8260,14,1297,1048,249,6,1,0
141604,869,4,38,32,6,6,0,0
42568,36,0,1,0,1,0,0,1
0,0,0,0,0,0,0,0,0
0,0,0,0,0,0,0,0,0
0,0,0,0,0,0,0,0,0
423410,5452,4,1355,1324,31,6,1,0
99743,2103,3,718,709,9,2,1,0
420200,1440,13,190,166,24,34,1,0
184660,2047,5,457,318,139,5,1,0
0,0,0,0,0,0,0,0,0
0,0,0,0,0,0,0,0,0
771036,2731,9,239,218,21,49,1,0
177628,1330,6,150,136,14,5,1,0
74035,199,8,11,11,0,4,1,0
0,0,0,0,0,0,0,0,0
0,0,0,0,0,0,0,0,0
0,0,0,0,0,0,0,0,0
162167,2469,2,1407,1401,6,7,0,0
0,0,0,0,0,0,0,0,0
361450,1249,7,134,94,40,3,1,0
185421,382,8,32,24,8,21,1,0
0,0,0,0,0,0,0,0,0
511194,4670,2,337,307,30,2,1,0
57216,436,3,77,75,2,5,1,0
4061,47,1,7,7,0,0,1,0
77995,522,5,78,77,1,7,0,0
0,0,0,0,0,0,0,0,0
857851,2186,4,136,128,8,1,1,0
171140,968,7,131,119,12,5,1,0
392809,1716,6,186,174,12,9,1,0
16160,71,2,0,0,0,0,0,0
0,0,0,0,0,0,0,0,0
0,0,0,0,0,0,0,0,0
105036,914,5,55,47,8,1,1,0
0,0,0,0,0,0,0,0,0
755444,1107,10,164,147,17,17,1,0
0,0,0,0,0,0,0,0,0
0,0,0,0,0,0,0,0,0
436187,2709,8,403,287,116,310,1,0
4209440,2794,5,360,254,106,15,1,0
174981,212,4,9,7,2,3,1,0
443357,1959,6,251,190,61,15,1,0
258009,1126,10,239,227,12,24,1,0
176188,823,7,80,58,22,8,1,0
698794,6505,4,1065,1065,0,36,1,0
168637,3008,4,243,241,2,4,1,0
4160,22,0,0,0,0,0,0,0
0,0,0,0,0,0,0,0,0
102561,512,4,27,24,3,1,1,0
260509,1595,4,238,214,24,6,1,0
20679,35,0,2,1,1,0,1,0
532278,5240,5,1282,20,1262,6,1,0
594743,8053,5,1186,1169,17,9,1,0
51684,607,4,193,191,2,6,1,0
44362,527,3,161,159,2,4,1,0
0,0,0,0,0,0,0,0,0
4629428,34937,6,3359,1905,1454,27,1,0
47110,132,8,3,0,3,0,1,0
0,0,0,0,0,0,0,0,0
195825,1674,7,217,10,207,1,0,0
108422,176,1,25,16,9,1,1,0
121786,1393,4,269,256,13,3,1,0
0,0,0,0,0,0,0,0,0
401327,823,5,88,78,10,0,1,0
339488,1266,6,115,106,9,4,1,0
266292,1966,3,277,259,18,0,1,0
9896,172,2,20,16,4,0,1,0
484231,2979,1,275,268,7,0,1,0
33684,226,0,4,4,0,0,0,0
399328,2754,5,766,717,49,16,1,0
9442,156,3,31,30,1,5,0,0
0,0,0,0,0,0,0,0,0
551746,1731,6,254,239,15,7,1,0
185502,1454,7,201,103,98,4,1,0
0,0,0,0,0,0,0,0,0
98914,455,3,91,73,18,10,1,0
518105,2527,7,686,420,266,2,1,0
337377,2020,6,350,68,282,3,1,0
218754,527,6,20,9,11,5,0,0
0,0,0,0,0,0,0,0,0
147702,737,5,75,68,7,6,1,0
430816,2066,6,290,282,8,3,1,0
106440,1381,2,191,187,4,2,1,0
297899,1683,5,132,123,9,10,1,0
159346,797,5,65,56,9,1,1,0
0,0,0,0,0,0,0,0,0
84347,513,8,119,114,5,4,1,0
108686,1849,6,330,330,0,19,1,0
432116,1725,11,251,227,24,17,1,0
0,0,0,0,0,0,0,0,0
54767,785,4,314,313,1,2,0,0
9130,142,4,28,28,0,1,0,0
98890,1466,4,175,164,11,78,1,0
24728,158,4,14,8,6,7,1,0
432613,3795,8,504,473,31,42,1,0
476113,1108,3,139,118,21,4,1,0
14992,100,2,7,7,0,0,0,0
255013,2771,5,345,320,25,2,0,0
0,0,0,0,0,0,0,0,0
161278,1130,2,225,185,40,1,1,0
51967,324,2,46,44,2,3,1,0
73455,1301,2,355,325,30,6,1,0
0,0,0,0,0,0,0,0,0
136283,969,7,208,189,19,15,1,0
0,0,0,0,0,0,0,0,0
0,0,0,0,0,0,0,0,0
0,0,0,0,0,0,0,0,0
189163,666,0,16,16,0,3,1,0
283426,1347,0,126,126,0,23,1,0
0,0,0,0,0,0,0,0,0
1195686,1685,4,327,280,47,4,1,0
309671,2249,7,275,248,27,20,1,0
281361,1232,4,78,70,8,1,0,0
0,0,0,0,0,0,0,0,0
356250,2510,2,332,313,19,5,1,0
356250,2510,2,332,312,20,5,1,0
72630,826,5,214,211,3,11,1,0
44219,531,5,137,137,0,9,1,0
0,0,0,0,0,0,0,0,0
105892,483,11,74,73,1,12,1,0
74289,274,11,49,49,0,11,1,0
212921,1440,8,225,213,12,6,1,0
165962,870,8,161,149,12,6,1,0
82461,1203,1,382,333,49,3,1,0
7050,57,0,8,0,8,0,0,0
229568,884,14,123,113,10,17,1,0
60621,867,4,97,52,45,1,1,0
0,0,0,0,0,0,0,0,0
180901,1174,9,207,196,11,16,0,0
530636,1055,8,44,38,6,7,1,0
5817,75,1,2,2,0,0,0,0
211702,1348,9,382,382,0,5,1,0
119123,207,8,30,29,1,2,1,0
84730,963,0,61,33,28,2,1,0
0,0,0,0,0,0,0,0,0
0,0,0,0,0,0,0,0,0
0,0,0,0,0,0,0,0,0
113689,1684,7,289,258,31,13,1,0
298482,1067,8,222,170,52,23,1,0
213492,535,7,107,102,5,13,1,0
0,0,0,0,0,0,0,0,0
0,0,0,0,0,0,0,0,0
223014,1270,8,165,76,89,2,1,0
276754,496,1,11,4,7,1,1,0
390493,1592,4,508,504,4,1,1,0
117523,1971,5,576,569,7,3,1,0
131387,549,4,67,61,6,2,1,0
0,0,0,0,0,0,0,0,0
1182020,456,4,45,43,2,7,1,0
40911,278,2,31,14,17,9,0,0
485481,1500,4,165,152,13,11,1,0
770109,4078,13,597,590,7,22,1,1
0,0,0,0,0,0,0,0,0
2207587,4911,2,524,257,267,29,1,0
204313,1853,5,469,457,12,15,0,0
0,0,0,0,0,0,0,0,0
3501,35,0,0,0,0,0,0,0
0,0,0,0,0,0,0,0,0
276336,3756,5,831,762,69,0,0,0
305975,2812,10,693,677,16,56,0,0
0,0,0,0,0,0,0,0,0
35306,175,7,17,15,2,3,1,0
176937,1264,4,340,292,48,3,1,0
35048,392,4,96,53,43,5,1,0
57021,519,8,126,124,2,3,0,0
291495,1709,8,414,253,161,31,1,0
0,0,0,0,0,0,0,0,0
66365,716,4,196,196,0,0,1,0
461310,4209,8,518,466,52,41,1,0
0,0,0,0,0,0,0,0,0
318386,1844,1,379,349,30,1,1,0
488447,2057,5,206,193,13,6,1,0
0,0,0,0,0,0,0,0,0
0,0,0,0,0,0,0,0,0
157236,478,8,26,20,6,5,1,0
166376,1490,6,211,180,31,6,1,0
521170,2264,8,314,288,26,19,1,0
463152,1544,13,153,132,21,48,1,0
740241,3936,3,743,643,100,36,1,0
432770,1971,3,189,165,24,28,0,0
0,0,0,0,0,0,0,0,0
209698,1578,5,110,90,20,40,1,0
240035,1219,7,205,203,2,13,0,0
86159,174,6,6,3,3,5,1,0
241591,2244,8,575,561,14,12,0,0
0,0,0,0,0,0,0,0,0
1124609,1458,6,129,84,45,32,1,0
0,0,0,0,0,0,0,0,0
1219828,4506,9,685,673,12,233,1,0
782850,3717,9,652,640,12,225,1,0
0,0,0,0,0,0,0,0,0
224490,2236,6,521,507,14,4,1,0
205303,1543,6,414,401,13,4,1,0
303380,2182,2,316,298,18,1,1,0
3732,51,2,6,4,2,0,0,0
867255,1665,3,244,238,6,8,1,0
5845,31,2,0,0,0,0,0,0
860318,7164,3,840,780,60,25,0,0
90929,338,4,60,55,5,8,0,0
158515,909,7,180,173,7,0,1,0
0,0,0,0,0,0,0,0,0
0,0,0,0,0,0,0,0,0
380839,1059,3,260,253,7,14,1,0
250999,1214,4,192,178,14,18,1,0
39310,465,0,114,44,70,1,1,0
0,0,0,0,0,0,0,0,0
2977142,198,2,26,22,4,0,1,0
9689,121,3,10,10,0,1,1,0
39017,790,1,45,45,0,6,1,0
0,0,0,0,0,0,0,0,0
143887,1740,4,519,442,77,38,0,0
0,0,0,0,0,0,0,0,0
0,0,0,0,0,0,0,0,0
224933,1526,7,230,222,8,6,1,0
0,0,0,0,0,0,0,0,0
421036,1025,6,83,76,7,0,1,0
0,0,0,0,0,0,0,0,0
0,0,0,0,0,0,0,0,0
0,0,0,0,0,0,0,0,0
0,0,0,0,0,0,0,0,0
62214,426,2,113,109,4,7,0,0
0,0,0,0,0,0,0,0,0
184481,566,7,29,19,10,59,1,0
37505,91,1,11,10,1,0,1,0
659208,3590,2,209,198,11,8,1,0
0,0,0,0,0,0,0,0,0
0,0,0,0,0,0,0,0,0
0,0,0,0,0,0,0,0,0
2128286,1011,3,90,67,23,1,1,0
0,0,0,0,0,0,0,0,0
408295,2093,6,619,572,47,58,1,0
22675,146,3,18,16,2,1,1,0
0,0,0,0,0,0,0,0,0
365755,2616,1,619,365,254,93,1,0
0,0,0,0,0,0,0,0,0
30960,395,4,82,77,5,0,0,0
13473,115,5,5,5,0,0,0,0
171586,1255,2,345,340,5,6,0,0
0,0,0,0,0,0,0,0,0
120985,1101,7,251,98,153,9,1,0
11324,187,1,24,17,7,0,1,0
0,0,0,0,0,0,0,0,0
0,0,0,0,0,0,0,0,0
88786,870,9,195,181,14,34,1,0
16831,401,0,140,140,0,1,1,0
0,0,0,0,0,0,0,0,0
234344,1481,5,213,207,6,1,1,0
601172,1948,2,214,210,4,0,1,0
77270,361,0,64,59,5,0,1,0
0,0,0,0,0,0,0,0,0
203379,702,8,93,88,5,4,1,0
463512,1088,3,132,119,13,4,1,0
14593,100,2,7,7,0,0,0,0
700105,4676,7,1453,1441,12,299,1,0
0,0,0,0,0,0,0,0,0
7125,77,2,14,14,0,0,0,0
0,0,0,0,0,0,0,0,0
103544,1012,4,188,90,98,8,0,0
0,0,0,0,0,0,0,0,0
0,0,0,0,0,0,0,0,0
250903,2181,5,409,333,76,3,1,0
0,0,0,0,0,0,0,0,0
0,0,0,0,0,0,0,0,0
231417,1703,5,426,415,11,10,1,0
0,0,0,0,0,0,0,0,0
559405,2340,16,341,253,88,24,1,0
71163,1221,2,11,2,9,1,0,0
0,0,0,0,0,0,0,0,0
184549,1060,1,164,162,2,7,1,0
108152,232,1,35,33,2,10,1,0
0,0,0,0,0,0,0,0,0
271425,1646,10,280,250,30,7,1,0
0,0,0,0,0,0,0,0,0
376063,3026,12,704,690,14,50,1,0
161047,1230,12,345,337,8,20,1,0
487845,1729,15,393,392,1,17,1,0
379835,767,14,138,137,1,15,1,0
0,0,0,0,0,0,0,0,0
740111,2368,13,447,425,22,20,0,0
0,0,0,0,0,0,0,0,0
610561,1845,9,257,231,26,10,1,0
18338,46,0,8,8,0,0,0,0
257804,2552,5,466,315,151,11,0,0
561462,1350,0,159,151,8,3,1,0
326509,2702,5,814,769,45,10,1,0
878444,2930,5,547,450,97,1,1,0
0,0,0,0,0,0,0,0,0
0,0,0,0,0,0,0,0,0
0,0,0,0,0,0,0,0,0
501537,3117,13,347,318,29,5,1,0
215220,892,10,202,157,45,8,1,0
74321,437,9,81,74,7,0,1,0
59909,123,2,4,4,0,0,1,0
1514082,1901,11,204,170,34,30,1,0
303837,1138,2,350,343,7,1,1,0
0,0,0,0,0,0,0,0,0
954317,1859,8,155,135,20,8,1,0
54113,151,5,1,1,0,0,0,0
327422,2134,10,424,394,30,11,1,0
400704,2098,7,523,470,53,27,1,0
57419,440,7,85,73,12,1,1,0
1123517,3367,4,574,441,133,2,1,0
370184,972,3,259,221,38,1,1,0
448088,3091,8,819,812,7,75,1,0
145541,711,6,72,68,4,2,1,0
42444,925,7,2,2,0,2,0,0
76340,884,3,60,53,7,82,1,0
64678,267,5,36,36,0,13,1,0
679732,3119,3,396,346,50,3,1,0
419964,2273,7,288,21,267,9,1,0
212779,1084,7,166,158,8,7,1,0
0,0,0,0,0,0,0,0,0
320614,3771,2,546,425,121,1,1,0
144567,1717,3,260,252,8,3,1,0
105439,1433,5,238,230,8,3,1,0
175570,1032,1,95,75,20,17,1,0
5239,119,2,33,33,0,5,1,0
5601,105,2,32,32,0,5,1,0
233093,1186,6,263,2,261,2,1,0
115341,777,7,180,173,7,2,1,0
22291,355,3,99,99,0,0,1,0
78464,1176,2,226,226,0,0,1,0
417214,2532,7,311,279,32,42,1,0
344971,3662,9,1081,412,669,56,1,0
122490,1716,4,198,167,31,2,0,0
60919,980,6,128,120,8,3,1,0
6799,101,3,6,3,3,1,1,1
0,0,0,0,0,0,0,0,0
0,0,0,0,0,0,0,0,0
0,0,0,0,0,0,0,0,0
0,0,0,0,0,0,0,0,0
148817,1626,8,275,274,1,13,1,0
64456,244,9,8,7,1,12,1,0
118515,1055,5,239,219,20,17,1,0
173688,1888,4,260,260,0,0,1,0
2494930,2078,4,308,281,27,5,1,0
0,0,0,0,0,0,0,0,0
0,0,0,0,0,0,0,0,0
363206,2412,11,423,287,136,29,0,0
142095,610,9,111,93,18,15,0,0
192742,1552,4,452,416,36,16,1,0
64822,141,7,11,2,9,5,0,0
297150,2931,9,384,371,13,14,1,0
157222,586,0,4,1,3,2,1,0
141746,1994,3,938,913,25,6,1,0
155412,1413,2,111,104,7,34,1,0
89632,562,2,41,39,2,34,1,0
0,0,0,0,0,0,0,0,0
310386,2037,1,139,95,44,0,1,0
36605,170,2,15,15,0,0,1,0
91537,1237,5,224,221,3,7,1,0
39510,453,5,63,63,0,3,1,0
0,0,0,0,0,0,0,0,0
159152,1138,5,234,225,9,12,1,0
0,0,0,0,0,0,0,0,0
0,0,0,0,0,0,0,0,0
159283,917,1,265,260,5,2,0,0
217399,664,11,108,95,13,22,1,0
909622,4430,7,475,23,452,13,1,0
0,0,0,0,0,0,0,0,0
47636,394,6,104,70,34,5,1,0
0,0,0,0,0,0,0,0,0
794266,1789,13,168,115,53,7,1,0
35966,436,2,11,2,9,1,0,0
0,0,0,0,0,0,0,0,0
0,0,0,0,0,0,0,0,0
0,0,0,0,0,0,0,0,0
0,0,0,0,0,0,0,0,0
313041,1877,7,184,178,6,23,1,1
58967,921,5,227,224,3,7,1,0
41030,662,6,231,228,3,8,1,0
0,0,0,0,0,0,0,0,0
76101,1003,6,197,191,6,3,0,0
281486,1725,3,569,546,23,18,0,0
0,0,0,0,0,0,0,0,0
1001708,3193,4,41,35,6,2,1,0
0,0,0,0,0,0,0,0,0
1989840,2497,3,224,215,9,0,1,0
0,0,0,0,0,0,0,0,0
0,0,0,0,0,0,0,0,0
0,0,0,0,0,0,0,0,0
1148094,1389,3,190,178,12,2,1,0
709977,1602,6,215,187,28,32,1,0
0,0,0,0,0,0,0,0,0
47079,596,2,65,44,21,3,0,0
613057,2052,6,468,454,14,20,1,0
507803,1600,8,407,393,14,20,1,0
468572,1159,3,131,107,24,4,1,0
14596,100,2,7,7,0,0,0,0
190384,1489,3,386,345,41,0,1,0
1341910,2620,12,169,145,24,15,1,0
19589,378,0,102,57,45,0,1,0
43751,393,4,49,48,1,11,1,0
1425040,9808,2,352,230,122,1,1,0
146917,1009,6,201,190,11,6,1,0
179886,1538,5,444,443,1,7,1,0
124113,799,4,211,210,1,7,1,0
1205643,2186,7,372,346,26,253,1,0
774039,3104,4,499,418,81,5,1,0
564396,2095,4,368,312,56,5,1,0
380655,3233,5,443,402,41,6,1,0
0,0,0,0,0,0,0,0,0
0,0,0,0,0,0,0,0,0
167239,1645,8,405,385,20,19,1,0
0,0,0,0,0,0,0,0,0
376483,4319,6,449,427,22,8,1,0
58161,619,1,113,113,0,0,1,0
0,0,0,0,0,0,0,0,0
141493,1492,2,466,404,62,1,1,0
0,0,0,0,0,0,0,0,0
0,0,0,0,0,0,0,0,0
1051868,2107,10,241,214,27,34,1,0
1103330,796,9,82,67,15,1,1,0
92682,912,3,91,90,1,2,0,0
2158954,9411,4,404,403,1,0,1,0
1508030,12803,6,899,144,755,20,0,0
385837,3899,5,825,784,41,11,0,0
100482,1008,3,188,178,10,6,0,0
108486,598,4,233,223,10,5,1,0
102946,943,5,190,180,10,37,1,0
42154,431,4,52,29,23,0,1,0
11495,82,3,8,6,2,0,1,0
0,0,0,0,0,0,0,0,0
61831,226,0,47,25,22,0,1,1
109042,395,0,47,39,8,1,1,1
577,7,0,0,0,0,0,0,0
182746,635,3,156,100,56,5,1,0
0,0,0,0,0,0,0,0,0
132747,1137,4,212,179,33,2,1,0
491553,1807,5,503,492,11,21,1,0
62967,665,0,196,187,9,2,1,0
97951,462,3,59,35,24,9,1,0
433217,2312,4,532,330,202,16,1,0
473645,1262,3,132,116,16,20,1,0
116854,311,1,46,33,13,4,1,0
761396,1019,3,77,71,6,6,1,0
0,0,0,0,0,0,0,0,0
0,0,0,0,0,0,0,0,0
137835,1425,8,268,257,11,11,1,0
435678,3493,2,227,161,66,0,1,0
83705,922,6,249,152,97,2,0,0
0,0,0,0,0,0,0,0,0
209784,2357,9,473,470,3,6,1,0
233468,2451,10,476,470,6,6,1,0
256026,769,6,45,37,8,4,1,0
859150,3429,1,376,350,26,11,1,0
0,0,0,0,0,0,0,0,0
0,0,0,0,0,0,0,0,0
488100,1671,5,157,147,10,5,1,0
53311,150,2,5,4,1,3,0,0
0,0,0,0,0,0,0,0,0
25574,426,0,147,147,0,1,1,0
15981,149,0,27,27,0,1,1,0
95105,1416,2,472,461,11,2,1,0
336780,1050,2,48,27,21,12,1,0
420055,2112,4,353,273,80,15,1,0
43922,663,4,147,116,31,1,1,0
213418,910,0,77,71,6,0,0,0
1394298,4642,4,420,399,21,9,0,0
7052,119,1,10,1,9,0,0,0
130771,1713,6,620,617,3,2,1,0
434308,4127,5,1273,253,1020,1,0,0
258036,2106,5,217,93,124,23,1,0
0,0,0,0,0,0,0,0,0
449056,2294,3,332,314,18,7,1,0
587519,1613,1,136,127,9,2,1,1
273036,134,1,8,6,2,1,1,1
0,0,0,0,0,0,0,0,0
200972,376,4,4,0,4,0,1,0
146606,763,2,109,101,8,7,1,0
0,0,0,0,0,0,0,0,0
0,0,0,0,0,0,0,0,0
0,0,0,0,0,0,0,0,0
608514,1580,10,415,409,6,35,1,0
209975,601,8,128,124,4,3,1,0
221836,377,1,56,9,47,0,0,0
339957,2968,8,954,947,7,10,1,0
193710,1177,11,236,201,35,5,1,0
238521,700,12,134,101,33,9,1,0
163617,814,4,138,110,28,4,1,0
171683,2023,2,449,354,95,69,0,0
0,0,0,0,0,0,0,0,0
0,0,0,0,0,0,0,0,0
167498,341,7,12,8,4,4,0,0
40981,302,5,63,57,6,0,1,0
43162,307,5,67,61,6,0,1,0
17576,132,3,0,0,0,1,0,0
1690509,2630,7,543,518,25,17,1,0
0,0,0,0,0,0,0,0,0
62846,363,5,45,33,12,1,1,1
39808,230,2,32,28,4,0,1,1
303806,4066,8,531,492,39,6,1,0
0,0,0,0,0,0,0,0,0
0,0,0,0,0,0,0,0,0
14337,94,3,4,3,1,4,0,0
762664,8935,10,1566,1496,70,19,1,0
54547,942,2,290,271,19,6,1,0
68319,1065,3,329,226,103,7,0,0
282130,1401,1,149,126,23,4,1,0
93771,1716,3,284,282,2,3,0,0
15933,233,5,53,52,1,0,1,0
0,0,0,0,0,0,0,0,0
54981,636,3,74,62,12,3,1,0
62466,340,8,36,31,5,29,0,0
0,0,0,0,0,0,0,0,0
1592,11,0,1,1,0,0,0,0
115892,1158,1,413,285,128,1,1,0
38157,405,0,58,57,1,0,1,0
0,0,0,0,0,0,0,0,0
4738900,36928,4,3521,2014,1507,34,1,0
47110,132,8,3,0,3,0,1,0
144125,782,8,142,107,35,6,1,0
18085,339,6,77,35,42,0,1,0
0,0,0,0,0,0,0,0,0
382966,4819,4,631,139,492,10,1,0
21786,171,5,14,8,6,0,0,0
430450,1290,13,123,55,68,0,1,0
0,0,0,0,0,0,0,0,0
201293,1216,13,51,7,44,3,1,0
0,0,0,0,0,0,0,0,0
508728,1911,4,159,143,16,1,1,0
123388,557,6,43,40,3,4,1,0
116691,479,5,31,28,3,0,1,0
304133,1350,8,238,7,231,21,1,0
0,0,0,0,0,0,0,0,0
98707,1236,2,315,297,18,19,0,0
36048,176,1,33,28,5,0,0,0
228714,334,0,16,3,13,0,1,0
8523,89,2,21,14,7,0,1,0
26652,36,0,3,1,2,0,0,0
687791,1873,6,150,144,6,13,0,0
671625,2380,0,165,143,22,0,1,0
414826,1376,4,120,109,11,0,1,0
201212,659,5,85,52,33,13,1,0
11864,89,2,10,7,3,0,1,0
396061,2557,3,452,438,14,3,1,0
389454,1764,10,424,405,19,30,1,0
0,0,0,0,0,0,0,0,0
0,0,0,0,0,0,0,0,0
136550,2355,5,385,381,4,2,1,0
260830,1902,10,414,402,12,17,1,0
259299,1903,10,414,406,8,17,1,0
14488,183,4,33,22,11,2,1,0
7265,59,2,6,3,3,0,1,0
848481,73,2,0,0,0,1,1,0
0,0,0,0,0,0,0,0,0
61140,1041,1,293,283,10,6,1,0
7450,77,1,13,7,6,1,0,0
0,0,0,0,0,0,0,0,0
0,0,0,0,0,0,0,0,0
98053,838,3,76,67,9,16,1,0
0,0,0,0,0,0,0,0,0
300132,2105,2,613,596,17,0,1,0
0,0,0,0,0,0,0,0,0
146444,1240,7,145,113,32,5,1,0
99977,602,7,21,18,3,5,1,0
120867,912,4,124,113,11,1,1,0
66463,812,2,251,243,8,0,1,0
12094,193,2,43,35,8,0,1,0
337375,2474,8,475,437,38,22,1,0
37763,138,0,8,4,4,1,0,0
0,0,0,0,0,0,0,0,0
672337,2729,4,479,441,38,32,1,0
39351,582,4,138,135,3,1,1,0
457752,1444,3,131,124,7,13,1,0
10836,82,2,3,3,0,0,0,0
0,0,0,0,0,0,0,0,0
0,0,0,0,0,0,0,0,0
0,0,0,0,0,0,0,0,0
331937,2243,4,412,340,72,15,1,0
34396,232,4,18,7,11,0,1,0
762473,958,7,71,61,10,54,1,0
149458,990,2,282,276,6,17,1,0
146623,982,2,282,276,6,17,1,0
27511,42,0,2,1,1,0,0,0
0,0,0,0,0,0,0,0,0
801534,2020,11,347,249,98,13,1,0
0,0,0,0,0,0,0,0,0
329565,734,4,132,116,16,6,1,0
104837,183,2,12,6,6,3,1,0
0,0,0,0,0,0,0,0,0
535424,3689,5,570,553,17,15,1,0
18341,166,1,9,9,0,0,0,0
0,0,0,0,0,0,0,0,0
197410,968,6,190,150,40,1,1,0
0,0,0,0,0,0,0,0,0
152211,1303,4,84,56,28,2,1,0
0,0,0,0,0,0,0,0,0
0,0,0,0,0,0,0,0,0
121641,400,10,65,65,0,4,1,0
340758,2490,11,325,301,24,45,1,0
103974,1907,0,596,582,14,4,0,0
24894,369,0,154,153,1,1,0,0
358005,3552,3,650,636,14,1,1,0
0,0,0,0,0,0,0,0,0
238793,2628,14,593,587,6,65,1,0
0,0,0,0,0,0,0,0,0
308401,1155,9,114,107,7,7,1,0
121129,1214,3,180,16,164,7,0,0
76172,737,6,119,102,17,1,1,0
0,0,0,0,0,0,0,0,0
304037,3712,9,1101,1095,6,6,0,0
263792,1651,11,273,50,223,2,1,0
8120,62,9,1,0,1,2,1,0
0,0,0,0,0,0,0,0,0
185776,1018,0,157,148,9,5,1,0
123204,444,0,72,67,5,0,1,0
191676,400,9,51,44,7,8,1,0
56753,169,8,4,4,0,3,0,0
2590082,17537,2,1587,995,592,18,0,0
14357,93,1,8,8,0,0,0,0
1600358,5501,3,391,383,8,3,0,0
50985,125,1,5,5,0,2,0,0
0,0,0,0,0,0,0,0,0
802872,6361,22,921,889,32,11,1,0
27080,309,4,51,0,51,2,0,0
0,0,0,0,0,0,0,0,0
62251,571,4,114,102,12,7,0,0
11958,76,2,4,4,0,2,1,0
0,0,0,0,0,0,0,0,0
0,0,0,0,0,0,0,0,0
500546,5823,15,1102,1089,13,18,0,0
139493,1539,6,251,227,24,8,1,0
35250,340,2,92,71,21,8,0,0
0,0,0,0,0,0,0,0,0
1242423,14207,5,751,719,32,3,1,0
110243,440,5,47,42,5,0,1,0
512523,1405,0,263,258,5,11,1,0
0,0,0,0,0,0,0,0,0
0,0,0,0,0,0,0,0,0
318469,2034,6,588,423,165,19,1,0
305415,871,7,164,141,23,11,1,0
837709,4657,13,794,630,164,10,1,1
250457,687,4,115,109,6,0,1,0
0,0,0,0,0,0,0,0,0
205497,899,3,181,162,19,8,1,0
208338,753,2,218,210,8,3,1,0
0,0,0,0,0,0,0,0,0
211401,1877,8,260,260,0,76,1,0
46890,317,10,40,38,2,3,1,0
400169,281,1,62,55,7,3,1,0
624331,3259,2,383,376,7,0,1,0
85710,28,0,0,0,0,0,0,0
54258,601,4,73,35,38,6,1,0
127540,1982,2,404,402,2,0,1,0
37447,498,4,83,81,2,3,1,0
386167,1756,9,332,311,21,20,0,0
238389,904,7,50,47,3,2,0,0
0,0,0,0,0,0,0,0,0
51929,559,4,66,63,3,0,0,0
410348,1616,3,212,26,186,10,1,0
31627,111,4,15,15,0,0,0,0
716860,6838,9,1597,1457,140,192,1,0
118202,635,12,78,62,16,29,1,0
154395,1996,2,524,172,352,81,1,0
228676,339,0,17,12,5,0,1,0
77011,690,1,113,104,9,6,1,0
7244,28,0,0,0,0,0,0,0
11478,49,0,1,0,1,0,0,0
0,0,0,0,0,0,0,0,0
4466,64,0,6,6,0,0,0,0
621394,1847,7,165,159,6,5,1,0
540222,1897,7,168,148,20,7,1,0
22047,224,8,51,49,2,2,1,0
498224,748,5,10,8,2,2,1,0
271270,2002,5,116,111,5,5,1,0
64086,369,10,47,45,2,16,1,0
400454,934,3,94,84,10,4,1,0
0,0,0,0,0,0,0,0,0
0,0,0,0,0,0,0,0,0
1285416,3611,11,527,84,443,63,0,0
406689,643,8,58,53,5,4,1,0
334799,1411,4,187,179,8,17,1,0
194896,612,10,76,54,22,11,1,0
11601,64,3,4,3,1,1,0,0
396602,2412,10,444,404,40,12,1,0
0,0,0,0,0,0,0,0,0
0,0,0,0,0,0,0,0,0
0,0,0,0,0,0,0,0,0
115676,307,3,39,37,2,0,0,0
0,0,0,0,0,0,0,0,0
2844029,4619,8,622,606,16,6,1,0
268198,265,9,11,10,1,9,1,0
0,0,0,0,0,0,0,0,0
28360,45,0,4,1,3,0,0,0
791057,2924,2,746,745,1,2,0,0
230355,1154,2,110,92,18,4,0,0
0,0,0,0,0,0,0,0,0
1138697,8129,7,1795,1575,220,12,1,0
839063,8605,4,1283,1259,24,4,1,0
69655,226,5,9,9,0,19,0,0
158310,1982,9,500,487,13,13,1,0
618110,2740,6,302,278,24,10,1,0
0,0,0,0,0,0,0,0,0
12689,34,1,0,0,0,1,0,0
0,0,0,0,0,0,0,0,0
0,0,0,0,0,0,0,0,0
15465,235,0,71,69,2,0,1,0
0,0,0,0,0,0,0,0,0
255612,3019,7,404,383,21,13,1,1
64249,913,5,112,110,2,5,1,1
136235,437,2,106,94,12,5,1,0
28892,145,2,25,21,4,0,0,0
28892,145,2,25,21,4,0,0,0
0,0,0,0,0,0,0,0,0
0,0,0,0,0,0,0,0,0
7370,190,0,20,20,0,0,1,0
142190,1278,3,189,148,41,10,1,0
65684,118,2,0,0,0,1,0,0
280960,3569,11,799,788,11,16,1,0
159574,2200,3,967,143,824,0,1,0
7847,71,6,3,2,1,0,0,0
0,0,0,0,0,0,0,0,0
306932,976,13,167,151,16,49,1,0
88784,349,13,35,25,10,14,0,0
110746,931,6,112,94,18,3,1,0
321173,2616,7,677,615,62,5,1,0
190869,1089,17,182,170,12,12,1,0
24881,185,5,2,1,1,0,1,0
0,0,0,0,0,0,0,0,0
268147,1690,10,267,245,22,11,1,0
211968,702,3,101,91,10,2,0,0
96446,339,6,64,56,8,4,0,0
148887,1434,3,427,418,9,1,1,0
0,0,0,0,0,0,0,0,0
0,0,0,0,0,0,0,0,0
23286,172,3,11,11,0,3,1,0
0,0,0,0,0,0,0,0,0
0,0,0,0,0,0,0,0,0
232349,2332,5,316,211,105,12,1,0
194211,1827,11,269,225,44,37,1,0
92365,732,9,151,115,36,23,1,0
35429,636,4,147,123,24,24,1,0
0,0,0,0,0,0,0,0,0
0,0,0,0,0,0,0,0,0
0,0,0,0,0,0,0,0,0
265484,753,10,95,87,8,16,1,0
0,0,0,0,0,0,0,0,0
318107,1400,2,276,203,73,4,1,0
25267,182,0,17,5,12,2,1,0
1290936,3562,6,379,339,40,27,1,1
1545453,124,3,8,3,5,2,1,0
1752375,501,7,12,6,6,59,1,0
0,0,0,0,0,0,0,0,0
40289,392,5,42,40,2,1,1,0
20256,177,4,26,26,0,0,1,0
144326,2071,5,400,394,6,12,1,0
56080,693,5,149,144,5,15,1,0
326304,3942,12,282,272,10,97,1,1
33468,365,0,34,32,2,0,1,0
1144451,5725,2,577,563,14,1,0,0
108149,1066,1,80,70,10,4,1,0
791684,2663,6,494,453,41,2,1,0
11722,180,1,5,1,4,0,1,0
14219,94,2,5,2,3,0,0,0
0,0,0,0,0,0,0,0,0
232212,1921,9,338,314,24,14,1,1
0,0,0,0,0,0,0,0,0
0,0,0,0,0,0,0,0,0
17444,238,4,24,24,0,5,1,0
6553,95,3,11,6,5,0,1,0
569251,1946,7,316,87,229,26,1,0
243652,745,9,131,83,48,10,1,0
0,0,0,0,0,0,0,0,0
92486,1198,4,149,125,24,19,0,0
636998,4679,5,989,975,14,31,1,0
362427,3266,7,708,694,14,10,1,0
446872,1514,4,196,185,11,14,1,0
3155350,4081,1,152,132,20,3,1,0
7994,34,0,0,0,0,0,0,0
0,0,0,0,0,0,0,0,0
0,0,0,0,0,0,0,0,0
0,0,0,0,0,0,0,0,0
1117045,3124,4,343,263,80,5,1,0
0,0,0,0,0,0,0,0,0
117354,657,8,84,82,2,10,1,0
0,0,0,0,0,0,0,0,0
96267,580,5,91,89,2,9,1,0
0,0,0,0,0,0,0,0,0
174674,2697,2,1412,263,1149,6,1,0
45921,513,3,150,105,45,3,1,0
40467,592,3,36,36,0,4,1,0
0,0,0,0,0,0,0,0,0
479923,1089,4,168,157,11,0,1,0
259416,142,3,8,6,2,0,1,0
287928,770,3,147,137,10,1,1,0
93025,181,3,21,10,11,2,1,0
230042,341,0,17,11,6,0,1,0
487609,3843,1,235,215,20,9,1,0
0,0,0,0,0,0,0,0,0
85765,1572,8,47,30,17,2,1,0
155410,1143,5,196,150,46,19,1,0
57064,298,5,44,34,10,15,0,0
0,0,0,0,0,0,0,0,0
0,0,0,0,0,0,0,0,0
1335001,2100,6,199,174,25,32,1,0
130223,962,3,197,102,95,4,0,0
1392910,910,5,97,91,6,0,1,0
1103895,158,7,3,3,0,0,1,0
0,0,0,0,0,0,0,0,0
53997,1115,2,253,239,14,9,0,0
42494,541,5,115,112,3,2,1,0
1857839,2093,5,199,188,11,1,1,0
1780450,2204,5,195,186,9,4,1,0
0,0,0,0,0,0,0,0,0
2156601,5942,7,628,566,62,1,1,0
993960,3629,5,270,253,17,15,1,0
1110430,1990,5,362,354,8,18,1,0
0,0,0,0,0,0,0,0,0
548677,2646,2,266,242,24,2,1,0
0,0,0,0,0,0,0,0,0
0,0,0,0,0,0,0,0,0
178731,3092,3,828,793,35,27,1,0
7681,52,0,6,1,5,0,0,0
0,0,0,0,0,0,0,0,0
0,0,0,0,0,0,0,0,0
28272,538,2,109,104,5,0,0,0
979604,1456,10,177,171,6,20,1,0
0,0,0,0,0,0,0,0,0
0,0,0,0,0,0,0,0,0
104812,586,6,134,111,23,9,1,0
240604,1486,9,157,148,9,16,1,0
109412,1286,9,286,25,261,8,1,0
78095,784,9,150,135,15,5,1,0
1266926,2581,15,726,707,19,16,1,0
999605,1629,15,618,605,13,11,1,0
23167,400,3,116,110,6,0,1,0
11619,64,3,4,3,1,1,0,0
665610,5881,6,390,375,15,7,0,0
0,0,0,0,0,0,0,0,0
100066,640,6,110,78,32,4,1,0
368359,579,0,117,90,27,11,1,0
1130998,1230,1,82,73,9,0,1,0
79316,776,1,69,63,6,0,1,0
21591,174,4,7,5,2,2,0,0
21628,241,4,54,52,2,3,1,0
859033,552,10,58,57,1,3,1,0
32539,162,6,6,6,0,6,0,0
133167,1163,0,265,248,17,2,1,0
28381,328,0,99,88,11,0,1,0
0,0,0,0,0,0,0,0,0
149273,1147,7,193,104,89,10,1,0
67711,273,3,12,10,2,2,1,0
27753,42,0,2,1,1,0,0,0
27680,42,0,2,1,1,0,0,0
526483,4481,9,293,168,125,57,1,0
0,0,0,0,0,0,0,0,0
0,0,0,0,0,0,0,0,0
162090,853,10,109,93,16,4,1,0
104151,316,8,56,47,9,3,1,0
816735,3597,1,545,387,158,4,1,0
0,0,0,0,0,0,0,0,0
738249,1658,4,183,179,4,2,1,0
975,16,0,0,0,0,0,0,0
240953,1050,6,129,103,26,16,1,0
109539,970,0,350,347,3,1,1,0
96714,570,4,192,153,39,3,0,0
92296,766,0,0,0,0,4,0,0
41581,292,6,32,26,6,0,1,0
253236,734,6,87,67,20,2,1,0
0,0,0,0,0,0,0,0,0
196352,1455,12,231,165,66,3,1,0
59000,969,3,396,353,43,152,0,0
385743,7454,3,1869,1863,6,4,1,0
18530,259,3,35,32,3,3,1,0
175741,1655,6,207,158,49,11,1,0
0,0,0,0,0,0,0,0,0
143999,591,8,30,21,9,13,1,0
0,0,0,0,0,0,0,0,0
2375767,1012,1,74,51,23,3,1,0
0,0,0,0,0,0,0,0,0
61801,317,4,35,33,2,2,1,0
313163,2537,2,353,349,4,55,1,0
194818,1527,4,382,381,1,22,1,0
429732,1561,11,460,446,14,9,0,0
5170742,1721,6,76,73,3,34,0,0
0,0,0,0,0,0,0,0,0
43036,36,0,1,0,1,0,0,1
0,0,0,0,0,0,0,0,0
0,0,0,0,0,0,0,0,0
114126,1257,2,243,238,5,8,1,0
238056,2177,10,457,345,112,23,1,0
425246,2935,5,703,673,30,0,1,0
656138,564,3,114,113,1,2,1,0
799178,2609,10,526,104,422,20,0,0
406247,638,8,58,53,5,4,1,0
1179127,14453,3,1125,1087,38,15,1,0
193777,1609,3,185,179,6,13,1,0
437840,1033,4,87,67,20,3,1,0
428871,1502,1,127,89,38,0,1,0
218550,1934,10,434,400,34,12,1,0
0,0,0,0,0,0,0,0,0
82428,821,8,166,138,28,2,1,0
166098,1040,14,176,156,20,23,1,0
0,0,0,0,0,0,0,0,0
276927,3720,5,489,393,96,6,1,0
0,0,0,0,0,0,0,0,0
253580,987,5,153,150,3,1,1,0
0,0,0,0,0,0,0,0,0
491618,2988,1,731,650,81,20,1,0
234352,406,0,17,11,6,0,1,0
91484,1451,2,452,448,4,2,1,0
64718,409,3,91,88,3,0,1,0
51853,1246,2,414,409,5,1,1,0
140460,1659,5,217,200,17,2,1,0
234685,1128,5,73,65,8,0,1,0
45,3,0,0,0,0,0,0,0
0,0,0,0,0,0,0,0,0
0,0,0,0,0,0,0,0,0
289222,1398,4,242,238,4,3,1,0
210605,369,7,34,30,4,5,1,0
108388,1376,6,286,271,15,31,1,0
75463,537,1,133,129,4,1,1,0
19119,223,1,42,38,4,1,1,0
469087,3779,10,402,388,14,78,1,0
0,0,0,0,0,0,0,0,0
0,0,0,0,0,0,0,0,0
700730,3360,8,967,960,7,10,1,0
558347,2995,7,915,908,7,7,1,0
367877,665,2,46,45,1,1,1,0
0,0,0,0,0,0,0,0,0
55922,845,1,155,66,89,0,0,0
68079,413,5,50,47,3,0,1,0
0,0,0,0,0,0,0,0,0
231720,1504,3,297,283,14,9,1,0
0,0,0,0,0,0,0,0,0
19692,34,0,1,1,0,0,1,0
128132,1486,3,327,319,8,1,1,0
9461,95,2,3,3,0,0,0,0
462423,2366,7,620,553,67,21,1,0
357834,2022,4,256,185,71,17,1,0
94646,485,2,67,40,27,0,1,0
157776,450,12,40,33,7,25,1,0
18714,165,0,0,0,0,0,0,0
551537,2432,18,326,282,44,27,1,1
394039,883,3,118,92,26,4,1,0
14539,100,2,7,7,0,0,0,0
0,0,0,0,0,0,0,0,0
1159714,3185,11,154,152,2,19,1,0
229194,338,0,17,8,9,0,1,0
213537,1023,3,198,169,29,9,1,0
141150,255,3,27,11,16,4,1,0
128404,1402,3,209,189,20,3,0,0
0,0,0,0,0,0,0,0,0
0,0,0,0,0,0,0,0,0
329612,2003,1,479,469,10,6,1,0
153093,662,1,442,432,10,6,1,0
106780,695,2,71,67,4,4,1,0
312658,861,1,4,1,3,3,0,0
0,0,0,0,0,0,0,0,0
73140,737,5,112,108,4,2,1,0
55641,341,3,32,26,6,0,1,0
0,0,0,0,0,0,0,0,0
124818,1821,2,622,620,2,5,0,0
25728,131,2,20,18,2,5,0,0
0,0,0,0,0,0,0,0,0
0,0,0,0,0,0,0,0,0
0,0,0,0,0,0,0,0,0
1127205,4290,3,1069,1051,18,1,0,0
0,0,0,0,0,0,0,0,0
0,0,0,0,0,0,0,0,0
0,0,0,0,0,0,0,0,0
43939,382,7,55,52,3,0,1,0
38688,559,6,100,86,14,5,0,0
0,0,0,0,0,0,0,0,0
182304,1468,8,215,181,34,6,1,0
251189,2633,3,370,362,8,1,1,0
110884,924,4,79,74,5,5,1,0
1894209,3641,7,511,460,51,24,1,0
569763,945,3,2,0,2,9,1,0
0,0,0,0,0,0,0,0,0
670722,1376,7,212,186,26,43,1,0
1025521,1834,2,344,290,54,1,1,0
544806,1608,5,353,299,54,2,1,0
333519,4165,8,666,655,11,6,0,0
242510,2413,6,760,505,255,0,1,1
137964,1072,12,243,179,64,1,1,0
188303,1961,7,544,533,11,28,1,0
149190,740,6,81,62,19,8,1,0
0,0,0,0,0,0,0,0,0
22723,341,7,51,27,24,1,1,0
78794,295,11,15,15,0,25,1,0
85550,361,12,22,21,1,29,1,0
618120,3758,12,561,520,41,19,1,0
219884,1565,8,224,217,7,81,1,0
216177,2168,3,83,33,50,62,1,0
112038,671,11,56,47,9,14,0,0
194892,901,8,211,187,24,27,1,0
4361074,9902,14,139,127,12,110,1,0
49854,487,2,26,11,15,0,1,0
116586,837,8,215,160,55,18,1,0
55836,506,3,184,148,36,6,1,0
711105,4924,11,749,721,28,7,1,1
27279,731,4,192,190,2,0,1,0
6645,100,5,18,17,1,2,1,0
90773,868,3,216,25,191,0,0,0
0,0,0,0,0,0,0,0,0
0,0,0,0,0,0,0,0,0
518195,7743,2,1059,1053,6,7,1,0
165814,1556,14,286,258,28,8,1,0
302636,1570,2,248,228,20,0,1,0
302636,1570,2,248,227,21,0,1,0
661645,4601,3,192,183,9,3,1,0
0,0,0,0,0,0,0,0,0
546443,1465,3,423,408,15,2,1,0
25723,428,2,52,50,2,6,1,0
85402,683,4,128,82,46,0,1,0
212109,983,2,61,52,9,34,1,0
0,0,0,0,0,0,0,0,0
0,0,0,0,0,0,0,0,0
1996,60,0,15,5,10,0,0,0
810949,3457,6,266,250,16,11,1,0
0,0,0,0,0,0,0,0,0
641184,1199,7,77,65,12,16,1,0
586948,523,6,49,37,12,16,1,0
0,0,0,0,0,0,0,0,0
844315,5949,4,654,627,27,14,1,0
210719,1047,4,188,185,3,16,1,0
213151,851,8,79,45,34,1,1,0
0,0,0,0,0,0,0,0,0
122250,2291,2,816,791,25,9,0,0
2621,38,1,4,4,0,0,0,0
496403,1768,3,297,272,25,6,0,0
3324,31,1,0,0,0,1,0,0
0,0,0,0,0,0,0,0,0
540891,4062,2,885,876,9,31,1,0
0,0,0,0,0,0,0,0,0
995296,4951,2,337,272,65,4,1,0
189795,2418,4,369,368,1,11,1,0
896996,5910,8,1862,1852,10,10,1,0
168637,569,5,39,29,10,9,1,0
0,0,0,0,0,0,0,0,0
159634,871,1,181,160,21,2,1,0
1545455,124,3,8,3,5,2,1,0
1752163,500,7,12,6,6,59,1,0
0,0,0,0,0,0,0,0,0
1206445,5508,8,387,288,99,18,1,0
0,0,0,0,0,0,0,0,0
0,0,0,0,0,0,0,0,0
53178,1012,2,238,234,4,8,1,0
314302,818,9,118,108,10,6,1,0
281849,265,7,22,19,3,6,0,0
264154,734,6,54,41,13,1,1,0
0,0,0,0,0,0,0,0,0
65343,536,5,250,210,40,0,0,0
8061,70,6,3,2,1,0,0,0
421,6,0,0,0,0,0,0,0
965063,712,9,105,95,10,1,1,0
41463,466,8,105,102,3,2,1,0
0,0,0,0,0,0,0,0,0
0,0,0,0,0,0,0,0,0
0,0,0,0,0,0,0,0,0
0,0,0,0,0,0,0,0,0
0,0,0,0,0,0,0,0,0
0,0,0,0,0,0,0,0,0
360240,3654,4,752,702,50,26,1,0
67064,325,4,49,48,1,5,1,0
1410592,8490,2,1045,846,199,12,1,0
1345658,1743,6,196,125,71,36,1,0
258601,1590,6,153,108,45,36,1,0
57533,950,1,179,156,23,0,1,0
0,0,0,0,0,0,0,0,0
95534,441,0,74,54,20,1,1,0
190507,1270,8,352,347,5,3,1,0
0,0,0,0,0,0,0,0,0
119516,1251,4,185,180,5,22,1,0
36629,321,2,52,46,6,5,1,0
0,0,0,0,0,0,0,0,0
817184,3350,5,687,627,60,11,1,0
0,0,0,0,0,0,0,0,0
360930,677,2,98,98,0,0,1,1
0,0,0,0,0,0,0,0,0
0,0,0,0,0,0,0,0,0
136812,910,14,145,138,7,8,1,0
141672,761,5,66,53,13,5,1,0
111465,2369,1,432,427,5,1,1,0
27812,388,1,20,19,1,1,1,0
46046,320,5,78,61,17,3,1,0
185250,4716,0,401,399,2,0,0,0
147537,1094,5,98,74,24,5,1,0
0,0,0,0,0,0,0,0,0
19876,33,0,1,1,0,0,1,0
76107,505,4,30,30,0,7,1,0
0,0,0,0,0,0,0,0,0
0,0,0,0,0,0,0,0,0
43090,197,7,0,0,0,2,0,0
554582,1025,5,168,163,5,7,1,0
229422,338,0,17,11,6,0,1,0
486415,1720,5,268,246,22,18,1,0
745231,2988,8,464,372,92,2,1,0
28451,130,5,8,7,1,1,0,0
172363,1371,4,273,262,11,2,0,0
0,0,0,0,0,0,0,0,0
1187012,4153,14,972,61,911,28,1,0
0,0,0,0,0,0,0,0,0
0,0,0,0,0,0,0,0,0
0,0,0,0,0,0,0,0,0
0,0,0,0,0,0,0,0,0
0,0,0,0,0,0,0,0,0
67942,901,2,148,53,95,3,1,0
663082,5950,10,1135,870,265,47,1,0
83051,324,10,8,8,0,7,0,0
153495,535,0,124,122,2,0,1,0
0,0,0,0,0,0,0,0,0
559807,5674,7,594,553,41,11,1,0
75707,356,14,39,15,24,10,1,0
60441,291,13,32,17,15,10,1,0
0,0,0,0,0,0,0,0,0
0,0,0,0,0,0,0,0,0
0,0,0,0,0,0,0,0,0
0,0,0,0,0,0,0,0,0
144543,1131,14,197,182,15,11,1,0
78861,863,9,257,255,2,9,1,0
31643,292,9,48,46,2,8,1,0
0,0,0,0,0,0,0,0,0
191183,1126,6,229,193,36,1,1,0
0,0,0,0,0,0,0,0,0
78774,603,7,75,47,28,2,1,0
0,0,0,0,0,0,0,0,0
0,0,0,0,0,0,0,0,0
193013,748,9,85,79,6,9,0,0
130665,1976,1,381,360,21,1,1,0
294441,2278,6,323,311,12,14,1,0
400704,1056,3,185,113,72,10,1,0
78649,108,1,10,7,3,2,0,0
494437,2604,6,346,294,52,19,0,0
260068,934,0,74,67,7,0,0,0
14902,94,3,3,3,0,2,1,0
467552,1863,7,124,95,29,3,1,0
114319,745,0,33,23,10,0,0,0
58053,14,0,1,1,0,0,0,0
0,0,0,0,0,0,0,0,0
1082112,1713,10,221,207,14,22,1,0
0,0,0,0,0,0,0,0,0
0,0,0,0,0,0,0,0,0
0,0,0,0,0,0,0,0,0
570097,4913,6,250,214,36,3,1,0
0,0,0,0,0,0,0,0,0
0,0,0,0,0,0,0,0,0
163943,754,0,86,76,10,0,1,0
58923,193,1,35,25,10,0,1,0
0,0,0,0,0,0,0,0,0
3200884,2304,9,140,85,55,94,1,0
1523311,2087,9,96,79,17,114,1,0
163208,2139,1,254,230,24,46,1,0
806329,3662,12,829,801,28,0,1,0
158208,1454,3,171,171,0,10,1,0
139689,1179,3,206,181,25,33,1,0
0,0,0,0,0,0,0,0,0
70743,769,4,80,76,4,6,1,1
434460,1249,3,283,267,16,0,1,0
0,0,0,0,0,0,0,0,0
0,0,0,0,0,0,0,0,0
0,0,0,0,0,0,0,0,0
0,0,0,0,0,0,0,0,0
342123,3819,6,1664,952,712,6,0,0
0,0,0,0,0,0,0,0,0
134048,1058,3,278,264,14,1,1,0
54521,699,2,139,137,2,0,0,0
5291,65,2,13,12,1,0,0,0
575916,6699,11,659,637,22,6,1,1
268784,2608,4,337,327,10,3,1,0
2944947,3350,8,700,595,105,14,1,0
508255,1184,9,204,168,36,34,1,0
182838,2846,1,330,327,3,1,1,0
17659,164,1,23,21,2,0,1,0
174014,1106,2,87,25,62,3,0,0
326265,2200,10,450,414,36,30,1,0
921843,1486,2,233,202,31,2,1,0
19679,32,0,1,1,0,0,1,0
0,0,0,0,0,0,0,0,0
0,0,0,0,0,0,0,0,0
266074,3677,1,1024,900,124,128,1,0
0,0,0,0,0,0,0,0,0
152528,1284,9,336,334,2,5,1,0
0,0,0,0,0,0,0,0,0
0,0,0,0,0,0,0,0,0
196975,918,2,43,43,0,8,1,0
79389,380,3,24,23,1,5,1,0
0,0,0,0,0,0,0,0,0
520149,2048,4,430,356,74,5,0,1
0,0,0,0,0,0,0,0,0
0,0,0,0,0,0,0,0,0
111446,1416,6,295,269,26,3,1,0
13321,132,7,10,10,0,2,0,0
0,0,0,0,0,0,0,0,0
481049,1674,5,326,45,281,2,1,0
285142,1310,4,267,260,7,1,1,0
0,0,0,0,0,0,0,0,0
311615,3500,3,555,531,24,0,1,0
143429,1569,3,188,176,12,0,1,0
119644,1350,12,119,70,49,48,1,0
2347375,26336,5,1992,1676,316,15,0,0
507422,2011,4,389,379,10,14,1,0
0,0,0,0,0,0,0,0,0
248856,1789,8,74,63,11,9,1,0
248856,1789,8,74,63,11,9,1,0
55204,682,6,52,45,7,0,1,0
369921,3590,5,1385,1240,145,3,1,0
37397,564,0,29,15,14,0,1,0
37397,564,0,29,18,11,0,1,0
0,0,0,0,0,0,0,0,0
317000,1146,0,145,132,13,3,1,0
228170,2294,12,473,421,52,41,1,0
58780,571,10,128,124,4,17,1,0
0,0,0,0,0,0,0,0,0
0,0,0,0,0,0,0,0,0
152062,1100,7,149,135,14,4,1,0
0,0,0,0,0,0,0,0,0
139566,354,4,37,32,5,11,1,0
111266,144,4,14,10,4,1,1,0
0,0,0,0,0,0,0,0,0
166749,620,6,162,23,139,2,1,0
0,0,0,0,0,0,0,0,0
177250,2594,3,323,268,55,1,1,0
96613,1125,5,290,253,37,2,1,0
0,0,0,0,0,0,0,0,0
430937,1553,11,142,113,29,34,1,0
402487,1936,6,459,387,72,26,0,0
408278,1972,6,459,396,63,25,0,0
768560,808,7,121,101,20,0,1,0
768560,808,7,121,99,22,0,1,0
109030,1807,3,356,298,58,14,0,0
155320,1067,7,183,161,22,21,1,0
0,0,0,0,0,0,0,0,0
0,0,0,0,0,0,0,0,0
355513,1615,2,106,92,14,2,0,0
83253,681,7,119,104,15,0,1,0
0,0,0,0,0,0,0,0,0
0,0,0,0,0,0,0,0,0
257951,590,7,80,71,9,6,1,0
2319,19,0,0,0,0,0,0,0
0,0,0,0,0,0,0,0,0
274683,3428,3,2645,2643,2,364,1,0
167983,758,7,70,58,12,1,1,0
3068,67,1,4,4,0,0,0,0
98461,1740,1,399,340,59,10,1,0
0,0,0,0,0,0,0,0,0
0,0,0,0,0,0,0,0,0
229237,1750,4,210,200,10,10,1,0
253118,928,3,141,118,23,10,1,0
196718,290,3,52,40,12,3,1,0
526010,1454,5,78,5,73,8,1,0
298856,126,2,7,6,1,0,1,0
167136,1526,1,656,649,7,0,1,0
15796,149,2,23,21,2,0,1,1
777469,1375,6,236,220,16,6,1,0
45553,258,6,9,3,6,6,0,0
0,0,0,0,0,0,0,0,0
152434,1078,4,202,187,15,3,1,0
433228,2685,1,328,322,6,79,1,0
0,0,0,0,0,0,0,0,0
290635,1392,1,246,171,75,12,1,0
34740,187,4,26,15,11,3,1,0
38033,66,5,0,0,0,0,0,0
20494,87,3,3,3,0,0,1,0
101696,842,12,179,144,35,5,1,0
0,0,0,0,0,0,0,0,0
229364,338,0,17,14,3,0,1,0
0,0,0,0,0,0,0,0,0
174333,990,9,113,19,94,0,1,0
0,0,0,0,0,0,0,0,0
416320,3046,6,740,712,28,9,1,0
256269,1467,4,266,234,32,1,1,0
10542,115,0,5,5,0,3,1,0
0,0,0,0,0,0,0,0,0
251969,1230,8,154,148,6,14,1,0
130418,623,9,120,106,14,3,1,0
179438,1466,12,183,170,13,21,1,0
169709,1279,8,277,265,12,13,1,0
169709,1279,8,277,265,12,13,1,0
0,0,0,0,0,0,0,0,0
260550,1519,6,197,181,16,5,1,0
10855,125,2,24,23,1,0,1,0
81744,966,6,130,117,13,5,1,0
16654,189,6,35,21,14,3,1,0
0,0,0,0,0,0,0,0,0
162564,1259,8,144,132,12,11,1,0
0,0,0,0,0,0,0,0,0
99374,700,6,265,262,3,1,1,0
427494,666,3,113,108,5,0,1,0
0,0,0,0,0,0,0,0,0
0,0,0,0,0,0,0,0,0
446632,2104,9,439,402,37,5,1,0
8430,57,5,0,0,0,0,1,0
64660,686,6,125,52,73,1,1,0
322971,2880,2,549,547,2,4,1,0
128569,308,3,20,18,2,6,1,0
101059,687,9,114,100,14,26,1,0
23703,159,4,28,21,7,2,1,0
9323,142,4,16,15,1,1,1,0
8795,123,5,20,16,4,1,1,0
62925,679,6,51,19,32,5,1,0
0,0,0,0,0,0,0,0,0
0,0,0,0,0,0,0,0,0
17510,80,1,18,18,0,0,0,0
349913,3428,15,750,713,37,145,1,0
893963,8170,6,574,302,272,39,1,0
171548,684,5,71,46,25,7,1,0
508001,3689,4,480,468,12,4,1,0
2078382,5825,8,686,670,16,15,1,0
0,0,0,0,0,0,0,0,0
0,0,0,0,0,0,0,0,0
78923,1193,2,262,247,15,2,1,0
1832028,1622,7,228,227,1,12,1,0
0,0,0,0,0,0,0,0,0
275518,1474,3,132,129,3,2,1,0
65263,379,4,49,37,12,4,1,0
0,0,0,0,0,0,0,0,0
0,0,0,0,0,0,0,0,0
381543,1385,5,41,40,1,0,1,0
94721,225,2,23,22,1,0,1,0
150916,724,2,179,119,60,3,1,0
455342,3545,5,430,381,49,6,1,1
0,0,0,0,0,0,0,0,0
859020,860,6,204,103,101,12,1,0
106574,713,8,106,103,3,7,0,0
0,0,0,0,0,0,0,0,0
25305,109,0,5,1,4,0,1,0
191841,83,0,6,6,0,2,1,0
651895,2672,9,411,326,85,39,1,0
620139,2631,9,410,326,84,37,1,0
75292,665,9,18,13,5,5,1,0
81541,1066,6,152,140,12,2,1,0
0,0,0,0,0,0,0,0,0
0,0,0,0,0,0,0,0,0
453560,3129,4,687,641,46,10,0,0
66907,444,4,41,33,8,0,0,0
0,0,0,0,0,0,0,0,0
28591,320,1,18,10,8,0,1,0
0,0,0,0,0,0,0,0,0
92468,1041,2,60,33,27,2,1,0
347415,2770,11,180,165,15,61,1,0
150250,2022,9,339,320,19,72,1,1
90224,754,3,178,138,40,8,1,0
63258,290,2,41,30,11,2,1,0
92243,1217,4,149,137,12,11,1,0
3094,47,1,2,1,1,0,1,0
77794,559,6,71,66,5,0,1,0
38624,302,7,31,29,2,28,1,0
12653,120,6,19,19,0,0,1,0
0,0,0,0,0,0,0,0,0
56923,633,8,97,77,20,5,0,0
0,0,0,0,0,0,0,0,0
0,0,0,0,0,0,0,0,0
887930,1717,6,144,131,13,39,1,0
91233,1011,0,131,128,3,3,1,0
0,0,0,0,0,0,0,0,0
114830,531,8,94,86,8,0,1,0
4452,78,1,19,19,0,1,0,0
0,0,0,0,0,0,0,0,0
0,0,0,0,0,0,0,0,0
0,0,0,0,0,0,0,0,0
0,0,0,0,0,0,0,0,0
420833,1630,1,297,286,11,1,1,1
126721,1139,4,234,223,11,0,1,0
421137,3386,2,737,706,31,27,1,0
0,0,0,0,0,0,0,0,0
61891,402,9,73,71,2,2,1,0
174982,212,4,9,6,3,3,1,0
1190495,8736,6,542,409,133,22,1,0
8747,87,0,4,1,3,3,0,0
821797,1573,2,164,10,154,14,1,0
39360,810,4,157,130,27,0,1,0
501684,1397,3,120,120,0,19,1,0
472743,1538,7,266,233,33,7,1,0
146010,1505,5,169,94,75,0,1,0
230539,1168,5,114,111,3,14,0,0
69275,1741,4,275,273,2,1,1,0
154744,1114,8,298,193,105,31,1,0
153673,1450,6,278,239,39,6,1,0
78666,794,5,157,131,26,6,1,0
416359,1477,4,325,318,7,0,1,0
364775,2394,6,291,283,8,5,1,0
242842,1779,6,267,234,33,7,1,0
18470,160,5,20,7,13,0,1,0
0,0,0,0,0,0,0,0,0
138316,1260,7,420,399,21,3,1,0
36492,233,12,10,10,0,8,1,0
11408,133,3,23,10,13,5,1,0
208982,3259,8,744,422,322,136,1,0
79722,1241,5,288,260,28,8,1,0
34609,266,3,42,38,4,0,1,0
0,0,0,0,0,0,0,0,0
297181,2993,7,205,167,38,7,1,0
213243,2355,5,19,16,3,5,1,0
0,0,0,0,0,0,0,0,0
0,0,0,0,0,0,0,0,0
0,0,0,0,0,0,0,0,0
0,0,0,0,0,0,0,0,0
195474,1334,3,221,206,15,0,0,0
520856,1414,2,183,177,6,8,1,0
108677,180,2,3,3,0,2,1,0
209235,2038,2,363,352,11,1,1,0
132104,753,6,82,56,26,9,1,0
0,0,0,0,0,0,0,0,0
85133,550,10,95,90,5,62,1,0
27552,294,3,67,61,6,3,0,0
90908,797,6,157,129,28,0,1,0
253462,1184,6,153,142,11,3,1,0
70484,635,3,71,53,18,5,1,0
0,0,0,0,0,0,0,0,0
0,0,0,0,0,0,0,0,0
0,0,0,0,0,0,0,0,0
0,0,0,0,0,0,0,0,0
342116,2079,5,315,144,171,11,1,0
0,0,0,0,0,0,0,0,0
136320,578,5,161,145,16,1,1,0
18062,116,3,7,7,0,0,0,0
92593,427,5,71,71,0,2,1,0
781754,799,7,93,89,4,1,1,0
742224,643,8,103,97,6,1,1,0
75305,1029,5,235,205,30,2,1,0
17996,339,0,49,45,4,1,0,0
68171,631,7,86,83,3,0,1,0
11698,175,7,33,31,2,0,1,0
0,0,0,0,0,0,0,0,0
514586,2210,5,463,420,43,25,0,0
0,0,0,0,0,0,0,0,0
0,0,0,0,0,0,0,0,0
0,0,0,0,0,0,0,0,0
807677,1603,9,189,172,17,9,1,0
129041,1839,5,201,173,28,7,1,0
25873,295,5,67,51,16,0,1,0
804554,2109,6,291,275,16,19,1,0
245521,484,7,6,5,1,5,0,0
320179,809,4,68,68,0,1,1,0
0,0,0,0,0,0,0,0,0
0,0,0,0,0,0,0,0,0
127101,1860,4,624,565,59,20,0,0
514165,2650,9,524,473,51,23,1,0
159928,1229,5,271,252,19,17,1,0
11871,222,2,44,40,4,0,1,0
117304,1124,5,217,205,12,11,0,0
0,0,0,0,0,0,0,0,0
0,0,0,0,0,0,0,0,0
122289,1164,5,123,105,18,4,1,0
172432,1056,8,74,57,17,22,1,0
102343,417,3,38,23,15,14,1,0
0,0,0,0,0,0,0,0,0
245593,1782,13,156,133,23,250,0,0
0,0,0,0,0,0,0,0,0
0,0,0,0,0,0,0,0,0
0,0,0,0,0,0,0,0,0
200568,1414,3,204,12,192,0,0,0
8844,100,0,6,6,0,0,0,0
2921412,8302,5,2076,2067,9,74,1,0
267648,191,0,0,0,0,1,1,0
981568,3588,6,840,833,7,13,1,0
76807,990,2,164,160,4,7,1,0
0,0,0,0,0,0,0,0,0
0,0,0,0,0,0,0,0,0
0,0,0,0,0,0,0,0,0
0,0,0,0,0,0,0,0,0
0,0,0,0,0,0,0,0,0
246762,1341,2,261,252,9,3,0,0
41309,262,1,35,30,5,3,1,0
45809,516,3,138,138,0,2,0,0
0,0,0,0,0,0,0,0,0
0,0,0,0,0,0,0,0,0
42134,515,5,122,120,2,2,1,0
97847,861,0,142,100,42,11,1,0
116409,1226,8,302,286,16,6,1,0
23178,99,6,10,10,0,3,0,0
0,0,0,0,0,0,0,0,0
31114,318,4,19,19,0,6,1,0
0,0,0,0,0,0,0,0,0
314564,811,1,92,88,4,0,1,0
24796,210,2,21,21,0,0,1,0
93216,1041,3,236,186,50,4,1,0
569,7,0,0,0,0,0,0,0
1014360,6691,0,331,316,15,1,1,0
0,0,0,0,0,0,0,0,0
440084,1019,3,119,112,7,5,1,0
14750,101,2,7,7,0,0,0,0
242422,2654,6,296,262,34,11,1,0
89355,285,6,35,28,7,11,1,0
77070,538,5,89,64,25,2,1,0
160527,1361,8,283,281,2,1,0,1
565026,329,4,64,60,4,3,1,0
553092,169,1,15,10,5,3,1,0
37323,328,7,29,29,0,0,1,0
3788,45,6,1,0,1,0,0,0
0,0,0,0,0,0,0,0,0
0,0,0,0,0,0,0,0,0
0,0,0,0,0,0,0,0,0
162567,1037,3,152,151,1,6,1,0
12492,114,2,18,17,1,5,1,0
0,0,0,0,0,0,0,0,0
86884,599,6,112,110,2,3,1,0
191379,83,0,6,6,0,2,1,0
134505,1617,7,287,273,14,14,0,0
0,0,0,0,0,0,0,0,0
0,0,0,0,0,0,0,0,0
337480,1941,9,318,299,19,6,0,0
0,0,0,0,0,0,0,0,0
176073,1951,3,197,189,8,5,0,0
53254,507,4,77,69,8,5,1,0
27770,112,4,1,1,0,3,0,0
299263,3654,12,647,608,39,164,0,0
18366,34,2,0,0,0,0,0,0
547588,5149,10,850,827,23,20,1,1
1003303,2010,8,295,280,15,108,1,0
421607,668,8,59,46,13,3,1,0
198998,1177,8,298,274,24,0,1,0
684655,1203,6,156,65,91,8,1,0
0,0,0,0,0,0,0,0,0
1318967,5962,5,896,816,80,126,1,0
73253,423,1,37,14,23,7,1,0
35438,649,1,194,184,10,3,1,0
1155519,3553,1,962,591,371,220,1,0
46173,174,5,6,0,6,8,1,0
62880,858,4,197,119,78,14,1,0
0,0,0,0,0,0,0,0,0
0,0,0,0,0,0,0,0,0
282606,1144,0,54,54,0,8,0,0
6832,78,4,4,3,1,0,0,0
0,0,0,0,0,0,0,0,0
382637,3906,5,363,355,8,6,1,0
86525,691,4,84,77,7,3,1,0
257786,1474,5,194,159,35,9,1,0
0,0,0,0,0,0,0,0,0
103010,1073,3,168,155,13,6,1,0
107970,926,3,145,112,33,2,1,0
9260,106,3,16,16,0,0,1,0
79860,1361,7,327,323,4,5,1,0
36690,777,4,250,247,3,3,1,0
21946,35,0,1,1,0,0,1,0
319133,4999,4,1527,1514,13,1,1,0
0,0,0,0,0,0,0,0,0
51059,750,13,192,192,0,12,1,0
84681,680,5,229,49,180,1,1,0
90333,261,0,48,24,24,0,1,1
1062151,408,2,38,34,4,0,1,0
9989,122,3,10,10,0,1,1,0
0,0,0,0,0,0,0,0,0
3822226,2127,5,280,235,45,22,1,0
502135,3862,6,752,722,30,17,0,1
774999,2460,9,317,240,77,26,1,0
255614,925,6,192,123,69,11,1,0
139321,1416,7,133,128,5,7,0,0
8764,66,1,8,8,0,0,1,0
183978,1865,10,502,484,18,28,1,0
0,0,0,0,0,0,0,0,0
23441,37,0,2,1,1,0,1,0
0,0,0,0,0,0,0,0,0
336780,3408,5,723,710,13,10,1,0
136024,1718,9,226,207,19,7,1,0
239389,1919,7,78,67,11,10,1,0
239387,1919,7,78,64,14,10,1,0
0,0,0,0,0,0,0,0,0
0,0,0,0,0,0,0,0,0
214829,1500,3,247,174,73,1,0,0
68412,259,3,37,29,8,3,0,0
68539,388,5,52,51,1,0,1,0
0,0,0,0,0,0,0,0,0
0,0,0,0,0,0,0,0,0
52878,414,0,96,93,3,0,0,0
0,0,0,0,0,0,0,0,0
37731,345,7,75,72,3,11,1,0
0,0,0,0,0,0,0,0,0
0,0,0,0,0,0,0,0,0
186253,1501,2,245,244,1,31,1,0
0,0,0,0,0,0,0,0,0
5033,55,1,4,3,1,1,0,0
120734,659,8,119,119,0,19,0,0
850915,2262,5,185,147,38,4,1,0
0,0,0,0,0,0,0,0,0
0,0,0,0,0,0,0,0,0
4276178,2702,7,443,385,58,15,1,1
167169,4224,3,751,747,4,0,1,0
172451,1219,2,122,97,25,0,1,0
146130,854,2,70,62,8,3,1,0
177638,940,4,147,99,48,8,0,0
722050,2691,4,132,120,12,12,0,0
631656,2680,7,243,203,40,4,1,0
119585,1273,5,209,206,3,1,1,0
186356,1112,6,231,214,17,9,1,0
0,0,0,0,0,0,0,0,0
23176,40,0,3,1,2,0,1,0
0,0,0,0,0,0,0,0,0
155516,1162,5,252,224,28,24,0,0
612292,5390,8,666,651,15,216,0,0
179093,1169,7,301,267,34,10,1,0
273235,2855,12,349,240,109,1,1,0
0,0,0,0,0,0,0,0,0
637631,3280,2,156,68,88,4,1,0
3442809,3138,7,494,487,7,26,1,0
0,0,0,0,0,0,0,0,0
485034,6059,1,998,997,1,182,1,0
178395,2015,7,351,319,32,13,1,0
0,0,0,0,0,0,0,0,0
42198,484,0,261,257,4,0,1,0
11664,146,2,20,16,4,1,1,0
13173,199,6,16,16,0,1,0,0
7241,115,6,15,15,0,1,0,0
43799,721,0,143,132,11,0,0,0
0,0,0,0,0,0,0,0,0
121784,855,8,162,146,16,4,1,0
1576,11,0,1,1,0,0,0,0
667137,1216,11,201,196,5,35,1,0
597087,582,12,61,53,8,38,1,0
2169,38,2,5,4,1,0,1,0
0,0,0,0,0,0,0,0,0
280103,1978,5,361,350,11,10,1,0
1740471,1588,8,198,173,25,9,1,0
13177,185,5,18,16,2,1,1,0
440624,6976,4,2673,2597,76,36,1,0
11287,111,6,9,8,1,0,1,0
955183,1479,9,216,191,25,23,1,0
66189,389,4,79,68,11,3,1,0
0,0,0,0,0,0,0,0,0
700097,138,2,0,0,0,0,1,0
607520,1960,1,49,46,3,11,1,0
326103,1325,7,99,81,18,53,0,0
175709,606,11,7,4,3,5,0,0
193897,1360,3,205,196,9,0,1,0
674822,2452,4,820,812,8,8,1,0
189357,974,6,92,75,17,14,1,0
0,0,0,0,0,0,0,0,0
3125105,13645,6,1044,1005,39,5,1,0
326698,2357,12,63,10,53,11,1,0
853738,2733,10,323,68,255,60,1,0
0,0,0,0,0,0,0,0,0
66279,528,6,28,24,4,29,1,0
73106,483,7,89,78,11,3,1,0
199577,1376,3,165,145,20,30,1,0
82013,214,4,6,6,0,2,0,0
221321,3542,12,627,624,3,8,1,0
31001,260,8,30,23,7,6,1,0
0,0,0,0,0,0,0,0,0
0,0,0,0,0,0,0,0,0
271260,2392,4,616,527,89,1,0,1
299590,819,4,100,85,15,0,1,0
8412,79,4,3,2,1,0,0,0
14414,213,2,19,14,5,2,0,0
105032,1585,5,394,389,5,47,1,0
25550,277,3,59,51,8,3,1,0
7649755,3603,4,105,96,9,221,1,0
35535,119,0,3,2,1,0,0,0
336033,3478,1,985,972,13,7,1,0
18945,322,1,88,72,16,1,1,0
351041,1825,9,122,112,10,27,1,0
45977,263,5,22,12,10,0,1,0
175060,1724,7,410,365,45,6,1,0
898051,5268,8,251,241,10,16,1,0
744180,3204,7,14,10,4,13,1,0
57215,546,1,121,121,0,0,1,0
104988,565,0,59,3,56,48,1,0
238620,1049,7,202,168,34,14,1,0
82894,1033,5,83,78,5,2,0,0
0,0,0,0,0,0,0,0,0
0,0,0,0,0,0,0,0,0
1480113,2233,9,230,197,33,8,1,0
74946,523,0,89,87,2,1,1,0
0,0,0,0,0,0,0,0,0
1014021,1204,6,112,96,16,28,1,0
136280,1444,3,278,271,7,32,1,0
2680,36,0,1,1,0,0,0,0
237628,1266,9,123,85,38,117,0,0
597421,1487,0,149,145,4,2,1,1
273345,134,1,8,5,3,1,1,1
156385,842,8,100,96,4,14,1,0
453510,2319,6,300,204,96,53,1,0
315498,5723,0,1822,673,1149,2,0,0
5563,94,0,14,14,0,1,1,0
183031,1352,8,251,211,40,2,1,0
1125123,3473,4,976,953,23,2,1,0
0,0,0,0,0,0,0,0,0
197810,1948,7,318,287,31,40,1,0
24848,185,1,28,22,6,3,1,0
0,0,0,0,0,0,0,0,0
0,0,0,0,0,0,0,0,0
0,0,0,0,0,0,0,0,0
0,0,0,0,0,0,0,0,0
161851,1759,8,280,276,4,8,1,0
7961,130,3,14,9,5,2,1,0
366185,1071,12,15,15,0,74,0,0
0,0,0,0,0,0,0,0,0
43843,288,2,31,14,17,9,0,0
201695,1351,3,158,148,10,5,0,0
142596,506,5,78,68,10,1,1,0
50939,148,1,11,0,11,0,1,0
314170,2058,3,118,77,41,2,1,0
0,0,0,0,0,0,0,0,0
0,0,0,0,0,0,0,0,0
0,0,0,0,0,0,0,0,0
126295,1510,7,392,371,21,16,1,0
237361,4156,6,1288,1254,34,13,0,0
7638,40,0,1,1,0,0,0,0
0,0,0,0,0,0,0,0,0
203313,1104,10,135,117,18,24,1,0
0,0,0,0,0,0,0,0,0
146463,721,3,72,57,15,1,1,0
0,0,0,0,0,0,0,0,0
201801,2232,3,665,645,20,9,1,0
0,0,0,0,0,0,0,0,0
0,0,0,0,0,0,0,0,0
0,0,0,0,0,0,0,0,0
201347,1473,3,192,161,31,0,0,0
9173,100,0,6,6,0,0,0,0
0,0,0,0,0,0,0,0,0
0,0,0,0,0,0,0,0,0
5545,58,2,2,2,0,3,0,0
0,0,0,0,0,0,0,0,0
0,0,0,0,0,0,0,0,0
227190,2051,7,408,275,133,9,1,0
0,0,0,0,0,0,0,0,0
1666190,5165,12,529,500,29,27,1,0
0,0,0,0,0,0,0,0,0
171390,888,3,108,106,2,1,1,0
0,0,0,0,0,0,0,0,0
0,0,0,0,0,0,0,0,0
150604,597,6,107,95,12,0,1,0
51232,189,9,10,8,2,3,0,0
0,0,0,0,0,0,0,0,0
681388,3590,6,852,793,59,4,1,0
51088,122,8,4,0,4,3,0,0
366284,1740,2,282,282,0,1,1,0
9371,114,2,11,11,0,3,1,0
33331,394,9,83,77,6,1,1,0
0,0,0,0,0,0,0,0,0
913267,2916,10,662,653,9,30,1,0
65740,290,2,13,8,5,6,1,0
28551,45,0,4,1,3,0,0,0
0,0,0,0,0,0,0,0,0
352124,1765,7,250,243,7,9,1,0
0,0,0,0,0,0,0,0,0
0,0,0,0,0,0,0,0,0
619908,1129,6,78,46,32,10,1,0
143647,197,6,4,4,0,9,1,0
41778,260,0,42,30,12,0,1,0
30838,370,1,82,65,17,0,1,0
263359,907,4,145,8,137,2,1,0
264967,747,4,142,115,27,9,1,0
184089,968,10,203,168,35,12,1,0
14124,173,4,12,8,4,5,1,0
7256,84,4,7,7,0,0,1,0
40622,448,5,123,123,0,3,0,0
183057,1438,11,172,117,55,11,1,0
422289,2606,8,199,86,113,63,0,0
360843,394,2,49,42,7,1,0,0
343044,1764,3,366,351,15,11,1,0
1636391,3230,6,305,192,113,30,1,0
0,0,0,0,0,0,0,0,0
793484,5971,3,1338,1268,70,30,1,0
139915,1001,0,111,95,16,13,1,0
77981,669,11,85,78,7,4,1,0
10455,135,6,24,18,6,2,1,0
0,0,0,0,0,0,0,0,0
5852759,326,1,12,6,6,1,1,0
5852759,326,1,12,10,2,1,1,0
231841,340,0,17,8,9,0,1,0
107608,1064,5,201,200,1,1,1,0
0,0,0,0,0,0,0,0,0
955231,1296,7,96,90,6,70,1,0
0,0,0,0,0,0,0,0,0
257897,201,2,16,15,1,1,1,0
263478,101,2,8,8,0,3,0,0
0,0,0,0,0,0,0,0,0
69176,2039,2,571,566,5,2,1,0
0,0,0,0,0,0,0,0,0
182188,386,10,34,31,3,0,1,0
429894,3086,8,309,298,11,15,1,0
0,0,0,0,0,0,0,0,0
0,0,0,0,0,0,0,0,0
0,0,0,0,0,0,0,0,0
147237,1818,6,404,89,315,9,1,1
0,0,0,0,0,0,0,0,0
31844,79,4,0,0,0,2,1,0
79981,833,11,104,11,93,0,1,0
17528,56,1,0,0,0,0,0,0
4688011,19397,11,5601,5600,1,493,1,0
0,0,0,0,0,0,0,0,0
120811,816,8,150,134,16,2,1,0
657411,1206,3,143,129,14,1,0,0
0,0,0,0,0,0,0,0,0
0,0,0,0,0,0,0,0,0
0,0,0,0,0,0,0,0,0
75897,1603,2,411,395,16,1,0,0
278529,1449,6,121,94,27,9,1,0
1232367,2400,6,5,4,1,6,0,0
208631,2438,2,783,773,10,2,0,0
313155,985,9,154,144,10,17,0,0
154664,587,7,97,95,2,5,0,0
182099,3052,2,648,187,461,10,1,0
0,0,0,0,0,0,0,0,0
0,0,0,0,0,0,0,0,0
0,0,0,0,0,0,0,0,0
272989,1111,3,131,102,29,4,0,0
0,0,0,0,0,0,0,0,0
126481,1475,4,200,190,10,4,1,0
126481,1475,4,200,188,12,4,1,0
160083,692,3,146,130,16,1,1,0
82424,213,4,6,6,0,2,0,0
178636,2524,8,518,496,22,8,1,0
41264,293,8,51,45,6,6,1,0
0,0,0,0,0,0,0,0,0
293237,1904,8,355,304,51,3,1,0
132836,2181,2,449,435,14,30,1,0
6481,115,0,3,3,0,0,1,0
0,0,0,0,0,0,0,0,0
0,0,0,0,0,0,0,0,0
383333,2391,4,301,285,16,10,1,0
127133,2351,2,485,475,10,9,1,0
16010,235,0,59,54,5,2,1,0
63901,999,5,95,76,19,13,0,0
13850,83,1,4,4,0,1,1,0
0,0,0,0,0,0,0,0,0
201295,541,10,61,61,0,24,1,0
653703,1624,5,137,100,37,6,1,0
64785,730,8,93,86,7,4,1,0
19359,209,8,36,30,6,4,1,0
193864,1586,6,399,399,0,7,1,0
334600,1283,9,104,84,20,2,1,0
514372,1334,3,141,124,17,4,1,0
15164,101,2,7,7,0,0,0,0
17949,332,2,72,40,32,3,1,0
554585,4348,12,698,510,188,326,0,0
33921,127,4,5,3,2,1,0,0
27999,540,6,144,142,2,0,1,0
7553,95,6,10,9,1,0,1,0
2265,37,1,2,0,2,0,1,0
0,0,0,0,0,0,0,0,0
148198,1457,2,68,54,14,1,0,0
235840,1926,4,321,309,12,8,1,0
37268,308,2,4,4,0,2,0,0
216576,847,3,79,65,14,1,1,0
62439,259,2,5,5,0,1,0,0
139155,1825,3,401,16,385,1,0,0
164306,3093,2,627,627,0,5,0,0
121496,946,6,105,64,41,6,0,0
0,0,0,0,0,0,0,0,0
63464,1395,3,209,198,11,1,1,0
19225,268,2,30,24,6,1,1,0
210383,540,18,80,74,6,21,0,0
251066,1991,5,277,195,82,33,1,0
140208,1007,5,135,130,5,24,1,0
74236,716,10,214,189,25,1,1,0
181092,1721,4,319,252,67,13,0,0
688200,5228,3,971,959,12,8,1,0
521395,3589,4,838,826,12,9,1,0
81322,1285,1,333,322,11,8,1,0
7698,52,0,6,1,5,0,0,0
0,0,0,0,0,0,0,0,0
0,0,0,0,0,0,0,0,0
433859,1869,7,185,138,47,9,1,0
64033,1698,3,750,254,496,0,1,0
397321,7079,1,1400,930,470,5,0,0
511674,2910,14,378,340,38,46,0,0
0,0,0,0,0,0,0,0,0
229084,1715,6,390,355,35,2,1,0
0,0,0,0,0,0,0,0,0
0,0,0,0,0,0,0,0,0
0,0,0,0,0,0,0,0,0
186430,900,1,195,162,33,8,1,0
72307,390,4,60,47,13,2,1,0
0,0,0,0,0,0,0,0,0
0,0,0,0,0,0,0,0,0
7035,120,4,14,7,7,0,1,0
0,0,0,0,0,0,0,0,0
917398,2733,8,781,776,5,9,1,0
22949,61,1,2,2,0,0,0,0
482340,2978,2,285,268,17,0,1,0
51191,506,8,104,93,11,2,1,0
44358,129,5,1,1,0,2,0,0
228128,1376,6,138,117,21,4,1,0
0,0,0,0,0,0,0,0,0
182534,1750,6,157,135,22,5,1,0
67185,248,5,17,13,4,4,1,0
0,0,0,0,0,0,0,0,0
30621,353,5,38,13,25,10,0,0
7322,99,5,13,12,1,0,0,0
470154,716,7,70,59,11,4,1,0
420759,328,1,16,10,6,3,1,0
285892,2484,7,627,612,15,1,1,0
0,0,0,0,0,0,0,0,0
22923,263,0,83,81,2,0,1,0
1278074,2032,3,349,334,15,6,1,0
0,0,0,0,0,0,0,0,0
0,0,0,0,0,0,0,0,0
871766,3271,2,99,78,21,0,1,0
0,0,0,0,0,0,0,0,0
0,0,0,0,0,0,0,0,0
1255949,4788,6,1021,979,42,13,1,0
349173,634,5,142,112,30,10,1,0
431039,2097,16,322,305,17,3,1,0
65236,427,4,72,66,6,0,1,0
398574,426,3,62,56,6,2,1,0
51470,671,2,148,148,0,6,1,0
47480,207,1,22,22,0,6,1,0
0,0,0,0,0,0,0,0,0
123056,629,10,85,73,12,2,1,0
738220,2374,10,292,202,90,6,0,0
120968,672,8,127,120,7,3,1,0
16995,125,6,7,5,2,4,0,0
0,0,0,0,0,0,0,0,0
22338,451,2,89,89,0,4,1,0
15315,270,2,41,41,0,4,1,0
5513,46,0,0,0,0,0,0,0
49499,553,6,117,97,20,1,0,0
0,0,0,0,0,0,0,0,0
80150,385,1,55,53,2,1,0,0
17770,79,1,9,9,0,0,0,0
84380,814,2,202,170,32,1,1,1
29566,302,4,73,36,37,2,1,0
1958835,1960,3,142,108,34,3,1,0
0,0,0,0,0,0,0,0,0
27810,42,0,2,1,1,0,0,0
0,0,0,0,0,0,0,0,0
0,0,0,0,0,0,0,0,0
182216,2674,8,384,361,23,2,1,0
89807,1370,1,185,177,8,3,1,0
483602,2957,6,712,708,4,1,1,0
15801,77,1,3,3,0,0,0,0
0,0,0,0,0,0,0,0,0
0,0,0,0,0,0,0,0,0
588781,6123,3,676,521,155,16,1,0
470065,3334,2,296,295,1,2,1,0
87702,755,8,113,108,5,8,1,0
170041,193,7,28,25,3,1,1,0
10963,125,1,29,26,3,0,1,0
36993,525,2,20,20,0,1,1,0
170129,1521,2,258,161,97,3,1,0
11604,85,0,4,4,0,0,0,0
0,0,0,0,0,0,0,0,0
0,0,0,0,0,0,0,0,0
351062,4029,4,1128,370,758,8,1,0
0,0,0,0,0,0,0,0,0
72877,311,4,29,27,2,0,0,0
280607,1940,11,383,360,23,33,0,0
0,0,0,0,0,0,0,0,0
0,0,0,0,0,0,0,0,0
147533,1029,6,228,218,10,4,1,0
7746,29,0,1,1,0,1,0,0
252484,2778,9,368,308,60,23,1,0
0,0,0,0,0,0,0,0,0
2188188,2634,5,644,634,10,2,1,0
2099497,1944,6,451,441,10,4,1,0
344002,1620,2,180,173,7,7,1,0
798520,6324,10,1613,1607,6,8,1,0
145470,1289,2,269,28,241,8,1,0
0,0,0,0,0,0,0,0,0
163192,1200,4,166,130,36,1,1,0
0,0,0,0,0,0,0,0,0
0,0,0,0,0,0,0,0,0
78585,1260,2,333,303,30,4,1,0
75208,1000,5,273,220,53,3,1,0
201353,1184,8,272,180,92,29,1,0
178866,1001,8,136,90,46,30,1,0
0,0,0,0,0,0,0,0,0
638184,823,5,89,79,10,10,1,0
0,0,0,0,0,0,0,0,0
152427,1975,6,318,307,11,0,1,0
87016,1240,6,190,185,5,0,1,0
627918,1132,5,67,61,6,3,1,0
0,0,0,0,0,0,0,0,0
53804,546,4,54,47,7,2,1,0
34750,275,2,36,29,7,1,1,0
394334,751,8,117,111,6,8,1,0
0,0,0,0,0,0,0,0,0
0,0,0,0,0,0,0,0,0
0,0,0,0,0,0,0,0,0
126121,1478,5,121,102,19,3,1,0
47110,132,8,3,0,3,0,1,0
1689921,955,10,238,221,17,2,1,0
0,0,0,0,0,0,0,0,0
27677,42,0,2,1,1,0,0,0
126762,1347,8,197,189,8,19,1,0
79154,820,11,195,179,16,12,1,0
172725,1630,12,333,290,43,12,1,0
17647,110,5,8,8,0,0,1,0
0,0,0,0,0,0,0,0,0
0,0,0,0,0,0,0,0,0
351592,2797,5,414,396,18,9,1,0
116820,385,5,9,8,1,6,1,0
437126,1934,16,191,171,20,25,1,0
0,0,0,0,0,0,0,0,0
653052,2311,10,327,301,26,22,1,0
642240,2113,9,305,278,27,22,1,0
0,0,0,0,0,0,0,0,0
0,0,0,0,0,0,0,0,0
101478,814,6,217,21,196,10,1,0
374525,2313,6,273,143,130,20,0,0
2091035,7994,7,1643,1577,66,19,1,0
332762,922,7,41,31,10,17,1,0
722993,4941,6,681,681,0,12,1,0
288174,1854,12,397,388,9,7,1,0
218791,1637,12,354,347,7,7,1,0
71037,609,3,29,28,1,0,1,0
0,0,0,0,0,0,0,0,0
2240233,16298,3,2077,1481,596,11,1,0
28774,43,3,0,0,0,0,0,0
28774,43,3,0,0,0,0,0,0
0,0,0,0,0,0,0,0,0
0,0,0,0,0,0,0,0,0
0,0,0,0,0,0,0,0,0
0,0,0,0,0,0,0,0,0
69412,512,4,123,102,21,4,1,0
20305,121,2,15,11,4,0,0,0
670131,5621,3,782,738,44,28,0,0
229139,2104,4,419,128,291,22,0,0
0,0,0,0,0,0,0,0,0
0,0,0,0,0,0,0,0,0
0,0,0,0,0,0,0,0,0
59320,418,4,74,73,1,4,1,0
848326,8596,4,1287,1262,25,1,0,0
29473,310,2,21,19,2,6,1,0
0,0,0,0,0,0,0,0,0
415104,1494,3,276,209,67,15,1,0
0,0,0,0,0,0,0,0,0
290772,1069,9,159,112,47,7,0,0
0,0,0,0,0,0,0,0,0
221988,1485,4,505,486,19,0,0,0
397304,2801,7,827,683,144,18,1,0
0,0,0,0,0,0,0,0,0
14799,89,1,2,2,0,0,0,0
0,0,0,0,0,0,0,0,0
422809,2415,7,258,231,27,3,0,0
693610,3419,5,870,842,28,2,1,0
696923,3387,4,863,837,26,2,1,0
135092,1205,4,155,130,25,14,1,0
92468,1041,2,60,33,27,2,1,0
776822,4679,5,685,678,7,11,1,0
125205,261,5,29,28,1,5,1,0
410494,2955,19,867,752,115,50,1,1
37259,419,8,81,64,17,1,1,0
0,0,0,0,0,0,0,0,0
660471,3959,3,892,215,677,2,1,0
184185,850,8,163,149,14,34,1,0
0,0,0,0,0,0,0,0,0
22451,190,3,32,27,5,2,1,0
65641,1006,4,158,124,34,16,1,0
0,0,0,0,0,0,0,0,0
1976275,7313,11,722,440,282,56,0,0
406340,639,8,58,53,5,4,1,0
0,0,0,0,0,0,0,0,0
0,0,0,0,0,0,0,0,0
0,0,0,0,0,0,0,0,0
251250,3795,2,839,838,1,2,1,0
0,0,0,0,0,0,0,0,0
211127,3087,2,878,838,40,11,0,0
24016,141,1,17,16,1,2,0,0
596000,2965,3,356,333,23,2,1,0
3874,51,1,5,5,0,0,0,0
75493,72,0,4,3,1,0,1,0
397165,2801,7,827,678,149,18,1,0
294169,1550,2,303,297,6,2,1,0
814136,6696,5,1398,1340,58,58,1,0
813717,6690,5,1398,1340,58,59,1,0
0,0,0,0,0,0,0,0,0
1167905,3277,5,251,227,24,61,1,0
7597,89,5,14,14,0,0,1,0
491050,4156,8,304,286,18,28,1,0
19423,41,2,0,0,0,0,0,0
181445,634,3,110,97,13,2,1,0
1097,21,0,3,2,1,0,1,0
1393067,18994,3,6865,6743,122,32,0,0
1393067,18994,3,6865,6743,122,32,0,0
30427,131,1,24,24,0,1,1,0
33420,57,0,5,5,0,1,1,0
172994,1306,8,231,224,7,19,1,0
0,0,0,0,0,0,0,0,0
569961,1184,6,241,227,14,140,1,0
11313,142,0,9,6,3,0,1,0
0,0,0,0,0,0,0,0,0
0,0,0,0,0,0,0,0,0
0,0,0,0,0,0,0,0,0
5243,76,7,0,0,0,0,0,0
69380,325,9,56,47,9,7,1,0
0,0,0,0,0,0,0,0,0
480437,2136,5,356,316,40,7,1,0
0,0,0,0,0,0,0,0,0
0,0,0,0,0,0,0,0,0
0,0,0,0,0,0,0,0,0
87521,1154,2,419,258,161,4,1,0
0,0,0,0,0,0,0,0,0
314605,392,5,13,9,4,0,0,0
97826,828,9,205,203,2,1,1,0
23209,186,4,37,36,1,0,0,0
30837,94,1,0,0,0,0,0,0
102218,1504,6,316,274,42,3,0,0
46778,205,0,75,73,2,0,0,0
0,0,0,0,0,0,0,0,0
375842,919,5,63,54,9,8,1,0
393527,1083,5,64,55,9,7,1,0
194680,1099,3,288,282,6,10,1,0
30058,302,4,92,91,1,2,1,0
15513,110,3,16,15,1,0,1,0
276289,670,2,47,44,3,0,1,0
23704,69,1,2,2,0,0,0,0
803064,2225,3,355,339,16,4,1,0
0,0,0,0,0,0,0,0,0
225001,1841,6,594,583,11,6,1,0
842703,2448,17,553,495,58,49,1,0
22642,34,0,1,1,0,0,1,0
46510,411,1,90,85,5,10,1,0
0,0,0,0,0,0,0,0,0
62603,541,4,76,70,6,10,1,0
14056,86,4,1,1,0,3,0,0
285915,2002,5,279,198,81,2,1,0
163106,1142,4,224,199,25,24,1,0
254289,674,10,72,70,2,13,1,0
37754,171,11,3,3,0,13,0,0
0,0,0,0,0,0,0,0,0
0,0,0,0,0,0,0,0,0
0,0,0,0,0,0,0,0,0
1340819,3097,4,273,258,15,9,1,0
556593,3107,9,748,735,13,3,0,0
0,0,0,0,0,0,0,0,0
208156,1428,5,317,311,6,3,1,0
42893,402,1,60,49,11,1,0,0
101195,1490,4,373,367,6,1,0,1
7616,74,3,9,9,0,0,0,0
1263895,3211,4,225,191,34,116,1,0
311500,1085,8,113,104,9,12,1,0
205480,876,7,6,6,0,2,0,0
0,0,0,0,0,0,0,0,0
0,0,0,0,0,0,0,0,0
0,0,0,0,0,0,0,0,0
784765,2211,4,423,417,6,7,1,0
168136,1792,1,322,318,4,2,0,0
494725,6496,3,824,823,1,3,1,0
472486,1452,3,152,96,56,1,1,0
21107,379,2,111,88,23,1,1,0
231215,690,3,45,38,7,0,1,0
106395,1197,5,181,172,9,12,1,0
36331,271,5,34,29,5,14,1,0
373682,3064,3,269,238,31,25,1,1
39186,308,1,94,73,21,2,1,0
0,0,0,0,0,0,0,0,0
0,0,0,0,0,0,0,0,0
623480,2747,4,402,221,181,23,0,0
89086,261,0,48,24,24,0,1,1
176905,1428,8,298,295,3,17,1,0
112821,1739,4,390,387,3,1,1,0
188730,2221,6,325,211,114,5,1,0
0,0,0,0,0,0,0,0,0
0,0,0,0,0,0,0,0,0
20925,152,10,22,17,5,0,1,0
241942,1652,1,272,261,11,0,1,0
0,0,0,0,0,0,0,0,0
618746,4322,10,235,219,16,18,1,0
270697,569,11,35,17,18,14,0,0
389686,2768,3,347,326,21,13,1,0
352775,1622,5,269,247,22,3,1,0
661778,1301,7,54,43,11,5,1,0
567958,3090,7,525,420,105,6,1,0
567958,3090,7,525,420,105,6,1,0
454593,2151,7,526,451,75,6,1,0
0,0,0,0,0,0,0,0,0
0,0,0,0,0,0,0,0,0
0,0,0,0,0,0,0,0,0
76853,755,5,79,52,27,8,1,0
41791,206,6,41,39,2,0,1,0
85690,748,5,88,69,19,0,0,0
685500,522,0,5,2,3,2,1,1
525193,2802,3,664,651,13,14,1,0
33572,116,2,8,8,0,0,0,0
178365,1825,7,427,408,19,30,1,0
0,0,0,0,0,0,0,0,0
541183,163,5,20,0,20,0,1,0
236033,4262,4,735,593,142,0,0,0
84502,1229,4,272,198,74,0,0,0
0,0,0,0,0,0,0,0,0
790706,1758,4,361,358,3,1,1,0
0,0,0,0,0,0,0,0,0
95040,432,4,46,40,6,2,1,0
0,0,0,0,0,0,0,0,0
158862,1020,0,334,240,94,1,1,0
390176,1299,2,186,171,15,2,1,0
217373,200,5,10,10,0,1,1,0
780328,1339,8,194,137,57,7,1,0
767170,1272,8,187,130,57,7,1,0
58157,619,1,113,113,0,0,1,0
0,0,0,0,0,0,0,0,0
645567,5113,2,880,867,13,0,1,0
0,0,0,0,0,0,0,0,0
41489,792,5,142,137,5,8,1,0
14505,94,3,4,4,0,4,0,0
47736,685,6,52,45,7,2,1,0
0,0,0,0,0,0,0,0,0
0,0,0,0,0,0,0,0,0
290877,1756,5,192,177,15,2,0,0
328480,1623,5,87,79,8,2,0,0
241019,1123,5,180,171,9,16,1,0
1496045,151,2,11,11,0,0,1,0
0,0,0,0,0,0,0,0,0
0,0,0,0,0,0,0,0,0
0,0,0,0,0,0,0,0,0
1484052,2232,1,286,267,19,1,1,0
45448,248,2,25,20,5,3,1,0
0,0,0,0,0,0,0,0,0
95601,1149,3,173,156,17,3,1,0
320275,1772,6,178,134,44,7,1,0
209501,2121,5,239,234,5,5,1,0
0,0,0,0,0,0,0,0,0
493678,2165,0,182,180,2,50,1,0
0,0,0,0,0,0,0,0,0
128192,1045,11,252,113,139,14,1,0
297609,811,1,213,178,35,2,0,0
66849,249,0,46,24,22,0,1,1
66847,249,0,46,39,7,0,1,1
0,0,0,0,0,0,0,0,0
21892,35,0,1,1,0,0,1,0
40047,278,2,34,17,17,9,0,0
0,0,0,0,0,0,0,0,0
320278,1529,18,256,195,61,5,1,0
120949,773,16,156,150,6,5,1,0
813142,1381,2,181,154,27,12,1,0
130398,376,2,30,25,5,13,1,0
849212,2392,15,307,269,38,22,1,0
0,0,0,0,0,0,0,0,0
605248,592,5,96,95,1,0,1,0
956261,663,6,45,1,44,1,1,0
3955,63,0,9,9,0,0,1,0
0,0,0,0,0,0,0,0,0
53818,91,5,10,2,8,2,1,0
204481,2013,1,277,262,15,58,1,0
232121,1232,1,226,211,15,4,1,0
445716,5180,3,1301,1288,13,12,1,0
24498,381,8,115,88,27,0,1,0
0,0,0,0,0,0,0,0,0
400422,2492,4,445,424,21,0,1,0
266927,2216,6,578,531,47,1,1,0
8657,71,6,3,2,1,0,0,0
68577,283,2,9,8,1,1,1,0
156937,1780,3,309,292,17,8,1,0
28711,190,4,16,11,5,11,1,0
1495317,5455,2,570,544,26,1,1,0
154792,1596,8,313,194,119,21,1,0
358456,1013,7,69,60,9,5,1,0
318112,1313,7,191,174,17,6,1,0
183179,213,7,10,9,1,4,1,0
0,0,0,0,0,0,0,0,0
47436,227,7,39,38,1,0,1,0
48077,307,7,38,37,1,0,1,0
1176039,1747,13,150,123,27,2,1,0
0,0,0,0,0,0,0,0,0
51115,44,3,0,0,0,0,0,0
113646,549,2,89,73,16,7,1,0
0,0,0,0,0,0,0,0,0
647357,2377,15,246,192,54,26,1,0
42332,579,2,11,2,9,1,0,0
258011,888,3,87,75,12,5,1,0
0,0,0,0,0,0,0,0,0
61175,340,3,69,65,4,22,0,0
473746,1018,2,106,90,16,14,0,0
0,0,0,0,0,0,0,0,0
0,0,0,0,0,0,0,0,0
74468,921,2,258,251,7,9,1,0
0,0,0,0,0,0,0,0,0
91059,657,9,69,59,10,12,1,0
51901,143,2,108,107,1,0,0,0
22013,35,0,1,1,0,0,1,0
230422,338,0,17,8,9,0,1,0
412542,3191,5,640,23,617,2,1,0
394502,1762,13,137,122,15,39,1,0
537642,4730,2,764,753,11,2,1,0
422791,1915,1,251,204,47,2,1,0
1857927,2532,13,158,140,18,34,1,0
1326255,284,0,0,0,0,0,0,0
732942,2398,9,656,644,12,67,1,0
230405,338,0,17,14,3,0,1,0
7332,83,2,11,6,5,0,0,0
145975,657,15,128,128,0,31,1,0
191106,2372,3,301,269,32,5,1,0
92603,827,2,165,157,8,2,1,0
170896,714,2,131,120,11,2,1,0
23671,191,3,22,15,7,0,1,0
0,0,0,0,0,0,0,0,0
417964,1528,11,139,113,26,32,1,0
0,0,0,0,0,0,0,0,0
0,0,0,0,0,0,0,0,0
0,0,0,0,0,0,0,0,0
0,0,0,0,0,0,0,0,0
0,0,0,0,0,0,0,0,0
673400,1257,2,246,228,18,5,1,0
1187203,2606,12,575,544,31,14,1,0
749403,2008,11,460,437,23,9,1,0
90575,1080,1,195,171,24,9,1,0
20772,265,1,88,85,3,0,1,0
76164,765,0,109,85,24,0,1,0
0,0,0,0,0,0,0,0,0
153834,1183,6,259,248,11,5,1,0
152497,1199,8,284,244,40,8,1,0
2330,56,0,3,3,0,0,0,0
545056,5483,0,2408,2321,87,8,1,0
29711,187,1,30,28,2,1,1,0
32957,64,3,0,0,0,1,0,0
2607370,5387,9,156,116,40,23,1,0
40264,142,6,3,1,2,3,0,0
73302,834,11,191,150,41,5,1,0
132685,2222,3,805,804,1,14,1,0
9996,166,2,39,38,1,4,1,0
0,0,0,0,0,0,0,0,0
0,0,0,0,0,0,0,0,0
112497,621,3,77,70,7,6,1,0
126595,178,0,6,5,1,0,1,0
0,0,0,0,0,0,0,0,0
0,0,0,0,0,0,0,0,0
416706,6138,7,1311,1244,67,148,1,0
0,0,0,0,0,0,0,0,0
129812,1240,9,215,212,3,14,1,0
0,0,0,0,0,0,0,0,0
85801,638,0,135,134,1,0,0,0
45088,488,4,63,63,0,33,1,0
37035,292,4,29,29,0,30,1,0
240873,3000,3,815,815,0,6,1,0
0,0,0,0,0,0,0,0,0
772724,1576,7,357,339,18,6,1,0
1040773,3189,4,453,438,15,110,1,0
73190,741,1,168,155,13,0,1,1
93723,1392,3,335,317,18,6,0,0
507932,3500,4,630,610,20,23,1,0
281551,2328,7,523,456,67,7,0,0
0,0,0,0,0,0,0,0,0
220441,1196,0,145,119,26,4,1,0
0,0,0,0,0,0,0,0,0
0,0,0,0,0,0,0,0,0
0,0,0,0,0,0,0,0,0
56940,480,2,113,97,16,2,1,0
33567,119,2,8,5,3,3,0,0
3667977,3579,5,384,282,102,5,1,0
643085,2735,5,217,207,10,7,1,0
0,0,0,0,0,0,0,0,0
185686,517,6,93,91,2,19,1,0
600631,3212,8,627,617,10,26,1,0
0,0,0,0,0,0,0,0,0
62850,211,4,33,33,0,0,1,0
0,0,0,0,0,0,0,0,0
0,0,0,0,0,0,0,0,0
69641,784,2,298,275,23,2,0,0
104499,469,3,98,97,1,9,1,0
703137,6524,10,2420,2386,34,65,1,0
92953,1329,3,3,3,0,7,0,0
0,0,0,0,0,0,0,0,0
138093,873,7,137,127,10,14,1,0
0,0,0,0,0,0,0,0,0
876424,1936,8,190,85,105,14,1,0
92739,1002,2,166,152,14,3,1,0
216127,1854,4,209,163,46,1,1,0
40945,237,3,8,7,1,1,1,0
888195,2441,1,251,245,6,0,0,0
12159,118,0,11,8,3,0,0,0
0,0,0,0,0,0,0,0,0
0,0,0,0,0,0,0,0,0
6779,127,0,38,19,19,0,0,0
0,0,0,0,0,0,0,0,0
632394,1862,8,245,230,15,19,1,0
126115,1296,15,287,280,7,8,1,0
85149,760,15,132,120,12,9,1,0
0,0,0,0,0,0,0,0,0
228878,339,0,17,9,8,0,1,0
242870,1139,2,130,126,4,0,1,0
45039,168,2,3,3,0,0,0,0
128516,1681,3,289,285,4,3,1,0
49728,689,3,145,113,32,1,1,0
10119,71,3,5,5,0,0,0,0
104659,370,3,76,67,9,2,1,0
22956,227,3,42,28,14,2,1,0
269292,1064,9,183,159,24,6,1,0
149015,1930,5,786,776,10,28,0,0
30039,226,4,43,33,10,4,0,0
441965,3925,5,449,430,19,6,1,0
616982,1579,2,357,349,8,43,1,0
15983,274,1,77,74,3,3,1,0
2162808,1522,8,75,69,6,18,1,0
4385,97,2,12,12,0,0,0,0
0,0,0,0,0,0,0,0,0
0,0,0,0,0,0,0,0,0
228356,334,0,16,3,13,0,1,0
0,0,0,0,0,0,0,0,0
57869,533,8,85,79,6,0,1,0
73057,700,7,68,62,6,5,1,0
332623,1611,15,378,354,24,22,1,0
0,0,0,0,0,0,0,0,0
51886,480,1,89,61,28,19,1,0
4167,30,1,1,1,0,0,0,0
155404,1138,3,119,112,7,0,1,0
19837,108,1,3,1,2,0,0,0
432051,1108,6,234,234,0,0,1,1
82818,1028,0,247,26,221,4,0,0
5223,26,0,1,1,0,0,0,0
43893,695,6,235,232,3,0,1,0
2081,35,0,3,2,1,0,0,0
0,0,0,0,0,0,0,0,0
0,0,0,0,0,0,0,0,0
384812,8347,3,153,152,1,1,0,0
11383,270,3,41,38,3,2,0,0
79612,356,4,61,57,4,1,1,0
384406,1411,10,192,169,23,25,1,0
0,0,0,0,0,0,0,0,0
722874,1923,3,227,219,8,2,1,0
60583,180,2,36,19,17,0,1,0
0,0,0,0,0,0,0,0,0
126482,1447,2,328,323,5,9,0,0
89298,1096,2,292,287,5,9,0,0
17977,87,7,1,1,0,5,0,0
18284,104,7,7,7,0,5,0,0
108107,1425,4,268,260,8,8,1,0
0,0,0,0,0,0,0,0,0
324206,1985,5,313,305,8,11,0,0
26272,424,0,77,70,7,1,1,0
6933,78,0,12,10,2,1,0,0
0,0,0,0,0,0,0,0,0
0,0,0,0,0,0,0,0,0
171002,1347,2,236,214,22,3,0,0
266825,191,0,0,0,0,1,1,0
0,0,0,0,0,0,0,0,0
27215,318,4,58,57,1,0,0,0
18917,254,4,52,52,0,0,0,0
145647,1856,5,507,505,2,5,1,0
7097,88,3,17,17,0,1,0,0
309326,1821,5,485,451,34,5,1,0
158197,1532,9,346,318,28,14,1,0
0,0,0,0,0,0,0,0,0
326972,1440,4,256,243,13,3,1,0
0,0,0,0,0,0,0,0,0
806784,3099,6,489,487,2,1,1,0
733597,2903,7,472,470,2,1,1,0
34685,18,0,1,1,0,0,0,0
0,0,0,0,0,0,0,0,0
164856,1695,6,265,222,43,36,0,0
0,0,0,0,0,0,0,0,0
454511,1516,4,125,105,20,6,0,0
613672,4016,0,333,298,35,4,1,0
141623,722,3,82,59,23,41,1,0
0,0,0,0,0,0,0,0,0
173276,2548,5,513,507,6,4,1,0
367295,2493,0,300,294,6,12,1,0
86140,552,0,68,66,2,5,1,0
104834,982,1,220,215,5,2,1,0
19142,328,1,108,101,7,1,1,0
0,0,0,0,0,0,0,0,0
29683,61,2,3,0,3,0,0,0
184951,1228,7,305,300,5,21,1,0
106196,425,8,93,85,8,3,1,0
0,0,0,0,0,0,0,0,0
0,0,0,0,0,0,0,0,0
174426,787,5,57,54,3,9,1,0
0,0,0,0,0,0,0,0,0
0,0,0,0,0,0,0,0,0
0,0,0,0,0,0,0,0,0
213879,3324,13,443,421,22,10,1,0
63988,744,14,186,180,6,11,1,0
20990,260,3,9,8,1,0,1,0
391706,1458,1,103,99,4,1,1,0
385272,3468,7,813,797,16,13,1,0
47424,302,7,6,6,0,8,1,0
0,0,0,0,0,0,0,0,0
52069,502,3,88,86,2,6,1,0
7682,52,0,6,1,5,0,0,0
264218,1242,7,85,37,48,6,1,0
443198,955,1,101,99,2,1,1,0
131777,1703,9,364,344,20,0,0,0
0,0,0,0,0,0,0,0,0
0,0,0,0,0,0,0,0,0
0,0,0,0,0,0,0,0,0
0,0,0,0,0,0,0,0,0
277322,1968,9,443,405,38,27,0,0
167784,1211,5,108,95,13,19,1,0
167829,1210,5,108,94,14,19,1,0
0,0,0,0,0,0,0,0,0
310513,792,0,63,56,7,2,0,0
61048,606,5,143,134,9,7,0,0
0,0,0,0,0,0,0,0,0
0,0,0,0,0,0,0,0,0
147693,1092,4,307,306,1,1,1,0
39587,190,4,8,8,0,2,1,0
211404,2271,3,362,350,12,9,1,0
685567,522,0,5,2,3,2,1,1
138241,1061,2,301,298,3,8,0,0
921958,2627,4,307,275,32,161,1,0
23246,249,9,17,17,0,0,1,0
157776,882,6,202,197,5,0,1,0
59138,707,6,74,70,4,9,0,0
20012,262,6,43,36,7,0,0,0
90820,1472,1,480,480,0,2,1,0
84766,963,0,61,33,28,2,1,0
339707,3599,2,1244,390,854,31,1,0
384429,2934,0,298,11,287,2,1,0
35372,86,0,2,1,1,1,0,0
197768,1373,6,278,261,17,57,0,0
0,0,0,0,0,0,0,0,0
141565,1035,3,91,77,14,15,0,0
0,0,0,0,0,0,0,0,0
22062,35,0,1,1,0,0,1,0
222729,1818,9,323,319,4,9,1,0
161634,1203,11,239,231,8,10,1,0
0,0,0,0,0,0,0,0,0
0,0,0,0,0,0,0,0,0
0,0,0,0,0,0,0,0,0
19936,210,5,33,29,4,0,1,0
816044,2669,2,218,101,117,37,0,0
128192,754,5,244,242,2,4,1,0
0,0,0,0,0,0,0,0,0
70070,445,1,75,61,14,0,1,0
0,0,0,0,0,0,0,0,0
144017,1570,7,330,296,34,7,1,0
148393,1261,15,157,87,70,28,1,0
196802,2780,9,534,501,33,16,1,0
0,0,0,0,0,0,0,0,0
306992,828,8,87,81,6,6,1,0
106723,1184,1,214,183,31,3,1,0
34459,389,1,67,53,14,6,1,0
0,0,0,0,0,0,0,0,0
1841607,11863,8,3506,3500,6,1868,1,0
0,0,0,0,0,0,0,0,0
0,0,0,0,0,0,0,0,0
0,0,0,0,0,0,0,0,0
67138,872,3,20,14,6,20,0,0
266096,1439,4,144,110,34,16,0,0
159113,110,5,6,1,5,2,0,0
133423,1987,14,313,281,32,17,1,0
43867,319,5,50,45,5,1,1,0
0,0,0,0,0,0,0,0,0
0,0,0,0,0,0,0,0,0
0,0,0,0,0,0,0,0,0
202866,1704,5,225,215,10,3,1,0
140255,1268,5,255,229,26,5,1,0
103373,1798,2,469,365,104,2,1,0
443656,1801,3,266,236,30,13,1,0
413762,1439,3,288,253,35,4,1,1
209895,567,5,70,53,17,4,1,0
314136,3557,2,1333,1243,90,14,1,0
390401,3147,14,695,654,41,0,1,1
7346,75,1,9,7,2,0,1,0
0,0,0,0,0,0,0,0,0
218748,1088,14,260,238,22,8,1,0
193431,766,16,160,139,21,13,1,0
4668,39,1,0,0,0,0,0,0
91857,1336,4,303,303,0,5,1,0
516013,2217,11,423,109,314,13,0,0
359180,1792,7,140,118,22,8,1,0
0,0,0,0,0,0,0,0,0
0,0,0,0,0,0,0,0,0
467997,1370,0,386,376,10,0,1,0
62144,812,3,227,185,42,5,1,0
378940,1328,8,117,96,21,6,1,0
0,0,0,0,0,0,0,0,0
804535,5250,7,388,380,8,12,1,0
230168,565,5,72,19,53,8,1,0
177435,362,5,41,31,10,6,1,0
0,0,0,0,0,0,0,0,0
179141,2460,2,407,400,7,1,1,0
126341,1663,5,266,235,31,30,1,0
48327,166,1,44,31,13,4,1,0
39537,705,3,175,173,2,12,1,0
42552,441,4,119,99,20,5,1,0
4240,22,0,0,0,0,0,0,0
938515,5912,3,497,454,43,5,1,0
142077,1188,6,257,208,49,5,0,0
407974,3648,9,833,810,23,15,0,0
0,0,0,0,0,0,0,0,0
306561,1095,7,208,195,13,27,1,0
537681,3115,8,438,333,105,29,1,0
0,0,0,0,0,0,0,0,0
109442,1102,7,233,218,15,9,1,0
19729,203,5,24,24,0,2,1,0
421672,155,2,6,6,0,1,0,0
94442,766,7,225,212,13,1,1,0
28487,599,0,107,107,0,0,1,0
538753,5779,2,1218,1218,0,4,1,0
6643,71,7,1,1,0,0,0,0
28595,45,0,4,1,3,0,0,0
0,0,0,0,0,0,0,0,0
54980,328,0,35,12,23,0,0,0
269723,1372,12,160,150,10,37,1,0
755277,1683,5,121,75,46,0,1,0
148095,1301,5,318,284,34,6,0,0
0,0,0,0,0,0,0,0,0
270154,648,5,203,189,14,15,1,0
43292,340,8,64,50,14,20,1,0
157276,287,1,33,24,9,0,1,0
26992,415,0,103,103,0,0,0,0
0,0,0,0,0,0,0,0,0
162789,988,5,170,168,2,20,1,0
222620,1423,12,137,130,7,6,1,0
61054,508,10,39,28,11,11,1,0
60928,507,10,39,28,11,11,1,0
0,0,0,0,0,0,0,0,0
624745,566,4,59,56,3,0,0,0
0,0,0,0,0,0,0,0,0
0,0,0,0,0,0,0,0,0
0,0,0,0,0,0,0,0,0
16957,124,1,5,5,0,4,0,0
198411,1365,15,218,175,43,5,1,0
269490,2636,2,370,369,1,1,1,0
0,0,0,0,0,0,0,0,0
0,0,0,0,0,0,0,0,0
255771,3124,1,1852,1851,1,0,1,0
129344,165,1,22,17,5,2,1,0
573823,4237,4,358,349,9,2,1,0
0,0,0,0,0,0,0,0,0
2325,27,0,1,1,0,1,0,0
881317,2824,3,640,588,52,24,1,0
0,0,0,0,0,0,0,0,0
419485,1495,0,181,175,6,8,0,0
107219,180,0,10,10,0,0,0,0
547773,1993,7,150,140,10,9,1,0
511898,222,1,14,8,6,0,1,0
567529,1822,4,273,265,8,1,1,0
608774,2685,5,542,512,30,3,1,0
274454,840,6,46,22,24,24,1,0
78164,206,1,5,5,0,2,0,0
440153,3038,8,354,346,8,6,1,0
142843,595,4,74,74,0,3,0,0
120986,992,2,94,84,10,11,0,0
13019,99,2,10,2,8,0,0,0
113919,334,10,20,11,9,31,1,0
183490,1118,17,175,139,36,21,1,0
0,0,0,0,0,0,0,0,0
880574,860,6,63,58,5,6,1,0
846586,351,7,5,4,1,6,1,0
1498801,2503,11,245,230,15,32,1,0
48236,181,4,1,1,0,3,0,0
57564,701,1,132,131,1,0,0,0
48918,749,3,137,134,3,2,1,0
121745,554,3,39,20,19,2,0,0
0,0,0,0,0,0,0,0,0
0,0,0,0,0,0,0,0,0
0,0,0,0,0,0,0,0,0
494715,6496,3,824,179,645,3,1,0
0,0,0,0,0,0,0,0,0
0,0,0,0,0,0,0,0,0
199612,882,3,108,5,103,0,0,0
344843,1274,6,81,62,19,87,1,0
188895,1584,1,202,174,28,0,1,0
130266,862,6,138,123,15,0,0,0
27861,171,2,9,1,8,9,0,0
370489,1321,2,127,127,0,3,1,0
313700,1048,2,125,122,3,0,1,0
187285,2515,4,515,512,3,2,1,0
103037,281,9,24,20,4,15,1,0
54810,373,6,26,26,0,0,1,0
518160,4599,2,763,757,6,16,1,0
398870,3735,3,638,632,6,20,1,0
1382496,13206,1,1075,1055,20,0,1,0
0,0,0,0,0,0,0,0,0
0,0,0,0,0,0,0,0,0
158649,2007,2,573,556,17,10,0,0
43607,880,2,247,243,4,1,1,0
49308,545,6,76,75,1,4,1,0
0,0,0,0,0,0,0,0,0
44567,249,7,40,39,1,0,1,0
47875,346,7,42,41,1,0,1,0
194040,4171,4,574,573,1,3,1,0
254735,875,3,167,157,10,5,0,0
98493,429,4,108,98,10,6,0,0
0,0,0,0,0,0,0,0,0
0,0,0,0,0,0,0,0,0
469972,3493,2,305,285,20,9,1,0
0,0,0,0,0,0,0,0,0
0,0,0,0,0,0,0,0,0
0,0,0,0,0,0,0,0,0
0,0,0,0,0,0,0,0,0
25494,491,4,116,108,8,0,1,0
490256,1128,11,154,134,20,1,1,0
9333,91,3,4,2,2,0,0,0
123469,576,6,89,52,37,14,1,0
11400,81,7,6,6,0,0,1,0
553245,575,3,71,67,4,1,1,0
347498,490,2,13,10,3,0,0,0
787084,1565,11,146,130,16,27,1,0
0,0,0,0,0,0,0,0,0
220957,2234,9,234,222,12,26,1,0
127543,1238,4,210,208,2,1,1,0
38656,288,5,54,52,2,3,1,0
61526,623,3,145,144,1,17,1,0
766848,2138,3,206,189,17,9,1,0
149194,1391,5,146,138,8,4,1,0
510985,2254,4,365,321,44,18,1,0
7411,68,5,6,6,0,1,0,0
1052888,2664,11,485,449,36,36,1,0
370970,1843,14,408,391,17,23,1,0
0,0,0,0,0,0,0,0,0
40348,403,3,70,66,4,0,1,0
17663,59,3,9,9,0,0,0,0
375826,3074,12,646,625,21,43,1,1
0,0,0,0,0,0,0,0,0
600116,3227,6,373,336,37,126,1,0
309345,671,3,80,68,12,4,1,0
15038,101,2,7,7,0,0,0,0
0,0,0,0,0,0,0,0,0
0,0,0,0,0,0,0,0,0
59850,587,4,201,186,15,0,1,0
307431,1184,6,258,230,28,102,1,0
0,0,0,0,0,0,0,0,0
0,0,0,0,0,0,0,0,0
0,0,0,0,0,0,0,0,0
0,0,0,0,0,0,0,0,0
11517,327,1,8,8,0,0,1,0
257141,2619,3,381,364,17,1,1,0
0,0,0,0,0,0,0,0,0
92430,1041,2,60,33,27,2,1,0
297011,2431,3,6,1,5,21,1,0
0,0,0,0,0,0,0,0,0
166689,2112,4,657,636,21,14,1,0
3707093,3957,2,642,609,33,2,1,0
341832,1771,8,177,171,6,24,1,0
1328048,2950,8,90,84,6,93,0,0
20130,88,3,4,4,0,0,0,0
0,0,0,0,0,0,0,0,0
675758,2742,2,315,280,35,0,1,0
74408,762,2,71,71,0,1,0,0
0,0,0,0,0,0,0,0,0
0,0,0,0,0,0,0,0,0
25003,72,1,0,0,0,26,0,0
95818,991,4,164,158,6,47,1,0
67248,510,2,69,67,2,5,1,0
23001,155,2,19,18,1,11,1,0
919985,1795,10,227,216,11,8,1,0
613606,1113,2,62,53,9,1,0,0
924028,6254,9,648,620,28,202,0,0
0,0,0,0,0,0,0,0,0
0,0,0,0,0,0,0,0,0
0,0,0,0,0,0,0,0,0
422517,2798,12,301,286,15,2,1,0
0,0,0,0,0,0,0,0,0
0,0,0,0,0,0,0,0,0
0,0,0,0,0,0,0,0,0
0,0,0,0,0,0,0,0,0
0,0,0,0,0,0,0,0,0
0,0,0,0,0,0,0,0,0
0,0,0,0,0,0,0,0,0
0,0,0,0,0,0,0,0,0
0,0,0,0,0,0,0,0,0
147564,2083,3,366,323,43,15,1,0
0,0,0,0,0,0,0,0,0
0,0,0,0,0,0,0,0,0
0,0,0,0,0,0,0,0,0
0,0,0,0,0,0,0,0,0
230775,341,0,17,14,3,0,1,0
0,0,0,0,0,0,0,0,0
0,0,0,0,0,0,0,0,0
202335,2217,11,429,361,68,3,1,0
0,0,0,0,0,0,0,0,0
307340,1458,6,145,108,37,4,1,0
406909,143,7,10,5,5,1,1,0
17859,256,0,25,24,1,0,0,0
0,0,0,0,0,0,0,0,0
448575,1355,3,107,101,6,0,1,0
0,0,0,0,0,0,0,0,0
637883,2718,15,335,301,34,29,1,0
259550,1569,12,189,163,26,10,1,0
350748,72,0,8,6,2,0,0,0
345720,1172,12,130,118,12,10,1,0
194373,581,3,55,28,27,4,1,0
10540,65,0,4,4,0,0,0,0
0,0,0,0,0,0,0,0,0
0,0,0,0,0,0,0,0,0
295646,1029,4,166,144,22,17,1,0
79907,712,10,180,5,175,2,1,0
0,0,0,0,0,0,0,0,0
839229,2383,12,178,164,14,39,1,0
0,0,0,0,0,0,0,0,0
606021,2279,6,276,265,11,1,1,0
92467,1041,2,60,33,27,2,1,0
70839,804,3,99,89,10,0,0,0
9091,99,3,4,4,0,2,0,0
0,0,0,0,0,0,0,0,0
21549,367,0,102,89,13,0,1,0
201126,58,0,9,5,4,0,1,0
0,0,0,0,0,0,0,0,0
0,0,0,0,0,0,0,0,0
0,0,0,0,0,0,0,0,0
6208819,3360,1,565,540,25,43,1,0
555748,1462,6,204,134,70,12,1,1
257457,1186,5,160,131,29,12,1,0
0,0,0,0,0,0,0,0,0
951943,1185,6,116,83,33,29,1,0
336867,2478,13,517,234,283,17,1,0
3666835,29925,5,3027,1772,1255,39,1,0
47110,132,8,3,0,3,0,1,0
104888,865,9,127,104,23,2,1,0
0,0,0,0,0,0,0,0,0
0,0,0,0,0,0,0,0,0
100565,1280,2,188,171,17,7,1,0
22987,39,0,2,2,0,0,1,0
0,0,0,0,0,0,0,0,0
510317,4158,8,363,196,167,43,1,0
293691,1509,1,115,111,4,6,1,0
0,0,0,0,0,0,0,0,0
67527,653,11,67,66,1,10,0,0
677189,556,0,4,0,4,2,1,1
54928,563,5,85,43,42,0,1,0
309477,5388,5,377,355,22,20,0,0
0,0,0,0,0,0,0,0,0
419603,3745,13,810,792,18,7,1,0
643041,6206,2,1807,1806,1,2,1,0
19184,286,2,50,12,38,5,1,0
0,0,0,0,0,0,0,0,0
0,0,0,0,0,0,0,0,0
35496,361,4,35,35,0,0,1,0
164372,2709,3,599,535,64,8,1,0
0,0,0,0,0,0,0,0,0
86184,1223,5,272,265,7,1,1,0
56545,903,4,228,226,2,0,1,0
89015,1115,5,311,307,4,9,1,0
43047,254,4,10,10,0,1,0,0
70389,298,6,44,35,9,1,0,0
580321,1974,5,289,254,35,17,1,0
106099,952,3,137,114,23,5,1,0
0,0,0,0,0,0,0,0,0
779201,661,2,27,26,1,28,0,0
494609,1049,6,132,126,6,8,1,0
19829,86,1,4,3,1,0,0,0
0,0,0,0,0,0,0,0,0
71549,806,1,215,204,11,5,1,0
21860,35,0,1,1,0,0,1,0
600532,3942,5,155,141,14,3,1,0
0,0,0,0,0,0,0,0,0
163744,407,2,52,41,11,5,1,0
23893,315,4,53,49,4,2,1,0
28820,237,7,51,48,3,0,1,0
0,0,0,0,0,0,0,0,0
22049,33,0,1,1,0,0,1,0
0,0,0,0,0,0,0,0,0
216501,590,6,115,105,10,25,1,0
0,0,0,0,0,0,0,0,0
0,0,0,0,0,0,0,0,0
724575,2819,3,325,325,0,14,0,0
197489,2060,7,349,336,13,12,1,0
143594,1992,6,530,522,8,6,1,0
90576,222,4,12,8,4,8,1,0
0,0,0,0,0,0,0,0,0
134397,591,8,173,153,20,8,1,0
539535,3940,17,719,689,30,23,1,0
0,0,0,0,0,0,0,0,0
0,0,0,0,0,0,0,0,0
278370,2689,7,269,182,87,156,0,0
62779,727,1,251,250,1,7,0,0
265578,539,4,28,24,4,22,0,0
374558,2778,3,385,366,19,2,1,0
0,0,0,0,0,0,0,0,0
131100,1815,1,497,496,1,0,0,0
60491,669,7,73,57,16,6,1,0
249243,2349,5,336,316,20,9,0,0
31819,270,3,30,25,5,11,0,0
148142,1518,13,618,617,1,2,1,0
0,0,0,0,0,0,0,0,0
116581,675,8,63,59,4,0,0,0
0,0,0,0,0,0,0,0,0
266953,1888,3,152,150,2,19,1,0
0,0,0,0,0,0,0,0,0
7692,63,0,25,22,3,0,0,0
4922,77,0,11,10,1,1,0,0
309270,961,4,40,30,10,0,1,0
565,7,0,0,0,0,0,0,0
398724,977,7,182,170,12,13,1,0
0,0,0,0,0,0,0,0,0
0,0,0,0,0,0,0,0,0
203690,1249,0,372,369,3,121,1,0
0,0,0,0,0,0,0,0,0
3665673,1481,4,172,143,29,4,0,0
416029,3179,8,222,209,13,3,1,0
668269,5164,7,34,27,7,3,1,0
188427,1269,9,193,180,13,11,1,0
534018,2158,2,137,68,69,1,1,0
0,0,0,0,0,0,0,0,0
78417,550,5,114,102,12,10,1,0
108748,1080,5,149,134,15,4,1,0
40865,335,6,42,33,9,5,1,0
284168,496,1,13,7,6,1,1,0
409994,691,6,110,79,31,5,1,0
326485,1071,1,235,196,39,6,1,0
0,0,0,0,0,0,0,0,0
0,0,0,0,0,0,0,0,0
0,0,0,0,0,0,0,0,0
124403,1028,8,236,228,8,9,1,0
250488,1728,3,179,175,4,0,1,0
0,0,0,0,0,0,0,0,0
86894,1093,2,253,239,14,1,1,0
71729,851,3,224,207,17,4,1,0
0,0,0,0,0,0,0,0,0
0,0,0,0,0,0,0,0,0
0,0,0,0,0,0,0,0,0
261244,1579,3,233,192,41,0,1,0
92271,1016,2,286,249,37,18,1,0
124058,685,13,65,50,15,12,1,0
58792,1049,2,186,184,2,0,1,0
575403,1200,2,161,130,31,4,1,0
15411,145,0,35,31,4,2,1,0
0,0,0,0,0,0,0,0,0
477284,1312,8,78,68,10,22,1,0
350060,666,8,59,48,11,8,1,0
202374,1008,10,241,191,50,8,1,0
93361,88,2,7,2,5,3,0,0
579235,8881,5,598,541,57,17,0,0
105471,514,8,82,58,24,3,0,0
39285,726,1,326,325,1,0,1,0
16107,108,0,53,52,1,0,1,0
124060,1154,7,62,60,2,0,0,0
1141,28,0,2,2,0,0,0,0
284763,4121,3,683,578,105,8,1,0
274063,3877,6,871,868,3,10,1,0
82634,217,0,46,23,23,0,1,1
440907,1037,18,155,149,6,14,1,0
855777,7424,11,859,762,97,22,1,0
870555,7448,11,849,770,79,22,0,0
120642,777,8,158,152,6,13,1,0
75772,171,0,27,26,1,0,1,0
8100,62,0,4,1,3,0,0,0
199031,1720,7,493,476,17,2,1,0
0,0,0,0,0,0,0,0,0
320856,1737,3,236,211,25,63,0,0
1443291,2170,3,339,332,7,157,1,0
762257,333,6,48,40,8,5,1,0
0,0,0,0,0,0,0,0,0
0,0,0,0,0,0,0,0,0
27575,42,0,2,1,1,0,0,0
0,0,0,0,0,0,0,0,0
214316,2378,13,497,445,52,5,1,0
1312517,4477,12,481,407,74,73,1,0
66913,893,6,170,169,1,3,1,0
11347,258,0,55,55,0,0,1,0
392071,764,1,109,61,48,0,1,0
95840,826,7,121,112,9,0,0,0
14505,207,3,49,36,13,3,0,0
5292635,2485,7,447,9,438,13,1,0
200446,516,1,14,13,1,0,1,0
265253,2376,4,375,340,35,3,1,0
0,0,0,0,0,0,0,0,0
58148,767,6,211,189,22,17,1,0
44423,628,6,192,170,22,14,1,0
0,0,0,0,0,0,0,0,0
8080,124,4,6,6,0,0,1,0
0,0,0,0,0,0,0,0,0
310738,2220,2,345,320,25,1,1,0
16384,214,1,38,32,6,9,1,0
109421,963,3,216,210,6,18,1,0
380403,3199,5,523,517,6,6,0,0
60715,696,1,1,0,1,0,0,0
0,0,0,0,0,0,0,0,0
554922,3420,6,626,603,23,3,1,0
78701,379,7,81,79,2,0,1,0
100588,1203,2,185,163,22,0,1,0
219303,902,4,96,92,4,0,1,0
178285,677,4,70,64,6,0,1,0
47468,741,3,149,142,7,1,1,0
164980,1264,8,172,150,22,53,1,0
165235,1264,8,172,150,22,53,1,0
0,0,0,0,0,0,0,0,0
822283,2534,15,248,239,9,13,1,0
713125,1852,15,211,203,8,6,1,0
98696,1450,2,415,413,2,8,0,0
16717,188,0,21,21,0,2,0,0
0,0,0,0,0,0,0,0,0
289731,3683,4,857,833,24,14,0,0
337225,4079,8,916,816,100,25,1,0
148616,1143,11,323,300,23,29,1,0
0,0,0,0,0,0,0,0,0
0,0,0,0,0,0,0,0,0
44383,702,8,88,77,11,7,1,0
0,0,0,0,0,0,0,0,0
197754,2179,3,581,539,42,11,1,1
9524,77,4,10,10,0,0,1,0
57439,239,4,73,51,22,0,0,0
139789,657,4,68,44,24,0,1,0
250523,1663,2,186,67,119,0,1,0
43969,938,1,23,14,9,1,1,0
1004927,2379,2,372,356,16,0,1,0
9989,122,3,10,10,0,1,1,0
179890,639,2,73,27,46,0,1,0
19948,411,1,161,133,28,1,1,0
889151,1359,6,113,102,11,4,1,0
74049,683,3,109,100,9,0,1,0
88539,809,3,17,4,13,0,0,0
0,0,0,0,0,0,0,0,0
192930,718,5,139,115,24,6,0,0
1012055,1299,6,123,99,24,27,1,0
280050,1898,1,324,306,18,0,0,0
340627,2340,0,586,574,12,8,1,0
407265,2796,4,344,288,56,48,1,0
9940,95,2,9,9,0,1,1,0
0,0,0,0,0,0,0,0,0
284458,1368,4,473,453,20,5,1,0
108385,170,3,4,4,0,5,1,0
1079630,1642,10,246,211,35,22,1,0
0,0,0,0,0,0,0,0,0
0,0,0,0,0,0,0,0,0
486717,3335,6,314,294,20,13,1,1
5351,70,2,12,12,0,0,0,0
12561,49,2,0,0,0,0,0,0
0,0,0,0,0,0,0,0,0
663840,1048,7,100,84,16,10,1,0
240144,951,4,179,177,2,4,0,0
0,0,0,0,0,0,0,0,0
212503,900,10,113,108,5,16,1,0
566,7,0,0,0,0,0,0,0
82390,1531,5,279,274,5,1,1,0
27024,767,1,342,339,3,0,1,0
0,0,0,0,0,0,0,0,0
315261,2486,1,550,532,18,19,1,0
41024,235,1,9,4,5,7,1,0
27695,410,4,92,58,34,2,1,0
178591,2230,2,200,194,6,27,1,0
17320,258,4,62,36,26,0,0,0
12286,182,5,34,34,0,0,1,0
828597,4252,9,807,781,26,157,1,0
0,0,0,0,0,0,0,0,0
113670,1363,3,249,195,54,2,1,0
180049,1208,8,199,176,23,21,1,0
4909,75,1,5,3,2,0,1,0
15971,311,0,121,121,0,1,1,0
656321,5868,3,491,372,119,17,1,1
677976,2244,4,352,204,148,12,1,0
718468,3346,5,175,167,8,9,1,0
109437,50,3,0,0,0,0,0,0
112300,1695,4,390,315,75,85,1,0
45437,584,4,143,74,69,7,1,0
0,0,0,0,0,0,0,0,0
595817,2638,12,457,388,69,19,1,0
355997,528,10,54,38,16,12,1,0
111292,1894,6,421,393,28,2,1,0
59625,1029,5,258,244,14,1,0,0
86660,926,7,205,202,3,81,1,0
163232,1688,5,304,297,7,15,0,0
16168,209,2,55,40,15,0,1,0
57748,587,4,107,23,84,18,1,0
353257,1245,6,223,188,35,23,0,0
0,0,0,0,0,0,0,0,0
538559,7265,8,1460,442,1018,108,1,1
18595,423,0,130,129,1,0,1,0
16653,332,0,91,90,1,0,1,0
343347,784,6,62,57,5,9,1,0
505879,2635,9,329,310,19,16,1,0
92467,1041,2,60,33,27,2,1,0
229286,1333,4,136,93,43,34,1,0
0,0,0,0,0,0,0,0,0
589740,4574,8,1029,1016,13,22,1,0
194703,1511,7,33,23,10,44,0,0
32080,269,6,19,3,16,3,1,0
41989,261,3,24,22,2,4,1,0
259941,1300,1,211,185,26,7,1,0
0,0,0,0,0,0,0,0,0
319643,1162,4,184,171,13,6,1,0
0,0,0,0,0,0,0,0,0
35291,248,5,47,4,43,5,1,0
32592,229,5,45,22,23,5,1,0
0,0,0,0,0,0,0,0,0
38351,284,4,29,20,9,6,1,0
38351,284,4,29,20,9,6,1,0
61546,553,4,79,78,1,8,0,0
32782,254,4,49,48,1,8,0,0
254330,697,4,116,109,7,0,1,0
0,0,0,0,0,0,0,0,0
76151,911,11,214,195,19,0,0,0
141595,792,4,146,136,10,41,0,0
71283,40,5,0,0,0,0,0,1
226149,2961,9,596,591,5,8,1,0
261597,1646,15,375,336,39,11,1,0
54326,377,1,87,84,3,1,1,0
0,0,0,0,0,0,0,0,0
0,0,0,0,0,0,0,0,0
0,0,0,0,0,0,0,0,0
0,0,0,0,0,0,0,0,0
44322,443,1,118,111,7,0,1,0
0,0,0,0,0,0,0,0,0
289628,1086,13,199,170,29,6,1,0
0,0,0,0,0,0,0,0,0
0,0,0,0,0,0,0,0,0
203017,1473,3,260,230,30,0,0,0
9301,100,0,6,6,0,0,0,0
0,0,0,0,0,0,0,0,0
231886,341,0,17,9,8,0,1,0
914771,1651,11,139,129,10,26,1,0
0,0,0,0,0,0,0,0,0
0,0,0,0,0,0,0,0,0
208015,1019,3,80,75,5,13,1,0
0,0,0,0,0,0,0,0,0
0,0,0,0,0,0,0,0,0
199938,1462,7,166,158,8,10,0,0
0,0,0,0,0,0,0,0,0
0,0,0,0,0,0,0,0,0
56911,495,6,97,93,4,0,1,0
0,0,0,0,0,0,0,0,0
285018,1844,8,281,257,24,9,1,0
6345,63,2,4,4,0,2,1,0
348237,1490,1,309,288,21,1,1,0
0,0,0,0,0,0,0,0,0
487072,2204,5,507,431,76,4,1,0
100551,828,3,194,182,12,4,1,0
383506,1188,2,136,129,7,1,0,0
0,0,0,0,0,0,0,0,0
501966,2179,3,327,308,19,5,1,0
26652,268,6,70,67,3,13,1,0
0,0,0,0,0,0,0,0,0
340284,2954,4,450,435,15,39,1,0
0,0,0,0,0,0,0,0,0
107035,1132,7,197,171,26,3,1,0
26655,222,7,13,12,1,8,1,0
182602,2110,1,426,419,7,0,1,0
39103,577,1,145,138,7,0,1,0
269835,875,11,154,149,5,6,1,0
250528,520,13,118,113,5,4,1,0
499928,2119,13,374,348,26,31,1,0
420358,1551,13,260,239,21,31,1,0
0,0,0,0,0,0,0,0,0
0,0,0,0,0,0,0,0,0
0,0,0,0,0,0,0,0,0
272786,1610,6,343,293,50,19,1,0
0,0,0,0,0,0,0,0,0
466465,4633,8,1287,1275,12,11,1,0
237977,824,5,126,76,50,34,1,0
178858,908,11,119,107,12,2,1,0
146599,1032,10,209,199,10,4,1,0
69888,436,9,85,76,9,3,1,0
70151,1933,2,569,568,1,2,1,0
448639,927,2,40,3,37,7,0,0
0,0,0,0,0,0,0,0,0
0,0,0,0,0,0,0,0,0
116079,1208,5,217,208,9,1,1,0
0,0,0,0,0,0,0,0,0
281932,1516,1,179,153,26,7,1,0
215081,1688,0,346,332,14,2,1,0
50353,366,6,28,10,18,0,1,0
17705,97,3,5,5,0,1,0,0
213015,2561,2,331,164,167,6,1,0
22497,196,3,20,15,5,0,1,0
0,0,0,0,0,0,0,0,0
0,0,0,0,0,0,0,0,0
0,0,0,0,0,0,0,0,0
97852,1004,8,169,133,36,4,1,0
0,0,0,0,0,0,0,0,0
861982,2439,5,300,280,20,38,1,0
13501,8,0,0,0,0,0,0,0
13501,8,0,0,0,0,0,0,0
0,0,0,0,0,0,0,0,0
0,0,0,0,0,0,0,0,0
8136,170,2,24,22,2,0,1,0
8662,148,3,24,22,2,2,1,0
1991,28,1,7,3,4,0,1,0
12844,175,6,13,10,3,3,0,0
0,0,0,0,0,0,0,0,0
0,0,0,0,0,0,0,0,0
0,0,0,0,0,0,0,0,0
779600,1105,3,78,69,9,0,1,0
94204,987,5,213,209,4,24,1,0
41565,440,7,108,106,2,25,0,0
0,0,0,0,0,0,0,0,0
209743,2398,8,694,393,301,17,1,0
336979,2270,3,226,208,18,0,1,0
227693,1328,4,136,102,34,31,1,0
0,0,0,0,0,0,0,0,0
0,0,0,0,0,0,0,0,0
0,0,0,0,0,0,0,0,0
4406,81,1,21,21,0,0,0,0
8979,183,3,29,24,5,0,0,0
877155,1016,7,77,76,1,11,1,0
101383,417,7,53,41,12,14,1,0
375101,1107,16,139,127,12,8,1,0
0,0,0,0,0,0,0,0,0
0,0,0,0,0,0,0,0,0
358240,831,6,110,88,22,13,1,0
340404,610,3,77,67,10,9,1,0
2142397,9744,7,790,782,8,310,1,0
0,0,0,0,0,0,0,0,0
225777,843,6,94,91,3,1,1,0
0,0,0,0,0,0,0,0,0
564400,3109,8,664,646,18,6,1,0
50406,140,2,10,7,3,2,0,0
1020178,1525,10,207,193,14,19,1,0
0,0,0,0,0,0,0,0,0
153044,1263,2,351,251,100,0,1,0
83276,61,0,6,6,0,6,0,0
13887,262,0,62,61,1,0,1,0
110609,1039,8,203,189,14,7,1,0
111509,992,9,290,289,1,8,1,0
0,0,0,0,0,0,0,0,0
941679,1752,3,249,238,11,6,1,0
5845,31,2,0,0,0,0,0,0
474145,6363,8,1158,1158,0,3,1,0
247150,1477,8,167,152,15,10,1,0
276132,833,9,11,1,10,5,1,0
84766,963,0,61,33,28,2,1,0
198252,957,6,185,151,34,1,1,0
0,0,0,0,0,0,0,0,0
373400,2182,10,412,396,16,20,1,0
426295,701,1,67,67,0,0,0,0
119780,119,2,3,3,0,1,1,0
209155,1789,8,126,91,35,9,0,0
28804,104,6,6,6,0,0,0,0
290849,543,1,28,20,8,0,1,0
0,0,0,0,0,0,0,0,0
0,0,0,0,0,0,0,0,0
0,0,0,0,0,0,0,0,0
519544,1849,7,345,336,9,18,1,0
300642,334,8,49,38,11,13,1,0
0,0,0,0,0,0,0,0,0
489883,4046,5,148,139,9,23,0,0
142164,1244,2,9,1,8,0,0,0
153285,3609,2,764,761,3,271,1,0
13259,113,2,10,10,0,1,1,0
0,0,0,0,0,0,0,0,0
0,0,0,0,0,0,0,0,0
0,0,0,0,0,0,0,0,0
30808,215,0,55,45,10,0,0,0
181347,1516,7,297,173,124,4,1,0
14915,142,3,2,1,1,4,0,0
23379,81,3,1,0,1,2,1,0
3013445,1378,4,139,88,51,47,1,0
5894314,360,1,6,5,1,5,1,0
0,0,0,0,0,0,0,0,0
386947,1287,2,181,161,20,6,1,0
571969,3349,12,160,146,14,46,1,0
0,0,0,0,0,0,0,0,0
0,0,0,0,0,0,0,0,0
206881,3074,3,905,898,7,5,0,0
0,0,0,0,0,0,0,0,0
0,0,0,0,0,0,0,0,0
27970,42,0,2,1,1,0,0,0
0,0,0,0,0,0,0,0,0
172102,1808,6,417,407,10,7,1,0
0,0,0,0,0,0,0,0,0
731343,2000,7,637,568,69,2,1,0
242342,1209,2,274,197,77,4,1,0
24986,177,0,16,5,11,2,1,0
433481,1075,7,119,112,7,2,1,0
34863,155,0,30,21,9,1,1,0
0,0,0,0,0,0,0,0,0
143554,1512,9,339,325,14,13,0,0
57379,503,6,109,96,13,12,0,0
0,0,0,0,0,0,0,0,0
0,0,0,0,0,0,0,0,0
0,0,0,0,0,0,0,0,0
0,0,0,0,0,0,0,0,0
0,0,0,0,0,0,0,0,0
139623,1471,1,371,361,10,6,0,0
0,0,0,0,0,0,0,0,0
0,0,0,0,0,0,0,0,0
20221,182,4,62,56,6,0,1,0
288679,1724,8,355,348,7,4,1,0
613738,1297,6,283,271,12,1,1,0
182660,1318,11,263,257,6,7,1,0
217968,1633,5,340,321,19,30,1,0
0,0,0,0,0,0,0,0,0
38389,729,4,122,122,0,2,1,0
4335,66,3,9,9,0,0,1,0
0,0,0,0,0,0,0,0,0
173773,1223,2,281,274,7,1,1,0
22775,164,1,31,28,3,0,1,0
446425,2962,8,560,557,3,20,1,0
199699,1640,8,248,240,8,17,1,0
407742,3613,5,938,903,35,73,1,0
19915,100,3,11,6,5,1,1,0
583039,2086,7,234,51,183,1,1,0
0,0,0,0,0,0,0,0,0
483253,1748,7,283,267,16,14,1,0
0,0,0,0,0,0,0,0,0
48517,789,3,22,16,6,1,0,0
17406,320,0,22,15,7,1,1,1
886835,3518,4,389,341,48,5,1,0
381901,756,14,61,54,7,2,1,0
438487,4244,3,1819,1778,41,22,0,0
0,0,0,0,0,0,0,0,0
0,0,0,0,0,0,0,0,0
84874,684,5,96,94,2,21,1,0
0,0,0,0,0,0,0,0,0
847389,3396,5,417,405,12,81,1,0
35998,434,2,74,72,2,2,0,0
35094,652,3,33,32,1,2,0,0
585099,3120,6,167,158,9,129,1,0
288784,1803,4,168,152,16,15,1,0
103890,1107,3,132,125,7,3,1,0
0,0,0,0,0,0,0,0,0
81397,801,6,243,229,14,20,0,0
0,0,0,0,0,0,0,0,0
157901,2078,1,150,148,2,0,1,0
22567,371,1,30,28,2,0,1,0
0,0,0,0,0,0,0,0,0
196461,1774,4,89,56,33,0,1,0
184454,581,6,136,123,13,25,1,0
486480,2869,4,382,372,10,7,1,0
10342,108,4,2,2,0,0,0,0
1205265,2274,10,143,137,6,30,1,0
12118,75,2,0,0,0,2,0,0
1705,24,6,1,1,0,0,0,0
8100,71,6,3,2,1,0,0,0
0,0,0,0,0,0,0,0,0
400350,2141,3,514,296,218,8,1,0
185638,2680,11,388,380,8,11,0,0
37788,450,7,69,63,6,5,0,0
115700,816,1,153,149,4,4,0,0
0,0,0,0,0,0,0,0,0
0,0,0,0,0,0,0,0,0
0,0,0,0,0,0,0,0,0
776342,469,1,8,8,0,3,1,0
253725,2410,10,357,312,45,8,1,1
172789,1322,2,221,204,17,45,0,0
0,0,0,0,0,0,0,0,0
0,0,0,0,0,0,0,0,0
145547,339,10,37,32,5,2,1,0
513303,2039,2,233,43,190,1,1,0
25785,123,1,13,13,0,0,1,0
0,0,0,0,0,0,0,0,0
0,0,0,0,0,0,0,0,0
0,0,0,0,0,0,0,0,0
0,0,0,0,0,0,0,0,0
64779,251,3,51,51,0,2,1,0
50503,350,5,41,30,11,2,1,0
44629,66,0,9,8,1,5,0,0
0,0,0,0,0,0,0,0,0
279787,2796,4,586,576,10,2,1,0
255562,2770,4,585,575,10,2,1,0
37840,498,2,173,173,0,9,1,0
7227,82,2,5,5,0,2,1,0
228935,339,0,17,9,8,0,1,0
50172,762,7,113,63,50,0,1,0
7876,80,6,7,6,1,0,1,0
176306,2668,1,601,594,7,2,1,0
78981,1189,1,304,297,7,2,1,0
862555,5886,3,497,457,40,2,1,0
0,0,0,0,0,0,0,0,0
603586,3695,8,347,341,6,13,0,0
0,0,0,0,0,0,0,0,0
0,0,0,0,0,0,0,0,0
0,0,0,0,0,0,0,0,0
0,0,0,0,0,0,0,0,0
63168,842,1,156,156,0,4,0,0
0,0,0,0,0,0,0,0,0
2105,25,2,1,1,0,0,0,0
0,0,0,0,0,0,0,0,0
141422,1049,4,131,118,13,6,1,0
0,0,0,0,0,0,0,0,0
0,0,0,0,0,0,0,0,0
178602,2709,5,801,793,8,11,1,0
85809,1110,11,287,281,6,7,1,0
123797,926,3,205,193,12,7,1,1
766214,1233,3,132,103,29,2,1,0
0,0,0,0,0,0,0,0,0
378231,1630,7,326,318,8,20,1,0
4181,15,0,0,0,0,0,0,0
175929,1278,3,225,212,13,28,0,0
0,0,0,0,0,0,0,0,0
0,0,0,0,0,0,0,0,0
0,0,0,0,0,0,0,0,0
0,0,0,0,0,0,0,0,0
0,0,0,0,0,0,0,0,0
167118,2406,9,598,558,40,6,0,0
0,0,0,0,0,0,0,0,0
0,0,0,0,0,0,0,0,0
0,0,0,0,0,0,0,0,0
116372,1743,1,322,278,44,2,1,0
403095,1835,4,326,287,39,9,1,0
20536,75,1,2,2,0,0,0,0
700784,2724,12,504,470,34,86,0,0
179411,1492,2,180,139,41,1,1,0
0,0,0,0,0,0,0,0,0
154746,1911,7,213,200,13,15,0,0
325865,1306,10,252,239,13,14,1,0
0,0,0,0,0,0,0,0,0
0,0,0,0,0,0,0,0,0
942213,1576,7,204,169,35,12,1,0
141936,1219,9,350,323,27,7,0,0
21001,306,0,63,58,5,0,1,0
10236,120,0,10,10,0,0,0,0
223473,2674,4,723,711,12,5,1,0
0,0,0,0,0,0,0,0,0
262741,1045,9,147,136,11,15,1,0
23423,74,2,4,0,4,2,0,0
0,0,0,0,0,0,0,0,0
458317,3954,10,810,783,27,18,1,0
0,0,0,0,0,0,0,0,0
242231,1445,5,155,57,98,27,1,0
830820,4525,5,323,284,39,5,1,0
390084,1059,2,258,250,8,2,1,0
18196,232,0,40,31,9,0,1,0
0,0,0,0,0,0,0,0,0
0,0,0,0,0,0,0,0,0
814911,3599,7,381,360,21,22,1,1
14793,137,9,15,14,1,0,0,0
0,0,0,0,0,0,0,0,0
0,0,0,0,0,0,0,0,0
217825,2791,4,753,753,0,3,1,0
170806,733,16,70,61,9,10,1,0
356306,983,11,102,90,12,11,1,0
116841,1397,3,101,77,24,17,1,0
27254,388,2,31,19,12,0,1,0
253402,750,7,58,56,2,49,1,0
0,0,0,0,0,0,0,0,0
169506,892,2,132,116,16,0,0,0
24008,131,6,3,2,1,1,0,0
1574,27,0,0,0,0,0,0,0
0,0,0,0,0,0,0,0,0
0,0,0,0,0,0,0,0,0
364372,1064,2,98,83,15,4,0,0
176228,1120,9,196,176,20,2,1,0
0,0,0,0,0,0,0,0,0
0,0,0,0,0,0,0,0,0
424902,1596,3,219,207,12,1,0,0
289011,1515,3,235,207,28,2,1,0
92269,1013,3,357,266,91,6,1,0
23779,179,2,24,17,7,3,0,0
0,0,0,0,0,0,0,0,0
0,0,0,0,0,0,0,0,0
0,0,0,0,0,0,0,0,0
0,0,0,0,0,0,0,0,0
399954,1040,1,151,141,10,2,1,0
1784,29,1,1,0,1,0,0,0
120967,1628,8,260,252,8,5,0,1
323619,864,7,74,62,12,6,1,0
0,0,0,0,0,0,0,0,0
203920,1356,3,200,182,18,0,0,0
21937,35,0,1,1,0,0,1,0
84017,575,2,40,23,17,6,0,0
327367,1440,1,125,111,14,3,1,0
231809,341,0,17,10,7,0,1,0
495529,1186,2,310,307,3,11,1,0
434633,257,4,46,45,1,7,1,0
155324,1200,5,165,82,83,1,1,0
274750,1183,10,129,128,1,74,1,0
0,0,0,0,0,0,0,0,0
78061,1014,8,44,36,8,24,1,0
26527,205,4,30,24,6,1,0,0
0,0,0,0,0,0,0,0,0
214921,2303,5,501,62,439,14,1,1
5740,97,3,9,0,9,0,1,0
63230,910,8,214,173,41,1,1,0
0,0,0,0,0,0,0,0,0
40864,313,7,62,60,2,2,1,0
5768,58,6,3,2,1,0,0,0
167395,1579,6,202,188,14,7,1,0
84099,604,5,102,96,6,5,1,0
36146,452,1,73,53,20,0,1,0
0,0,0,0,0,0,0,0,0
2255076,1438,2,184,170,14,6,1,0
227607,2114,11,299,252,47,85,0,0
178903,2101,3,626,621,5,10,1,0
0,0,0,0,0,0,0,0,0
0,0,0,0,0,0,0,0,0
218788,1757,11,302,282,20,10,1,0
0,0,0,0,0,0,0,0,0
0,0,0,0,0,0,0,0,0
0,0,0,0,0,0,0,0,0
0,0,0,0,0,0,0,0,0
373300,1130,6,178,78,100,14,1,0
0,0,0,0,0,0,0,0,0
716177,6205,6,1721,1707,14,4,1,0
142215,1204,5,293,290,3,9,1,0
83852,829,5,114,97,17,9,1,0
189887,585,4,141,120,21,1,1,0
672543,557,0,4,0,4,2,1,1
1114395,799,2,54,44,10,6,1,0
0,0,0,0,0,0,0,0,0
0,0,0,0,0,0,0,0,0
156570,1397,3,324,218,106,5,1,1
0,0,0,0,0,0,0,0,0
0,0,0,0,0,0,0,0,0
1421133,2643,11,190,169,21,27,1,0
73351,720,6,120,112,8,1,1,0
0,0,0,0,0,0,0,0,0
0,0,0,0,0,0,0,0,0
0,0,0,0,0,0,0,0,0
0,0,0,0,0,0,0,0,0
17304,253,3,51,51,0,0,1,0
0,0,0,0,0,0,0,0,0
0,0,0,0,0,0,0,0,0
37690,282,3,57,56,1,2,1,0
85728,853,10,140,135,5,20,0,0
28004,206,9,28,26,2,4,0,0
5229965,38871,9,4300,2696,1604,18,1,1
47110,132,8,3,0,3,0,1,0
343885,1871,5,464,451,13,36,1,0
0,0,0,0,0,0,0,0,0
200522,1419,3,204,187,17,0,0,0
8844,100,0,6,6,0,0,0,0
524914,3947,4,226,202,24,28,1,0
0,0,0,0,0,0,0,0,0
23338,179,1,47,43,4,0,1,0
18438,172,4,19,11,8,2,1,0
260348,2730,3,692,452,240,32,1,0
2207842,22464,2,825,491,334,15,1,1
226258,1723,5,52,52,0,10,0,0
0,0,0,0,0,0,0,0,0
2430025,3653,7,125,113,12,4,1,0
0,0,0,0,0,0,0,0,0
81855,880,5,275,272,3,2,1,0
107322,566,7,162,160,2,0,1,0
244403,1809,15,189,182,7,17,1,0
406119,2739,5,592,535,57,1,1,0
58897,518,5,116,107,9,0,1,0
463776,1660,12,139,121,18,16,1,0
62174,943,3,584,583,1,0,0,0
262040,1960,11,173,167,6,6,1,0
177010,1189,11,137,133,4,5,1,0
107277,633,3,156,149,7,7,1,0
44879,152,2,17,15,2,4,1,0
375359,546,6,85,72,13,0,1,0
0,0,0,0,0,0,0,0,0
37183,732,2,165,164,1,0,1,0
6103,103,2,20,19,1,0,1,0
0,0,0,0,0,0,0,0,0
3065,5,0,0,0,0,0,0,0
122878,716,8,84,72,12,10,1,0
0,0,0,0,0,0,0,0,0
0,0,0,0,0,0,0,0,0
0,0,0,0,0,0,0,0,0
212951,553,5,50,28,22,3,1,0
82981,941,3,117,113,4,0,0,0
0,0,0,0,0,0,0,0,0
0,0,0,0,0,0,0,0,0
229999,564,5,72,61,11,8,1,0
53641,195,4,39,30,9,3,1,0
0,0,0,0,0,0,0,0,0
0,0,0,0,0,0,0,0,0
16292,89,0,15,1,14,0,1,0
113029,78,3,6,2,4,1,0,0
239404,1573,3,275,236,39,1,1,0
0,0,0,0,0,0,0,0,0
303680,1559,8,192,176,16,1,1,0
2013738,5364,10,848,843,5,26,1,0
75381,669,0,61,52,9,3,1,0
0,0,0,0,0,0,0,0,0
1226108,6904,6,1594,1292,302,16,1,0
137616,968,10,190,165,25,0,1,0
126467,1043,4,128,117,11,3,1,0
35112,257,0,8,4,4,4,0,0
83116,1110,4,205,199,6,8,1,0
50352,35,0,0,0,0,0,0,0
185660,1604,5,166,126,40,0,1,0
30300,89,2,1,1,0,0,0,0
44780,459,3,107,103,4,8,1,0
0,0,0,0,0,0,0,0,0
315500,2437,5,335,257,78,53,1,0
0,0,0,0,0,0,0,0,0
48154,393,2,100,88,12,0,1,0
18397,189,2,15,11,4,0,1,0
380678,3470,5,334,314,20,35,1,0
87867,1390,1,367,355,12,5,1,0
0,0,0,0,0,0,0,0,0
549044,1627,2,264,232,32,2,1,0
0,0,0,0,0,0,0,0,0
146240,1117,7,180,171,9,26,1,0
14179,270,4,67,67,0,3,1,0
817998,1443,7,89,87,2,20,0,0
139080,897,2,111,90,21,2,0,0
231486,337,0,16,3,13,0,1,0
373148,1469,2,276,225,51,1,1,0
38046,119,3,9,9,0,0,1,0
39501,249,2,20,7,13,0,1,0
67890,1111,4,95,95,0,13,1,0
11796,129,2,11,11,0,4,1,0
24399,141,0,9,5,4,5,1,0
28249,45,0,4,1,3,0,0,0
0,0,0,0,0,0,0,0,0
0,0,0,0,0,0,0,0,0
205872,1959,8,263,248,15,7,1,1
714970,8938,9,2735,2735,0,1,0,0
41635,1032,5,325,310,15,9,1,0
101278,811,16,181,53,128,5,1,0
42548,88,0,3,2,1,0,0,0
193061,956,15,129,119,10,0,0,0
67688,700,10,80,24,56,7,1,0
0,0,0,0,0,0,0,0,0
31593,502,1,40,40,0,0,1,0
0,0,0,0,0,0,0,0,0
0,0,0,0,0,0,0,0,0
776862,2043,6,97,45,52,15,1,0
0,0,0,0,0,0,0,0,0
323856,1479,5,161,141,20,26,1,0
2535,28,1,0,0,0,0,0,0
644243,1707,1,153,148,5,2,1,1
274094,134,1,8,6,2,1,1,1
0,0,0,0,0,0,0,0,0
0,0,0,0,0,0,0,0,0
517618,7025,5,944,912,32,17,1,0
83128,450,6,67,51,16,10,1,0
29387,393,0,119,97,22,0,1,0
213964,1450,10,197,192,5,0,1,0
173438,795,2,247,243,4,8,1,0
65324,365,0,115,114,1,0,1,0
833616,2903,13,241,221,20,41,0,0
0,0,0,0,0,0,0,0,0
406221,2212,5,337,252,85,5,1,0
51800,615,5,163,160,3,1,0,0
2441,52,0,1,1,0,0,0,0
373578,2540,0,300,292,8,12,1,0
86055,552,0,68,66,2,5,1,0
157747,556,11,47,37,10,4,1,0
132705,339,11,35,25,10,4,1,0
3309,38,2,1,1,0,0,0,0
0,0,0,0,0,0,0,0,0
21064,205,5,39,39,0,4,0,0
1691453,417,6,73,68,5,5,1,0
0,0,0,0,0,0,0,0,0
738787,1905,4,120,111,9,1,1,0
15149,16,0,1,0,1,0,0,0
130717,1342,9,214,205,9,10,0,0
404762,2554,4,226,214,12,9,1,0
13566,179,2,32,30,2,0,1,0
3840,53,1,4,4,0,0,0,0
0,0,0,0,0,0,0,0,0
1345052,4242,4,250,242,8,0,1,0
114811,108,0,15,8,7,0,1,0
91928,483,10,106,103,3,8,1,0
0,0,0,0,0,0,0,0,0
70161,676,6,154,149,5,12,1,0
41570,316,5,76,72,4,6,1,0
950405,1056,6,145,45,100,0,1,0
217358,1060,2,219,194,25,10,1,0
0,0,0,0,0,0,0,0,0
1962941,4923,6,421,397,24,4,1,0
676097,618,3,56,51,5,5,0,0
0,0,0,0,0,0,0,0,0
763675,1918,7,251,243,8,15,0,0
545848,192,6,3,3,0,10,0,0
106205,920,7,84,77,7,1,0,0
628521,2226,6,311,286,25,18,1,0
0,0,0,0,0,0,0,0,0
370942,1754,5,534,487,47,7,1,0
129469,803,3,124,118,6,0,1,0
5277,74,0,0,0,0,0,0,0
570752,1235,3,160,149,11,1,1,0
173915,1494,5,404,384,20,25,1,0
41736,758,3,110,99,11,0,0,0
3037,101,0,14,14,0,0,0,0
232625,415,3,41,35,6,1,1,0
275584,3848,6,1719,1685,34,75,1,0
295120,2062,13,540,189,351,1,1,0
12400,91,2,9,5,4,0,1,0
700981,2068,1,376,352,24,11,1,0
307389,1289,1,87,73,14,5,1,0
93037,1428,3,268,266,2,4,1,0
362528,4407,13,1120,1081,39,28,1,0
102802,445,9,20,19,1,22,1,0
0,0,0,0,0,0,0,0,0
0,0,0,0,0,0,0,0,0
0,0,0,0,0,0,0,0,0
0,0,0,0,0,0,0,0,0
58401,329,8,76,66,10,9,1,0
1472311,1188,1,158,147,11,1,1,0
356681,105,0,5,5,0,0,1,0
130654,1086,7,240,209,31,10,1,0
202012,1270,8,316,265,51,9,1,0
653921,2552,6,207,191,16,7,0,0
807655,2722,3,252,229,23,51,1,0
246341,2833,4,85,73,12,14,1,0
0,0,0,0,0,0,0,0,0
158834,668,3,143,124,19,1,1,0
82750,213,4,6,6,0,2,0,0
0,0,0,0,0,0,0,0,0
0,0,0,0,0,0,0,0,0
128501,1043,9,184,176,8,20,1,0
92746,298,1,78,43,35,1,0,0
0,0,0,0,0,0,0,0,0
0,0,0,0,0,0,0,0,0
0,0,0,0,0,0,0,0,0
0,0,0,0,0,0,0,0,0
163937,1430,5,252,228,24,4,1,0
67325,945,3,220,208,12,8,1,0
8309,97,3,5,5,0,2,1,0
176795,1254,12,146,81,65,16,1,0
433830,2954,8,311,284,27,10,1,0
791005,2106,13,286,282,4,22,1,0
293710,1556,9,113,103,10,152,1,0
366111,2093,3,226,91,135,25,1,0
314106,2367,8,544,277,267,7,1,0
170318,422,7,44,43,1,30,1,0
88161,946,2,175,172,3,3,1,0
0,0,0,0,0,0,0,0,0
0,0,0,0,0,0,0,0,0
235856,1451,5,269,255,14,0,1,0
0,0,0,0,0,0,0,0,0
0,0,0,0,0,0,0,0,0
126424,1565,3,406,403,3,10,1,0
0,0,0,0,0,0,0,0,0
1442577,11093,5,4859,4814,45,20,1,0
51513,193,0,15,15,0,1,1,0
19308,347,1,55,52,3,0,1,0
37500,929,3,298,260,38,0,0,0
21959,35,0,1,1,0,0,1,0
0,0,0,0,0,0,0,0,0
55836,357,5,25,9,16,8,0,0
455051,5068,5,186,177,9,22,1,0
547199,3652,4,461,437,24,3,0,0
106668,353,1,33,11,22,0,1,0
20204,74,1,7,0,7,0,0,0
775388,511,5,91,86,5,4,1,0
340292,2962,9,215,209,6,19,1,0
186717,1375,10,84,78,6,26,1,0
249624,2266,6,530,253,277,38,1,0
20918,278,5,55,32,23,1,0,0
0,0,0,0,0,0,0,0,0
0,0,0,0,0,0,0,0,0
534028,43,2,1,0,1,0,0,0
0,0,0,0,0,0,0,0,0
0,0,0,0,0,0,0,0,0
14754,312,4,113,72,41,1,1,0
0,0,0,0,0,0,0,0,0
61623,372,5,40,3,37,0,1,0
0,0,0,0,0,0,0,0,0
201282,2042,0,763,712,51,12,0,0
331217,359,0,77,71,6,0,1,0
272667,133,1,8,0,8,1,1,0
180995,1584,1,294,284,10,1,1,0
32681,439,4,105,98,7,1,1,0
0,0,0,0,0,0,0,0,0
0,0,0,0,0,0,0,0,0
0,0,0,0,0,0,0,0,0
0,0,0,0,0,0,0,0,0
515320,1102,2,131,93,38,4,0,0
136429,579,1,162,95,67,1,1,0
351926,803,4,105,81,24,4,1,0
143878,1545,4,480,453,27,2,1,0
130382,337,3,40,40,0,2,1,0
385670,2714,2,244,241,3,49,0,0
9812,74,3,4,4,0,2,0,0
0,0,0,0,0,0,0,0,0
0,0,0,0,0,0,0,0,0
81545,828,5,189,188,1,11,0,0
0,0,0,0,0,0,0,0,0
0,0,0,0,0,0,0,0,0
0,0,0,0,0,0,0,0,0
275870,4401,7,586,536,50,11,1,0
5591,60,5,7,7,0,3,0,0
0,0,0,0,0,0,0,0,0
1572,11,0,1,1,0,0,0,0
131967,1139,13,161,139,22,12,1,0
184782,635,5,209,204,5,0,1,0
365330,868,0,109,99,10,0,1,0
1112949,6919,2,879,754,125,1,1,0
173266,362,2,28,25,3,0,1,0
231105,1882,9,346,329,17,2,1,0
0,0,0,0,0,0,0,0,0
0,0,0,0,0,0,0,0,0
615722,2606,16,359,310,49,30,1,1
156226,478,9,58,51,7,0,1,0
0,0,0,0,0,0,0,0,0
24973,218,0,49,48,1,2,1,0
0,0,0,0,0,0,0,0,0
116773,1035,2,201,201,0,4,1,0
0,0,0,0,0,0,0,0,0
7019,191,3,35,35,0,0,0,0
81392,546,4,83,74,9,5,1,0
74699,549,4,64,59,5,5,1,0
326196,1324,4,217,200,17,1,1,0
0,0,0,0,0,0,0,0,0
139451,1231,5,334,274,60,3,1,0
0,0,0,0,0,0,0,0,0
0,0,0,0,0,0,0,0,0
278675,1184,8,102,64,38,13,1,0
1300678,1723,4,460,433,27,12,1,0
88274,259,0,48,24,24,0,1,1
0,0,0,0,0,0,0,0,0
0,0,0,0,0,0,0,0,0
109913,759,13,79,58,21,22,1,0
144070,1032,13,96,61,35,41,1,0
41358,515,6,79,75,4,4,1,0
0,0,0,0,0,0,0,0,0
236888,1284,6,176,106,70,2,1,0
20733,145,1,19,6,13,0,0,0
605516,3178,7,312,284,28,13,1,0
267416,2573,9,435,401,34,28,1,0
0,0,0,0,0,0,0,0,0
73005,497,7,51,50,1,14,1,0
38953,367,1,48,42,6,9,1,0
0,0,0,0,0,0,0,0,0
0,0,0,0,0,0,0,0,0
184891,1046,5,246,236,10,1,0,0
110079,710,8,196,186,10,13,0,0
223323,1241,3,161,145,16,3,1,0
0,0,0,0,0,0,0,0,0
0,0,0,0,0,0,0,0,0
159731,423,5,146,133,13,9,1,0
59170,626,6,64,51,13,7,1,0
40614,323,6,56,47,9,4,1,0
0,0,0,0,0,0,0,0,0
123102,1635,6,361,342,19,22,0,0
593604,10187,7,3441,745,2696,28,1,0
0,0,0,0,0,0,0,0,0
0,0,0,0,0,0,0,0,0
0,0,0,0,0,0,0,0,0
0,0,0,0,0,0,0,0,0
92409,1028,8,217,217,0,9,1,0
39384,391,4,86,79,7,1,0,0
34620,227,4,44,39,5,0,0,0
1473706,4269,8,709,699,10,1,1,0
202325,1058,4,232,218,14,1,1,0
170719,532,4,119,108,11,0,1,0
0,0,0,0,0,0,0,0,0
0,0,0,0,0,0,0,0,0
217762,2582,2,529,522,7,0,0,0
103120,1045,2,257,250,7,0,0,0
0,0,0,0,0,0,0,0,0
0,0,0,0,0,0,0,0,0
0,0,0,0,0,0,0,0,0
65071,401,10,72,68,4,16,1,0
319955,2385,2,209,204,5,1,0,0
873747,8451,15,151,43,108,6,1,0
0,0,0,0,0,0,0,0,0
180708,164,0,2,2,0,1,1,0
81231,554,3,63,40,23,0,1,0
7364,94,2,18,15,3,2,1,0
0,0,0,0,0,0,0,0,0
0,0,0,0,0,0,0,0,0
0,0,0,0,0,0,0,0,0
938771,2689,8,353,318,35,2,1,0
131170,1679,2,406,357,49,26,0,0
92467,1041,2,60,33,27,2,1,0
15180,181,1,40,37,3,0,1,0
271436,2003,5,116,95,21,5,1,0
0,0,0,0,0,0,0,0,0
497385,2423,5,237,215,22,13,1,0
40408,638,3,151,119,32,0,0,0
150746,1621,2,459,428,31,2,0,0
474186,1436,1,219,200,19,1,1,0
0,0,0,0,0,0,0,0,0
829568,2298,7,374,343,31,24,1,0
1461002,9996,7,14,6,8,11,1,0
146625,1978,4,533,479,54,0,0,0
76255,452,3,81,33,48,62,1,0
392003,1794,8,530,517,13,1,1,0
207796,317,5,33,30,3,4,1,0
71538,1179,2,402,341,61,5,1,0
89182,733,4,77,75,2,8,1,0
443865,4489,10,675,644,31,10,1,0
584724,2739,10,384,356,28,11,1,0
0,0,0,0,0,0,0,0,0
33810,377,4,80,52,28,0,1,0
232127,341,0,17,8,9,0,1,0
110617,974,10,150,136,14,6,1,0
0,0,0,0,0,0,0,0,0
1046832,5097,14,731,550,181,76,1,0
507930,1487,16,266,238,28,29,1,0
0,0,0,0,0,0,0,0,0
0,0,0,0,0,0,0,0,0
0,0,0,0,0,0,0,0,0
0,0,0,0,0,0,0,0,0
0,0,0,0,0,0,0,0,0
389552,6148,7,1595,1583,12,12,1,0
333042,1862,6,554,547,7,48,1,0
283642,2650,12,321,307,14,6,1,0
0,0,0,0,0,0,0,0,0
0,0,0,0,0,0,0,0,0
134385,979,2,119,37,82,6,1,0
254473,1379,4,219,135,84,0,1,0
156261,3121,1,870,849,21,0,1,0
140055,1588,4,261,246,15,9,1,0
39201,486,0,113,104,9,1,1,0
4806,40,2,3,3,0,0,0,0
29577,256,1,61,21,40,0,1,0
19464,161,1,37,7,30,1,1,0
905441,2967,11,291,251,40,29,1,0
93052,431,7,114,111,3,4,1,0
30537,208,10,25,22,3,4,1,0
44586,328,0,7,4,3,0,1,0
77182,876,4,206,139,67,1,1,0
77799,321,1,82,80,2,3,1,0
75903,1189,3,293,269,24,6,0,0
92964,586,5,113,113,0,8,1,0
52947,310,5,47,45,2,5,1,0
0,0,0,0,0,0,0,0,0
0,0,0,0,0,0,0,0,0
406634,621,1,56,56,0,1,0,0
118248,121,2,3,3,0,0,1,0
269864,2277,3,658,581,77,8,1,0
2143877,2748,10,200,163,37,3,1,0
223785,2223,2,317,289,28,30,0,0
915412,1689,1,210,196,14,3,1,0
850273,941,3,88,55,33,7,1,0
0,0,0,0,0,0,0,0,0
616681,4816,1,645,624,21,8,1,0
23522,277,4,21,20,1,0,1,0
62205,927,7,171,25,146,8,1,0
0,0,0,0,0,0,0,0,0
21250,219,1,17,14,3,2,0,0
235383,1136,2,226,165,61,2,0,0
564377,1471,3,252,242,10,13,1,0
179906,1323,3,387,354,33,3,1,0
1845009,67087,8,16712,478,16234,40,1,0
189100,911,8,217,205,12,2,1,0
347466,1695,3,153,18,135,2,1,0
165699,730,5,54,54,0,0,1,0
0,0,0,0,0,0,0,0,0
551531,4155,7,432,380,52,175,1,0
0,0,0,0,0,0,0,0,0
308236,1907,5,389,378,11,2,0,0
556229,4029,1,307,296,11,1,0,0
188135,594,11,71,69,2,25,1,0
141247,747,6,157,92,65,13,1,0
60778,186,9,6,4,2,1,0,0
0,0,0,0,0,0,0,0,0
0,0,0,0,0,0,0,0,0
99679,431,1,25,19,6,1,1,0
215158,2571,9,429,323,106,12,0,0
0,0,0,0,0,0,0,0,0
108160,1503,5,234,210,24,1,1,0
16594,97,3,6,3,3,5,0,0
0,0,0,0,0,0,0,0,0
0,0,0,0,0,0,0,0,0
50551,428,6,58,54,4,3,1,0
452008,1364,8,188,177,11,28,1,0
42170,560,7,143,137,6,8,1,0
0,0,0,0,0,0,0,0,0
155292,442,7,59,56,3,1,1,0
569891,3664,5,721,700,21,8,1,0
230301,2983,7,656,631,25,3,1,0
0,0,0,0,0,0,0,0,0
174880,3919,1,1132,1131,1,3,0,0
177215,3941,1,1132,1132,0,3,0,0
0,0,0,0,0,0,0,0,0
7760,90,3,8,8,0,0,1,0
0,0,0,0,0,0,0,0,0
24155,256,3,51,51,0,5,0,0
24883,263,3,54,51,3,5,0,0
0,0,0,0,0,0,0,0,0
778991,9223,9,2010,793,1217,4,1,0
47654,280,8,15,15,0,3,1,0
13807,178,5,39,31,8,0,1,0
299814,2141,9,338,322,16,14,1,0
17064,265,4,59,52,7,0,1,0
6790,83,1,7,7,0,2,1,0
449373,824,2,168,123,45,3,0,0
270140,191,0,0,0,0,1,1,0
238377,2245,2,523,466,57,64,0,0
0,0,0,0,0,0,0,0,0
761720,3168,9,358,315,43,0,1,0
478318,2882,3,605,575,30,6,0,0
301682,1870,2,395,388,7,8,1,1
113757,1611,3,241,230,11,4,1,0
24810,326,3,91,78,13,3,1,0
0,0,0,0,0,0,0,0,0
149509,1253,6,201,178,23,25,1,0
149442,1253,6,201,178,23,25,1,0
1805264,3373,6,347,1,346,37,1,0
5482,36,0,0,0,0,0,1,0
175517,888,1,280,248,32,21,1,0
281055,1505,4,238,234,4,8,1,0
30166,306,4,72,69,3,3,1,0
372432,2106,3,237,205,32,12,1,0
56347,521,3,129,105,24,5,1,0
9050,71,6,0,0,0,0,0,0
0,0,0,0,0,0,0,0,0
0,0,0,0,0,0,0,0,0
0,0,0,0,0,0,0,0,0
325247,2901,5,252,203,49,104,0,0
453756,1050,3,114,110,4,4,1,0
0,0,0,0,0,0,0,0,0
23470,37,0,2,1,1,0,1,0
29901,138,9,14,13,1,0,1,0
455295,2493,6,543,496,47,4,1,0
571262,1993,3,617,591,26,2,1,0
386632,2319,4,557,531,26,11,1,0
0,0,0,0,0,0,0,0,0
119023,1860,4,257,211,46,6,1,0
195765,2499,5,598,596,2,0,1,0
0,0,0,0,0,0,0,0,0
205250,1455,9,189,145,44,13,0,0
71702,2040,2,572,568,4,2,1,0
141281,974,3,160,159,1,0,1,0
0,0,0,0,0,0,0,0,0
56133,724,1,128,117,11,1,0,0
98878,956,2,58,43,15,0,1,0
860680,3862,9,637,614,23,73,1,0
851223,3353,8,611,579,32,87,1,0
981234,5786,6,1035,981,54,8,1,0
116591,1879,2,213,206,7,1,0,0
0,0,0,0,0,0,0,0,0
112148,888,0,211,135,76,3,1,0
412735,3198,13,849,823,26,14,0,0
386622,3045,13,912,882,30,32,0,0
3016,31,2,5,4,1,0,1,0
5303,68,1,3,0,3,1,1,0
0,0,0,0,0,0,0,0,0
9516,164,0,41,41,0,0,0,0
79827,510,11,103,98,5,23,1,0
93383,453,4,80,80,0,0,1,0
407032,3491,12,661,127,534,9,1,0
388030,2935,12,681,582,99,5,1,0
108938,1243,0,354,354,0,0,1,0
16478,224,0,53,53,0,0,1,0
0,0,0,0,0,0,0,0,0
59765,105,1,3,3,0,0,0,0
0,0,0,0,0,0,0,0,0
186985,1128,11,228,198,30,5,1,0
237031,673,12,128,98,30,9,1,0
582234,1498,1,200,159,41,1,1,0
432410,3579,10,460,429,31,7,1,0
122945,2201,2,756,752,4,1,1,0
1823485,754,7,44,35,9,7,1,0
0,0,0,0,0,0,0,0,0
0,0,0,0,0,0,0,0,0
0,0,0,0,0,0,0,0,0
0,0,0,0,0,0,0,0,0
105200,90,0,14,13,1,6,0,0
198066,1537,9,212,193,19,5,1,0
0,0,0,0,0,0,0,0,0
109414,422,4,106,90,16,1,1,0
8860,103,3,7,7,0,3,0,0
273392,1360,10,263,253,10,12,1,0
112240,792,7,239,222,17,0,1,0
96905,619,7,219,205,14,0,1,0
0,0,0,0,0,0,0,0,0
472532,5708,4,1118,1116,2,0,1,0
916763,521,10,27,25,2,4,1,0
0,0,0,0,0,0,0,0,0
867936,2665,9,322,68,254,49,1,0
0,0,0,0,0,0,0,0,0
76662,586,4,82,81,1,0,1,0
310961,797,4,113,112,1,49,1,0
206435,1601,8,389,375,14,17,1,0
183165,1279,9,192,183,9,20,1,0
1137023,9060,5,1962,1949,13,4,1,0
389095,1073,3,182,174,8,0,1,0
374530,895,3,158,150,8,0,1,0
601708,11933,5,3735,3734,1,6,1,1
542258,10857,5,3543,3531,12,5,1,0
30333,141,1,10,1,9,1,1,0
54148,258,0,16,8,8,3,0,0
172148,1708,8,470,460,10,8,1,0
108925,538,8,80,66,14,3,0,0
182932,311,7,33,25,8,4,0,0
0,0,0,0,0,0,0,0,0
360321,3978,10,391,352,39,11,1,0
88041,192,4,12,11,1,6,1,0
42938,436,8,97,87,10,6,1,0
0,0,0,0,0,0,0,0,0
365868,1885,3,146,146,0,16,1,0
47750,253,2,31,31,0,5,1,0
46701,445,4,17,10,7,4,1,0
46718,445,4,17,10,7,4,1,0
0,0,0,0,0,0,0,0,0
36004,481,7,54,50,4,0,1,0
33530,405,9,52,48,4,2,1,0
406008,612,4,90,86,4,21,1,0
27502,427,4,40,30,10,0,1,0
0,0,0,0,0,0,0,0,0
471655,3831,5,442,427,15,11,1,0
91176,610,5,173,172,1,12,1,0
1351294,3584,5,506,464,42,1,1,0
285152,4030,7,953,865,88,80,1,0
5408,76,3,4,4,0,0,0,0
0,0,0,0,0,0,0,0,0
0,0,0,0,0,0,0,0,0
0,0,0,0,0,0,0,0,0
0,0,0,0,0,0,0,0,0
147946,979,6,274,249,25,0,1,0
0,0,0,0,0,0,0,0,0
0,0,0,0,0,0,0,0,0
561310,3297,4,364,353,11,3,0,0
0,0,0,0,0,0,0,0,0
471979,1055,2,45,6,39,7,0,0
259369,895,8,42,41,1,11,1,0
0,0,0,0,0,0,0,0,0
113556,1921,6,287,281,6,1,1,0
0,0,0,0,0,0,0,0,0
106450,1244,9,161,144,17,5,1,0
197218,708,10,89,71,18,10,0,0
0,0,0,0,0,0,0,0,0
1405522,2972,12,381,368,13,21,1,0
0,0,0,0,0,0,0,0,0
826397,2721,9,338,296,42,2,1,0
29327,136,5,8,7,1,2,0,0
75988,487,13,72,61,11,2,1,0
0,0,0,0,0,0,0,0,0
445376,1131,2,96,84,12,1,1,0
0,0,0,0,0,0,0,0,0
0,0,0,0,0,0,0,0,0
4769743,4562,2,455,289,166,12,1,0
322687,1826,5,457,454,3,7,1,0
0,0,0,0,0,0,0,0,0
0,0,0,0,0,0,0,0,0
300058,1225,0,185,173,12,0,1,0
0,0,0,0,0,0,0,0,0
0,0,0,0,0,0,0,0,0
307783,1867,6,297,56,241,76,1,0
384388,3596,8,781,738,43,2,1,0
0,0,0,0,0,0,0,0,0
0,0,0,0,0,0,0,0,0
0,0,0,0,0,0,0,0,0
171256,537,5,46,42,4,8,1,0
334525,1721,2,237,209,28,2,1,0
208304,944,2,37,18,19,2,1,0
287397,3035,6,830,800,30,19,1,0
151465,1702,8,505,500,5,11,1,0
526443,932,12,223,206,17,2,1,0
56149,589,3,100,97,3,4,1,0
0,0,0,0,0,0,0,0,0
0,0,0,0,0,0,0,0,0
0,0,0,0,0,0,0,0,0
93522,527,5,65,57,8,7,1,0
0,0,0,0,0,0,0,0,0
0,0,0,0,0,0,0,0,0
1632,11,0,1,1,0,0,0,0
130151,681,3,101,89,12,0,1,0
0,0,0,0,0,0,0,0,0
64323,407,4,65,44,21,3,0,0
1221779,6005,2,472,432,40,3,1,0
0,0,0,0,0,0,0,0,0
483136,2126,4,283,267,16,5,1,0
289945,1739,4,123,121,2,5,0,0
204891,2273,2,929,924,5,2,1,0
681639,3791,15,618,450,168,16,1,0
170138,183,1,64,34,30,0,1,0
0,0,0,0,0,0,0,0,0
0,0,0,0,0,0,0,0,0
0,0,0,0,0,0,0,0,0
0,0,0,0,0,0,0,0,0
100400,653,11,103,92,11,4,1,0
201363,1977,6,369,352,17,47,1,0
103805,387,5,16,15,1,41,1,0
69951,1269,4,413,412,1,1,1,0
74267,322,1,9,2,7,9,1,0
120678,1404,1,286,244,42,0,1,0
167046,1774,7,418,326,92,7,1,0
0,0,0,0,0,0,0,0,0
1427880,1155,2,167,158,9,0,1,0
377099,91,0,2,2,0,0,1,0
138384,1125,9,248,242,6,2,1,0
31936,395,8,81,75,6,1,1,0
0,0,0,0,0,0,0,0,0
0,0,0,0,0,0,0,0,0
0,0,0,0,0,0,0,0,0
299781,1663,9,60,51,9,14,1,0
3444886,4927,5,102,102,0,383,1,0
29663,176,5,11,9,2,6,0,0
0,0,0,0,0,0,0,0,0
436457,3654,3,344,298,46,27,1,0
270933,996,4,125,112,13,32,0,0
223877,1249,17,244,237,7,10,1,0
131653,504,5,8,7,1,0,1,0
14304,212,4,72,72,0,2,1,0
208299,945,8,120,110,10,0,1,0
17528,56,1,0,0,0,0,0,0
638780,1177,4,201,188,13,9,1,0
53675,398,3,49,41,8,0,1,0
2967,30,0,3,2,1,0,1,0
24871,218,0,49,4,45,2,1,0
231872,2514,3,651,537,114,1,1,0
245161,987,1,74,39,35,0,0,0
0,0,0,0,0,0,0,0,0
0,0,0,0,0,0,0,0,0
145232,1843,6,113,99,14,12,1,0
1330630,1033,2,132,124,8,0,1,0
1264511,167,2,26,19,7,0,1,0
82022,796,5,114,111,3,6,0,0
565193,1720,4,271,261,10,7,0,0
1446018,4915,9,391,330,61,1,1,0
1807195,3550,7,267,257,10,31,1,0
349904,306,6,4,4,0,11,1,0
0,0,0,0,0,0,0,0,0
70426,413,7,52,52,0,0,1,0
222750,905,8,116,96,20,2,1,0
278911,2208,0,279,258,21,4,1,0
15250,180,2,25,22,3,1,1,0
20967,322,4,72,62,10,0,1,0
0,0,0,0,0,0,0,0,0
22895,666,3,270,232,38,0,1,0
226293,1509,2,268,250,18,1,1,0
267025,1216,2,135,117,18,1,1,0
337240,2504,1,224,184,40,32,0,0
291131,2688,5,596,15,581,1,1,0
143226,1132,4,246,246,0,11,1,0
426135,2406,0,138,131,7,23,1,0
100048,2032,2,439,431,8,8,1,0
346618,2448,6,247,242,5,23,1,0
187518,340,6,11,9,2,6,1,0
0,0,0,0,0,0,0,0,0
187600,1987,1,407,380,27,0,1,0
0,0,0,0,0,0,0,0,0
1669333,182,1,2,0,2,1,0,0
189107,679,1,113,113,0,0,1,0
694188,4848,7,835,821,14,41,1,0
244813,2168,4,515,469,46,7,1,0
68156,301,3,40,34,6,5,1,0
250332,1419,12,360,346,14,48,1,0
0,0,0,0,0,0,0,0,0
0,0,0,0,0,0,0,0,0
0,0,0,0,0,0,0,0,0
146798,1195,6,141,83,58,2,0,0
0,0,0,0,0,0,0,0,0
644279,492,2,75,65,10,5,1,0
269096,1289,9,277,266,11,12,1,0
64608,64,2,2,2,0,0,1,0
464742,1668,7,123,112,11,94,1,0
221420,1251,5,173,139,34,9,1,0
119754,842,7,142,71,71,3,0,0
75617,611,4,60,40,20,2,1,0
4268,34,2,0,0,0,0,0,0
0,0,0,0,0,0,0,0,0
77827,1119,5,240,69,171,5,1,0
0,0,0,0,0,0,0,0,0
177895,1530,3,356,347,9,10,1,0
801542,4363,6,1144,1097,47,101,0,0
0,0,0,0,0,0,0,0,0
879955,3622,1,263,170,93,4,1,0
91722,294,0,12,6,6,1,1,0
104353,1069,8,221,201,20,3,1,0
22522,413,2,113,104,9,3,1,0
0,0,0,0,0,0,0,0,0
103113,867,10,157,151,6,1,1,0
28497,95,1,6,4,2,10,0,0
0,0,0,0,0,0,0,0,0
2208388,1871,4,271,203,68,24,1,0
0,0,0,0,0,0,0,0,0
0,0,0,0,0,0,0,0,0
173083,1387,9,308,288,20,11,0,0
0,0,0,0,0,0,0,0,0
0,0,0,0,0,0,0,0,0
614217,2215,2,250,214,36,4,1,0
0,0,0,0,0,0,0,0,0
214382,616,2,59,59,0,1,0,0
345303,774,3,62,61,1,3,0,0
370462,3952,5,588,528,60,4,1,0
0,0,0,0,0,0,0,0,0
0,0,0,0,0,0,0,0,0
470567,2387,3,792,783,9,2,1,0
172068,2475,10,490,385,105,4,1,0
44218,161,3,3,3,0,1,0,0
811678,4528,6,464,430,34,80,1,0
6845,81,0,13,13,0,0,1,0
3754,50,2,8,8,0,0,0,0
5240,65,2,10,9,1,0,1,0
0,0,0,0,0,0,0,0,0
0,0,0,0,0,0,0,0,0
134994,1626,14,312,247,65,8,1,0
444060,2669,10,669,581,88,12,0,0
191521,477,9,104,90,14,13,0,0
0,0,0,0,0,0,0,0,0
58778,584,7,141,114,27,13,1,0
12170,213,2,38,36,2,0,1,0
12265,225,2,38,36,2,0,1,0
857766,1836,10,186,167,19,25,1,0
381666,5042,3,1453,1450,3,21,0,0
16643,157,3,22,22,0,0,0,0
9762,247,0,77,54,23,0,1,0
201428,1057,16,135,124,11,17,1,0
1900791,6549,9,1321,1191,130,22,0,0
55557,704,3,87,74,13,8,1,0
160961,2227,6,668,667,1,19,1,0
188051,602,5,48,16,32,2,1,0
43303,770,2,183,116,67,4,1,0
62377,536,10,120,95,25,5,1,0
222042,934,8,178,168,10,8,1,0
1969,28,2,2,1,1,0,1,0
0,0,0,0,0,0,0,0,0
0,0,0,0,0,0,0,0,0
480008,2855,6,299,283,16,2,1,0
0,0,0,0,0,0,0,0,0
388240,2952,7,325,278,47,13,1,1
127658,198,7,8,8,0,2,0,0
166004,1834,9,336,325,11,4,1,0
92547,709,9,157,146,11,6,1,0
288169,1416,5,382,351,31,4,1,0
0,0,0,0,0,0,0,0,0
60701,444,1,65,62,3,0,0,0
228116,607,3,87,74,13,1,1,0
51165,433,7,44,24,20,0,1,0
199203,2383,5,217,102,115,9,1,0
30993,216,5,36,32,4,3,1,0
77061,514,1,88,85,3,1,1,0
0,0,0,0,0,0,0,0,0
0,0,0,0,0,0,0,0,0
185265,974,6,92,5,87,2,1,0
0,0,0,0,0,0,0,0,0
0,0,0,0,0,0,0,0,0
0,0,0,0,0,0,0,0,0
0,0,0,0,0,0,0,0,0
0,0,0,0,0,0,0,0,0
197881,1682,5,458,220,238,13,1,0
60748,972,2,258,224,34,1,0,0
6844,110,2,23,15,8,0,0,0
95978,659,1,234,183,51,1,1,0
88031,620,2,7,7,0,3,0,0
0,0,0,0,0,0,0,0,0
206539,832,9,134,98,36,1,1,0
0,0,0,0,0,0,0,0,0
98795,926,10,167,119,48,3,1,0
0,0,0,0,0,0,0,0,0
0,0,0,0,0,0,0,0,0
0,0,0,0,0,0,0,0,0
527275,2403,0,89,87,2,0,1,0
58624,233,0,11,10,1,0,1,0
226413,590,10,88,81,7,14,1,0
123183,672,2,99,81,18,3,1,0
0,0,0,0,0,0,0,0,0
405993,915,5,63,55,8,7,1,0
424807,1082,5,64,56,8,8,1,0
12068,233,1,73,73,0,0,1,0
12274,126,4,23,19,4,0,1,0
13007,142,4,24,20,4,0,1,0
0,0,0,0,0,0,0,0,0
514769,4330,1,396,378,18,80,1,0
0,0,0,0,0,0,0,0,0
191750,2027,16,446,369,77,19,1,0
31120,158,6,8,7,1,5,0,0
40915,239,5,17,17,0,0,1,0
12409,134,4,14,14,0,0,1,0
55796,477,5,71,67,4,0,1,0
15217,175,3,43,41,2,3,1,0
11182,118,5,14,13,1,0,1,0
666038,2308,7,475,394,81,6,1,0
78447,406,3,62,21,41,6,1,0
140354,809,4,71,69,2,62,1,0
0,0,0,0,0,0,0,0,0
92857,332,2,23,20,3,0,0,0
144619,689,4,73,55,18,2,1,0
144631,689,4,73,55,18,2,1,0
616774,3206,3,274,248,26,129,1,0
53052,171,2,6,6,0,2,1,0
111423,670,4,132,131,1,0,0,0
228490,1540,7,264,229,35,1,1,0
928140,4186,11,432,420,12,19,1,0
19805,104,0,2,2,0,2,0,0
1472232,1271,2,176,167,9,4,1,0
355424,101,0,3,3,0,0,1,0
35267,519,4,195,194,1,0,1,0
10598,165,4,38,37,1,0,1,0
97638,498,7,40,34,6,8,1,0
26748,171,8,27,19,8,1,1,0
400129,1849,8,124,109,15,24,1,0
88117,67,0,9,4,5,5,0,0
245846,977,2,198,194,4,4,1,0
0,0,0,0,0,0,0,0,0
0,0,0,0,0,0,0,0,0
253105,1882,3,560,509,51,7,0,0
0,0,0,0,0,0,0,0,0
604502,3695,4,644,629,15,7,1,0
0,0,0,0,0,0,0,0,0
0,0,0,0,0,0,0,0,0
0,0,0,0,0,0,0,0,0
0,0,0,0,0,0,0,0,0
49037,541,6,322,317,5,16,1,0
280039,1538,6,186,179,7,46,1,0
232699,343,0,17,11,6,0,1,0
0,0,0,0,0,0,0,0,0
58167,512,5,206,5,201,0,1,0
948257,2034,6,294,237,57,4,1,0
134968,1308,7,262,238,24,4,1,0
6172,51,4,5,5,0,0,1,0
86521,444,8,9,8,1,1,1,0
410430,1963,24,273,178,95,19,0,0
0,0,0,0,0,0,0,0,0
124486,843,14,92,76,16,12,1,0
993914,9563,4,3677,1638,2039,0,1,1
0,0,0,0,0,0,0,0,0
108207,682,7,178,172,6,4,0,0
0,0,0,0,0,0,0,0,0
269052,1459,1,223,192,31,7,1,0
0,0,0,0,0,0,0,0,0
251469,1182,2,240,197,43,2,1,0
28582,195,0,17,6,11,4,1,0
11793,178,3,26,18,8,0,1,0
217638,2678,5,536,7,529,17,0,0
645596,14895,6,127,124,3,16,1,0
9036,217,3,56,56,0,1,1,0
174769,812,13,140,126,14,0,1,0
49860,481,5,44,42,2,6,0,0
111370,1136,8,263,263,0,9,1,0
0,0,0,0,0,0,0,0,0
73877,778,12,199,135,64,0,1,0
264995,2701,1,335,215,120,3,0,0
306125,1172,2,170,112,58,3,1,0
0,0,0,0,0,0,0,0,0
0,0,0,0,0,0,0,0,0
0,0,0,0,0,0,0,0,0
212269,3303,7,740,684,56,4,0,0
110889,1917,6,410,405,5,4,0,0
199187,1623,8,330,327,3,14,1,0
7402,60,4,3,3,0,1,1,0
23741,418,3,118,108,10,0,1,0
0,0,0,0,0,0,0,0,0
0,0,0,0,0,0,0,0,0
131955,1661,9,220,152,68,6,1,0
58434,421,7,80,66,14,3,1,0
182962,742,10,87,73,14,16,1,0
0,0,0,0,0,0,0,0,0
33568,323,0,76,72,4,0,1,0
181294,1913,3,96,35,61,6,1,0
149326,369,6,5,3,2,10,0,0
319393,1647,2,333,309,24,9,1,0
281719,856,15,155,145,10,26,1,0
0,0,0,0,0,0,0,0,0
0,0,0,0,0,0,0,0,0
0,0,0,0,0,0,0,0,0
75475,338,2,28,25,3,7,1,0
37106,469,4,79,67,12,0,1,0
0,0,0,0,0,0,0,0,0
39573,564,1,105,97,8,0,1,0
31900,245,3,60,56,4,0,1,0
0,0,0,0,0,0,0,0,0
609063,2633,1,390,283,107,2,1,0
0,0,0,0,0,0,0,0,0
94953,989,0,357,353,4,0,0,0
0,0,0,0,0,0,0,0,0
107920,533,1,19,19,0,1,0,0
93170,1681,7,91,86,5,0,1,0
40168,356,9,24,20,4,6,1,0
317872,2830,4,708,695,13,9,1,0
78012,1302,2,467,456,11,6,1,0
0,0,0,0,0,0,0,0,0
0,0,0,0,0,0,0,0,0
99111,1084,6,219,209,10,11,1,0
0,0,0,0,0,0,0,0,0
35536,279,0,48,48,0,2,1,0
0,0,0,0,0,0,0,0,0
243124,1159,4,167,155,12,2,1,0
0,0,0,0,0,0,0,0,0
130199,863,9,32,10,22,0,1,0
221751,1390,4,118,60,58,0,1,0
50958,175,6,4,3,1,0,0,0
412328,1565,9,231,177,54,23,1,0
42231,296,5,83,62,21,0,0,0
231611,341,0,17,10,7,0,1,0
0,0,0,0,0,0,0,0,0
142628,585,8,49,48,1,13,0,0
441658,1087,10,231,222,9,14,1,0
150552,1221,8,216,211,5,16,1,0
119296,893,6,175,171,4,16,1,0
294893,1507,11,137,110,27,17,1,0
205939,617,11,54,48,6,17,1,0
426145,3460,13,415,403,12,32,0,0
0,0,0,0,0,0,0,0,0
94282,80,3,2,0,2,2,0,0
458666,2129,3,359,349,10,4,0,0
289491,2187,4,300,280,20,1,0,0
0,0,0,0,0,0,0,0,0
559301,2841,11,446,439,7,23,1,1
0,0,0,0,0,0,0,0,0
184360,1268,3,229,224,5,0,1,0
0,0,0,0,0,0,0,0,0
34337,603,4,133,127,6,0,1,0
197498,285,5,69,63,6,2,1,0
55012,633,4,44,43,1,0,1,0
20609,208,5,21,21,0,4,1,0
19671,304,3,45,40,5,2,0,0
266082,885,6,222,209,13,15,0,0
0,0,0,0,0,0,0,0,0
176802,1245,1,85,50,35,1,1,0
0,0,0,0,0,0,0,0,0
55390,883,0,41,39,2,0,1,0
122026,1161,9,261,235,26,1,1,0
0,0,0,0,0,0,0,0,0
0,0,0,0,0,0,0,0,0
0,0,0,0,0,0,0,0,0
0,0,0,0,0,0,0,0,0
49831,548,6,75,63,12,2,0,0
0,0,0,0,0,0,0,0,0
0,0,0,0,0,0,0,0,0
183169,2213,3,763,743,20,3,0,0
415375,2698,12,420,403,17,5,1,0
849608,5056,11,1460,1415,45,265,1,0
16543,37,0,0,0,0,0,0,0
200419,1227,7,51,31,20,10,1,0
15110,110,4,4,2,2,4,0,0
106719,786,4,178,175,3,9,1,0
0,0,0,0,0,0,0,0,0
17528,56,1,0,0,0,0,0,0
0,0,0,0,0,0,0,0,0
249165,2288,5,312,269,43,1,1,0
47742,349,4,48,27,21,1,0,0
0,0,0,0,0,0,0,0,0
111474,974,8,101,95,6,28,1,0
4086729,3540,5,370,322,48,3,1,0
589365,1107,6,225,185,40,3,1,0
0,0,0,0,0,0,0,0,0
0,0,0,0,0,0,0,0,0
16736,272,1,48,36,12,1,1,0
68772,845,4,227,112,115,3,1,0
118049,628,2,194,191,3,7,1,0
440912,2525,1,186,169,17,0,1,0
569,7,0,0,0,0,0,0,0
0,0,0,0,0,0,0,0,0
224771,2680,10,306,292,14,41,1,0
82049,619,9,86,71,15,36,1,0
168344,670,0,21,19,2,0,1,0
0,0,0,0,0,0,0,0,0
24148,172,1,23,14,9,3,1,0
233266,1231,9,268,262,6,13,1,0
56714,354,5,33,32,1,9,1,0
417024,1528,4,304,283,21,0,1,0
69708,777,1,60,46,14,0,0,0
4096,48,3,1,1,0,4,0,0
167629,1142,4,251,237,14,12,1,0
0,0,0,0,0,0,0,0,0
0,0,0,0,0,0,0,0,0
297138,1435,13,186,168,18,17,0,0
0,0,0,0,0,0,0,0,0
0,0,0,0,0,0,0,0,0
84638,575,6,79,35,44,1,1,0
185437,1250,4,164,2,162,0,1,0
936220,7653,4,563,518,45,2,1,0
0,0,0,0,0,0,0,0,0
25816,247,0,37,27,10,4,1,0
807725,2081,7,178,167,11,4,1,0
775396,212,6,2,2,0,3,1,0
433952,1095,5,24,20,4,0,1,0
29051,101,2,2,0,2,0,1,0
0,0,0,0,0,0,0,0,0
134926,1082,5,115,67,48,4,1,0
169040,786,3,75,62,13,7,1,0
74729,78,1,3,3,0,0,1,0
0,0,0,0,0,0,0,0,0
291090,2659,5,590,15,575,2,1,0
15457,125,8,23,21,2,0,1,0
0,0,0,0,0,0,0,0,0
51268,377,8,57,51,6,15,1,0
171399,1212,11,270,171,99,3,1,0
0,0,0,0,0,0,0,0,0
67907,629,7,111,102,9,12,1,0
0,0,0,0,0,0,0,0,0
454069,2911,5,561,558,3,5,1,0
128259,181,2,14,13,1,0,1,0
246980,4193,1,1984,1975,9,27,1,0
154336,611,4,42,42,0,0,1,0
208826,890,3,160,147,13,27,1,0
1032521,906,2,50,46,4,0,1,0
249182,1437,2,219,187,32,3,1,0
0,0,0,0,0,0,0,0,0
39620,403,5,44,38,6,7,1,0
21685,214,2,62,62,0,0,1,0
90666,686,0,133,129,4,6,1,0
87444,610,0,133,129,4,5,1,0
223346,2643,7,315,293,22,2,0,0
6550,60,3,6,6,0,2,0,0
257225,2205,7,479,413,66,6,1,0
14891,163,3,24,3,21,0,1,0
275323,886,8,88,56,32,4,1,0
7417,90,6,0,0,0,5,0,0
0,0,0,0,0,0,0,0,0
21045,298,1,15,15,0,1,1,0
262040,1647,4,367,276,91,17,1,0
0,0,0,0,0,0,0,0,0
5469720,36551,3,3524,2007,1517,7,1,0
47109,132,8,3,0,3,0,1,0
144630,464,1,56,50,6,16,1,0
11563,90,1,10,9,1,2,0,0
188207,925,5,187,172,15,3,1,0
1276694,5034,11,178,162,16,19,0,0
254005,455,11,17,12,5,18,0,0
210344,776,4,105,103,2,0,0,0
547998,4025,3,676,660,16,2,0,0
168876,972,6,139,134,5,6,1,0
83862,239,3,11,11,0,0,1,0
307320,1195,9,201,178,23,29,1,1
0,0,0,0,0,0,0,0,0
78843,964,5,237,235,2,1,1,0
133928,95,1,2,2,0,0,1,0
651265,3388,2,590,546,44,2,1,0
239324,669,3,96,4,92,0,1,0
384767,1227,0,248,187,61,0,1,0
39187,438,0,88,80,8,2,1,0
92374,231,7,24,19,5,1,1,0
13535,114,4,6,6,0,0,0,0
0,0,0,0,0,0,0,0,0
0,0,0,0,0,0,0,0,0
0,0,0,0,0,0,0,0,0
412953,3386,2,956,814,142,0,1,0
21953,239,6,38,32,6,1,1,0
0,0,0,0,0,0,0,0,0
1051664,1586,10,224,208,16,23,1,0
253624,1786,3,390,385,5,13,0,0
0,0,0,0,0,0,0,0,0
41947,404,6,59,52,7,4,1,0
245082,495,1,184,104,80,2,1,0
159572,61,0,2,2,0,0,1,0
0,0,0,0,0,0,0,0,0
0,0,0,0,0,0,0,0,0
47564,647,5,76,63,13,4,1,0
3039,21,2,0,0,0,0,0,0
213615,1546,6,418,407,11,11,1,0
365043,1104,15,105,100,5,18,1,0
0,0,0,0,0,0,0,0,0
646105,4407,12,1318,1300,18,19,1,0
719217,1283,10,197,136,61,22,1,0
265947,3625,0,383,307,76,10,0,0
89457,644,6,70,40,30,2,1,0
90054,259,0,48,24,24,0,1,1
0,0,0,0,0,0,0,0,0
235673,1813,6,281,261,20,9,0,1
164152,3930,3,1090,1074,16,10,1,0
138660,133,1,11,7,4,3,1,0
10068,64,1,0,0,0,2,0,0
503067,2906,0,168,83,85,3,0,0
60522,159,3,17,5,12,1,0,0
0,0,0,0,0,0,0,0,0
72526,565,5,119,97,22,42,1,0
0,0,0,0,0,0,0,0,0
0,0,0,0,0,0,0,0,0
98146,2012,3,613,554,59,17,1,0
40336,657,0,144,137,7,3,1,0
24782,425,3,85,76,9,7,0,0
0,0,0,0,0,0,0,0,0
3240,39,0,7,7,0,0,0,0
226902,2568,8,761,716,45,14,1,0
24892,195,6,27,27,0,0,1,0
220472,572,3,101,92,9,12,1,0
0,0,0,0,0,0,0,0,0
462919,2096,8,258,245,13,21,1,0
0,0,0,0,0,0,0,0,0
532401,2702,11,203,193,10,20,1,0
0,0,0,0,0,0,0,0,0
227255,1423,6,246,214,32,11,1,0
114656,260,4,13,13,0,2,1,0
0,0,0,0,0,0,0,0,0
0,0,0,0,0,0,0,0,0
0,0,0,0,0,0,0,0,0
106297,1354,8,264,188,76,2,0,0
0,0,0,0,0,0,0,0,0
0,0,0,0,0,0,0,0,0
515533,1088,7,150,141,9,23,1,0
446283,1406,10,207,199,8,10,1,0
679,12,0,1,1,0,0,0,0
25401,87,6,2,0,2,0,0,0
0,0,0,0,0,0,0,0,0
286385,1333,8,203,194,9,33,1,0
136775,1788,7,474,443,31,12,1,0
37219,308,7,66,56,10,5,0,0
111545,1113,4,181,169,12,13,1,0
0,0,0,0,0,0,0,0,0
0,0,0,0,0,0,0,0,0
164636,1450,6,280,255,25,35,1,0
81952,290,5,13,9,4,5,1,0
0,0,0,0,0,0,0,0,0
0,0,0,0,0,0,0,0,0
0,0,0,0,0,0,0,0,0
36393,473,7,103,94,9,3,1,0
83956,652,6,97,95,2,11,1,0
54740,319,5,26,24,2,8,1,0
0,0,0,0,0,0,0,0,0
17205,152,3,3,3,0,0,0,0
0,0,0,0,0,0,0,0,0
17978,87,7,1,1,0,5,0,0
17631,88,7,1,1,0,5,0,0
502543,2465,3,280,251,29,26,1,0
751561,1038,2,136,132,4,0,1,0
380353,129,2,9,8,1,2,1,0
248185,1625,2,359,330,29,22,1,0
36679,685,0,126,93,33,1,1,0
14361,275,0,70,59,11,1,1,0
0,0,0,0,0,0,0,0,0
0,0,0,0,0,0,0,0,0
0,0,0,0,0,0,0,0,0
0,0,0,0,0,0,0,0,0
194292,805,9,143,129,14,13,1,0
658900,2338,7,529,414,115,9,1,0
2999,46,3,3,3,0,0,0,0
231386,1898,6,402,395,7,4,0,0
83425,840,6,86,71,15,1,1,0
1032316,4055,8,411,347,64,13,1,0
398448,1483,18,309,293,16,23,1,0
31132,589,0,49,27,22,0,1,0
2856,53,0,4,2,2,0,0,0
174763,3323,2,816,813,3,13,1,0
109976,1236,7,335,324,11,7,1,0
0,0,0,0,0,0,0,0,0
9347,176,2,18,18,0,0,0,0
8018,88,1,11,10,1,1,1,0
184744,1394,6,280,257,23,11,1,0
0,0,0,0,0,0,0,0,0
63518,731,6,259,258,1,5,1,0
198756,543,6,13,9,4,49,0,0
46332,526,8,65,65,0,6,1,0
0,0,0,0,0,0,0,0,0
752768,1116,4,81,36,45,3,1,0
26696,95,2,8,6,2,1,0,0
74075,158,7,6,6,0,8,1,0
57415,306,6,0,0,0,11,0,0
313617,1967,3,80,79,1,60,0,0
1176476,1969,2,409,341,68,55,1,0
402333,628,2,176,148,28,3,1,0
361463,2452,10,323,317,6,16,1,0
34995,248,5,47,4,43,5,1,0
32592,229,5,45,22,23,5,1,0
22565,34,0,1,1,0,0,1,0
64744,1697,1,357,353,4,0,0,0
0,0,0,0,0,0,0,0,0
0,0,0,0,0,0,0,0,0
13042,155,2,30,30,0,2,1,0
297220,2203,3,539,415,124,7,1,0
435887,6640,10,1508,1167,341,7,1,0
0,0,0,0,0,0,0,0,0
0,0,0,0,0,0,0,0,0
0,0,0,0,0,0,0,0,0
0,0,0,0,0,0,0,0,0
0,0,0,0,0,0,0,0,0
200247,3051,5,552,41,511,9,0,1
62256,585,5,92,28,64,10,0,0
0,0,0,0,0,0,0,0,0
847330,792,2,73,55,18,0,1,0
0,0,0,0,0,0,0,0,0
0,0,0,0,0,0,0,0,0
0,0,0,0,0,0,0,0,0
13019,28,0,0,0,0,0,0,0
7683,86,1,6,3,3,0,0,0
0,0,0,0,0,0,0,0,0
0,0,0,0,0,0,0,0,0
0,0,0,0,0,0,0,0,0
2544627,7101,2,682,649,33,62,1,0
0,0,0,0,0,0,0,0,0
0,0,0,0,0,0,0,0,0
128274,990,2,281,249,32,4,1,0
406055,957,1,155,104,51,8,1,0
78650,108,1,10,7,3,2,0,0
124633,874,8,165,148,17,3,1,0
21150,228,3,33,30,3,3,1,0
369953,1219,6,133,117,16,1,1,0
0,0,0,0,0,0,0,0,0
84193,1052,5,213,189,24,3,0,0
0,0,0,0,0,0,0,0,0
267355,3047,7,467,461,6,3,1,0
64453,627,7,179,174,5,3,1,0
0,0,0,0,0,0,0,0,0
806974,5009,20,960,934,26,42,1,0
806943,5010,20,960,934,26,42,1,0
0,0,0,0,0,0,0,0,0
98356,780,10,112,105,7,6,0,0
108647,1165,4,285,279,6,1,1,0
0,0,0,0,0,0,0,0,0
52007,143,2,108,107,1,0,0,0
0,0,0,0,0,0,0,0,0
169520,1455,7,249,226,23,17,1,0
270326,1912,7,243,234,9,47,0,0
72942,880,4,162,134,28,1,0,0
590139,1613,10,127,112,15,1,1,0
307797,2364,4,361,340,21,15,1,0
12904,103,5,2,1,1,3,1,0
115148,332,2,0,0,0,0,1,0
73715,67,3,0,0,0,6,0,0
161277,1069,6,120,85,35,10,0,0
266118,1271,3,121,100,21,1,0,0
39538,189,5,5,5,0,6,1,0
0,0,0,0,0,0,0,0,0
293266,981,1,220,192,28,1,0,0
0,0,0,0,0,0,0,0,0
0,0,0,0,0,0,0,0,0
0,0,0,0,0,0,0,0,0
237577,1743,12,493,478,15,4,0,0
602218,3162,2,297,285,12,2,1,0
127220,2753,1,34,30,4,2,0,0
0,0,0,0,0,0,0,0,0
250521,1346,7,187,176,11,22,1,0
92305,979,4,158,151,7,6,1,0
33694,245,4,57,57,0,0,1,0
0,0,0,0,0,0,0,0,0
63125,420,13,71,61,10,6,1,0
1304289,3955,4,183,172,11,0,1,0
0,0,0,0,0,0,0,0,0
0,0,0,0,0,0,0,0,0
0,0,0,0,0,0,0,0,0
0,0,0,0,0,0,0,0,0
237668,2910,4,732,683,49,77,1,0
93081,846,6,108,100,8,7,1,0
303849,1930,7,431,413,18,23,1,0
411991,4783,4,1336,1309,27,6,1,0
335825,3685,5,1188,1159,29,11,1,0
0,0,0,0,0,0,0,0,0
385557,4329,8,565,544,21,7,1,0
58694,445,8,61,52,9,4,1,0
0,0,0,0,0,0,0,0,0
920440,5052,5,363,350,13,64,1,0
0,0,0,0,0,0,0,0,0
101844,512,4,27,24,3,1,1,0
2500,36,0,4,4,0,0,0,0
196503,1396,4,208,188,20,1,1,0
0,0,0,0,0,0,0,0,0
0,0,0,0,0,0,0,0,0
0,0,0,0,0,0,0,0,0
246852,1756,7,506,464,42,5,1,0
92346,231,5,31,29,2,3,1,0
21895,35,0,1,1,0,0,1,0
0,0,0,0,0,0,0,0,0
0,0,0,0,0,0,0,0,0
0,0,0,0,0,0,0,0,0
296518,1213,5,156,143,13,13,0,0
0,0,0,0,0,0,0,0,0
55565,338,9,37,8,29,0,1,0
0,0,0,0,0,0,0,0,0
157483,652,7,145,144,1,0,1,0
0,0,0,0,0,0,0,0,0
0,0,0,0,0,0,0,0,0
0,0,0,0,0,0,0,0,0
1098516,6371,6,2311,2010,301,9,1,0
469263,2289,9,239,165,74,17,1,0
0,0,0,0,0,0,0,0,0
201562,2897,8,486,295,191,3,0,0
59877,500,7,67,42,25,2,0,0
0,0,0,0,0,0,0,0,0
0,0,0,0,0,0,0,0,0
255505,1661,9,256,105,151,2,1,0
0,0,0,0,0,0,0,0,0
0,0,0,0,0,0,0,0,0
45019,253,8,87,82,5,0,0,0
167800,1164,8,196,146,50,4,1,0
0,0,0,0,0,0,0,0,0
0,0,0,0,0,0,0,0,0
8678,70,6,3,2,1,0,0,0
17503,224,3,40,36,4,2,1,0
16717,222,3,41,36,5,1,1,0
0,0,0,0,0,0,0,0,0
198398,2362,11,380,373,7,2,1,0
0,0,0,0,0,0,0,0,0
1174439,4035,5,187,177,10,38,1,0
474247,4572,10,645,628,17,30,1,0
364335,6076,5,2089,1628,461,91,0,0
230528,340,0,16,3,13,0,1,0
361040,1138,12,149,137,12,38,1,0
172194,754,7,83,83,0,19,1,0
31533,403,5,44,39,5,2,0,0
97443,302,2,22,17,5,0,0,0
84501,279,1,12,5,7,1,0,0
0,0,0,0,0,0,0,0,0
0,0,0,0,0,0,0,0,0
193363,1848,9,301,273,28,3,1,0
129060,869,9,118,103,15,6,1,0
0,0,0,0,0,0,0,0,0
420592,1721,8,156,151,5,39,0,0
0,0,0,0,0,0,0,0,0
0,0,0,0,0,0,0,0,0
13522,158,0,20,11,9,1,1,0
226715,1477,7,239,197,42,4,1,0
114008,960,4,225,27,198,4,1,0
274925,836,4,67,46,21,2,1,0
1157343,7316,5,2930,2895,35,12,1,0
627642,826,4,135,101,34,14,1,0
25818,347,2,38,33,5,3,1,0
477828,4422,9,658,639,19,134,1,0
1125593,29921,3,9817,8,9809,12,0,0
0,0,0,0,0,0,0,0,0
256624,2621,3,381,364,17,1,1,0
178339,590,2,88,25,63,1,1,0
109240,734,3,122,114,8,2,1,0
0,0,0,0,0,0,0,0,0
0,0,0,0,0,0,0,0,0
0,0,0,0,0,0,0,0,0
92436,1467,4,329,324,5,2,1,0
311692,1412,11,192,181,11,3,1,0
0,0,0,0,0,0,0,0,0
0,0,0,0,0,0,0,0,0
136332,1398,4,249,238,11,2,1,0
67692,739,4,112,109,3,6,1,0
79948,967,4,127,106,21,18,1,0
1772150,1761,2,275,271,4,0,1,0
1200301,1256,4,98,0,98,0,1,0
11392,117,0,5,4,1,4,1,0
0,0,0,0,0,0,0,0,0
0,0,0,0,0,0,0,0,0
13699,51,0,0,0,0,0,0,0
178717,1235,8,209,59,150,5,1,0
9712,153,2,25,25,0,0,1,0
38055,523,4,25,24,1,3,1,0
119173,950,7,221,198,23,11,1,0
70800,542,6,145,121,24,6,1,0
18524,318,3,35,26,9,0,1,0
216546,1369,11,341,309,32,9,1,0
49840,101,2,8,0,8,2,0,0
21947,33,0,1,1,0,0,1,0
434538,1865,6,185,157,28,6,1,0
73790,844,4,119,109,10,13,1,0
3422,53,1,3,3,0,0,0,0
0,0,0,0,0,0,0,0,0
206996,979,7,82,6,76,2,1,0
26592,482,5,82,64,18,0,0,0
506515,943,1,112,101,11,0,1,0
347679,861,1,111,100,11,1,1,0
14973,100,2,7,7,0,0,0,0
229310,1620,3,224,200,24,0,0,0
0,0,0,0,0,0,0,0,0
154451,1338,4,313,298,15,4,1,1
48506,434,5,95,83,12,6,1,0
0,0,0,0,0,0,0,0,0
0,0,0,0,0,0,0,0,0
56663,479,8,115,104,11,3,1,0
34489,229,7,44,44,0,3,1,0
105217,974,7,81,61,20,2,1,0
0,0,0,0,0,0,0,0,0
223717,2005,0,307,299,8,2,0,0
46101,452,3,81,50,31,62,1,0
0,0,0,0,0,0,0,0,0
110099,734,8,126,97,29,7,0,0
25589,290,6,49,44,5,2,0,0
0,0,0,0,0,0,0,0,0
70156,848,4,141,140,1,1,1,0
28046,42,0,2,1,1,0,0,0
180926,1053,7,202,179,23,1,1,0
324040,2389,9,407,391,16,2,1,0
76551,669,10,183,182,1,3,0,0
0,0,0,0,0,0,0,0,0
249110,1487,2,184,20,164,3,0,0
81834,416,4,103,100,3,0,1,0
22811,666,3,270,232,38,0,1,0
0,0,0,0,0,0,0,0,0
60884,531,10,102,101,1,0,0,0
285994,1801,12,199,195,4,15,1,0
0,0,0,0,0,0,0,0,0
22668,483,0,134,121,13,0,1,0
4772,97,0,17,15,2,0,1,0
0,0,0,0,0,0,0,0,0
498717,5138,4,962,659,303,4,0,0
8319,126,1,10,1,9,0,0,0
208794,1177,7,481,113,368,0,1,0
0,0,0,0,0,0,0,0,0
75988,678,4,130,127,3,0,1,0
29148,226,4,34,31,3,0,1,0
353074,1323,9,145,134,11,19,1,0
0,0,0,0,0,0,0,0,0
457676,2098,7,439,345,94,0,1,0
0,0,0,0,0,0,0,0,0
99885,714,3,28,18,10,0,0,0
0,0,0,0,0,0,0,0,0
629453,1940,8,238,217,21,11,1,0
612234,1738,8,218,196,22,14,1,0
104282,1579,1,620,620,0,2,1,0
3310,55,1,11,11,0,0,1,0
292292,995,1,221,216,5,1,0,0
166631,938,8,174,162,12,1,1,0
200506,2288,7,592,533,59,9,1,0
0,0,0,0,0,0,0,0,0
178437,2869,4,479,478,1,6,1,0
132180,564,2,133,111,22,1,1,0
1557487,3735,2,481,451,30,1,1,0
0,0,0,0,0,0,0,0,0
30725,420,7,118,115,3,4,1,0
0,0,0,0,0,0,0,0,0
133989,1020,9,193,151,42,14,0,0
656251,4132,4,353,353,0,2,1,0
39810,486,0,113,106,7,1,1,0
4757,40,2,3,3,0,0,0,0
0,0,0,0,0,0,0,0,0
0,0,0,0,0,0,0,0,0
93159,1260,3,82,76,6,2,1,0
18897,53,1,1,1,0,1,0,0
19287,203,3,48,32,16,2,1,0
17617,103,2,21,6,15,0,1,0
0,0,0,0,0,0,0,0,0
58323,473,4,111,91,20,2,1,0
7507,131,0,13,7,6,1,1,0
185472,1043,5,105,102,3,3,0,0
84088,300,11,46,44,2,8,0,0
27705,428,6,144,140,4,2,0,0
92467,1041,2,60,33,27,2,1,0
0,0,0,0,0,0,0,0,0
0,0,0,0,0,0,0,0,0
22677,211,8,39,26,13,0,1,0
15498,107,6,13,13,0,4,0,0
338217,1867,6,374,305,69,30,1,0
0,0,0,0,0,0,0,0,0
0,0,0,0,0,0,0,0,0
264522,2050,11,452,319,133,5,1,0
126657,290,2,12,1,11,0,0,0
0,0,0,0,0,0,0,0,0
5667197,2442,6,443,9,434,9,1,0
167947,2372,8,626,527,99,5,1,0
531984,3190,13,232,188,44,26,1,0
0,0,0,0,0,0,0,0,0
76874,800,2,205,188,17,6,1,0
0,0,0,0,0,0,0,0,0
824173,2053,10,297,287,10,11,1,0
475614,1194,5,120,104,16,20,1,0
14713,101,2,7,7,0,0,0,0
215272,1558,5,158,41,117,3,1,0
4727,55,0,1,1,0,0,0,0
4127,81,1,11,10,1,0,0,0
0,0,0,0,0,0,0,0,0
426036,1484,7,126,119,7,5,1,0
73366,467,4,20,13,7,6,1,0
169634,980,2,305,280,25,1,1,0
176918,1773,11,357,313,44,27,0,0
23939,40,0,2,2,0,0,0,0
153138,884,3,187,17,170,0,0,0
483754,3250,5,683,655,28,5,1,0
5018193,36666,8,3644,2136,1508,15,1,0
47110,132,8,3,0,3,0,1,0
0,0,0,0,0,0,0,0,0
0,0,0,0,0,0,0,0,0
0,0,0,0,0,0,0,0,0
34551,254,4,33,22,11,6,1,0
172126,967,7,163,153,10,10,1,0
124842,786,4,159,154,5,1,1,0
124844,786,4,159,154,5,1,1,0
63468,696,1,173,166,7,0,0,0
259545,656,2,83,73,10,10,1,0
0,0,0,0,0,0,0,0,0
725928,6918,11,795,695,100,2,0,0
725917,6918,11,795,695,100,2,0,0
0,0,0,0,0,0,0,0,0
223088,1120,5,51,30,21,0,0,0
150076,1439,4,244,233,11,2,1,0
103102,565,12,51,47,4,4,1,1
0,0,0,0,0,0,0,0,0
230477,345,0,17,9,8,0,1,0
0,0,0,0,0,0,0,0,0
26274,34,0,2,1,1,0,0,0
102866,1083,2,221,151,70,1,1,0
294272,3059,5,260,248,12,13,1,0
245295,3000,2,366,250,116,10,1,0
45451,607,8,150,150,0,7,1,0
77742,608,8,71,63,8,3,1,0
0,0,0,0,0,0,0,0,0
228778,1693,4,291,120,171,6,1,0
0,0,0,0,0,0,0,0,0
45185,697,3,117,117,0,0,0,0
10720,140,3,21,21,0,0,0,0
961496,341,3,40,33,7,1,1,0
0,0,0,0,0,0,0,0,0
0,0,0,0,0,0,0,0,0
0,0,0,0,0,0,0,0,0
217020,1435,8,95,90,5,21,1,0
260572,1649,7,232,150,82,8,1,0
18431,102,3,11,10,1,2,0,0
415561,2687,4,382,5,377,7,1,0
0,0,0,0,0,0,0,0,0
318843,3284,6,547,539,8,4,1,0
0,0,0,0,0,0,0,0,0
0,0,0,0,0,0,0,0,0
36716,322,5,29,26,3,1,0,0
0,0,0,0,0,0,0,0,0
154380,1046,2,298,289,9,15,1,0
1546,26,0,0,0,0,0,0,0
188950,1224,7,145,130,15,3,1,0
77988,562,7,7,7,0,3,0,0
15153,287,3,37,33,4,0,1,0
10222,212,3,37,33,4,0,1,0
484980,4032,3,626,433,193,1,1,0
0,0,0,0,0,0,0,0,0
3858,76,0,0,0,0,0,1,0
231717,1340,1,213,28,185,4,1,0
276028,940,3,89,82,7,1,1,0
0,0,0,0,0,0,0,0,0
0,0,0,0,0,0,0,0,0
234309,1565,6,326,326,0,16,0,0
61179,858,1,238,230,8,0,1,0
0,0,0,0,0,0,0,0,0
0,0,0,0,0,0,0,0,0
168249,1171,8,278,274,4,9,0,0
1083546,191,5,20,14,6,1,1,0
0,0,0,0,0,0,0,0,0
243308,484,1,19,19,0,8,0,0
140800,421,9,93,69,24,2,1,0
466638,2238,14,152,124,28,10,1,0
298374,1295,13,127,112,15,10,1,0
188167,1144,8,269,165,104,18,1,0
166186,960,8,132,76,56,16,1,0
63725,787,2,196,164,32,0,0,0
0,0,0,0,0,0,0,0,0
164771,898,7,209,204,5,1,1,0
0,0,0,0,0,0,0,0,0
151074,562,4,139,139,0,15,1,0
0,0,0,0,0,0,0,0,0
212485,535,9,136,135,1,0,0,0
185737,87,9,2,2,0,0,1,0
0,0,0,0,0,0,0,0,0
0,0,0,0,0,0,0,0,0
234357,2598,6,473,456,17,15,1,0
330136,3219,8,453,423,30,6,1,1
421,8,0,0,0,0,0,0,0
0,0,0,0,0,0,0,0,0
60413,892,0,37,34,3,4,1,0
238320,1472,4,117,117,0,1,1,0
0,0,0,0,0,0,0,0,0
346469,1381,3,134,131,3,3,0,0
337264,96,6,6,4,2,0,1,0
315618,876,6,122,97,25,14,1,0
0,0,0,0,0,0,0,0,0
182338,1620,10,273,257,16,54,1,0
33119,180,6,14,13,1,3,0,0
0,0,0,0,0,0,0,0,0
450946,2725,2,445,397,48,5,1,0
163817,332,1,74,24,50,0,1,0
0,0,0,0,0,0,0,0,0
69206,585,13,99,94,5,3,1,0
26539,196,12,22,20,2,0,1,0
58786,458,3,121,118,3,11,0,0
9156,111,3,27,24,3,4,0,0
413767,1959,4,309,291,18,6,1,0
876334,1409,5,273,269,4,263,1,0
79676,622,6,78,77,1,7,0,0
0,0,0,0,0,0,0,0,0
0,0,0,0,0,0,0,0,0
23662,331,10,79,73,6,2,1,0
486203,1844,2,305,292,13,4,1,0
0,0,0,0,0,0,0,0,0
6446,101,0,4,4,0,0,0,0
66571,858,1,303,278,25,0,1,0
11699,105,1,18,13,5,0,1,0
72842,761,2,138,132,6,2,0,0
0,0,0,0,0,0,0,0,0
905953,2198,9,296,280,16,13,1,0
0,0,0,0,0,0,0,0,0
215051,1357,2,230,229,1,2,1,1
310115,2292,2,333,245,88,46,1,0
0,0,0,0,0,0,0,0,0
293582,2641,9,262,251,11,1,1,0
17703,380,3,6,4,2,2,1,0
0,0,0,0,0,0,0,0,0
210358,3006,3,706,670,36,25,1,0
99802,1199,2,406,399,7,9,1,0
0,0,0,0,0,0,0,0,0
201123,1830,5,377,358,19,4,0,0
0,0,0,0,0,0,0,0,0
0,0,0,0,0,0,0,0,0
45117,619,7,189,188,1,0,0,0
232431,1297,17,273,264,9,5,1,0
232288,1297,17,273,264,9,5,1,0
0,0,0,0,0,0,0,0,0
0,0,0,0,0,0,0,0,0
0,0,0,0,0,0,0,0,0
7952,97,7,1,1,0,0,0,0
0,0,0,0,0,0,0,0,0
0,0,0,0,0,0,0,0,0
106027,1009,3,251,231,20,8,0,0
89116,1088,5,263,257,6,8,1,0
24020,330,3,68,63,5,0,1,0
625964,2264,4,186,156,30,0,1,0
54687,187,7,5,3,2,11,0,0
0,0,0,0,0,0,0,0,0
83551,836,9,118,111,7,5,1,0
680980,2025,3,165,156,9,11,1,0
527900,1148,3,4,4,0,6,0,0
262422,1613,6,265,233,32,0,0,0
692573,2781,7,150,105,45,11,1,0
366945,551,7,122,118,4,0,1,0
55285,301,2,3,2,1,2,0,0
0,0,0,0,0,0,0,0,0
0,0,0,0,0,0,0,0,0
0,0,0,0,0,0,0,0,0
779543,2699,9,420,394,26,32,0,0
279200,1192,16,183,92,91,23,1,0
0,0,0,0,0,0,0,0,0
142571,1905,10,344,338,6,2,0,0
75993,275,10,29,25,4,2,0,0
367885,3561,4,305,297,8,17,1,0
0,0,0,0,0,0,0,0,0
1298812,962,3,125,113,12,8,1,0
0,0,0,0,0,0,0,0,0
0,0,0,0,0,0,0,0,0
306526,2692,8,350,169,181,15,1,0
177741,1719,7,202,37,165,14,0,0
344740,2297,6,439,392,47,18,0,0
12138,163,3,23,23,0,0,1,0
156123,2391,2,194,193,1,33,1,0
36806,485,3,137,135,2,2,1,0
397750,1898,6,212,151,61,6,1,0
0,0,0,0,0,0,0,0,0
0,0,0,0,0,0,0,0,0
380673,2062,10,326,218,108,9,1,0
0,0,0,0,0,0,0,0,0
492486,1511,6,317,282,35,13,1,0
0,0,0,0,0,0,0,0,0
0,0,0,0,0,0,0,0,0
273618,818,5,87,76,11,2,1,0
0,0,0,0,0,0,0,0,0
0,0,0,0,0,0,0,0,0
37859,345,4,49,41,8,0,1,0
47808,371,6,165,165,0,8,1,0
2051872,11296,4,162,143,19,0,0,0
0,0,0,0,0,0,0,0,0
0,0,0,0,0,0,0,0,0
167368,1993,4,516,498,18,26,1,0
1432510,1202,2,156,149,7,4,1,0
354202,101,0,3,3,0,0,1,0
85915,656,3,185,175,10,10,1,0
233719,1946,5,427,401,26,15,1,0
276377,2502,11,516,476,40,27,1,0
0,0,0,0,0,0,0,0,0
53653,931,4,179,60,119,6,1,0
40123,640,3,149,46,103,6,1,0
89017,400,1,48,44,4,0,0,0
0,0,0,0,0,0,0,0,0
28297,233,0,32,25,7,3,1,0
772791,2904,1,285,229,56,0,1,0
0,0,0,0,0,0,0,0,0
0,0,0,0,0,0,0,0,0
0,0,0,0,0,0,0,0,0
617179,2023,2,345,288,57,2,1,0
111014,619,12,93,35,58,10,1,0
19683,85,0,11,7,4,1,0,0
7540,90,0,17,14,3,0,0,0
0,0,0,0,0,0,0,0,0
174254,2454,7,506,491,15,1,0,1
190767,1763,3,264,255,9,15,0,0
0,0,0,0,0,0,0,0,0
92695,979,5,187,170,17,17,0,0
0,0,0,0,0,0,0,0,0
0,0,0,0,0,0,0,0,0
198633,2449,1,515,508,7,0,1,0
56054,975,1,255,248,7,0,1,0
351671,6217,13,965,946,19,27,1,0
0,0,0,0,0,0,0,0,0
339507,2320,3,397,380,17,3,1,0
70802,244,3,29,21,8,0,1,0
796039,1838,5,244,123,121,12,1,0
0,0,0,0,0,0,0,0,0
175848,1367,9,321,36,285,14,1,0
147186,840,8,192,187,5,12,1,0
0,0,0,0,0,0,0,0,0
0,0,0,0,0,0,0,0,0
0,0,0,0,0,0,0,0,0
0,0,0,0,0,0,0,0,0
215366,2862,1,608,601,7,0,1,0
53774,977,1,261,254,7,0,1,0
324887,1907,2,182,131,51,37,1,0
61076,923,6,285,257,28,0,1,0
217290,5702,3,1914,1183,731,9,0,0
185719,978,1,170,17,153,1,1,0
0,0,0,0,0,0,0,0,0
107647,717,2,178,162,16,4,1,0
311709,1106,8,91,73,18,2,1,0
275123,2894,1,977,955,22,9,1,0
255413,994,10,164,152,12,27,1,0
383295,961,4,48,39,9,1,1,0
112198,145,0,10,10,0,0,1,0
786554,3353,5,608,525,83,10,1,0
299206,566,8,115,92,23,5,1,0
0,0,0,0,0,0,0,0,0
0,0,0,0,0,0,0,0,0
67340,683,3,58,55,3,11,1,0
107165,994,7,78,25,53,0,1,0
1016044,10340,10,518,509,9,76,0,0
258291,189,10,2,2,0,0,0,0
8896,147,4,12,5,7,0,1,0
0,0,0,0,0,0,0,0,0
83142,132,8,14,12,2,0,1,0
16794,109,2,0,0,0,0,0,0
141138,1817,7,304,286,18,9,1,0
0,0,0,0,0,0,0,0,0
50123,857,2,128,113,15,1,1,0
1102822,1313,0,63,27,36,0,1,0
0,0,0,0,0,0,0,0,0
93749,855,10,166,153,13,0,0,0
72528,744,11,161,146,15,4,0,0
18537,282,1,79,67,12,0,1,0
129203,2167,3,366,359,7,2,0,0
4236,11,0,0,0,0,0,0,0
6681,66,1,3,3,0,0,0,0
555542,6942,9,795,792,3,11,1,0
142601,716,10,65,38,27,9,1,0
753917,3463,1,149,116,33,10,1,0
22448,105,4,7,4,3,0,0,0
0,0,0,0,0,0,0,0,0
260107,715,2,75,71,4,3,1,0
0,0,0,0,0,0,0,0,0
83258,329,6,38,38,0,7,1,0
193343,1738,1,203,162,41,0,1,0
38152,224,1,8,7,1,0,1,0
0,0,0,0,0,0,0,0,0
0,0,0,0,0,0,0,0,0
0,0,0,0,0,0,0,0,0
0,0,0,0,0,0,0,0,0
0,0,0,0,0,0,0,0,0
0,0,0,0,0,0,0,0,0
23593,283,5,55,43,12,0,1,0
0,0,0,0,0,0,0,0,0
0,0,0,0,0,0,0,0,0
28874,116,1,21,21,0,0,1,0
25355,98,1,10,10,0,1,1,0
0,0,0,0,0,0,0,0,0
0,0,0,0,0,0,0,0,0
117961,1317,5,210,181,29,8,1,0
0,0,0,0,0,0,0,0,0
318291,809,6,163,139,24,4,1,0
91146,1108,7,159,151,8,17,1,0
0,0,0,0,0,0,0,0,0
0,0,0,0,0,0,0,0,0
0,0,0,0,0,0,0,0,0
55009,392,5,23,11,12,1,0,0
0,0,0,0,0,0,0,0,0
75426,1256,2,397,357,40,0,0,0
7986,83,2,15,15,0,0,0,0
141892,1181,10,269,259,10,6,1,0
348805,1090,8,172,167,5,0,1,0
348805,1090,8,172,167,5,0,1,0
694187,538,0,5,2,3,2,1,1
0,0,0,0,0,0,0,0,0
264203,1370,6,118,115,3,3,1,0
370285,4041,6,717,573,144,2,1,0
0,0,0,0,0,0,0,0,0
264144,2690,3,665,568,97,4,0,0
231952,1598,3,179,3,176,12,0,0
49216,192,4,9,2,7,13,0,0
142299,699,3,379,368,11,1,0,0
90623,1010,10,192,176,16,22,1,0
330409,2319,5,270,254,16,1,0,0
17768,363,2,34,30,4,0,1,0
5302,113,2,13,13,0,0,1,0
288377,365,0,17,13,4,2,1,0
267060,189,0,0,0,0,1,1,0
0,0,0,0,0,0,0,0,0
123147,650,3,105,74,31,0,1,0
241552,503,3,27,23,4,7,1,0
230479,2929,3,591,567,24,10,1,0
693741,538,0,5,3,2,2,1,1
0,0,0,0,0,0,0,0,0
0,0,0,0,0,0,0,0,0
69653,842,8,132,104,28,6,1,0
0,0,0,0,0,0,0,0,0
396092,3349,1,50,25,25,30,1,0
77329,1077,3,344,337,7,1,0,0
18120,137,4,14,14,0,4,0,0
0,0,0,0,0,0,0,0,0
0,0,0,0,0,0,0,0,0
0,0,0,0,0,0,0,0,0
61682,732,2,208,208,0,3,1,0
0,0,0,0,0,0,0,0,0
123531,1118,3,111,92,19,10,1,0
30572,172,1,0,0,0,0,0,0
0,0,0,0,0,0,0,0,0
0,0,0,0,0,0,0,0,0
24681,150,3,18,13,5,0,1,0
95846,943,6,194,175,19,8,0,0
30270,215,8,20,20,0,3,0,0
2257637,2468,9,265,252,13,2,1,0
61793,632,1,70,54,16,0,1,0
132118,626,1,93,68,25,2,1,0
0,0,0,0,0,0,0,0,0
398162,2857,4,695,680,15,0,1,0
767504,2882,9,308,255,53,13,1,0
502736,1567,5,46,42,4,5,1,0
16880,365,0,83,79,4,0,0,0
96518,1230,4,344,331,13,0,1,0
9053,73,3,7,7,0,0,1,0
31648,21,3,2,2,0,0,0,0
192807,1220,5,317,288,29,7,1,0
173416,1390,14,168,167,1,4,1,0
283200,964,4,242,227,15,2,1,0
44349,560,6,154,142,12,10,1,0
101002,626,10,105,0,105,0,0,0
1123291,1789,9,144,134,10,219,1,0
1022853,600,10,41,34,7,62,1,0
159129,695,3,141,124,17,1,1,0
355552,2255,1,426,404,22,0,0,0
0,0,0,0,0,0,0,0,0
0,0,0,0,0,0,0,0,0
161907,1983,3,421,407,14,4,0,0
252173,1530,9,225,208,17,16,1,0
185326,675,13,98,82,16,33,1,0
0,0,0,0,0,0,0,0,0
362154,1808,11,364,303,61,24,1,0
684961,2053,10,188,179,9,30,0,0
253110,1117,10,187,158,29,4,1,0
8431,56,1,1,1,0,1,1,0
8420,56,1,1,1,0,1,1,0
870879,535,8,92,79,13,1,1,0
0,0,0,0,0,0,0,0,0
73363,939,5,128,113,15,4,1,0
0,0,0,0,0,0,0,0,0
0,0,0,0,0,0,0,0,0
170598,1068,14,251,241,10,23,1,0
71113,421,9,110,108,2,5,0,0
852231,5050,17,342,242,100,19,1,0
418649,2296,17,197,182,15,11,1,0
623214,1242,3,152,145,7,1,0,0
0,0,0,0,0,0,0,0,0
0,0,0,0,0,0,0,0,0
0,0,0,0,0,0,0,0,0
0,0,0,0,0,0,0,0,0
38193,338,2,91,78,13,3,0,0
212331,4027,7,581,578,3,12,0,0
58022,743,7,95,91,4,11,0,0
1110350,2689,1,335,276,59,2,1,0
0,0,0,0,0,0,0,0,0
0,0,0,0,0,0,0,0,0
0,0,0,0,0,0,0,0,0
146238,1638,5,355,320,35,7,1,0
0,0,0,0,0,0,0,0,0
350885,4239,8,691,672,19,24,1,0
1479157,1967,5,137,115,22,46,1,0
523736,4209,15,1428,1420,8,3,1,0
99538,1003,2,184,171,13,18,1,0
17500,105,5,7,5,2,3,1,0
0,0,0,0,0,0,0,0,0
35583,115,2,13,0,13,0,1,0
101687,427,6,55,54,1,13,1,0
7312,17,0,2,0,2,0,0,0
672055,2809,4,241,220,21,6,1,0
0,0,0,0,0,0,0,0,0
325985,976,16,257,238,19,1,1,0
100104,722,8,46,29,17,7,1,0
27502,217,5,6,6,0,0,0,0
0,0,0,0,0,0,0,0,0
405066,968,3,111,98,13,4,1,0
14378,101,2,7,7,0,0,0,0
0,0,0,0,0,0,0,0,0
0,0,0,0,0,0,0,0,0
1783537,2006,11,160,126,34,32,1,0
185476,876,9,139,127,12,2,1,0
101998,1112,2,266,254,12,1,1,0
0,0,0,0,0,0,0,0,0
103026,904,9,153,147,6,17,1,0
179961,2917,1,58,45,13,129,1,0
806866,1114,8,110,97,13,11,1,0
243902,798,8,143,135,8,2,1,0
215706,977,7,142,139,3,1,1,0
0,0,0,0,0,0,0,0,0
117160,909,8,167,158,9,16,1,0
278484,3250,6,445,424,21,8,1,0
230937,343,0,16,3,13,0,1,0
0,0,0,0,0,0,0,0,0
301289,1856,2,399,391,8,8,1,1
214203,672,4,97,68,29,22,1,0
154925,406,4,53,41,12,24,1,0
247940,1894,5,611,597,14,9,1,0
0,0,0,0,0,0,0,0,0
176975,1691,3,381,364,17,7,1,0
380431,2398,14,411,263,148,10,1,0
90789,845,0,19,8,11,0,0,0
0,0,0,0,0,0,0,0,0
243976,2071,4,107,96,11,14,1,0
46525,683,8,81,64,17,1,1,0
75944,1048,8,243,240,3,5,1,0
65867,481,7,52,49,3,11,1,0
0,0,0,0,0,0,0,0,0
205227,4152,5,1599,1596,3,0,1,0
354896,2206,11,366,355,11,42,1,0
111307,241,11,10,6,4,7,1,0
0,0,0,0,0,0,0,0,0
155019,1485,2,297,281,16,7,1,1
767783,3514,13,602,558,44,93,1,0
452155,1876,3,268,253,15,5,1,0
9226,107,3,14,1,13,3,1,0
0,0,0,0,0,0,0,0,0
119173,1348,11,350,337,13,16,1,0
106397,1049,5,272,263,9,20,1,0
14792,137,7,20,9,11,0,1,0
0,0,0,0,0,0,0,0,0
0,0,0,0,0,0,0,0,0
194430,1055,4,95,76,19,3,0,0
311576,1505,1,155,126,29,1,1,0
0,0,0,0,0,0,0,0,0
0,0,0,0,0,0,0,0,0
209824,799,11,114,106,8,12,1,0
200550,670,14,93,75,18,16,1,0
34983,125,6,31,31,0,6,1,0
27672,271,4,43,36,7,0,1,0
75376,940,7,110,103,7,6,0,0
51107,438,8,35,35,0,2,1,0
0,0,0,0,0,0,0,0,0
205344,1803,4,204,162,42,5,1,0
40509,237,3,8,7,1,1,1,0
0,0,0,0,0,0,0,0,0
98463,587,3,75,51,24,2,1,0
21937,33,0,1,1,0,0,1,0
840431,1761,6,257,230,27,3,0,0
0,0,0,0,0,0,0,0,0
0,0,0,0,0,0,0,0,0
0,0,0,0,0,0,0,0,0
80765,1016,5,177,105,72,1,1,0
6980,129,2,9,8,1,1,0,0
272058,2628,10,548,540,8,17,0,1
849881,2401,6,314,288,26,18,1,0
244853,474,7,6,1,5,5,0,0
21951,35,0,1,1,0,0,1,0
223554,3462,6,655,648,7,2,1,0
7182,112,3,2,2,0,0,0,0
320651,1147,5,137,66,71,4,1,0
520797,289,4,5,4,1,8,0,0
556222,5367,5,1341,1184,157,6,1,0
606648,8231,5,1216,1199,17,9,1,0
621454,2572,8,461,407,54,30,1,0
48628,362,7,84,64,20,14,1,0
0,0,0,0,0,0,0,0,0
688045,6433,16,1815,1753,62,4,0,0
88572,255,0,48,24,24,0,1,1
243464,1859,17,397,322,75,12,1,0
208794,2377,2,461,416,45,10,1,0
0,0,0,0,0,0,0,0,0
388534,2380,6,467,415,52,7,1,0
154858,1178,10,141,90,51,3,0,0
0,0,0,0,0,0,0,0,0
0,0,0,0,0,0,0,0,0
381458,13149,3,654,648,6,2,0,0
229087,1695,14,335,269,66,18,1,1
0,0,0,0,0,0,0,0,0
0,0,0,0,0,0,0,0,0
0,0,0,0,0,0,0,0,0
0,0,0,0,0,0,0,0,0
0,0,0,0,0,0,0,0,0
151418,2538,3,599,584,15,8,1,0
395145,2143,5,402,391,11,10,1,0
923933,1886,6,138,31,107,3,1,0
446113,955,6,134,112,22,3,1,0
76222,860,3,110,105,5,9,0,0
27967,53,1,5,0,5,0,0,0
113503,1119,1,253,245,8,2,1,1
112394,690,10,83,65,18,2,1,0
0,0,0,0,0,0,0,0,0
342045,1802,11,426,399,27,28,1,0
0,0,0,0,0,0,0,0,0
129466,947,4,65,58,7,8,1,0
33774,233,2,18,3,15,7,1,0
0,0,0,0,0,0,0,0,0
573,7,0,0,0,0,0,0,0
0,0,0,0,0,0,0,0,0
0,0,0,0,0,0,0,0,0
12834,66,2,1,1,0,1,0,0
272290,1078,4,244,219,25,1,1,0
84766,963,0,61,33,28,2,1,0
125295,730,14,83,62,21,0,1,0
114843,146,7,5,4,1,3,1,0
645991,2722,3,632,607,25,3,0,0
376300,514,8,25,20,5,11,1,0
102089,206,3,2,1,1,0,1,0
0,0,0,0,0,0,0,0,0
0,0,0,0,0,0,0,0,0
1629995,2971,7,284,253,31,23,1,0
0,0,0,0,0,0,0,0,0
238717,1240,3,130,28,102,2,1,0
6026,67,4,10,10,0,0,0,0
526484,1359,2,338,327,11,5,1,0
108300,813,4,73,40,33,2,1,0
119730,848,5,76,43,33,2,1,0
30128,437,4,125,111,14,1,1,0
50392,1091,1,114,104,10,2,0,0
181742,1633,4,99,79,20,0,0,0
0,0,0,0,0,0,0,0,0
778200,2672,13,345,264,81,31,1,0
237058,2240,6,398,390,8,1,1,0
21948,283,6,51,44,7,1,1,0
123532,1068,2,215,215,0,10,1,0
223034,432,6,59,54,5,2,0,0
144871,1432,2,244,219,25,4,0,0
175182,1255,2,241,239,2,3,0,0
0,0,0,0,0,0,0,0,0
163127,1080,8,182,174,8,13,0,0
405179,2345,4,594,562,32,0,1,0
0,0,0,0,0,0,0,0,0
0,0,0,0,0,0,0,0,0
25496,320,3,45,41,4,3,0,0
0,0,0,0,0,0,0,0,0
0,0,0,0,0,0,0,0,0
31852,637,2,128,79,49,9,1,0
136511,1160,11,238,226,12,7,1,0
384002,1451,5,406,386,20,14,1,0
34770,318,5,52,50,2,13,0,0
0,0,0,0,0,0,0,0,0
433029,4342,3,465,444,21,1,0,0
105771,1389,3,249,244,5,3,0,0
0,0,0,0,0,0,0,0,0
0,0,0,0,0,0,0,0,0
707939,2423,2,356,342,14,5,0,0
0,0,0,0,0,0,0,0,0
67299,592,5,184,181,3,1,1,0
302990,1477,7,241,191,50,8,1,0
14286,160,5,7,6,1,0,0,0
0,0,0,0,0,0,0,0,0
0,0,0,0,0,0,0,0,0
0,0,0,0,0,0,0,0,0
34015,148,5,19,12,7,1,0,0
0,0,0,0,0,0,0,0,0
0,0,0,0,0,0,0,0,0
22024,35,0,1,1,0,0,1,0
0,0,0,0,0,0,0,0,0
218854,448,6,73,34,39,0,1,0
40357,278,4,21,18,3,1,1,0
844019,1318,6,133,121,12,49,1,0
54299,342,10,50,41,9,13,1,0
0,0,0,0,0,0,0,0,0
0,0,0,0,0,0,0,0,0
0,0,0,0,0,0,0,0,0
0,0,0,0,0,0,0,0,0
363486,2509,2,263,27,236,6,1,0
139608,1517,2,281,272,9,6,1,0
142348,971,3,83,70,13,2,1,0
0,0,0,0,0,0,0,0,0
57104,690,9,151,149,2,12,1,0
34587,344,9,44,41,3,11,1,0
0,0,0,0,0,0,0,0,0
195242,647,4,49,41,8,0,1,0
191810,598,4,37,30,7,1,1,0
466425,831,1,25,19,6,9,1,0
11898,52,0,0,0,0,2,0,0
0,0,0,0,0,0,0,0,0
174767,1560,6,515,498,17,15,1,0
12402,74,1,7,7,0,1,0,0
40689,572,0,470,30,440,0,0,0
317040,1732,10,238,184,54,6,1,0
0,0,0,0,0,0,0,0,0
257542,1263,6,167,164,3,3,1,0
138568,1914,6,345,326,19,3,0,0
43596,38,0,6,2,4,0,1,0
38030,247,3,22,19,3,4,1,0
0,0,0,0,0,0,0,0,0
521369,1540,9,213,198,15,12,1,0
37843,757,2,211,209,2,0,0,0
0,0,0,0,0,0,0,0,0
222937,1289,2,169,140,29,82,1,0
87595,1056,4,241,229,12,0,1,0
83317,656,5,40,30,10,20,1,0
160047,1474,8,425,390,35,33,1,0
0,0,0,0,0,0,0,0,0
139428,1709,1,319,283,36,10,0,0
0,0,0,0,0,0,0,0,0
0,0,0,0,0,0,0,0,0
0,0,0,0,0,0,0,0,0
0,0,0,0,0,0,0,0,0
0,0,0,0,0,0,0,0,0
0,0,0,0,0,0,0,0,0
0,0,0,0,0,0,0,0,0
0,0,0,0,0,0,0,0,0
0,0,0,0,0,0,0,0,0
0,0,0,0,0,0,0,0,0
84131,951,5,170,147,23,28,0,0
86562,927,9,125,121,4,2,1,0
0,0,0,0,0,0,0,0,0
18691,206,8,21,19,2,3,1,0
0,0,0,0,0,0,0,0,0
0,0,0,0,0,0,0,0,0
334702,4078,6,561,561,0,112,1,0
41500,243,7,24,24,0,5,0,0
182151,2676,0,822,809,13,5,0,0
0,0,0,0,0,0,0,0,0
0,0,0,0,0,0,0,0,0
90777,991,8,245,203,42,2,1,0
0,0,0,0,0,0,0,0,0
243805,3468,5,870,792,78,6,1,0
93708,771,3,179,152,27,9,1,0
62600,290,2,41,30,11,2,1,0
8727,123,0,24,24,0,0,1,0
8122,117,0,27,27,0,0,1,0
0,0,0,0,0,0,0,0,0
97327,586,17,101,0,101,8,1,0
168098,1302,7,213,201,12,0,1,0
749524,63,1,3,2,1,0,1,0
40084,545,2,73,25,48,3,1,0
223760,1261,5,159,137,22,8,0,0
0,0,0,0,0,0,0,0,0
101795,901,8,125,8,117,3,1,0
423765,2434,3,337,326,11,1,1,0
282020,1180,2,208,202,6,1,1,0
0,0,0,0,0,0,0,0,0
0,0,0,0,0,0,0,0,0
0,0,0,0,0,0,0,0,0
1103628,1439,2,261,209,52,13,1,1
74518,318,5,7,7,0,10,1,0
423638,377,7,61,58,3,18,1,0
426361,1720,2,574,561,13,19,1,0
31332,220,5,25,22,3,1,1,0
74365,689,7,161,128,33,3,0,0
0,0,0,0,0,0,0,0,0
493257,1584,6,546,545,1,2,1,0
326657,974,5,423,423,0,2,1,0
223073,3868,5,684,679,5,3,1,0
320914,1040,10,149,134,15,29,1,0
201874,1303,6,256,238,18,4,1,0
137262,1456,6,339,302,37,8,1,0
0,0,0,0,0,0,0,0,0
0,0,0,0,0,0,0,0,0
150211,1942,4,324,320,4,15,1,0
128349,658,5,91,91,0,13,1,0
0,0,0,0,0,0,0,0,0
68946,616,7,85,49,36,1,1,0
146309,1751,6,564,458,106,2,0,0
1022,18,1,0,0,0,0,0,1
248463,798,16,154,139,15,11,1,0
333452,3411,0,802,773,29,10,0,0
0,0,0,0,0,0,0,0,0
196411,1663,5,357,347,10,0,1,0
152144,825,2,115,104,11,13,1,0
0,0,0,0,0,0,0,0,0
254597,1256,7,183,164,19,46,1,0
0,0,0,0,0,0,0,0,0
1696045,1667,9,198,182,16,16,1,0
45993,582,7,133,92,41,8,1,0
120291,1222,8,457,451,6,2,1,0
120693,1224,8,457,451,6,2,1,0
187863,1108,3,203,106,97,1,1,0
0,0,0,0,0,0,0,0,0
63815,899,0,269,269,0,0,1,0
83476,509,6,67,65,2,7,1,0
122061,339,9,52,6,46,4,1,0
0,0,0,0,0,0,0,0,0
1785139,2325,10,299,285,14,26,1,0
291109,2657,4,381,369,12,17,0,0
197582,1828,11,341,270,71,25,0,1
171405,912,2,142,127,15,1,1,0
64657,114,2,12,12,0,0,1,0
196173,491,9,75,70,5,3,1,0
70047,699,5,173,161,12,7,0,0
156344,1481,3,347,345,2,6,1,0
276769,737,14,119,81,38,4,0,0
55603,516,2,94,78,16,5,1,0
129271,1021,7,179,166,13,5,1,0
161695,495,7,44,34,10,5,1,0
273689,4568,6,632,625,7,2,1,0
123779,2161,5,413,412,1,0,1,0
0,0,0,0,0,0,0,0,0
0,0,0,0,0,0,0,0,0
0,0,0,0,0,0,0,0,0
114974,1398,3,487,478,9,7,1,0
153276,1437,7,460,451,9,7,1,0
32027,292,6,72,72,0,4,1,0
0,0,0,0,0,0,0,0,0
268779,871,2,127,118,9,16,0,0
0,0,0,0,0,0,0,0,0
303002,4708,6,740,714,26,34,1,0
0,0,0,0,0,0,0,0,0
189558,2327,4,818,802,16,15,1,0
21301,122,3,17,17,0,0,1,0
0,0,0,0,0,0,0,0,0
0,0,0,0,0,0,0,0,0
463143,1535,9,194,181,13,14,1,0
114075,1340,2,383,379,4,58,1,0
41431,269,2,42,38,4,6,1,0
0,0,0,0,0,0,0,0,0
690491,3024,5,405,388,17,0,1,0
62729,1666,1,561,560,1,0,1,0
6978,155,0,62,51,11,0,0,0
0,0,0,0,0,0,0,0,0
260941,4632,1,1434,1351,83,15,1,0
281463,2397,8,368,351,17,12,0,0
585,5,0,0,0,0,0,0,1
63140,126,0,12,11,1,0,1,0
0,0,0,0,0,0,0,0,0
285217,1484,5,170,117,53,9,1,0
145779,377,6,13,3,10,8,0,0
106019,1389,4,421,416,5,9,1,0
41780,345,5,44,38,6,10,1,0
709343,4388,10,857,840,17,18,1,0
394808,3973,8,820,811,9,16,1,0
0,0,0,0,0,0,0,0,0
209871,2433,5,394,366,28,12,0,0
16719,144,2,12,10,2,0,0,0
115835,956,6,233,220,13,5,1,0
106814,1649,1,556,424,132,1,1,0
5889,109,1,11,10,1,0,1,0
0,0,0,0,0,0,0,0,0
37997,384,7,89,86,3,3,1,0
11179,197,2,7,6,1,0,1,0
266730,1269,3,230,218,12,0,1,0
188060,193,2,4,4,0,1,0,0
37261,244,1,60,53,7,1,1,0
37154,243,1,60,53,7,1,1,0
433352,1000,3,113,99,14,4,1,0
14378,101,2,7,7,0,0,0,0
0,0,0,0,0,0,0,0,0
560,7,0,0,0,0,0,0,0
0,0,0,0,0,0,0,0,0
147934,645,10,35,29,6,10,1,0
274633,1373,5,245,239,6,8,1,0
101954,879,10,178,172,6,7,1,0
187433,1168,3,212,201,11,1,1,0
0,0,0,0,0,0,0,0,0
22923,184,2,22,21,1,0,1,0
0,0,0,0,0,0,0,0,0
28767,45,0,4,1,3,0,0,0
0,0,0,0,0,0,0,0,0
0,0,0,0,0,0,0,0,0
0,0,0,0,0,0,0,0,0
122329,884,3,83,70,13,4,1,0
52877,402,2,39,35,4,0,1,0
1483421,8869,3,1080,878,202,12,1,0
186049,1115,5,103,87,16,12,1,0
514234,2062,15,392,329,63,19,1,0
24952,289,9,63,53,10,3,1,0
122392,1271,5,150,100,50,11,1,0
0,0,0,0,0,0,0,0,0
88926,1046,3,128,125,3,0,1,0
198860,707,2,113,8,105,14,1,0
12387,271,1,61,60,1,1,0,0
0,0,0,0,0,0,0,0,0
674333,3170,11,310,255,55,44,1,0
167133,846,14,236,229,7,12,0,0
29978,762,1,204,204,0,2,1,0
203859,1552,6,339,309,30,5,1,0
89209,255,0,48,24,24,0,1,1
374169,2098,6,358,337,21,0,1,0
123194,764,1,38,22,16,7,1,0
13616,280,3,69,69,0,0,0,0
315680,2591,3,633,615,18,7,1,0
0,0,0,0,0,0,0,0,0
1306341,4473,6,638,551,87,9,1,0
10678,61,2,4,4,0,0,1,0
0,0,0,0,0,0,0,0,0
578891,4088,6,601,589,12,46,1,0
57609,512,3,63,53,10,0,0,0
0,0,0,0,0,0,0,0,0
0,0,0,0,0,0,0,0,0
0,0,0,0,0,0,0,0,0
0,0,0,0,0,0,0,0,0
0,0,0,0,0,0,0,0,0
37124,292,3,14,11,3,0,1,0
15048,66,0,2,2,0,2,0,0
0,0,0,0,0,0,0,0,0
749337,6148,10,849,837,12,11,1,0
405647,1928,10,136,134,2,22,1,0
0,0,0,0,0,0,0,0,0
164028,1096,3,326,248,78,7,1,0
256726,1788,7,212,177,35,18,1,0
235728,1022,2,241,237,4,1,0,0
345650,3372,13,827,782,45,52,1,0
167002,1300,12,366,348,18,18,1,0
282223,2138,4,402,393,9,10,1,0
5702145,192,1,12,6,6,3,1,0
145932,524,9,67,63,4,6,1,0
244668,332,3,63,53,10,0,0,0
210253,1060,1,139,133,6,0,1,0
0,0,0,0,0,0,0,0,0
473082,8848,3,2674,2660,14,8,1,0
99912,1472,1,287,287,0,2,1,0
0,0,0,0,0,0,0,0,0
0,0,0,0,0,0,0,0,0
200221,1376,7,191,168,23,13,1,0
0,0,0,0,0,0,0,0,0
71925,818,10,142,118,24,6,1,0
0,0,0,0,0,0,0,0,0
2436589,1496,5,134,133,1,0,0,0
166893,1915,2,442,417,25,8,1,1
0,0,0,0,0,0,0,0,0
0,0,0,0,0,0,0,0,0
0,0,0,0,0,0,0,0,0
84035,705,5,170,170,0,8,0,0
59798,318,6,29,15,14,9,1,0
0,0,0,0,0,0,0,0,0
163229,814,9,124,111,13,10,1,0
0,0,0,0,0,0,0,0,0
0,0,0,0,0,0,0,0,0
53850,607,7,166,149,17,7,1,0
0,0,0,0,0,0,0,0,0
266274,1132,8,139,131,8,8,1,0
0,0,0,0,0,0,0,0,0
56543,790,11,211,182,29,2,1,0
158881,1014,12,103,99,4,1,1,0
166039,835,2,7,6,1,0,0,0
605536,4389,2,987,924,63,29,1,0
349975,3085,2,778,741,37,29,1,0
0,0,0,0,0,0,0,0,0
0,0,0,0,0,0,0,0,0
169806,611,5,101,17,84,3,1,0
0,0,0,0,0,0,0,0,0
0,0,0,0,0,0,0,0,0
0,0,0,0,0,0,0,0,0
132131,255,0,16,12,4,0,1,0
0,0,0,0,0,0,0,0,0
127012,874,12,77,70,7,1,1,0
29144,110,8,5,3,2,2,0,0
0,0,0,0,0,0,0,0,0
4595,78,1,4,4,0,0,1,0
107424,1021,0,145,18,127,4,1,0
58550,608,5,46,44,2,12,1,0
10212,159,1,32,31,1,0,0,0
7401,121,1,19,18,1,0,0,0
0,0,0,0,0,0,0,0,0
0,0,0,0,0,0,0,0,0
153468,681,5,137,123,14,4,1,0
0,0,0,0,0,0,0,0,0
336604,635,7,120,116,4,7,1,0
426448,1502,12,48,40,8,40,1,0
1083653,2459,7,338,332,6,5,1,0
861484,235,7,37,33,4,5,1,0
30588,250,1,62,56,6,0,1,0
77364,581,7,155,145,10,2,1,0
0,0,0,0,0,0,0,0,0
258170,1187,14,157,129,28,2,1,0
0,0,0,0,0,0,0,0,0
0,0,0,0,0,0,0,0,0
0,0,0,0,0,0,0,0,0
123223,238,1,15,14,1,2,0,0
112530,38,0,1,1,0,2,0,0
681275,3556,12,722,667,55,25,1,0
188790,705,11,34,18,16,49,0,0
0,0,0,0,0,0,0,0,0
0,0,0,0,0,0,0,0,0
0,0,0,0,0,0,0,0,0
0,0,0,0,0,0,0,0,0
0,0,0,0,0,0,0,0,0
173478,1427,4,438,438,0,0,1,0
0,0,0,0,0,0,0,0,0
224565,630,7,101,93,8,0,1,0
0,0,0,0,0,0,0,0,0
279407,1185,5,233,218,15,3,1,0
485595,3330,9,636,628,8,18,1,0
104568,1043,12,217,207,10,14,1,0
28641,45,0,4,1,3,0,0,0
0,0,0,0,0,0,0,0,0
118317,764,3,70,45,25,1,1,0
678216,557,0,4,0,4,2,1,1
0,0,0,0,0,0,0,0,0
58345,373,6,73,46,27,0,0,0
0,0,0,0,0,0,0,0,0
0,0,0,0,0,0,0,0,0
0,0,0,0,0,0,0,0,0
0,0,0,0,0,0,0,0,0
0,0,0,0,0,0,0,0,0
0,0,0,0,0,0,0,0,0
562767,2921,4,259,240,19,19,0,0
0,0,0,0,0,0,0,0,0
825700,1962,8,271,258,13,1,1,0
114836,109,0,15,8,7,0,1,0
0,0,0,0,0,0,0,0,0
0,0,0,0,0,0,0,0,0
71097,772,7,143,139,4,0,1,0
63339,272,2,36,5,31,0,0,0
22428,144,1,4,3,1,0,0,0
87082,930,4,271,271,0,5,0,0
151150,1441,1,435,315,120,2,1,0
0,0,0,0,0,0,0,0,0
0,0,0,0,0,0,0,0,0
271077,1439,1,180,52,128,26,0,0
129044,890,3,232,226,6,3,1,0
81379,546,4,83,74,9,5,1,0
74719,549,4,64,59,5,5,1,0
0,0,0,0,0,0,0,0,0
0,0,0,0,0,0,0,0,0
0,0,0,0,0,0,0,0,0
113405,1233,5,264,253,11,9,1,0
53923,849,3,15,15,0,7,1,0
153917,915,5,124,101,23,1,1,0
0,0,0,0,0,0,0,0,0
0,0,0,0,0,0,0,0,0
81319,440,12,55,43,12,5,1,0
216144,161,5,11,8,3,3,1,0
0,0,0,0,0,0,0,0,0
0,0,0,0,0,0,0,0,0
257756,2619,2,381,364,17,1,1,0
0,0,0,0,0,0,0,0,0
70297,857,4,197,177,20,1,1,0
1487242,1275,1,192,183,9,1,1,0
378942,92,0,2,2,0,0,1,0
0,0,0,0,0,0,0,0,0
494052,3898,3,584,383,201,8,0,0
236980,1119,9,263,217,46,12,1,0
183912,585,6,107,96,11,9,1,0
172186,435,7,82,72,10,14,1,0
0,0,0,0,0,0,0,0,0
153104,691,7,146,140,6,8,1,0
114292,225,7,26,20,6,6,1,0
157983,1889,7,467,455,12,14,1,0
0,0,0,0,0,0,0,0,0
0,0,0,0,0,0,0,0,0
7707,65,0,3,3,0,0,0,0
0,0,0,0,0,0,0,0,0
0,0,0,0,0,0,0,0,0
0,0,0,0,0,0,0,0,0
155211,1416,10,399,367,32,5,1,0
64130,717,10,195,181,14,5,1,0
264111,1851,3,320,309,11,1,1,0
155429,969,3,210,200,10,1,1,0
0,0,0,0,0,0,0,0,0
77908,916,4,274,272,2,13,1,0
0,0,0,0,0,0,0,0,0
0,0,0,0,0,0,0,0,0
3018197,32272,2,864,553,311,18,1,1
265652,855,7,77,61,16,1,1,0
0,0,0,0,0,0,0,0,0
206923,2395,8,564,549,15,18,1,0
32495,380,3,63,52,11,6,1,0
2893532,4930,6,699,584,115,21,1,0
413730,2581,11,515,504,11,28,1,0
29657,672,1,86,83,3,20,1,0
16326,123,1,10,8,2,3,1,0
786191,817,3,128,91,37,4,1,0
0,0,0,0,0,0,0,0,0
0,0,0,0,0,0,0,0,0
336529,2001,4,703,697,6,3,1,0
72682,858,2,146,122,24,6,1,0
0,0,0,0,0,0,0,0,0
31281,413,1,130,130,0,0,0,0
291313,1916,4,282,237,45,13,1,0
451018,2421,4,246,177,69,4,1,0
285104,158,8,13,6,7,1,1,0
53323,672,2,182,180,2,1,1,0
24789,141,2,25,25,0,0,0,0
246252,1252,15,214,207,7,28,0,0
294731,1523,16,221,197,24,29,0,0
0,0,0,0,0,0,0,0,0
0,0,0,0,0,0,0,0,0
243463,3136,8,364,357,7,11,1,0
92146,1205,8,158,155,3,0,0,0
150255,1296,5,237,203,34,7,0,0
0,0,0,0,0,0,0,0,0
631539,2604,8,350,326,24,103,1,0
8128,118,0,23,17,6,0,1,0
0,0,0,0,0,0,0,0,0
28736,221,5,33,29,4,20,0,0
183510,2105,11,251,233,18,34,1,0
281147,3413,5,294,218,76,3,1,0
103864,681,5,57,7,50,4,0,0
0,0,0,0,0,0,0,0,0
0,0,0,0,0,0,0,0,0
3203,39,0,0,0,0,0,0,0
45339,685,1,179,178,1,1,0,0
18844,200,1,35,34,1,1,0,0
20568,53,0,2,2,0,1,0,0
625945,4870,9,923,845,78,19,1,0
320997,770,3,115,106,9,2,1,0
777891,5713,8,665,657,8,2,0,0
493385,2594,9,462,462,0,1,0,0
0,0,0,0,0,0,0,0,0
0,0,0,0,0,0,0,0,0
0,0,0,0,0,0,0,0,0
0,0,0,0,0,0,0,0,0
125655,999,11,330,313,17,7,1,0
0,0,0,0,0,0,0,0,0
251788,3009,3,428,426,2,4,1,0
0,0,0,0,0,0,0,0,0
51134,674,3,174,174,0,6,1,0
126069,1047,11,130,66,64,5,1,0
0,0,0,0,0,0,0,0,0
184141,1442,8,134,131,3,35,1,0
0,0,0,0,0,0,0,0,0
0,0,0,0,0,0,0,0,0
0,0,0,0,0,0,0,0,0
0,0,0,0,0,0,0,0,0
0,0,0,0,0,0,0,0,0
292472,1500,1,131,112,19,11,0,0
312471,1843,1,420,409,11,1,1,0
570534,2199,0,469,10,459,0,0,0
99420,1021,9,150,101,49,11,1,0
0,0,0,0,0,0,0,0,0
0,0,0,0,0,0,0,0,0
0,0,0,0,0,0,0,0,0
309,6,0,0,0,0,0,0,0
0,0,0,0,0,0,0,0,0
36485,260,5,20,17,3,0,0,0
0,0,0,0,0,0,0,0,0
0,0,0,0,0,0,0,0,0
73566,776,9,120,115,5,8,0,0
0,0,0,0,0,0,0,0,0
1073224,4202,11,377,344,33,20,1,0
0,0,0,0,0,0,0,0,0
41613,207,4,8,8,0,9,1,0
237571,1719,6,199,179,20,4,1,0
94425,112,2,1,0,1,3,1,0
54870,594,2,94,91,3,10,1,0
0,0,0,0,0,0,0,0,0
120026,856,1,175,163,12,2,1,0
165271,1823,4,318,168,150,23,1,0
844217,1306,6,120,111,9,1,1,0
0,0,0,0,0,0,0,0,0
401654,2295,9,226,190,36,24,1,0
196050,1206,6,141,106,35,7,1,0
530017,1509,3,214,187,27,4,1,0
349898,883,3,118,92,26,4,1,0
0,0,0,0,0,0,0,0,0
7039,45,0,5,5,0,1,0,0
0,0,0,0,0,0,0,0,0
107397,1323,9,258,253,5,16,0,0
49342,456,9,120,115,5,8,0,0
1445676,2993,12,284,260,24,136,1,0
0,0,0,0,0,0,0,0,0
0,0,0,0,0,0,0,0,0
36506,312,1,43,33,10,0,1,0
9329,62,3,0,0,0,0,0,0
9340,62,3,0,0,0,0,0,0
569480,2635,4,446,436,10,3,1,0
1306002,1860,4,60,51,9,2,1,0
93611,388,6,32,27,5,9,1,0
170796,1077,6,204,178,26,13,1,0
301085,1759,6,214,141,73,3,0,0
5586,58,2,5,4,1,1,0,0
0,0,0,0,0,0,0,0,0
726683,2114,5,581,442,139,16,1,0
343303,1168,5,414,395,19,1,1,0
0,0,0,0,0,0,0,0,0
301885,1419,8,39,27,12,6,1,0
0,0,0,0,0,0,0,0,0
47659,367,4,55,49,6,4,1,0
207133,286,2,46,44,2,1,0,0
207133,286,2,46,44,2,1,0,0
0,0,0,0,0,0,0,0,0
187979,590,3,46,46,0,10,1,0
345741,3371,3,775,746,29,5,1,0
0,0,0,0,0,0,0,0,0
81709,710,4,103,99,4,9,1,0
18902,177,5,32,28,4,1,1,0
80427,692,6,30,29,1,3,0,0
149109,2471,5,452,443,9,1,0,0
305580,2086,3,407,397,10,4,1,0
265468,2037,7,530,56,474,1,1,0
177945,622,8,83,75,8,2,1,0
338381,92,6,0,0,0,1,1,0
437032,2174,19,313,295,18,11,1,0
230336,343,0,16,3,13,0,1,0
0,0,0,0,0,0,0,0,0
0,0,0,0,0,0,0,0,0
0,0,0,0,0,0,0,0,0
0,0,0,0,0,0,0,0,0
0,0,0,0,0,0,0,0,0
98038,1094,17,24,19,5,1,1,0
631176,5331,4,1278,1274,4,46,1,0
828456,5515,2,780,751,29,8,1,0
79288,863,3,80,79,1,7,1,0
456511,1628,15,211,196,15,3,1,0
165539,310,2,14,14,0,2,1,0
679037,1169,8,53,35,18,40,1,0
197024,779,5,131,126,5,14,1,0
0,0,0,0,0,0,0,0,0
412432,3213,5,588,417,171,11,1,0
0,0,0,0,0,0,0,0,0
15446,147,1,29,23,6,0,0,0
0,0,0,0,0,0,0,0,0
0,0,0,0,0,0,0,0,0
149471,1697,4,458,448,10,8,1,0
0,0,0,0,0,0,0,0,0
20212,373,4,89,88,1,0,1,0
79877,1152,5,269,269,0,13,1,0
25938,386,3,7,6,1,0,0,0
0,0,0,0,0,0,0,0,0
106374,1617,2,502,488,14,7,0,0
11214,248,1,82,81,1,0,0,0
66533,695,2,172,133,39,9,1,0
0,0,0,0,0,0,0,0,0
0,0,0,0,0,0,0,0,0
128765,193,3,12,0,12,6,0,1
731134,9594,4,3515,3476,39,18,1,0
51059,203,3,8,6,2,1,1,0
128514,1317,2,347,316,31,1,1,0
0,0,0,0,0,0,0,0,0
183662,1419,5,362,325,37,7,1,0
111325,215,4,9,1,8,0,0,0
116330,863,9,129,112,17,7,0,0
692361,537,0,4,3,1,2,1,1
2170031,8214,4,521,312,209,1,1,0
127771,881,5,104,82,22,0,1,0
24044,211,7,63,62,1,2,1,0
14892,124,7,21,18,3,2,1,0
345830,1745,4,195,190,5,2,1,0
0,0,0,0,0,0,0,0,0
0,0,0,0,0,0,0,0,0
609536,5384,4,229,219,10,6,1,0
46240,577,4,79,73,6,0,1,0
0,0,0,0,0,0,0,0,0
373228,7429,3,1856,1851,5,4,1,0
17604,256,3,35,32,3,3,1,0
156160,2019,1,286,284,2,6,1,0
232045,346,0,17,9,8,0,1,0
79947,589,5,151,108,43,1,1,0
271367,763,7,99,87,12,19,1,0
0,0,0,0,0,0,0,0,0
658906,2777,9,263,240,23,23,1,0
0,0,0,0,0,0,0,0,0
111658,1262,2,271,266,5,1,1,0
391155,1008,3,170,99,71,10,1,0
79837,108,1,10,10,0,2,0,0
97164,514,4,99,96,3,2,1,0
13542,145,4,21,21,0,0,0,0
561604,3308,7,463,272,191,20,1,0
112221,1366,0,401,401,0,1,1,0
39633,162,1,20,20,0,3,1,0
80587,827,3,127,108,19,7,1,0
140830,1428,7,223,197,26,18,0,0
90869,847,2,88,87,1,0,0,0
14140,183,5,34,33,1,0,0,0
0,0,0,0,0,0,0,0,0
164673,686,7,115,106,9,6,0,0
135067,337,6,24,17,7,4,0,0
829234,10192,3,2965,2739,226,9,0,0
271588,1951,4,186,154,32,2,1,0
175597,1095,4,58,40,18,2,1,0
0,0,0,0,0,0,0,0,0
0,0,0,0,0,0,0,0,0
0,0,0,0,0,0,0,0,0
65486,184,6,11,8,3,8,1,0
92488,939,6,166,138,28,4,1,0
0,0,0,0,0,0,0,0,0
122031,760,3,82,69,13,1,0,0
1790882,15224,17,139,9,130,35,1,0
1007447,8643,17,116,102,14,13,0,0
576064,3165,8,370,342,28,14,1,0
0,0,0,0,0,0,0,0,0
0,0,0,0,0,0,0,0,0
0,0,0,0,0,0,0,0,0
0,0,0,0,0,0,0,0,0
0,0,0,0,0,0,0,0,0
212755,1064,4,191,184,7,1,1,0
285309,2788,10,392,346,46,19,0,0
179252,1359,9,181,139,42,27,0,0
0,0,0,0,0,0,0,0,0
0,0,0,0,0,0,0,0,0
184336,1490,7,298,262,36,10,1,0
0,0,0,0,0,0,0,0,0
61644,602,4,131,97,34,6,1,0
122922,2412,3,490,399,91,2,1,0
0,0,0,0,0,0,0,0,0
198600,1266,7,114,111,3,7,1,0
99314,409,7,43,43,0,3,1,0
334545,3251,4,202,189,13,113,1,0
598554,2008,4,69,55,14,3,1,0
0,0,0,0,0,0,0,0,0
482028,964,1,5,4,1,10,0,0
36531,556,6,130,104,26,3,1,0
70032,452,4,86,81,5,2,1,0
0,0,0,0,0,0,0,0,0
217165,966,7,79,72,7,2,1,0
240331,262,8,25,22,3,0,0,0
32500,438,8,47,28,19,1,0,0
27770,42,0,2,1,1,0,0,0
144611,654,3,64,47,17,3,1,0
26359,127,0,21,21,0,0,0,0
0,0,0,0,0,0,0,0,0
0,0,0,0,0,0,0,0,0
0,0,0,0,0,0,0,0,0
28358,45,0,4,1,3,0,0,0
96382,667,3,155,142,13,0,1,0
0,0,0,0,0,0,0,0,0
11901,198,0,70,0,70,0,0,0
558436,4476,8,612,504,108,71,1,0
1613190,5832,1,586,517,69,3,0,0
1613436,5832,1,586,564,22,3,0,0
230856,929,4,113,102,11,37,0,0
175102,593,4,62,51,11,30,0,0
139156,1040,6,118,118,0,1,1,0
0,0,0,0,0,0,0,0,0
0,0,0,0,0,0,0,0,0
177375,983,3,166,142,24,0,1,0
344597,1224,5,10,3,7,2,0,0
0,0,0,0,0,0,0,0,0
0,0,0,0,0,0,0,0,0
206156,962,12,124,118,6,3,1,0
57619,529,7,87,83,4,5,1,0
0,0,0,0,0,0,0,0,0
0,0,0,0,0,0,0,0,0
357089,422,11,49,42,7,6,1,0
321236,195,11,22,17,5,6,1,0
0,0,0,0,0,0,0,0,0
0,0,0,0,0,0,0,0,0
10487,56,3,12,11,1,0,1,0
32389,707,1,201,159,42,0,1,0
0,0,0,0,0,0,0,0,0
87022,129,5,4,2,2,1,0,0
0,0,0,0,0,0,0,0,0
0,0,0,0,0,0,0,0,0
143083,681,1,74,72,2,1,0,0
153729,495,1,49,46,3,1,1,0
52219,143,2,108,107,1,0,0,0
383240,4332,3,149,74,75,37,1,0
0,0,0,0,0,0,0,0,0
0,0,0,0,0,0,0,0,0
76648,768,7,198,189,9,12,0,0
409429,1093,0,27,26,1,0,1,0
91450,270,2,37,12,25,2,1,0
0,0,0,0,0,0,0,0,0
1299611,1538,7,78,39,39,0,1,0
0,0,0,0,0,0,0,0,0
253319,1115,4,148,141,7,3,1,0
109765,449,5,66,59,7,7,1,0
0,0,0,0,0,0,0,0,0
15524,290,1,67,41,26,0,0,0
47001,525,5,108,101,7,2,1,0
12172,82,5,9,9,0,0,0,0
0,0,0,0,0,0,0,0,0
87134,642,8,100,87,13,13,1,0
0,0,0,0,0,0,0,0,0
538640,3320,7,585,569,16,20,1,0
412044,2820,7,562,546,16,12,1,0
1358150,4256,0,380,359,21,4,1,0
9980,31,1,0,0,0,0,0,0
289887,2130,3,267,260,7,8,1,0
41402,434,2,127,112,15,0,1,0
409438,4273,9,782,767,15,28,1,1
3748,50,4,3,2,1,0,0,0
167659,1581,11,189,118,71,25,1,0
65270,425,7,74,39,35,15,1,0
179450,1214,14,227,158,69,38,1,0
6739,66,5,3,2,1,0,0,0
552546,1198,4,233,204,29,0,1,0
71228,486,9,89,83,6,10,1,0
71237,486,9,89,83,6,10,1,0
0,0,0,0,0,0,0,0,0
91412,1400,3,363,235,128,1,1,0
3053,45,2,3,3,0,0,0,0
43044,36,0,1,0,1,0,0,1
0,0,0,0,0,0,0,0,0
84729,963,0,61,33,28,2,1,0
0,0,0,0,0,0,0,0,0
0,0,0,0,0,0,0,0,0
424927,3924,8,828,690,138,10,1,0
0,0,0,0,0,0,0,0,0
7524,95,0,16,15,1,1,1,0
67506,1819,2,568,568,0,3,1,0
0,0,0,0,0,0,0,0,0
15398,165,5,15,11,4,1,1,0
63606,452,3,145,139,6,6,1,0
28183,432,9,100,88,12,13,1,0
103996,940,3,134,126,8,3,1,0
20084,177,2,19,18,1,4,1,0
122872,478,3,120,116,4,0,0,0
8643,65,1,9,3,6,0,0,0
27691,42,0,2,1,1,0,0,0
71040,1385,5,278,246,32,2,1,0
0,0,0,0,0,0,0,0,0
0,0,0,0,0,0,0,0,0
0,0,0,0,0,0,0,0,0
51827,573,3,165,162,3,8,1,0
0,0,0,0,0,0,0,0,0
0,0,0,0,0,0,0,0,0
141741,1567,6,298,181,117,25,1,0
0,0,0,0,0,0,0,0,0
0,0,0,0,0,0,0,0,0
464866,1858,3,250,233,17,13,1,0
621545,979,1,138,124,14,0,1,0
0,0,0,0,0,0,0,0,0
683044,2041,14,183,165,18,34,1,0
88999,597,7,64,5,59,15,1,0
381694,1518,7,178,125,53,6,1,0
0,0,0,0,0,0,0,0,0
120504,1031,5,235,233,2,33,0,0
86426,791,4,281,267,14,0,0,0
244697,983,2,278,278,0,5,0,0
0,0,0,0,0,0,0,0,0
37704,243,0,39,37,2,0,1,0
0,0,0,0,0,0,0,0,0
365344,2077,2,628,545,83,84,1,0
12303,185,1,35,35,0,2,1,0
0,0,0,0,0,0,0,0,0
0,0,0,0,0,0,0,0,0
442527,865,6,63,60,3,3,1,0
97132,976,2,237,235,2,1,0,0
20957,341,2,77,77,0,3,1,0
0,0,0,0,0,0,0,0,0
0,0,0,0,0,0,0,0,0
188424,923,8,99,80,19,40,1,0
473901,4247,8,861,844,17,6,1,0
294913,762,9,103,84,19,3,1,0
343645,1629,7,187,156,31,2,1,0
0,0,0,0,0,0,0,0,0
0,0,0,0,0,0,0,0,0
0,0,0,0,0,0,0,0,0
544943,2489,12,736,730,6,3,1,0
434698,2264,13,711,705,6,5,1,0
0,0,0,0,0,0,0,0,0
0,0,0,0,0,0,0,0,0
395778,1683,4,221,15,206,13,1,0
233879,3324,6,377,369,8,53,1,0
51433,802,1,187,176,11,4,1,0
48233,753,1,38,30,8,0,1,0
376523,1277,4,101,87,14,5,1,0
530133,2493,1,103,70,33,4,1,0
32413,325,2,18,10,8,24,1,0
747912,1367,18,229,214,15,30,1,0
973503,1705,9,193,173,20,4,1,1
199407,860,3,57,32,25,5,1,0
62666,458,3,52,28,24,16,1,0
788873,3945,15,621,601,20,51,1,0
354704,1822,15,285,272,13,5,0,0
34218,118,3,7,7,0,2,1,0
114082,2101,6,150,144,6,4,1,0
41272,690,8,183,165,18,4,1,0
345146,899,2,115,47,68,0,0,0
79773,1280,1,213,210,3,8,1,0
322989,1973,1,480,472,8,2,1,0
233929,2507,8,478,467,11,9,0,0
92467,1041,2,60,33,27,2,1,0
216218,1041,1,191,174,17,11,1,0
195796,1030,10,133,126,7,5,1,0
154200,738,4,72,46,26,1,1,0
97651,725,3,209,202,7,6,1,0
448041,1922,4,269,30,239,2,1,0
374215,5376,5,565,541,24,2,1,0
218488,1002,4,140,138,2,0,1,0
0,0,0,0,0,0,0,0,0
43885,690,2,90,87,3,2,1,0
92939,893,6,173,155,18,10,1,0
0,0,0,0,0,0,0,0,0
0,0,0,0,0,0,0,0,0
182455,802,4,126,93,33,13,0,0
262673,1420,7,142,117,25,79,1,0
0,0,0,0,0,0,0,0,0
1813723,1277,2,190,171,19,1,1,0
466458,1877,4,178,149,29,103,1,0
370221,1137,2,124,120,4,10,0,0
0,0,0,0,0,0,0,0,0
180948,2374,6,405,370,35,17,1,0
80377,923,4,238,209,29,7,1,0
0,0,0,0,0,0,0,0,0
139875,956,4,242,240,2,7,1,0
78537,384,3,72,71,1,6,1,0
11508,144,6,2,2,0,5,0,0
81160,873,2,160,156,4,13,1,0
693118,538,0,5,2,3,2,1,1
365577,2675,6,480,314,166,58,1,0
304334,1540,6,339,9,330,34,1,0
256044,1281,6,180,146,34,2,0,0
0,0,0,0,0,0,0,0,0
3657,65,3,1,0,1,0,0,0
2404378,2776,8,455,422,33,57,1,0
162845,400,7,17,10,7,7,1,0
356207,3555,11,851,826,25,73,1,0
0,0,0,0,0,0,0,0,0
99640,1221,3,165,61,104,7,1,0
0,0,0,0,0,0,0,0,0
202519,954,1,117,92,25,0,1,0
0,0,0,0,0,0,0,0,0
1209776,17182,7,814,605,209,529,1,0
61611,295,6,7,6,1,7,1,0
147333,1204,8,290,275,15,12,1,0
0,0,0,0,0,0,0,0,0
117808,480,11,84,77,7,21,1,0
79392,727,4,137,128,9,4,1,0
0,0,0,0,0,0,0,0,0
254495,1350,6,136,125,11,47,1,0
19366,112,2,6,6,0,0,0,0
144799,492,5,29,21,8,1,0,0
140989,1296,10,234,227,7,32,0,0
951618,15154,7,1173,1172,1,9,0,0
317586,2069,2,172,153,19,3,1,0
0,0,0,0,0,0,0,0,0
184593,1217,0,187,187,0,1,1,0
339484,1748,15,288,257,31,24,0,1
0,0,0,0,0,0,0,0,0
0,0,0,0,0,0,0,0,0
182411,520,2,44,42,2,0,0,0
0,0,0,0,0,0,0,0,0
0,0,0,0,0,0,0,0,0
121460,1361,2,442,438,4,6,0,0
0,0,0,0,0,0,0,0,0
589878,1331,1,121,116,5,2,1,1
275205,134,1,8,5,3,1,1,1
27619,110,5,7,7,0,0,1,0
29811,180,6,3,1,2,0,1,0
52929,205,7,6,5,1,11,1,0
231583,343,0,16,3,13,0,1,0
124879,866,6,94,57,37,13,0,0
124250,848,6,94,57,37,13,0,0
110650,628,1,25,25,0,1,0,0
138938,2405,5,586,530,56,4,1,0
431177,1275,6,190,182,8,6,0,0
0,0,0,0,0,0,0,0,0
341857,1080,3,100,90,10,5,0,0
50835,35,0,0,0,0,0,0,0
0,0,0,0,0,0,0,0,0
8987,135,0,16,16,0,0,0,0
190146,1148,2,248,222,26,3,1,0
0,0,0,0,0,0,0,0,0
104207,881,3,229,210,19,9,0,0
161983,1001,7,99,67,32,8,1,0
9864,152,2,25,25,0,0,0,0
121745,1255,4,266,253,13,21,1,0
31999,321,2,29,28,1,3,1,0
0,0,0,0,0,0,0,0,0
404494,1097,9,139,130,9,5,1,0
160989,534,10,94,85,9,6,1,0
191164,804,4,148,145,3,0,1,0
105796,1898,1,351,342,9,2,1,0
163468,1831,6,430,424,6,16,1,0
480921,4245,7,1136,1135,1,15,1,0
215874,878,13,183,180,3,17,1,0
6712,63,6,3,2,1,0,0,0
0,0,0,0,0,0,0,0,0
188280,1284,9,222,206,16,9,1,0
65430,193,4,7,6,1,7,1,0
22710,37,0,2,1,1,0,1,0
392448,1812,5,279,273,6,5,1,0
185584,547,5,46,42,4,3,1,0
336875,1456,4,149,113,36,0,1,0
1164976,2539,10,327,309,18,14,1,0
0,0,0,0,0,0,0,0,0
0,0,0,0,0,0,0,0,0
0,0,0,0,0,0,0,0,0
2619299,1326,9,234,228,6,11,1,0
358130,537,3,100,85,15,5,1,0
354973,349,6,75,59,16,5,1,0
0,0,0,0,0,0,0,0,0
231134,2217,8,402,377,25,35,1,0
68324,884,5,217,191,26,13,1,0
0,0,0,0,0,0,0,0,0
0,0,0,0,0,0,0,0,0
60004,737,5,216,205,11,7,0,0
10835,124,1,7,6,1,0,0,0
1513323,17676,9,1586,1572,14,30,0,0
301255,1976,9,359,340,19,20,1,1
13553,222,3,48,47,1,0,1,0
9749,153,1,30,29,1,0,1,0
0,0,0,0,0,0,0,0,0
189460,1128,3,485,485,0,3,1,0
0,0,0,0,0,0,0,0,0
217688,1340,10,240,232,8,9,1,0
0,0,0,0,0,0,0,0,0
72704,1159,9,176,175,1,3,1,0
42409,400,10,93,92,1,3,1,0
344806,1695,7,217,36,181,12,1,0
281318,836,9,11,5,6,6,1,0
48893,552,8,105,89,16,2,1,0
1008575,4051,13,271,167,104,35,1,0
22688,313,2,57,57,0,4,0,0
0,0,0,0,0,0,0,0,0
210486,262,0,26,26,0,0,1,0
0,0,0,0,0,0,0,0,0
0,0,0,0,0,0,0,0,0
424630,5182,10,932,893,39,32,1,0
96941,478,5,67,67,0,7,1,0
99399,565,4,88,84,4,23,1,0
11078,173,1,22,22,0,4,1,0
0,0,0,0,0,0,0,0,0
444734,1569,7,139,108,31,1,0,0
1349,34,0,1,1,0,0,0,0
227719,2144,2,301,265,36,20,1,0
35756,522,2,94,85,9,3,1,0
33767,195,2,51,51,0,7,1,0
328855,1627,11,341,318,23,26,1,0
0,0,0,0,0,0,0,0,0
0,0,0,0,0,0,0,0,0
129181,1005,12,153,152,1,3,1,0
66589,917,5,236,235,1,9,0,0
0,0,0,0,0,0,0,0,0
0,0,0,0,0,0,0,0,0
387092,1486,5,329,321,8,1,1,0
0,0,0,0,0,0,0,0,0
124295,1162,3,72,45,27,2,1,0
0,0,0,0,0,0,0,0,0
45894,536,8,62,58,4,4,1,0
280212,1117,8,99,92,7,10,1,0
0,0,0,0,0,0,0,0,0
59930,665,9,122,116,6,6,1,0
0,0,0,0,0,0,0,0,0
0,0,0,0,0,0,0,0,0
692501,5395,10,749,736,13,27,1,0
0,0,0,0,0,0,0,0,0
27345,415,2,103,101,2,0,1,0
44166,420,1,146,145,1,0,0,0
424802,4149,3,375,288,87,0,1,0
4018,78,1,12,9,3,0,1,0
0,0,0,0,0,0,0,0,0
128058,536,10,43,37,6,5,1,0
37007,600,2,137,123,14,0,1,0
0,0,0,0,0,0,0,0,0
234085,2824,1,445,375,70,4,1,0
1320306,4112,4,221,213,8,0,1,0
153150,884,3,187,172,15,0,0,0
99155,497,8,124,106,18,14,1,0
139358,548,5,120,118,2,8,1,0
0,0,0,0,0,0,0,0,0
0,0,0,0,0,0,0,0,0
0,0,0,0,0,0,0,0,0
0,0,0,0,0,0,0,0,0
0,0,0,0,0,0,0,0,0
0,0,0,0,0,0,0,0,0
0,0,0,0,0,0,0,0,0
0,0,0,0,0,0,0,0,0
0,0,0,0,0,0,0,0,0
0,0,0,0,0,0,0,0,0
0,0,0,0,0,0,0,0,0
0,0,0,0,0,0,0,0,0
0,0,0,0,0,0,0,0,0
0,0,0,0,0,0,0,0,0
0,0,0,0,0,0,0,0,0
0,0,0,0,0,0,0,0,0
0,0,0,0,0,0,0,0,0
0,0,0,0,0,0,0,0,0
0,0,0,0,0,0,0,0,0
0,0,0,0,0,0,0,0,0
0,0,0,0,0,0,0,0,0
0,0,0,0,0,0,0,0,0
0,0,0,0,0,0,0,0,0
0,0,0,0,0,0,0,0,0
0,0,0,0,0,0,0,0,0
0,0,0,0,0,0,0,0,0
0,0,0,0,0,0,0,0,0
0,0,0,0,0,0,0,0,0
0,0,0,0,0,0,0,0,0
0,0,0,0,0,0,0,0,0
0,0,0,0,0,0,0,0,0
0,0,0,0,0,0,0,0,0
0,0,0,0,0,0,0,0,0
0,0,0,0,0,0,0,0,0
0,0,0,0,0,0,0,0,0
0,0,0,0,0,0,0,0,0
0,0,0,0,0,0,0,0,0
0,0,0,0,0,0,0,0,0
0,0,0,0,0,0,0,0,0
0,0,0,0,0,0,0,0,0
0,0,0,0,0,0,0,0,0
0,0,0,0,0,0,0,0,0
0,0,0,0,0,0,0,0,0
0,0,0,0,0,0,0,0,0
0,0,0,0,0,0,0,0,0
0,0,0,0,0,0,0,0,0
0,0,0,0,0,0,0,0,0
0,0,0,0,0,0,0,0,0
0,0,0,0,0,0,0,0,0
0,0,0,0,0,0,0,0,0
0,0,0,0,0,0,0,0,0
0,0,0,0,0,0,0,0,0
0,0,0,0,0,0,0,0,0
0,0,0,0,0,0,0,0,0
0,0,0,0,0,0,0,0,0
0,0,0,0,0,0,0,0,0
0,0,0,0,0,0,0,0,0
0,0,0,0,0,0,0,0,0
0,0,0,0,0,0,0,0,0
0,0,0,0,0,0,0,0,0
0,0,0,0,0,0,0,0,0
0,0,0,0,0,0,0,0,0
0,0,0,0,0,0,0,0,0
0,0,0,0,0,0,0,0,0
0,0,0,0,0,0,0,0,0
0,0,0,0,0,0,0,0,0
0,0,0,0,0,0,0,0,0
0,0,0,0,0,0,0,0,0
0,0,0,0,0,0,0,0,0
0,0,0,0,0,0,0,0,0
0,0,0,0,0,0,0,0,0
0,0,0,0,0,0,0,0,0
0,0,0,0,0,0,0,0,0
0,0,0,0,0,0,0,0,0
0,0,0,0,0,0,0,0,0
0,0,0,0,0,0,0,0,0
0,0,0,0,0,0,0,0,0
0,0,0,0,0,0,0,0,0
0,0,0,0,0,0,0,0,0
0,0,0,0,0,0,0,0,0
0,0,0,0,0,0,0,0,0
0,0,0,0,0,0,0,0,0
0,0,0,0,0,0,0,0,0
0,0,0,0,0,0,0,0,0
0,0,0,0,0,0,0,0,0
0,0,0,0,0,0,0,0,0
0,0,0,0,0,0,0,0,0
0,0,0,0,0,0,0,0,0
0,0,0,0,0,0,0,0,0
0,0,0,0,0,0,0,0,0
0,0,0,0,0,0,0,0,0
0,0,0,0,0,0,0,0,0
0,0,0,0,0,0,0,0,0
0,0,0,0,0,0,0,0,0
0,0,0,0,0,0,0,0,0
0,0,0,0,0,0,0,0,0
0,0,0,0,0,0,0,0,0
0,0,0,0,0,0,0,0,0
0,0,0,0,0,0,0,0,0
0,0,0,0,0,0,0,0,0
0,0,0,0,0,0,0,0,0
0,0,0,0,0,0,0,0,0
0,0,0,0,0,0,0,0,0
0,0,0,0,0,0,0,0,0
0,0,0,0,0,0,0,0,0
0,0,0,0,0,0,0,0,0
0,0,0,0,0,0,0,0,0
0,0,0,0,0,0,0,0,0
0,0,0,0,0,0,0,0,0
0,0,0,0,0,0,0,0,0
0,0,0,0,0,0,0,0,0
0,0,0,0,0,0,0,0,0
0,0,0,0,0,0,0,0,0
0,0,0,0,0,0,0,0,0
0,0,0,0,0,0,0,0,0
0,0,0,0,0,0,0,0,0
0,0,0,0,0,0,0,0,0
0,0,0,0,0,0,0,0,0
0,0,0,0,0,0,0,0,0
0,0,0,0,0,0,0,0,0
0,0,0,0,0,0,0,0,0
0,0,0,0,0,0,0,0,0
0,0,0,0,0,0,0,0,0
0,0,0,0,0,0,0,0,0
0,0,0,0,0,0,0,0,0
0,0,0,0,0,0,0,0,0
0,0,0,0,0,0,0,0,0
0,0,0,0,0,0,0,0,0
0,0,0,0,0,0,0,0,0
0,0,0,0,0,0,0,0,0
0,0,0,0,0,0,0,0,0
0,0,0,0,0,0,0,0,0
0,0,0,0,0,0,0,0,0
0,0,0,0,0,0,0,0,0
0,0,0,0,0,0,0,0,0
0,0,0,0,0,0,0,0,0
0,0,0,0,0,0,0,0,0
0,0,0,0,0,0,0,0,0
0,0,0,0,0,0,0,0,0
0,0,0,0,0,0,0,0,0
0,0,0,0,0,0,0,0,0
0,0,0,0,0,0,0,0,0
0,0,0,0,0,0,0,0,0
0,0,0,0,0,0,0,0,0
0,0,0,0,0,0,0,0,0
0,0,0,0,0,0,0,0,0
0,0,0,0,0,0,0,0,0
0,0,0,0,0,0,0,0,0
0,0,0,0,0,0,0,0,0
0,0,0,0,0,0,0,0,0
0,0,0,0,0,0,0,0,0
0,0,0,0,0,0,0,0,0
0,0,0,0,0,0,0,0,0
0,0,0,0,0,0,0,0,0
0,0,0,0,0,0,0,0,0
0,0,0,0,0,0,0,0,0
0,0,0,0,0,0,0,0,0
0,0,0,0,0,0,0,0,0
0,0,0,0,0,0,0,0,0
0,0,0,0,0,0,0,0,0
0,0,0,0,0,0,0,0,0
0,0,0,0,0,0,0,0,0
0,0,0,0,0,0,0,0,0
0,0,0,0,0,0,0,0,0
0,0,0,0,0,0,0,0,0
0,0,0,0,0,0,0,0,0
0,0,0,0,0,0,0,0,0
0,0,0,0,0,0,0,0,0
0,0,0,0,0,0,0,0,0
0,0,0,0,0,0,0,0,0
0,0,0,0,0,0,0,0,0
0,0,0,0,0,0,0,0,0
0,0,0,0,0,0,0,0,0
0,0,0,0,0,0,0,0,0
0,0,0,0,0,0,0,0,0
0,0,0,0,0,0,0,0,0
0,0,0,0,0,0,0,0,0
0,0,0,0,0,0,0,0,0
0,0,0,0,0,0,0,0,0
0,0,0,0,0,0,0,0,0
0,0,0,0,0,0,0,0,0
0,0,0,0,0,0,0,0,0
0,0,0,0,0,0,0,0,0
0,0,0,0,0,0,0,0,0
0,0,0,0,0,0,0,0,0
0,0,0,0,0,0,0,0,0
0,0,0,0,0,0,0,0,0
0,0,0,0,0,0,0,0,0
0,0,0,0,0,0,0,0,0
0,0,0,0,0,0,0,0,0
0,0,0,0,0,0,0,0,0
0,0,0,0,0,0,0,0,0
0,0,0,0,0,0,0,0,0
0,0,0,0,0,0,0,0,0
0,0,0,0,0,0,0,0,0
0,0,0,0,0,0,0,0,0
0,0,0,0,0,0,0,0,0
0,0,0,0,0,0,0,0,0
0,0,0,0,0,0,0,0,0
0,0,0,0,0,0,0,0,0
0,0,0,0,0,0,0,0,0
0,0,0,0,0,0,0,0,0
0,0,0,0,0,0,0,0,0
0,0,0,0,0,0,0,0,0
0,0,0,0,0,0,0,0,0
0,0,0,0,0,0,0,0,0
0,0,0,0,0,0,0,0,0
0,0,0,0,0,0,0,0,0
0,0,0,0,0,0,0,0,0
0,0,0,0,0,0,0,0,0
0,0,0,0,0,0,0,0,0
0,0,0,0,0,0,0,0,0
0,0,0,0,0,0,0,0,0
0,0,0,0,0,0,0,0,0
155524,1558,8,476,338,138,7,1,0
72383,565,10,81,72,9,9,1,0
15042,221,5,27,21,6,1,0,0
0,0,0,0,0,0,0,0,0
0,0,0,0,0,0,0,0,0
191734,1742,8,515,493,22,49,1,0
113738,2409,5,523,507,16,3,1,0
60045,702,6,246,242,4,8,1,0
25770,184,6,32,30,2,5,1,0
0,0,0,0,0,0,0,0,0
308625,868,2,143,134,9,2,1,0
117673,774,4,168,167,1,0,1,0
0,0,0,0,0,0,0,0,0
7985,131,2,15,7,8,0,1,0
113098,1389,2,329,328,1,8,0,0
161752,1128,5,202,194,8,3,1,0
0,0,0,0,0,0,0,0,0
232894,347,0,17,9,8,0,1,0
724523,3596,16,403,369,34,11,1,0
180411,153,4,10,7,3,1,1,0
1017893,115,5,4,4,0,1,1,0
114258,1271,6,282,260,22,10,1,0
58746,755,3,92,75,17,8,1,0
0,0,0,0,0,0,0,0,0
120949,737,10,181,150,31,11,1,0
0,0,0,0,0,0,0,0,0
25874,220,1,31,31,0,9,1,0
6911,163,0,29,28,1,0,1,0
61407,1182,4,296,271,25,8,1,0
0,0,0,0,0,0,0,0,0
216625,1079,10,180,168,12,2,0,0
11625,148,5,3,3,0,3,0,0
0,0,0,0,0,0,0,0,0
767264,3679,10,181,166,15,53,1,0
208032,435,10,5,4,1,7,0,0
553557,4000,12,375,347,28,6,0,1
63704,894,1,293,291,2,5,1,0
197402,1723,9,399,385,14,10,1,0
4135,46,3,4,4,0,0,0,0
0,0,0,0,0,0,0,0,0
125446,1477,10,287,286,1,1,0,0
7293,58,6,3,2,1,0,0,0
86181,359,9,29,28,1,1,0,0
9312,168,2,72,66,6,3,1,0
75588,1039,6,234,229,5,6,0,0
28543,322,6,53,48,5,6,0,0
0,0,0,0,0,0,0,0,0
79541,302,5,33,30,3,1,1,0
142391,1095,7,269,259,10,4,0,0
227148,906,6,247,106,141,4,0,0
0,0,0,0,0,0,0,0,0
0,0,0,0,0,0,0,0,0
207249,729,4,146,145,1,4,1,0
1928067,1057,5,67,49,18,1,1,0
0,0,0,0,0,0,0,0,0
0,0,0,0,0,0,0,0,0
247685,1485,8,204,185,19,2,1,0
0,0,0,0,0,0,0,0,0
273655,2069,4,259,238,21,0,0,0
0,0,0,0,0,0,0,0,0
0,0,0,0,0,0,0,0,0
0,0,0,0,0,0,0,0,0
128766,2049,3,486,482,4,13,1,0
0,0,0,0,0,0,0,0,0
100892,877,11,185,180,5,18,1,0
48446,149,6,13,8,5,1,1,0
0,0,0,0,0,0,0,0,0
474306,1341,8,129,25,104,10,1,0
8309,90,2,5,2,3,0,1,0
0,0,0,0,0,0,0,0,0
446866,3853,4,618,459,159,71,1,0
0,0,0,0,0,0,0,0,0
142310,2933,2,822,811,11,16,1,0
208132,1031,9,138,132,6,8,1,0
172958,656,7,83,71,12,6,1,0
0,0,0,0,0,0,0,0,0
0,0,0,0,0,0,0,0,0
0,0,0,0,0,0,0,0,0
53345,527,5,84,74,10,2,1,0
0,0,0,0,0,0,0,0,0
401722,465,3,63,63,0,0,1,0
390463,254,3,48,48,0,2,1,0
2367,23,5,0,0,0,0,0,0
71860,719,4,121,119,2,9,1,0
340361,1986,20,330,244,86,11,1,0
927456,4251,6,731,697,34,75,1,0
0,0,0,0,0,0,0,0,0
210246,652,7,80,80,0,7,0,0
0,0,0,0,0,0,0,0,0
18864,163,1,19,17,2,3,1,0
10157,87,0,12,11,1,1,1,0
0,0,0,0,0,0,0,0,0
0,0,0,0,0,0,0,0,0
12574,225,0,112,109,3,0,0,0
2678,51,1,2,1,1,0,0,0
250842,1473,12,336,309,27,38,1,0
0,0,0,0,0,0,0,0,0
1466795,699,6,31,25,6,17,1,0
367371,1097,12,200,175,25,84,1,0
389672,5396,5,1253,1124,129,3,1,0
119388,750,3,269,217,52,11,1,0
0,0,0,0,0,0,0,0,0
338602,1388,12,209,180,29,2,1,0
0,0,0,0,0,0,0,0,0
0,0,0,0,0,0,0,0,0
0,0,0,0,0,0,0,0,0
0,0,0,0,0,0,0,0,0
0,0,0,0,0,0,0,0,0
11193,96,3,13,13,0,0,1,0
1415282,950,2,71,54,17,2,1,0
385805,119,0,5,5,0,0,1,0
296519,835,5,12,10,2,5,1,0
0,0,0,0,0,0,0,0,0
0,0,0,0,0,0,0,0,0
0,0,0,0,0,0,0,0,0
68581,373,3,65,61,4,7,0,0
79997,351,2,25,20,5,2,1,0
94735,815,8,169,158,11,7,1,0
0,0,0,0,0,0,0,0,0
0,0,0,0,0,0,0,0,0
234828,765,1,143,138,5,1,1,0
47502,163,3,17,1,16,2,1,0
0,0,0,0,0,0,0,0,0
392059,1760,7,553,527,26,52,1,0
17381,230,3,11,1,10,3,1,0
6122,83,3,11,11,0,3,1,0
0,0,0,0,0,0,0,0,0
334887,673,5,130,124,6,0,1,0
512845,3937,6,672,662,10,8,1,0
0,0,0,0,0,0,0,0,0
65559,482,10,139,88,51,2,0,0
164308,714,5,64,40,24,8,0,0
0,0,0,0,0,0,0,0,0
0,0,0,0,0,0,0,0,0
0,0,0,0,0,0,0,0,0
0,0,0,0,0,0,0,0,0
41552,666,3,180,170,10,3,0,0
0,0,0,0,0,0,0,0,0
0,0,0,0,0,0,0,0,0
588624,3393,7,609,582,27,9,0,0
0,0,0,0,0,0,0,0,0
20499,345,1,78,61,17,0,1,0
12330,176,2,40,7,33,0,1,0
440175,3286,5,358,345,13,11,1,0
31089,151,3,5,4,1,2,0,0
499914,1505,16,235,209,26,29,0,0
0,0,0,0,0,0,0,0,0
247540,1632,2,479,470,9,2,0,0
51707,1038,6,311,310,1,0,0,0
0,0,0,0,0,0,0,0,0
47078,626,4,105,105,0,2,1,0
182034,1906,4,494,276,218,28,1,0
82758,746,6,152,125,27,7,1,0
914534,9429,8,934,357,577,271,1,0
11235,132,2,13,13,0,2,1,0
0,0,0,0,0,0,0,0,0
22091,205,7,51,51,0,1,1,0
9657,246,0,77,54,23,0,1,0
92805,885,5,131,126,5,3,0,0
0,0,0,0,0,0,0,0,0
146833,1527,3,299,293,6,1,0,0
0,0,0,0,0,0,0,0,0
272143,1827,10,305,285,20,5,1,0
104681,1110,2,150,76,74,14,1,0
11646,47,0,3,2,1,1,0,0
0,0,0,0,0,0,0,0,0
185694,1947,8,394,358,36,44,1,0
753840,1549,5,392,371,21,6,1,0
218509,2471,3,583,395,188,6,1,0
0,0,0,0,0,0,0,0,0
0,0,0,0,0,0,0,0,0
0,0,0,0,0,0,0,0,0
1513817,1159,7,83,82,1,5,1,0
215843,1513,2,56,56,0,0,0,0
311427,2048,13,204,52,152,4,1,0
161507,1401,5,345,339,6,1,1,0
112612,991,5,281,275,6,1,1,0
129408,196,3,10,10,0,2,1,0
64677,824,2,210,207,3,2,1,0
0,0,0,0,0,0,0,0,0
371229,2328,4,261,249,12,87,1,1
0,0,0,0,0,0,0,0,0
66517,1064,4,195,169,26,3,1,0
26193,405,3,131,106,25,1,1,0
139758,786,5,79,74,5,2,1,0
0,0,0,0,0,0,0,0,0
92430,1041,2,60,33,27,2,1,0
262624,3608,12,610,593,17,0,1,0
0,0,0,0,0,0,0,0,0
108297,956,4,150,114,36,2,1,0
19406,131,2,19,18,1,0,1,0
0,0,0,0,0,0,0,0,0
36913,630,1,93,89,4,12,0,0
14805,290,1,57,56,1,0,1,0
155199,1226,1,242,241,1,1,1,1
392225,2549,4,466,376,90,7,1,1
0,0,0,0,0,0,0,0,0
29415,342,5,62,61,1,0,0,0
60834,662,4,161,160,1,9,1,0
723659,6843,8,519,351,168,611,1,0
0,0,0,0,0,0,0,0,0
0,0,0,0,0,0,0,0,0
0,0,0,0,0,0,0,0,0
13804,266,1,142,137,5,0,1,0
0,0,0,0,0,0,0,0,0
207173,1693,6,1132,1131,1,0,1,0
32807,337,6,80,79,1,0,1,0
312132,1812,10,416,29,387,4,1,0
239805,1557,12,134,86,48,17,1,0
140624,1030,1,107,101,6,0,1,0
128090,797,0,137,130,7,0,0,0
34487,132,6,3,3,0,11,0,0
0,0,0,0,0,0,0,0,0
434313,2340,6,565,543,22,9,1,0
64864,742,6,223,220,3,6,1,0
0,0,0,0,0,0,0,0,0
378960,1401,5,247,238,9,11,1,0
203136,340,4,84,72,12,1,1,0
1074805,4503,9,490,457,33,18,1,0
231007,347,0,17,12,5,0,1,0
0,0,0,0,0,0,0,0,0
9768,46,0,2,0,2,0,0,0
0,0,0,0,0,0,0,0,0
138941,1545,2,602,591,11,6,0,0
10568,206,1,32,23,9,3,0,0
0,0,0,0,0,0,0,0,0
0,0,0,0,0,0,0,0,0
0,0,0,0,0,0,0,0,0
56074,397,5,34,34,0,18,0,0
0,0,0,0,0,0,0,0,0
134286,1661,4,467,440,27,7,1,0
0,0,0,0,0,0,0,0,0
146768,1183,9,129,119,10,0,1,0
41200,286,9,48,43,5,2,1,0
227511,733,4,32,28,4,0,1,0
115670,313,4,27,22,5,0,1,0
0,0,0,0,0,0,0,0,0
199803,430,5,33,28,5,20,1,0
0,0,0,0,0,0,0,0,0
0,0,0,0,0,0,0,0,0
94093,608,6,77,41,36,1,1,0
103797,811,3,73,47,26,3,1,0
0,0,0,0,0,0,0,0,0
107106,747,4,146,139,7,0,1,0
4844284,35930,9,3517,2016,1501,8,1,0
47110,132,8,3,0,3,0,1,0
1372423,5694,6,1179,1155,24,4,0,0
22902,37,0,2,1,1,0,1,0
0,0,0,0,0,0,0,0,0
0,0,0,0,0,0,0,0,0
0,0,0,0,0,0,0,0,0
0,0,0,0,0,0,0,0,0
885360,5011,3,613,169,444,542,1,0
0,0,0,0,0,0,0,0,0
0,0,0,0,0,0,0,0,0
0,0,0,0,0,0,0,0,0
61624,881,0,511,468,43,0,0,0
103776,949,7,162,159,3,29,0,0
54729,239,7,1,1,0,28,1,0
0,0,0,0,0,0,0,0,0
459804,1566,14,314,290,24,24,1,0
0,0,0,0,0,0,0,0,0
0,0,0,0,0,0,0,0,0
0,0,0,0,0,0,0,0,0
25587,93,1,9,8,1,2,0,0
531550,3037,6,838,838,0,15,1,0
459814,2066,7,499,499,0,14,1,0
54935,1004,2,109,98,11,21,0,0
4875,89,3,14,13,1,1,0,0
0,0,0,0,0,0,0,0,0
1059564,3567,1,497,472,25,0,1,0
18824,59,0,0,0,0,1,0,0
0,0,0,0,0,0,0,0,0
781105,2280,5,287,278,9,2,1,0
43652,428,4,52,44,8,2,1,0
111880,920,8,143,76,67,6,1,0
465714,2277,8,237,188,49,20,1,0
0,0,0,0,0,0,0,0,0
0,0,0,0,0,0,0,0,0
64344,621,3,96,74,22,1,1,0
48269,156,4,4,3,1,3,0,0
513954,4286,6,2007,2004,3,3,1,0
0,0,0,0,0,0,0,0,0
0,0,0,0,0,0,0,0,0
113168,1386,2,91,90,1,9,1,0
9337,69,1,0,0,0,0,0,0
248602,1476,11,244,224,20,46,1,0
23409,37,0,2,1,1,0,1,0
0,0,0,0,0,0,0,0,0
0,0,0,0,0,0,0,0,0
0,0,0,0,0,0,0,0,0
3276094,3105,5,311,252,59,4,1,0
619153,923,6,169,137,32,3,1,0
0,0,0,0,0,0,0,0,0
494715,4433,6,1192,1185,7,19,1,0
573620,2055,7,255,229,26,20,1,0
0,0,0,0,0,0,0,0,0
25751,100,1,13,10,3,0,1,0
0,0,0,0,0,0,0,0,0
234554,3376,1,811,668,143,1,0,0
0,0,0,0,0,0,0,0,0
0,0,0,0,0,0,0,0,0
234376,974,2,203,197,6,4,1,0
7222,70,0,4,4,0,1,1,0
123602,892,1,208,198,10,5,1,0
81474,353,4,9,2,7,6,1,0
639456,1044,11,101,79,22,1,1,0
10268,143,3,8,8,0,5,0,0
0,0,0,0,0,0,0,0,0
0,0,0,0,0,0,0,0,0
0,0,0,0,0,0,0,0,0
23605,229,7,33,25,8,2,1,0
0,0,0,0,0,0,0,0,0
0,0,0,0,0,0,0,0,0
0,0,0,0,0,0,0,0,0
0,0,0,0,0,0,0,0,0
59331,433,4,51,35,16,9,1,0
0,0,0,0,0,0,0,0,0
0,0,0,0,0,0,0,0,0
0,0,0,0,0,0,0,0,0
0,0,0,0,0,0,0,0,0
0,0,0,0,0,0,0,0,0
1580687,2402,14,402,207,195,62,1,0
146594,1006,3,58,50,8,1,0,0
135546,1120,6,212,200,12,11,1,0
268316,2552,7,310,247,63,14,0,0
268315,2552,7,310,280,30,14,0,0
209410,3851,7,624,578,46,1,1,0
233850,1605,9,333,319,14,7,1,0
141017,949,10,373,369,4,0,1,0
388371,1538,6,349,328,21,4,1,0
526556,1881,5,331,318,13,3,1,0
0,0,0,0,0,0,0,0,0
68234,537,4,99,95,4,4,1,0
129323,1441,5,216,209,7,6,1,0
0,0,0,0,0,0,0,0,0
0,0,0,0,0,0,0,0,0
293058,984,1,217,192,25,1,0,0
101590,589,16,76,71,5,10,1,0
105602,660,11,111,107,4,0,1,0
288712,903,8,151,136,15,4,1,0
0,0,0,0,0,0,0,0,0
0,0,0,0,0,0,0,0,0
27947,42,0,2,1,1,0,0,0
22515,39,0,3,1,2,0,1,0
220921,1865,6,503,499,4,8,1,0
235057,1882,5,503,497,6,9,1,0
132793,1501,2,234,234,0,8,0,0
997522,5298,4,997,997,0,3,1,0
170517,1116,9,178,155,23,17,1,0
85116,303,5,6,6,0,6,1,0
0,0,0,0,0,0,0,0,0
57626,961,4,320,296,24,0,0,0
10447,206,5,27,26,1,0,0,0
9808,112,3,7,5,2,1,0,0
136047,415,2,83,16,67,2,0,0
0,0,0,0,0,0,0,0,0
138224,871,5,183,165,18,8,1,0
0,0,0,0,0,0,0,0,0
87744,781,1,320,270,50,3,1,0
0,0,0,0,0,0,0,0,0
0,0,0,0,0,0,0,0,0
0,0,0,0,0,0,0,0,0
0,0,0,0,0,0,0,0,0
229311,1354,2,189,178,11,0,1,0
0,0,0,0,0,0,0,0,0
133499,776,5,142,118,24,9,0,0
0,0,0,0,0,0,0,0,0
102004,1005,10,169,161,8,7,1,0
100879,959,10,165,159,6,7,1,0
77673,815,4,175,149,26,2,1,0
78227,1787,2,603,588,15,0,1,0
561891,2589,4,18,1,17,13,0,0
83816,1487,2,362,358,4,8,1,0
46480,923,2,227,225,2,10,1,0
118475,530,4,67,64,3,9,0,0
45122,792,3,116,111,5,1,1,0
103339,1700,4,473,465,8,11,0,0
26871,143,2,16,15,1,2,1,0
319488,1493,14,125,113,12,22,1,0
206200,1195,5,108,101,7,5,1,0
849226,499,5,84,77,7,2,1,0
253114,2077,0,355,320,35,45,1,0
0,0,0,0,0,0,0,0,0
0,0,0,0,0,0,0,0,0
0,0,0,0,0,0,0,0,0
1166492,6762,1,229,221,8,6,0,0
40166,233,0,24,16,8,2,0,0
263377,3270,3,863,859,4,13,1,0
121432,940,8,150,130,20,3,1,0
286046,1812,5,427,402,25,64,1,0
275491,3379,1,1005,983,22,25,1,0
0,0,0,0,0,0,0,0,0
172600,2257,11,359,350,9,32,1,0
458090,1532,9,295,284,11,6,1,0
206338,784,11,99,87,12,1,1,0
74751,74,8,7,7,0,1,0,1
28533,45,0,4,1,3,0,0,0
135820,799,4,136,132,4,19,1,0
737271,2276,13,256,231,25,31,0,0
0,0,0,0,0,0,0,0,0
0,0,0,0,0,0,0,0,0
256942,1356,7,299,287,12,4,1,0
115570,141,6,5,3,2,5,0,0
0,0,0,0,0,0,0,0,0
0,0,0,0,0,0,0,0,0
1229051,9318,9,1999,1644,355,23,1,0
411039,1202,11,176,29,147,17,0,0
59667,229,4,44,43,1,0,1,0
371956,1933,11,176,157,19,18,1,0
35934,641,0,235,235,0,0,0,0
5870,124,0,25,25,0,0,0,0
207030,864,6,278,271,7,3,1,0
0,0,0,0,0,0,0,0,0
24562,320,4,45,8,37,0,1,0
124307,1135,4,205,198,7,0,1,0
0,0,0,0,0,0,0,0,0
459264,1781,5,257,255,2,2,1,0
245127,650,6,104,98,6,8,1,0
114514,327,5,50,44,6,0,1,0
0,0,0,0,0,0,0,0,0
225466,723,1,139,135,4,1,1,0
46731,163,3,17,1,16,2,1,0
699995,4538,5,274,229,45,93,1,0
0,0,0,0,0,0,0,0,0
0,0,0,0,0,0,0,0,0
0,0,0,0,0,0,0,0,0
320800,2957,3,979,832,147,5,1,0
119388,750,3,269,217,52,11,1,0
36384,502,4,138,103,35,0,0,0
228411,1332,1,215,214,1,11,1,0
1820655,5845,3,412,360,52,31,1,0
248405,462,3,72,49,23,6,1,0
14240,361,0,68,62,6,0,0,0
0,0,0,0,0,0,0,0,0
32272,477,5,140,113,27,0,1,0
125781,654,2,68,40,28,0,0,0
11661,124,6,11,10,1,5,0,0
134678,1007,7,104,97,7,2,1,0
74103,416,4,47,41,6,0,1,0
253466,1547,2,121,115,6,0,1,0
56831,427,1,62,56,6,0,1,0
144653,1110,3,280,268,12,1,1,0
0,0,0,0,0,0,0,0,0
0,0,0,0,0,0,0,0,0
70448,764,1,128,126,2,5,0,0
16139,279,1,22,20,2,2,0,0
0,0,0,0,0,0,0,0,0
0,0,0,0,0,0,0,0,0
45397,322,6,44,39,5,2,1,0
46018,481,4,108,95,13,6,1,0
17678,96,4,1,1,0,3,0,0
698043,2363,7,391,377,14,6,0,0
0,0,0,0,0,0,0,0,0
0,0,0,0,0,0,0,0,0
119803,767,4,43,30,13,0,1,0
334177,5801,5,1164,83,1081,2,1,0
0,0,0,0,0,0,0,0,0
0,0,0,0,0,0,0,0,0
138833,1291,5,228,143,85,1,0,0
73987,664,2,105,104,1,27,0,0
46632,307,0,76,69,7,0,1,0
457374,3213,16,946,841,105,12,1,0
264365,2173,15,630,604,26,12,1,0
98343,2444,2,738,730,8,6,1,0
0,0,0,0,0,0,0,0,0
0,0,0,0,0,0,0,0,0
196376,1124,8,267,242,25,5,1,0
153768,838,8,180,156,24,5,1,0
0,0,0,0,0,0,0,0,0
1881,26,1,1,1,0,0,0,0
404749,886,9,113,60,53,13,1,0
0,0,0,0,0,0,0,0,0
193424,1504,10,343,111,232,32,1,0
371363,3159,9,320,297,23,80,1,0
0,0,0,0,0,0,0,0,0
0,0,0,0,0,0,0,0,0
156576,1030,5,148,138,10,8,1,0
325333,687,6,119,116,3,19,1,0
20193,113,6,13,12,1,4,0,0
0,0,0,0,0,0,0,0,0
230987,347,0,17,8,9,0,1,0
348889,3094,10,781,750,31,42,1,0
683265,3740,4,236,222,14,4,1,0
0,0,0,0,0,0,0,0,0
856251,2063,7,230,158,72,13,1,0
0,0,0,0,0,0,0,0,0
802296,1902,15,429,18,411,2,1,0
90789,845,0,19,8,11,0,0,0
44383,575,1,55,40,15,0,1,0
26196,532,4,3,3,0,2,0,0
267978,3256,2,890,886,4,22,1,0
358458,3694,2,726,717,9,1,1,0
676173,2466,2,150,139,11,3,1,0
833137,1113,7,101,85,16,51,1,0
0,0,0,0,0,0,0,0,0
179061,2856,9,747,735,12,22,1,0
28270,42,0,2,1,1,0,0,0
274347,1055,6,88,86,2,27,0,0
17106,258,2,3,2,1,0,1,0
0,0,0,0,0,0,0,0,0
83782,474,5,28,15,13,11,1,0
0,0,0,0,0,0,0,0,0
1370769,12886,5,68,38,30,7,1,0
0,0,0,0,0,0,0,0,0
0,0,0,0,0,0,0,0,0
203067,2049,5,337,327,10,0,1,0
52974,732,5,155,144,11,0,1,0
0,0,0,0,0,0,0,0,0
171616,1055,2,132,95,37,4,1,0
96231,546,1,78,58,20,4,1,0
340843,3818,5,766,370,396,12,1,0
50793,659,3,237,234,3,3,1,0
132151,1889,6,369,361,8,15,0,0
0,0,0,0,0,0,0,0,0
127425,1982,5,329,322,7,4,1,1
0,0,0,0,0,0,0,0,0
0,0,0,0,0,0,0,0,0
0,0,0,0,0,0,0,0,0
0,0,0,0,0,0,0,0,0
1425974,3062,8,253,228,25,9,1,0
105312,262,7,44,26,18,5,1,0
94578,209,5,37,21,16,4,1,0
0,0,0,0,0,0,0,0,0
103587,1428,4,241,201,40,9,1,0
19641,139,3,3,3,0,0,0,0
151345,976,5,151,137,14,17,1,0
23253,130,0,21,8,13,4,1,0
413128,1849,8,508,449,59,14,1,0
0,0,0,0,0,0,0,0,0
27780,42,0,2,1,1,0,0,0
644046,1565,7,352,302,50,1,1,0
779766,2963,6,363,356,7,2,0,0
68337,940,8,163,156,7,2,1,0
174594,1214,2,151,141,10,3,1,1
0,0,0,0,0,0,0,0,0
2719,36,0,1,1,0,0,0,0
0,0,0,0,0,0,0,0,0
193420,2264,15,195,165,30,33,1,0
678636,5026,2,1120,1076,44,4,1,0
225043,789,5,109,98,11,6,1,0
403557,1187,2,25,25,0,10,0,0
0,0,0,0,0,0,0,0,0
0,0,0,0,0,0,0,0,0
9436,205,4,52,51,1,0,1,0
6635,65,4,7,7,0,0,0,0
0,0,0,0,0,0,0,0,0
300643,1529,13,352,332,20,22,1,0
0,0,0,0,0,0,0,0,0
0,0,0,0,0,0,0,0,0
367679,956,10,107,89,18,20,1,0
18758,57,1,4,3,1,0,1,0
0,0,0,0,0,0,0,0,0
368991,1122,1,185,153,32,1,0,0
72554,737,6,183,73,110,0,1,0
453441,1844,10,227,204,23,22,1,0
0,0,0,0,0,0,0,0,0
0,0,0,0,0,0,0,0,0
0,0,0,0,0,0,0,0,0
690589,1735,1,149,140,9,2,1,1
274421,134,1,8,5,3,1,1,1
70634,714,5,91,84,7,8,1,0
282531,1477,6,101,63,38,13,1,0
585,5,0,0,0,0,0,0,1
0,0,0,0,0,0,0,0,0
263513,1539,6,281,245,36,3,1,0
240766,2859,3,917,901,16,7,1,0
183908,1918,8,462,462,0,4,1,0
481542,1338,9,208,200,8,2,1,0
73852,1054,7,235,204,31,4,1,0
0,0,0,0,0,0,0,0,0
0,0,0,0,0,0,0,0,0
0,0,0,0,0,0,0,0,0
150899,1510,3,522,503,19,0,1,0
165975,252,6,2,0,2,2,1,0
230125,2093,6,468,458,10,7,1,0
120638,1363,1,427,321,106,2,1,0
0,0,0,0,0,0,0,0,0
119673,1066,2,224,224,0,6,1,0
268104,3655,1,1021,896,125,127,1,0
92467,1041,2,60,33,27,2,1,0
0,0,0,0,0,0,0,0,0
201250,3011,5,1057,1057,0,13,1,0
20293,297,1,96,96,0,0,1,0
49766,573,9,91,79,12,2,1,0
58438,344,5,48,31,17,4,1,0
163530,1263,4,393,135,258,2,1,0
60746,733,5,249,64,185,1,1,0
229145,1156,9,152,130,22,12,1,0
195859,2147,3,612,527,85,6,1,0
87222,465,8,54,43,11,17,0,0
60522,367,5,32,22,10,2,0,0
127770,648,1,52,6,46,4,1,0
0,0,0,0,0,0,0,0,0
44024,424,4,101,99,2,7,1,0
95666,625,4,177,164,13,15,1,0
0,0,0,0,0,0,0,0,0
0,0,0,0,0,0,0,0,0
0,0,0,0,0,0,0,0,0
0,0,0,0,0,0,0,0,0
0,0,0,0,0,0,0,0,0
0,0,0,0,0,0,0,0,0
0,0,0,0,0,0,0,0,0
807435,8110,8,428,387,41,26,1,0
301335,2444,3,432,413,19,63,1,0
199732,1493,14,182,172,10,8,1,0
143493,745,4,105,91,14,5,0,0
0,0,0,0,0,0,0,0,0
130051,517,6,49,49,0,0,1,0
20044,268,0,45,41,4,12,0,0
969082,1062,1,183,180,3,0,1,0
370850,804,4,96,90,6,12,1,0
274019,4133,2,697,695,2,1,1,0
0,0,0,0,0,0,0,0,0
41688,50,0,5,1,4,0,1,0
0,0,0,0,0,0,0,0,0
30396,450,2,66,61,5,5,1,0
1028712,3963,11,430,377,53,16,1,0
327637,1466,4,174,164,10,4,1,0
77151,1203,6,348,348,0,38,1,0
318472,1190,10,259,256,3,5,0,0
196642,2089,6,298,238,60,205,1,0
564202,2527,2,215,164,51,0,1,0
430776,1891,5,215,28,187,0,1,0
585851,2092,3,121,107,14,3,0,0
255429,1089,5,54,46,8,3,0,0
316515,3379,6,402,397,5,4,1,0
237675,2845,6,360,356,4,4,1,0
41661,568,5,161,154,7,18,1,0
842224,7551,3,585,427,158,17,1,1
110136,615,7,48,41,7,5,0,0
0,0,0,0,0,0,0,0,0
897132,1412,12,205,195,10,33,0,0
13235,127,5,13,11,2,0,1,0
651270,14003,7,1009,1005,4,32,0,0
1693772,2649,8,221,200,21,25,0,0
97319,1434,9,378,64,314,11,1,0
0,0,0,0,0,0,0,0,0
135448,1016,12,114,109,5,1,1,0
47110,132,8,3,0,3,0,1,0
287358,1730,1,284,253,31,1,1,0
403880,984,6,182,158,24,2,1,0
392930,2864,4,324,285,39,2,1,0
0,0,0,0,0,0,0,0,0
646985,3758,8,676,589,87,11,1,1
64383,157,14,7,5,2,1,0,0
0,0,0,0,0,0,0,0,0
0,0,0,0,0,0,0,0,0
0,0,0,0,0,0,0,0,0
0,0,0,0,0,0,0,0,0
0,0,0,0,0,0,0,0,0
0,0,0,0,0,0,0,0,0
313219,1920,9,457,449,8,9,1,1
0,0,0,0,0,0,0,0,0
257740,2619,2,381,364,17,1,1,0
18307,29,0,2,2,0,0,1,0
154628,54,3,9,6,3,1,1,0
274868,770,2,139,136,3,1,1,0
93682,182,3,15,9,6,1,1,0
0,0,0,0,0,0,0,0,0
961303,3583,5,128,72,56,6,1,0
813592,2252,3,6,6,0,8,1,0
46205,178,6,34,10,24,7,1,0
81650,856,3,233,230,3,2,1,0
23280,286,1,6,4,2,0,1,0
1336854,4311,4,270,262,8,0,1,0
508789,1220,9,202,197,5,1,1,0
41380,483,5,109,98,11,7,1,0
0,0,0,0,0,0,0,0,0
225156,984,11,182,178,4,3,1,0
594398,3972,8,933,929,4,17,0,0
413085,1278,21,183,161,22,3,1,0
0,0,0,0,0,0,0,0,0
0,0,0,0,0,0,0,0,0
0,0,0,0,0,0,0,0,0
84831,1159,5,140,125,15,25,1,0
22680,170,4,27,25,2,10,1,0
0,0,0,0,0,0,0,0,0
154711,1729,8,117,103,14,12,1,0
123573,1353,5,56,42,14,12,1,0
15744076,2541,6,48,41,7,150,1,0
47781,47,2,0,0,0,0,0,0
0,0,0,0,0,0,0,0,0
259520,385,6,10,6,4,0,1,0
156890,1221,9,116,106,10,60,0,0
45851,392,3,10,8,2,2,1,0
410645,1558,7,214,206,8,15,1,0
368962,1139,7,206,199,7,22,1,0
567274,2844,5,298,265,33,14,1,0
2886,44,0,9,9,0,3,0,0
240105,648,7,126,99,27,10,1,0
0,0,0,0,0,0,0,0,0
51524,582,5,23,15,8,0,1,0
0,0,0,0,0,0,0,0,0
0,0,0,0,0,0,0,0,0
557242,2619,6,249,198,51,19,1,0
0,0,0,0,0,0,0,0,0
43039,720,4,82,81,1,4,1,0
27253,310,7,49,49,0,1,0,0
303487,2264,7,173,166,7,20,1,0
46035,440,6,49,42,7,4,1,0
86324,1275,3,77,66,11,9,1,0
27334,165,3,50,37,13,6,1,0
395254,1316,4,262,254,8,3,1,0
327617,1824,1,380,339,41,1,1,0
0,0,0,0,0,0,0,0,0
141624,699,10,114,113,1,9,1,0
109390,1744,9,122,120,2,5,1,0
16841,131,6,11,11,0,0,1,0
0,0,0,0,0,0,0,0,0
107234,1227,3,178,166,12,1,1,0
93270,1061,4,194,135,59,3,1,0
0,0,0,0,0,0,0,0,0
0,0,0,0,0,0,0,0,0
0,0,0,0,0,0,0,0,0
682100,4094,7,429,400,29,3,1,0
3939,62,4,7,7,0,0,1,0
3790,36,5,0,0,0,0,0,0
279880,3120,6,620,588,32,12,0,0
139210,1229,5,334,268,66,3,1,0
9131,106,5,3,3,0,3,1,0
77367,798,9,152,138,14,1,1,0
224870,565,3,72,51,21,2,1,0
0,0,0,0,0,0,0,0,0
392482,2823,6,351,285,66,7,1,0
762682,1612,6,212,168,44,4,0,0
0,0,0,0,0,0,0,0,0
82043,773,4,275,136,139,1,1,0
14676,313,1,92,91,1,0,1,0
28508,375,2,80,66,14,1,0,0
367087,2023,7,271,203,68,40,1,0
145586,4339,1,68,64,4,12,0,0
71952,1476,2,262,261,1,8,1,0
362343,2837,6,437,406,31,15,1,0
0,0,0,0,0,0,0,0,0
88926,844,8,112,110,2,4,0,0
2096,13,0,1,0,1,0,0,0
0,0,0,0,0,0,0,0,0
23550,35,0,2,1,1,0,1,0
488012,4864,4,761,760,1,207,0,0
0,0,0,0,0,0,0,0,0
114673,1382,3,355,275,80,5,1,0
28177,301,2,57,52,5,1,1,0
0,0,0,0,0,0,0,0,0
621784,2993,5,316,311,5,2,1,0
13859,185,4,36,31,5,1,1,0
0,0,0,0,0,0,0,0,0
319428,1013,11,167,141,26,14,1,0
6377,36,2,3,1,2,0,0,0
290084,1157,5,338,259,79,3,1,0
334168,1549,3,119,96,23,2,1,0
0,0,0,0,0,0,0,0,0
128746,696,3,109,104,5,3,1,0
231367,1272,9,105,80,25,22,0,0
178543,222,3,40,37,3,0,0,0
499266,1035,8,192,170,22,3,0,0
0,0,0,0,0,0,0,0,0
57905,898,2,146,144,2,0,1,0
10879,143,2,18,14,4,0,1,0
0,0,0,0,0,0,0,0,0
415798,2930,2,544,409,135,2,1,0
60154,596,3,129,122,7,4,0,0
20975,330,0,26,20,6,0,0,0
657053,5003,17,1000,989,11,13,1,0
80470,741,0,143,129,14,22,0,0
28067,42,0,2,1,1,0,0,0
409494,1117,1,178,146,32,0,1,0
60423,319,5,43,42,1,0,1,0
687957,958,3,154,142,12,5,0,0
84884,663,2,160,93,67,2,1,0
0,0,0,0,0,0,0,0,0
639159,1950,1,253,155,98,9,1,0
40774,362,0,8,5,3,6,0,0
968100,4374,8,1053,1043,10,11,0,0
373498,400,6,14,12,2,8,0,0
236809,2767,9,419,400,19,13,0,0
50128,596,2,64,33,31,14,1,0
11054,43,0,2,0,2,1,0,0
0,0,0,0,0,0,0,0,0
120962,1266,2,344,333,11,1,0,0
40273,566,2,49,22,27,3,0,0
109455,1165,3,167,155,12,0,1,0
399838,8035,9,541,462,79,16,1,0
47104,683,9,130,73,57,6,1,0
0,0,0,0,0,0,0,0,0
102247,634,5,56,56,0,0,1,0
0,0,0,0,0,0,0,0,0
359839,2186,9,390,361,29,5,1,0
0,0,0,0,0,0,0,0,0
0,0,0,0,0,0,0,0,0
0,0,0,0,0,0,0,0,0
224826,938,1,40,37,3,18,1,0
224789,953,1,40,37,3,18,1,0
162869,2179,9,203,191,12,12,1,0
211619,1959,13,342,315,27,43,1,1
283347,439,3,47,27,20,2,1,0
0,0,0,0,0,0,0,0,0
0,0,0,0,0,0,0,0,0
0,0,0,0,0,0,0,0,0
0,0,0,0,0,0,0,0,0
42343,516,3,74,72,2,1,1,0
0,0,0,0,0,0,0,0,0
30387,139,4,15,13,2,1,1,0
0,0,0,0,0,0,0,0,0
602611,3066,7,247,193,54,16,1,0
0,0,0,0,0,0,0,0,0
1514928,978,7,165,140,25,0,1,0
37104,209,5,24,12,12,0,1,0
22705,37,0,2,1,1,0,1,0
225440,655,7,137,123,14,0,1,0
81359,292,4,67,50,17,0,1,0
0,0,0,0,0,0,0,0,0
328741,2131,4,222,199,23,4,0,0
0,0,0,0,0,0,0,0,0
0,0,0,0,0,0,0,0,0
131685,525,5,96,21,75,3,0,0
51471,549,3,50,47,3,7,0,0
723617,2432,5,152,147,5,3,0,0
69200,970,9,162,158,4,1,1,0
31718,498,8,113,109,4,1,1,0
151170,1845,9,234,226,8,6,1,0
0,0,0,0,0,0,0,0,0
64231,736,6,133,111,22,3,0,0
286620,1429,11,284,271,13,23,1,0
0,0,0,0,0,0,0,0,0
0,0,0,0,0,0,0,0,0
427960,1092,6,162,103,59,9,1,0
162746,1852,4,457,417,40,5,0,0
0,0,0,0,0,0,0,0,0
0,0,0,0,0,0,0,0,0
0,0,0,0,0,0,0,0,0
21152,357,2,39,39,0,1,0,0
165177,545,6,68,63,5,22,1,0
49556,299,3,26,23,3,4,1,0
115287,445,3,40,36,4,0,1,0
0,0,0,0,0,0,0,0,0
0,0,0,0,0,0,0,0,0
553912,1406,2,190,155,35,1,1,0
15060,162,0,12,2,10,2,1,0
27128,572,5,82,75,7,1,0,0
466422,2218,4,387,373,14,2,1,0
123416,1090,6,353,303,50,2,0,0
0,0,0,0,0,0,0,0,0
0,0,0,0,0,0,0,0,0
257796,2657,1,459,421,38,1,1,0
0,0,0,0,0,0,0,0,0
0,0,0,0,0,0,0,0,0
27742,237,1,56,56,0,2,0,0
348620,1653,1,531,531,0,0,1,0
627921,2082,16,208,203,5,49,1,0
0,0,0,0,0,0,0,0,0
0,0,0,0,0,0,0,0,0
668407,2340,13,113,93,20,16,1,0
130857,395,3,40,26,14,0,1,0
398023,2094,11,282,199,83,11,1,0
294965,2022,11,269,194,75,11,1,0
0,0,0,0,0,0,0,0,0
628249,1702,3,274,248,26,2,1,0
450695,993,3,161,148,13,2,1,0
132703,1861,3,600,585,15,39,1,0
1090577,3912,3,373,238,135,18,1,0
559935,3795,1,333,268,65,4,1,0
0,0,0,0,0,0,0,0,0
1481320,2050,5,288,271,17,4,1,0
0,0,0,0,0,0,0,0,0
0,0,0,0,0,0,0,0,0
1358832,1244,3,167,152,15,7,1,0
0,0,0,0,0,0,0,0,0
255609,2601,3,371,359,12,1,1,0
77818,865,9,44,37,7,3,1,0
0,0,0,0,0,0,0,0,0
197295,917,8,155,139,16,13,1,0
63399,109,3,8,6,2,2,0,0
374936,4433,6,497,482,15,67,1,0
256936,2932,7,241,238,3,69,1,0
0,0,0,0,0,0,0,0,0
0,0,0,0,0,0,0,0,0
274734,3011,2,602,602,0,3,1,0
24042,277,2,27,27,0,3,1,0
411672,1510,4,157,127,30,1,1,0
4229,20,0,0,0,0,1,0,0
20097,274,1,61,36,25,0,1,0
71440,1208,1,303,303,0,2,1,0
135021,472,3,60,55,5,0,1,0
84131,920,6,132,126,6,10,0,0
0,0,0,0,0,0,0,0,0
0,0,0,0,0,0,0,0,0
172767,2242,1,254,214,40,46,1,0
86184,790,3,155,152,3,0,1,0
49013,322,3,33,30,3,0,1,0
313556,1006,4,62,55,7,16,0,0
0,0,0,0,0,0,0,0,0
62953,726,3,250,245,5,17,1,0
279065,1979,13,434,413,21,44,1,0
0,0,0,0,0,0,0,0,0
0,0,0,0,0,0,0,0,0
237564,1620,4,148,96,52,1,1,0
85360,409,4,89,56,33,1,1,0
80298,352,2,41,25,16,5,1,1
37414,564,0,29,16,13,0,1,0
0,0,0,0,0,0,0,0,0
37556,508,11,82,75,7,2,1,0
0,0,0,0,0,0,0,0,0
603991,2985,8,438,412,26,13,1,0
0,0,0,0,0,0,0,0,0
37697,384,0,69,69,0,8,0,0
35515,201,4,37,36,1,2,0,0
677453,4174,1,423,374,49,2,1,0
0,0,0,0,0,0,0,0,0
0,0,0,0,0,0,0,0,0
21900,33,0,1,1,0,0,1,0
234853,364,0,18,9,9,0,1,0
15524,170,2,30,30,0,0,1,0
28348,45,0,4,1,3,0,0,0
0,0,0,0,0,0,0,0,0
0,0,0,0,0,0,0,0,0
0,0,0,0,0,0,0,0,0
0,0,0,0,0,0,0,0,0
80430,220,2,19,19,0,0,0,0
91509,1719,3,373,277,96,0,1,0
0,0,0,0,0,0,0,0,0
11220,87,3,2,0,2,3,1,0
0,0,0,0,0,0,0,0,0
0,0,0,0,0,0,0,0,0
0,0,0,0,0,0,0,0,0
137849,1153,8,170,165,5,18,1,1
44220,208,5,26,23,3,7,1,1
0,0,0,0,0,0,0,0,0
0,0,0,0,0,0,0,0,0
7314,17,0,2,0,2,0,0,0
197180,783,8,33,25,8,1,1,0
0,0,0,0,0,0,0,0,0
3438752,2705,5,385,344,41,9,1,1
127011,557,5,68,64,4,6,1,0
3159,31,0,2,2,0,0,1,0
0,0,0,0,0,0,0,0,0
0,0,0,0,0,0,0,0,0
365539,2688,6,104,100,4,6,1,0
0,0,0,0,0,0,0,0,0
0,0,0,0,0,0,0,0,0
160712,447,7,71,1,70,7,1,0
57886,631,2,73,62,11,1,1,0
3198917,1345,8,93,78,15,68,1,0
1794223,1566,9,82,67,15,109,1,0
0,0,0,0,0,0,0,0,0
0,0,0,0,0,0,0,0,0
134446,763,2,270,270,0,0,1,0
66009,579,4,57,49,8,2,1,0
31468,171,4,27,19,8,1,1,0
35610,795,2,262,261,1,0,1,0
5687,98,2,16,16,0,0,1,0
0,0,0,0,0,0,0,0,0
0,0,0,0,0,0,0,0,0
270193,1907,0,63,60,3,0,0,0
605676,3452,3,784,768,16,5,1,0
409938,380,2,21,17,4,5,1,0
181544,1267,2,185,149,36,12,0,0
0,0,0,0,0,0,0,0,0
550094,2964,4,485,472,13,11,1,0
176792,342,5,14,13,1,13,1,0
0,0,0,0,0,0,0,0,0
0,0,0,0,0,0,0,0,0
0,0,0,0,0,0,0,0,0
354099,1094,9,79,75,4,13,1,0
316214,941,10,74,70,4,13,1,0
0,0,0,0,0,0,0,0,0
0,0,0,0,0,0,0,0,0
26900,134,4,17,15,2,5,1,0
411784,2698,11,742,651,91,145,1,0
513189,4822,3,494,483,11,20,1,0
74962,585,2,123,115,8,5,1,0
64867,355,8,35,30,5,1,1,0
2098,19,1,0,0,0,0,1,0
0,0,0,0,0,0,0,0,0
260183,591,8,132,130,2,1,1,0
0,0,0,0,0,0,0,0,0
397260,708,4,34,31,3,3,1,0
0,0,0,0,0,0,0,0,0
37503,416,9,88,88,0,7,1,0
64347,711,10,201,96,105,0,0,0
34217,664,2,209,209,0,0,1,0
74935,527,2,110,104,6,2,1,0
31497,136,4,4,4,0,0,0,0
118671,1420,3,303,290,13,14,0,0
42910,492,3,90,67,23,3,1,0
9037,71,4,3,2,1,2,0,0
646979,3140,7,527,412,115,138,1,0
456675,2154,7,527,452,75,6,1,0
0,0,0,0,0,0,0,0,0
23167,400,3,116,106,10,0,1,0
10331,64,3,4,3,1,1,0,0
0,0,0,0,0,0,0,0,0
36448,194,6,10,6,4,6,1,0
0,0,0,0,0,0,0,0,0
0,0,0,0,0,0,0,0,0
188089,661,7,98,94,4,1,1,0
192380,1290,7,102,89,13,1,1,0
0,0,0,0,0,0,0,0,0
0,0,0,0,0,0,0,0,0
43278,649,6,97,73,24,0,1,0
16293,256,4,77,68,9,0,1,0
91704,878,1,156,142,14,8,1,0
0,0,0,0,0,0,0,0,0
0,0,0,0,0,0,0,0,0
271578,1439,2,168,101,67,8,1,0
14156,51,3,3,3,0,2,0,0
0,0,0,0,0,0,0,0,0
85181,949,4,179,171,8,5,1,0
653740,4526,6,531,492,39,4,1,0
0,0,0,0,0,0,0,0,0
401973,1442,2,109,83,26,0,1,0
6094,108,2,21,9,12,0,1,0
0,0,0,0,0,0,0,0,0
375824,1932,2,329,293,36,25,1,0
91392,324,5,10,9,1,5,0,0
27574,39,0,2,1,1,0,0,0
0,0,0,0,0,0,0,0,0
487653,897,0,52,50,2,2,1,0
0,0,0,0,0,0,0,0,0
0,0,0,0,0,0,0,0,0
0,0,0,0,0,0,0,0,0
0,0,0,0,0,0,0,0,0
243392,884,11,144,119,25,34,1,0
0,0,0,0,0,0,0,0,0
0,0,0,0,0,0,0,0,0
116504,1220,6,163,138,25,2,1,0
128974,1284,6,179,140,39,2,1,0
0,0,0,0,0,0,0,0,0
216724,1722,2,344,312,32,9,1,0
12708,34,1,0,0,0,1,0,0
277166,924,7,170,136,34,22,1,0
75939,558,2,116,92,24,17,1,0
0,0,0,0,0,0,0,0,0
0,0,0,0,0,0,0,0,0
7541,75,5,3,1,2,0,1,0
0,0,0,0,0,0,0,0,0
719974,2381,17,217,140,77,69,1,0
38490,458,2,11,2,9,1,0,0
283616,1659,6,315,303,12,3,1,0
233702,1295,7,122,114,8,3,1,0
0,0,0,0,0,0,0,0,0
571386,722,8,79,73,6,0,1,0
31536,107,2,3,3,0,0,0,0
81358,567,2,85,47,38,0,1,0
705787,554,0,5,0,5,2,1,1
23502,38,0,2,1,1,0,1,0
107463,525,4,64,49,15,0,1,0
0,0,0,0,0,0,0,0,0
98974,1330,5,398,394,4,12,1,0
57303,1339,1,294,288,6,0,0,0
57822,498,1,102,86,16,0,1,0
0,0,0,0,0,0,0,0,0
441184,1204,7,128,116,12,8,1,0
0,0,0,0,0,0,0,0,0
18603,93,0,13,9,4,0,1,0
160716,490,7,95,84,11,6,1,0
0,0,0,0,0,0,0,0,0
0,0,0,0,0,0,0,0,0
474169,1753,9,229,217,12,38,1,0
99707,846,1,188,176,12,0,1,0
170988,1082,6,241,241,0,6,0,0
0,0,0,0,0,0,0,0,0
225041,3613,3,907,893,14,6,1,0
947629,6083,0,305,290,15,0,1,0
89516,997,5,209,198,11,8,1,0
47693,424,5,103,94,9,6,1,0
0,0,0,0,0,0,0,0,0
299280,2138,3,195,155,40,5,1,0
0,0,0,0,0,0,0,0,0
1323792,4762,4,1476,1460,16,5,1,0
0,0,0,0,0,0,0,0,0
566496,1336,5,98,86,12,1,1,0
13331,146,1,18,12,6,4,1,0
64792,399,4,12,10,2,3,1,0
8904,69,2,2,2,0,1,0,0
0,0,0,0,0,0,0,0,0
0,0,0,0,0,0,0,0,0
172090,1487,8,167,149,18,6,1,0
0,0,0,0,0,0,0,0,0
155314,2002,6,569,548,21,11,1,0
120829,613,0,71,63,8,3,0,0
135267,199,8,10,10,0,9,0,0
0,0,0,0,0,0,0,0,0
0,0,0,0,0,0,0,0,0
4765,46,3,2,1,1,0,1,0
27007,275,3,29,20,9,16,1,0
83731,941,3,170,160,10,17,1,0
51491,267,1,125,124,1,1,1,0
0,0,0,0,0,0,0,0,0
236114,1130,4,189,160,29,5,1,0
226859,1303,11,203,187,16,21,1,0
0,0,0,0,0,0,0,0,0
28829,479,3,122,121,1,0,1,0
0,0,0,0,0,0,0,0,0
145079,1421,10,288,228,60,16,1,0
19217,256,5,44,10,34,3,0,0
60640,743,5,33,15,18,0,1,0
0,0,0,0,0,0,0,0,0
3461,40,0,10,8,2,1,0,0
78492,934,9,207,198,9,6,1,0
961920,8489,9,1306,1287,19,7,1,0
127594,538,3,68,37,31,0,0,0
136167,537,4,125,109,16,2,0,0
21815,360,7,103,60,43,2,1,0
161919,966,10,162,154,8,16,1,0
24911,117,1,9,9,0,0,1,0
1026724,1905,8,229,216,13,15,0,0
0,0,0,0,0,0,0,0,0
126619,1508,5,154,127,27,0,1,0
0,0,0,0,0,0,0,0,0
109864,1382,2,716,381,335,5,1,0
0,0,0,0,0,0,0,0,0
0,0,0,0,0,0,0,0,0
0,0,0,0,0,0,0,0,0
98910,1024,1,208,206,2,18,1,0
735690,4388,8,783,699,84,4,1,0
7973,128,1,10,10,0,0,0,0
0,0,0,0,0,0,0,0,0
966897,1248,3,237,144,93,14,1,0
0,0,0,0,0,0,0,0,0
354543,3981,7,682,674,8,59,1,0
48014,533,5,25,16,9,0,1,0
0,0,0,0,0,0,0,0,0
0,0,0,0,0,0,0,0,0
0,0,0,0,0,0,0,0,0
96321,1265,5,458,452,6,2,1,0
58869,130,2,4,0,4,0,1,0
0,0,0,0,0,0,0,0,0
151592,1527,7,229,229,0,14,1,0
89232,757,7,152,151,1,8,1,0
0,0,0,0,0,0,0,0,0
62684,804,6,128,126,2,3,1,0
56983,290,7,30,29,1,3,1,0
39719,547,0,187,166,21,0,1,0
3041,71,0,6,6,0,0,0,0
589433,1462,6,227,225,2,5,1,0
0,0,0,0,0,0,0,0,0
0,0,0,0,0,0,0,0,0
0,0,0,0,0,0,0,0,0
0,0,0,0,0,0,0,0,0
86206,1304,7,199,176,23,2,1,0
11307,97,3,22,16,6,2,0,0
0,0,0,0,0,0,0,0,0
124192,503,11,103,84,19,0,0,0
47736,145,3,4,4,0,0,1,0
0,0,0,0,0,0,0,0,0
0,0,0,0,0,0,0,0,0
0,0,0,0,0,0,0,0,0
0,0,0,0,0,0,0,0,0
0,0,0,0,0,0,0,0,0
173936,631,8,153,153,0,8,1,0
152026,180,8,25,25,0,7,1,0
0,0,0,0,0,0,0,0,0
455769,3617,4,248,131,117,4,1,0
148347,697,4,112,96,16,2,1,0
0,0,0,0,0,0,0,0,0
0,0,0,0,0,0,0,0,0
111711,1020,7,201,174,27,4,1,0
0,0,0,0,0,0,0,0,0
0,0,0,0,0,0,0,0,0
43467,418,4,37,33,4,7,1,0
214433,518,6,14,13,1,1,1,0
24344,126,0,9,9,0,0,0,0
1742663,2779,2,222,206,16,1,1,0
358924,105,0,5,5,0,0,1,0
81137,1430,4,281,215,66,8,1,0
1613667,4625,14,228,60,168,13,1,0
13238,212,0,30,12,18,0,0,0
35721,346,4,101,93,8,4,1,0
0,0,0,0,0,0,0,0,0
0,0,0,0,0,0,0,0,0
11597,203,2,60,58,2,5,1,0
0,0,0,0,0,0,0,0,0
239912,1731,16,184,164,20,4,1,0
354936,4114,15,217,175,42,12,1,0
0,0,0,0,0,0,0,0,0
349766,1490,2,66,53,13,2,1,0
0,0,0,0,0,0,0,0,0
0,0,0,0,0,0,0,0,0
0,0,0,0,0,0,0,0,0
0,0,0,0,0,0,0,0,0
238191,1627,13,322,298,24,0,1,0
0,0,0,0,0,0,0,0,0
117116,1072,4,231,228,3,12,1,0
128539,455,2,0,0,0,0,0,0
128835,456,2,0,0,0,0,0,0
0,0,0,0,0,0,0,0,0
0,0,0,0,0,0,0,0,0
188074,696,3,113,103,10,4,1,0
0,0,0,0,0,0,0,0,0
98169,927,5,165,97,68,3,0,0
22944,37,0,2,1,1,0,1,0
61895,576,6,130,54,76,2,1,0
49974,408,6,116,35,81,4,1,0
117381,701,3,115,110,5,12,1,0
717397,96,4,2,2,0,2,0,0
328534,643,3,1,1,0,3,0,0
0,0,0,0,0,0,0,0,0
371025,5668,6,931,880,51,1,1,0
0,0,0,0,0,0,0,0,0
0,0,0,0,0,0,0,0,0
356878,2597,1,657,649,8,1,0,0
0,0,0,0,0,0,0,0,0
191781,1403,10,283,263,20,7,1,0
186579,807,8,101,11,90,7,1,0
147964,2582,6,635,526,109,11,1,0
29388,238,4,65,12,53,0,1,0
0,0,0,0,0,0,0,0,0
82514,851,1,72,58,14,1,1,0
151462,1064,6,232,187,45,2,1,0
453946,2086,3,405,281,124,13,1,0
252709,750,5,17,11,6,6,1,0
197795,1025,9,75,70,5,0,1,0
52566,1130,3,380,380,0,47,0,0
5659,81,3,2,2,0,0,0,0
0,0,0,0,0,0,0,0,0
112101,1575,4,341,272,69,5,1,0
0,0,0,0,0,0,0,0,0
138919,1881,3,437,435,2,8,1,0
183330,2243,6,355,350,5,2,1,0
0,0,0,0,0,0,0,0,0
0,0,0,0,0,0,0,0,0
82860,815,0,115,88,27,0,1,0
0,0,0,0,0,0,0,0,0
0,0,0,0,0,0,0,0,0
0,0,0,0,0,0,0,0,0
75278,913,3,151,147,4,0,1,0
97245,694,13,154,137,17,5,1,0
47717,212,6,4,4,0,2,0,0
561590,2430,6,560,503,57,4,1,0
51121,122,8,4,0,4,3,0,0
9373,103,4,11,7,4,0,1,0
21864,269,1,58,51,7,1,0,0
0,0,0,0,0,0,0,0,0
159507,2298,2,702,533,169,9,1,0
0,0,0,0,0,0,0,0,0
454972,1116,1,156,144,12,2,1,0
59503,160,0,14,14,0,0,1,0
0,0,0,0,0,0,0,0,0
0,0,0,0,0,0,0,0,0
346991,1281,5,214,205,9,3,1,1
52740,1019,2,283,254,29,0,1,0
6822,99,2,19,19,0,0,0,0
247601,971,5,94,80,14,2,1,0
198478,605,5,29,21,8,0,0,0
0,0,0,0,0,0,0,0,0
119541,607,3,110,89,21,1,1,0
116906,343,7,15,6,9,2,1,0
39776,689,2,124,119,5,0,1,0
0,0,0,0,0,0,0,0,0
0,0,0,0,0,0,0,0,0
0,0,0,0,0,0,0,0,0
115838,1049,9,267,26,241,2,1,0
115838,1049,9,267,26,241,2,1,0
0,0,0,0,0,0,0,0,0
73486,457,2,163,161,2,0,0,0
141929,575,6,43,40,3,8,0,0
305263,1777,8,323,308,15,88,1,0
41799,158,6,4,4,0,4,0,0
0,0,0,0,0,0,0,0,0
0,0,0,0,0,0,0,0,0
134038,1380,7,240,165,75,13,1,0
133951,1379,6,240,165,75,13,1,0
219540,629,4,75,65,10,4,1,0
219669,629,4,75,61,14,4,1,0
582238,1623,6,206,126,80,3,1,0
301028,126,2,7,6,1,0,1,0
0,0,0,0,0,0,0,0,0
342772,699,9,69,63,6,12,1,0
0,0,0,0,0,0,0,0,0
127648,978,1,128,120,8,1,1,0
304871,1798,0,4,4,0,0,0,0
0,0,0,0,0,0,0,0,0
0,0,0,0,0,0,0,0,0
52540,427,8,132,113,19,1,0,0
0,0,0,0,0,0,0,0,0
206714,1513,20,225,221,4,19,1,0
118251,254,13,22,15,7,8,1,0
0,0,0,0,0,0,0,0,0
45461,380,8,41,35,6,2,0,0
0,0,0,0,0,0,0,0,0
4322324,2297,7,476,468,8,65,1,0
0,0,0,0,0,0,0,0,0
510018,4169,17,508,478,30,12,1,0
8998,149,5,26,25,1,1,0,0
0,0,0,0,0,0,0,0,0
13358,91,7,0,0,0,5,0,0
2051774,1565,4,134,121,13,6,1,0
1883747,610,4,68,57,11,7,1,0
427498,1227,6,147,129,18,21,1,0
0,0,0,0,0,0,0,0,0
0,0,0,0,0,0,0,0,0
69162,242,0,26,17,9,5,0,0
0,0,0,0,0,0,0,0,0
43110,388,8,50,48,2,0,1,0
170047,495,6,95,71,24,3,1,0
0,0,0,0,0,0,0,0,0
0,0,0,0,0,0,0,0,0
423005,2223,8,331,301,30,7,0,0
8134,86,6,6,5,1,0,0,0
0,0,0,0,0,0,0,0,0
162028,2168,6,357,350,7,35,1,0
28018,42,0,2,1,1,0,0,0
56114,904,5,123,115,8,2,1,0
0,0,0,0,0,0,0,0,0
16228,68,4,0,0,0,4,0,0
0,0,0,0,0,0,0,0,0
21964,33,0,1,1,0,0,1,0
0,0,0,0,0,0,0,0,0
456999,974,4,178,115,63,2,0,0
676959,557,0,4,0,4,2,1,1
235191,543,3,68,60,8,0,1,0
0,0,0,0,0,0,0,0,0
0,0,0,0,0,0,0,0,0
7643728,39716,5,3806,2307,1499,25,1,0
47110,132,8,3,0,3,0,1,0
272457,1674,10,584,574,10,16,1,0
320838,1050,13,114,105,9,49,1,0
315343,1426,4,250,226,24,3,1,0
364611,1871,12,369,349,20,8,1,0
0,0,0,0,0,0,0,0,0
296769,1261,9,193,172,21,8,1,0
37658,317,9,59,46,13,6,1,0
0,0,0,0,0,0,0,0,0
0,0,0,0,0,0,0,0,0
0,0,0,0,0,0,0,0,0
1083574,282,8,19,19,0,12,0,0
361637,1337,9,170,10,160,3,1,0
0,0,0,0,0,0,0,0,0
61999,928,6,151,133,18,0,1,0
370220,1283,1,177,166,11,7,1,0
151783,247,0,50,42,8,3,1,0
0,0,0,0,0,0,0,0,0
0,0,0,0,0,0,0,0,0
4046,36,2,3,1,2,0,0,0
0,0,0,0,0,0,0,0,0
242224,1452,5,332,239,93,1,1,0
0,0,0,0,0,0,0,0,0
0,0,0,0,0,0,0,0,0
70644,487,10,49,48,1,3,0,0
27986,44,0,4,3,1,0,0,0
180896,1089,4,252,223,29,33,1,0
88119,462,3,42,40,2,2,1,0
384358,1868,3,319,307,12,3,1,0
0,0,0,0,0,0,0,0,0
228735,1460,1,210,77,133,9,0,0
85510,1407,3,228,220,8,16,1,0
28838,282,3,68,68,0,5,1,0
138096,380,7,56,52,4,35,0,0
22073,312,0,52,52,0,1,1,0
149521,958,8,171,111,60,1,0,0
0,0,0,0,0,0,0,0,0
14762,152,2,27,25,2,0,0,0
0,0,0,0,0,0,0,0,0
11803,108,2,12,1,11,1,1,0
6122,83,3,11,11,0,3,1,0
22639,248,3,59,44,15,2,1,0
926870,2999,5,200,187,13,16,1,0
66410,296,6,7,5,2,12,0,0
0,0,0,0,0,0,0,0,0
0,0,0,0,0,0,0,0,0
0,0,0,0,0,0,0,0,0
0,0,0,0,0,0,0,0,0
95677,933,8,164,156,8,11,1,0
0,0,0,0,0,0,0,0,0
0,0,0,0,0,0,0,0,0
0,0,0,0,0,0,0,0,0
0,0,0,0,0,0,0,0,0
0,0,0,0,0,0,0,0,0
0,0,0,0,0,0,0,0,0
21459,312,0,52,52,0,1,1,0
0,0,0,0,0,0,0,0,0
5002,64,0,23,13,10,0,0,0
177574,880,4,133,79,54,41,1,0
100040,743,6,194,193,1,2,1,0
651104,1455,3,63,36,27,39,0,0
4873,27,4,2,1,1,0,0,0
22056,312,0,52,52,0,1,1,0
293050,2805,3,336,309,27,1,1,0
0,0,0,0,0,0,0,0,0
142960,537,3,78,59,19,4,1,0
277067,1777,2,258,242,16,1,1,0
1898,23,4,0,0,0,0,0,0
1223450,12163,6,312,291,21,22,0,0
119474,884,5,201,199,2,22,0,0
573143,3589,10,685,642,43,42,1,1
79347,676,7,196,95,101,6,1,0
21077,242,6,20,14,6,9,1,0
58450,222,7,31,31,0,0,1,0
269501,1656,6,379,373,6,9,1,0
115488,601,5,125,119,6,1,1,1
0,0,0,0,0,0,0,0,0
0,0,0,0,0,0,0,0,0
228539,2993,6,548,526,22,1,1,0
280039,1183,0,245,233,12,4,1,0
2071,26,0,3,3,0,0,1,0
240171,791,7,151,115,36,3,1,0
0,0,0,0,0,0,0,0,0
242063,6134,6,1530,1529,1,27,1,0
81906,552,4,27,27,0,11,1,0
1082964,3183,5,138,103,35,42,1,0
231390,1458,8,121,112,9,9,1,0
151806,977,15,107,75,32,41,1,0
250178,1196,8,247,213,34,12,1,0
172979,421,5,50,36,14,12,1,0
151855,1171,9,131,98,33,10,1,0
0,0,0,0,0,0,0,0,0
125224,1420,3,167,157,10,4,1,0
0,0,0,0,0,0,0,0,0
103391,586,15,95,64,31,9,1,0
266908,1188,8,237,217,20,20,1,1
102039,894,14,113,110,3,33,1,0
20833,349,6,59,57,2,5,1,0
90557,897,2,219,185,34,4,1,0
0,0,0,0,0,0,0,0,0
0,0,0,0,0,0,0,0,0
192923,857,6,170,53,117,3,1,0
0,0,0,0,0,0,0,0,0
311896,973,7,55,48,7,10,1,0
311690,972,7,55,48,7,10,1,0
83894,1754,2,314,294,20,5,1,0
0,0,0,0,0,0,0,0,0
323713,3459,4,530,523,7,33,1,0
126928,1483,4,315,307,8,4,1,0
0,0,0,0,0,0,0,0,0
20967,369,3,69,69,0,3,1,0
4624,96,2,17,17,0,1,1,0
561354,2064,3,180,169,11,1,0,0
0,0,0,0,0,0,0,0,0
462214,2519,2,358,257,101,3,1,0
22110,35,0,1,1,0,0,1,0
79378,1119,4,173,154,19,8,0,0
476265,819,3,107,42,65,2,1,0
274898,1997,6,438,434,4,2,0,0
0,0,0,0,0,0,0,0,0
5532,85,4,16,16,0,0,1,0
129119,365,2,62,59,3,6,1,0
0,0,0,0,0,0,0,0,0
241705,1096,2,140,136,4,1,1,0
5537316,32907,4,85,69,16,78,1,0
91436,648,7,111,82,29,1,1,0
365592,1250,4,162,143,19,9,1,0
1355798,4651,4,246,212,34,0,1,0
55435,192,7,5,3,2,11,0,0
107336,960,5,269,56,213,4,1,0
276057,2765,7,559,548,11,9,1,0
87311,254,0,48,24,24,0,1,1
24083,452,4,99,15,84,1,1,0
0,0,0,0,0,0,0,0,0
208307,2008,7,77,67,10,0,1,0
80479,452,3,81,33,48,62,1,0
380303,1074,0,221,152,69,0,1,0
490548,4088,7,781,757,24,32,1,0
126432,628,3,94,85,9,4,1,0
22202,312,0,52,52,0,1,1,0
326331,1268,5,105,88,17,16,1,0
0,0,0,0,0,0,0,0,0
0,0,0,0,0,0,0,0,0
628519,7081,1,524,523,1,1,1,0
3386,60,2,10,10,0,1,0,0
164852,2554,5,540,532,8,20,1,0
45507,492,7,45,42,3,8,0,0
29585,270,7,35,35,0,13,0,0
89915,1049,8,269,66,203,4,1,0
26056,195,6,41,35,6,2,1,0
52251,164,5,21,20,1,0,1,0
435549,3134,4,404,382,22,5,1,0
212933,1983,4,349,339,10,4,1,0
0,0,0,0,0,0,0,0,0
116727,1031,6,147,147,0,3,0,0
203554,5008,0,1283,1283,0,0,1,0
495806,3940,5,653,499,154,3,0,0
315598,2892,7,268,255,13,4,0,0
13151,87,4,6,4,2,2,0,0
199628,1114,3,73,33,40,9,1,0
0,0,0,0,0,0,0,0,0
287507,981,8,111,3,108,5,0,0
156539,718,8,111,101,10,2,0,0
176354,227,1,33,16,17,2,1,0
288213,1401,5,72,68,4,56,1,0
75496,420,6,70,69,1,33,0,0
582,7,0,0,0,0,0,0,0
47107,803,2,226,218,8,10,0,0
256635,1837,1,591,583,8,24,1,0
49323,445,2,113,105,8,8,1,0
0,0,0,0,0,0,0,0,0
0,0,0,0,0,0,0,0,0
1006595,2297,9,197,186,11,14,1,0
0,0,0,0,0,0,0,0,0
0,0,0,0,0,0,0,0,0
208817,608,5,98,80,18,4,1,0
0,0,0,0,0,0,0,0,0
0,0,0,0,0,0,0,0,0
214371,1420,4,182,160,22,11,1,0
36619,157,3,13,13,0,1,1,0
0,0,0,0,0,0,0,0,0
0,0,0,0,0,0,0,0,0
0,0,0,0,0,0,0,0,0
0,0,0,0,0,0,0,0,0
306668,1187,8,116,105,11,47,1,0
0,0,0,0,0,0,0,0,0
0,0,0,0,0,0,0,0,0
20415,494,0,85,84,1,0,1,0
0,0,0,0,0,0,0,0,0
0,0,0,0,0,0,0,0,0
1398363,2305,7,245,219,26,16,1,0
936994,695,7,41,35,6,16,1,0
463694,2420,4,299,274,25,28,1,0
504393,776,1,160,124,36,4,1,0
546131,1185,5,186,136,50,8,0,0
7683,86,1,6,3,3,0,0,0
203669,1546,5,27,23,4,4,1,0
0,0,0,0,0,0,0,0,0
0,0,0,0,0,0,0,0,0
92853,2001,2,261,260,1,0,0,0
37515,491,3,144,116,28,0,1,0
539536,3123,9,894,836,58,22,1,0
199410,917,6,138,117,21,6,1,0
550474,1989,9,447,350,97,26,1,0
100228,138,6,10,4,6,3,0,0
147298,1359,5,215,157,58,7,1,0
15171,274,2,11,11,0,9,0,0
1390575,2948,1,291,281,10,0,1,0
0,0,0,0,0,0,0,0,0
236384,3061,1,603,592,11,76,1,0
114519,1255,1,289,279,10,0,0,0
0,0,0,0,0,0,0,0,0
0,0,0,0,0,0,0,0,0
27416,39,0,2,1,1,0,0,0
77245,1235,7,312,312,0,12,1,0
602257,3184,7,277,240,37,2,1,0
34862,289,4,19,4,15,0,0,0
10293,230,2,72,72,0,0,0,0
0,0,0,0,0,0,0,0,0
197455,531,14,109,102,7,2,1,0
85973,1502,6,252,246,6,0,0,0
122166,1045,9,162,151,11,7,1,0
0,0,0,0,0,0,0,0,0
50763,495,4,54,46,8,1,0,0
124789,1004,6,222,214,8,6,1,0
178284,715,5,71,62,9,6,1,0
1214224,2166,3,414,386,28,11,1,0
883,23,0,2,0,2,0,0,1
213324,844,1,64,48,16,1,0,0
437721,2258,7,879,869,10,17,1,0
0,0,0,0,0,0,0,0,0
0,0,0,0,0,0,0,0,0
0,0,0,0,0,0,0,0,0
968,9,1,0,0,0,0,0,0
0,0,0,0,0,0,0,0,0
0,0,0,0,0,0,0,0,0
0,0,0,0,0,0,0,0,0
0,0,0,0,0,0,0,0,0
0,0,0,0,0,0,0,0,0
451098,1510,4,132,126,6,45,1,0
284310,1364,4,232,182,50,8,1,0
77186,288,7,17,13,4,10,1,0
652362,374,1,21,20,1,1,0,0
89991,386,2,49,0,49,0,1,0
506874,1746,10,217,198,19,2,1,0
469369,1058,7,94,76,18,6,1,0
301146,821,10,167,156,11,4,1,0
0,0,0,0,0,0,0,0,0
0,0,0,0,0,0,0,0,0
295198,1928,10,212,196,16,17,1,0
158692,1654,11,169,167,2,16,0,0
57416,382,11,42,40,2,15,0,0
0,0,0,0,0,0,0,0,0
18312,294,3,63,62,1,2,1,0
226222,2033,12,586,574,12,24,1,0
0,0,0,0,0,0,0,0,0
0,0,0,0,0,0,0,0,0
80331,793,11,149,136,13,6,1,0
0,0,0,0,0,0,0,0,0
262925,1334,4,158,149,9,3,1,0
37516,390,8,100,71,29,2,0,0
0,0,0,0,0,0,0,0,0
0,0,0,0,0,0,0,0,0
126237,2208,6,317,313,4,7,1,0
181933,638,10,139,133,6,16,1,0
6628,66,0,3,2,1,0,0,0
25861,426,2,96,23,73,2,1,0
46215,941,4,93,22,71,1,1,0
108072,48,3,0,0,0,0,0,0
1273124,1539,2,175,125,50,2,1,0
812792,470,2,32,29,3,2,1,0
99582,610,7,128,127,1,0,1,0
357452,1407,4,318,274,44,0,1,0
0,0,0,0,0,0,0,0,0
346149,1007,8,177,160,17,38,1,0
492283,1513,18,328,321,7,20,1,0
325966,1435,19,285,275,10,21,1,0
19599,255,2,45,36,9,0,1,0
19409,219,1,42,39,3,0,0,0
131211,817,2,108,107,1,3,1,0
0,0,0,0,0,0,0,0,0
0,0,0,0,0,0,0,0,0
6953,67,2,13,12,1,1,0,0
1857545,980,9,149,23,126,1,1,0
0,0,0,0,0,0,0,0,0
583709,627,9,28,16,12,17,1,0
375097,1937,11,430,406,24,27,1,0
0,0,0,0,0,0,0,0,0
60202,552,1,14,8,6,0,0,0
190761,683,17,87,81,6,13,1,0
0,0,0,0,0,0,0,0,0
0,0,0,0,0,0,0,0,0
15794,164,1,45,43,2,0,1,0
20430,110,0,20,18,2,0,1,0
245870,799,2,146,140,6,1,1,0
46970,162,2,19,1,18,2,1,0
39400,715,4,126,74,52,12,0,0
2866,31,4,4,4,0,1,0,0
1029932,2053,11,333,305,28,5,1,0
0,0,0,0,0,0,0,0,0
209969,2264,5,124,124,0,0,1,0
31053,374,3,135,110,25,0,1,0
6977,120,2,28,25,3,0,1,0
0,0,0,0,0,0,0,0,0
0,0,0,0,0,0,0,0,0
42458,396,8,63,53,10,5,1,0
1649110,1381,9,108,94,14,14,1,0
0,0,0,0,0,0,0,0,0
60283,543,1,36,35,1,2,1,0
66610,776,2,41,39,2,2,1,0
169831,1772,6,211,192,19,37,1,0
21439,218,5,28,28,0,2,1,0
29776,454,5,14,14,0,2,1,0
398832,1706,9,121,96,25,32,1,0
387982,1967,4,472,450,22,23,1,0
90697,232,7,31,26,5,1,1,0
197889,2274,2,374,246,128,27,0,0
0,0,0,0,0,0,0,0,0
557123,310,4,37,32,5,1,1,0
95988,933,6,145,143,2,9,1,0
183556,1927,10,370,329,41,6,1,0
0,0,0,0,0,0,0,0,0
0,0,0,0,0,0,0,0,0
340117,1342,4,172,158,14,0,1,0
184707,1283,4,147,138,9,134,0,0
119862,689,1,110,109,1,1,0,0
264251,3893,2,27,26,1,3,1,0
0,0,0,0,0,0,0,0,0
670744,2160,6,169,159,10,8,1,0
0,0,0,0,0,0,0,0,0
55254,372,5,27,20,7,4,1,0
299529,2268,3,188,120,68,1,1,0
0,0,0,0,0,0,0,0,0
195328,195,4,4,3,1,0,0,0
74353,641,3,117,102,15,6,1,0
69377,904,4,242,241,1,6,1,0
68324,900,4,242,241,1,6,1,0
708999,1290,5,305,290,15,183,1,0
0,0,0,0,0,0,0,0,0
0,0,0,0,0,0,0,0,0
299604,3712,3,660,616,44,2,1,0
152416,368,2,58,29,29,10,1,0
0,0,0,0,0,0,0,0,0
281950,2520,5,263,246,17,1,0,0
236956,659,5,92,88,4,6,1,0
121931,1657,2,201,200,1,0,0,0
0,0,0,0,0,0,0,0,0
5115,84,2,11,10,1,1,1,0
226344,845,4,121,105,16,1,1,0
0,0,0,0,0,0,0,0,0
170395,1391,3,376,6,370,0,1,0
9989,122,3,10,10,0,1,1,0
176885,1233,3,184,126,58,2,1,0
278020,289,9,71,43,28,0,1,0
0,0,0,0,0,0,0,0,0
436439,910,11,121,25,96,12,1,0
492095,2247,7,230,174,56,32,1,0
59629,697,1,212,195,17,6,1,0
0,0,0,0,0,0,0,0,0
72923,587,5,63,41,22,6,1,0
57635,1015,6,205,175,30,3,1,0
36787,628,5,143,121,22,2,1,0
111066,602,4,226,14,212,0,0,0
15649,302,0,89,86,3,0,0,0
1335919,4131,4,202,194,8,0,1,0
0,0,0,0,0,0,0,0,0
0,0,0,0,0,0,0,0,0
103120,439,2,70,64,6,20,1,0
472348,1784,0,393,384,9,17,1,0
0,0,0,0,0,0,0,0,0
0,0,0,0,0,0,0,0,0
58692,411,1,38,31,7,1,1,0
0,0,0,0,0,0,0,0,0
698335,3044,4,290,267,23,39,1,0
202758,1196,4,184,160,24,3,1,0
0,0,0,0,0,0,0,0,0
168960,664,0,111,89,22,1,1,0
112526,265,0,58,34,24,0,1,0
21949,33,0,1,1,0,0,1,0
145860,1358,8,149,111,38,2,1,0
0,0,0,0,0,0,0,0,0
0,0,0,0,0,0,0,0,0
133263,713,5,112,80,32,1,0,0
35840,426,3,11,11,0,2,1,0
199851,949,6,185,149,36,1,1,0
0,0,0,0,0,0,0,0,0
23311,102,0,7,7,0,0,0,0
20387,290,2,37,34,3,3,1,0
20570,193,7,30,25,5,5,1,0
0,0,0,0,0,0,0,0,0
39386,569,4,50,37,13,6,1,0
668,13,0,0,0,0,0,0,0
29130,210,7,23,19,4,3,1,0
303167,1818,3,513,506,7,0,1,0
52153,564,4,78,66,12,0,0,0
20163,134,4,3,3,0,1,0,0
222874,2601,8,524,397,127,54,1,0
663379,3689,8,246,233,13,16,1,0
199314,851,8,118,106,12,17,1,0
756550,5127,6,222,210,12,5,1,0
1658588,2216,7,249,94,155,36,1,0
140801,1124,1,244,243,1,8,0,0
65095,606,3,193,191,2,0,1,0
0,0,0,0,0,0,0,0,0
254227,1524,3,317,309,8,0,1,0
172665,1178,2,252,244,8,0,1,0
70876,1018,3,181,173,8,15,1,0
18561,86,3,4,4,0,3,0,0
57827,505,8,67,43,24,19,1,0
11361,142,1,44,43,1,3,0,0
2130,39,0,8,8,0,0,0,0
2895898,7931,3,2038,2013,25,1,1,0
33132,462,6,274,264,10,2,1,0
174679,534,6,91,79,12,1,1,0
0,0,0,0,0,0,0,0,0
160474,1300,2,182,166,16,20,1,0
13540,253,2,62,38,24,4,1,0
155455,216,2,8,4,4,0,0,1
2445558,4890,7,297,159,138,68,1,0
202186,1921,6,328,230,98,1,1,0
433186,2726,17,364,226,138,36,1,0
314400,1959,17,194,179,15,21,1,0
724232,3447,7,364,21,343,10,1,0
206858,1073,7,155,151,4,23,0,0
137203,713,2,37,31,6,0,1,0
646405,4679,2,123,123,0,5,0,0
5802,62,0,5,5,0,0,0,0
82573,815,7,252,250,2,9,1,0
521808,1509,4,127,102,25,5,1,0
1378131,309,5,33,30,3,15,1,0
75219,477,6,91,81,10,1,1,0
66246,391,8,47,39,8,3,1,0
503249,2499,12,315,283,32,176,1,0
896431,2993,9,257,252,5,17,1,0
114088,824,1,107,103,4,1,1,0
737,19,0,0,0,0,0,0,0
1285611,5037,4,1426,98,1328,7,1,0
68375,687,1,45,38,7,5,1,0
0,0,0,0,0,0,0,0,0
141690,731,7,131,69,62,3,0,0
150074,2028,2,574,552,22,57,0,0
0,0,0,0,0,0,0,0,0
0,0,0,0,0,0,0,0,0
467043,2557,17,420,378,42,19,1,0
101089,1115,5,361,351,10,1,1,0
3537,48,3,7,7,0,0,1,0
251937,2583,4,467,428,39,29,1,0
0,0,0,0,0,0,0,0,0
0,0,0,0,0,0,0,0,0
62185,716,7,173,161,12,2,1,0
329163,1024,6,181,177,4,0,0,0
0,0,0,0,0,0,0,0,0
983928,3843,7,759,747,12,34,1,0
121894,857,3,142,94,48,2,1,0
0,0,0,0,0,0,0,0,0
285047,1344,6,262,223,39,6,1,0
372779,515,8,139,120,19,2,1,0
185328,1784,5,290,247,43,29,1,0
0,0,0,0,0,0,0,0,0
0,0,0,0,0,0,0,0,0
0,0,0,0,0,0,0,0,0
0,0,0,0,0,0,0,0,0
0,0,0,0,0,0,0,0,0
36900,371,5,87,86,1,2,1,0
421103,756,7,64,42,22,5,1,0
0,0,0,0,0,0,0,0,0
0,0,0,0,0,0,0,0,0
1001477,6491,2,626,626,0,2,1,0
0,0,0,0,0,0,0,0,0
10710,126,1,22,3,19,1,0,0
244215,3123,7,682,544,138,38,1,0
75799,320,5,17,17,0,32,1,0
0,0,0,0,0,0,0,0,0
3876,61,0,12,12,0,0,1,0
142324,1588,0,474,325,149,0,0,0
4265,79,0,20,20,0,0,0,0
0,0,0,0,0,0,0,0,0
372787,2143,10,430,413,17,28,1,1
307100,811,8,157,153,4,6,1,0
0,0,0,0,0,0,0,0,0
106379,491,12,45,33,12,7,1,0
110697,209,6,4,3,1,0,1,0
484136,2290,8,371,361,10,42,1,0
331827,2660,8,444,417,27,8,1,0
281187,2237,6,392,371,21,8,1,0
0,0,0,0,0,0,0,0,0
0,0,0,0,0,0,0,0,0
214737,2012,7,505,383,122,11,1,0
660361,3889,7,674,389,285,11,1,0
19419,131,5,16,11,5,0,0,0
2453,46,2,2,2,0,1,1,0
4775718,35607,11,3456,1973,1483,6,1,0
246735,1861,5,407,315,92,9,1,0
0,0,0,0,0,0,0,0,0
100551,1170,6,252,248,4,1,1,0
79622,922,8,112,107,5,3,1,0
0,0,0,0,0,0,0,0,0
61917,479,3,119,98,21,0,0,0
0,0,0,0,0,0,0,0,0
52768,574,2,93,84,9,11,1,0
101632,701,3,181,156,25,1,1,0
157967,1786,2,267,255,12,1,1,0
0,0,0,0,0,0,0,0,0
776817,3164,7,503,496,7,7,1,0
432025,2069,8,389,382,7,8,1,0
29100,247,3,54,51,3,4,0,0
0,0,0,0,0,0,0,0,0
2807320,994,4,118,37,81,33,1,0
607371,329,1,5,5,0,5,1,0
1021294,4939,8,876,710,166,0,1,0
96299,420,9,53,48,5,12,0,0
21285,136,10,4,4,0,6,0,0
206403,1133,11,178,164,14,19,1,0
195715,1077,11,182,168,14,14,1,0
114245,745,0,33,3,30,0,0,0
70052,377,9,35,33,2,20,1,0
378211,1352,3,176,114,62,3,1,0
5611,62,0,9,8,1,0,0,0
0,0,0,0,0,0,0,0,0
207738,714,9,67,58,9,6,1,0
7650,38,6,0,0,0,0,0,0
235012,1948,5,368,319,49,4,1,0
19747,119,5,6,6,0,6,1,0
104547,1588,3,360,356,4,16,1,0
52261,859,1,264,67,197,0,1,0
145320,522,8,155,14,141,0,1,0
12697,89,6,7,1,6,0,0,0
118525,1327,3,153,136,17,3,0,0
156099,1612,3,330,327,3,6,1,0
215051,444,6,75,49,26,0,1,0
706909,2913,6,321,308,13,23,1,0
29077,497,5,75,75,0,0,1,0
0,0,0,0,0,0,0,0,0
0,0,0,0,0,0,0,0,0
0,0,0,0,0,0,0,0,0
163511,1303,5,143,136,7,0,1,0
47885,85,5,2,2,0,0,1,0
105379,365,2,35,30,5,8,1,0
46269,186,5,39,33,6,8,1,0
226215,963,2,110,97,13,3,1,0
0,0,0,0,0,0,0,0,0
35881,561,4,53,53,0,4,1,0
0,0,0,0,0,0,0,0,0
0,0,0,0,0,0,0,0,0
306239,1355,12,308,289,19,1,1,0
0,0,0,0,0,0,0,0,0
120262,547,5,34,16,18,2,1,0
0,0,0,0,0,0,0,0,0
208783,2177,3,435,412,23,5,1,0
146426,1023,4,304,99,205,2,1,0
273051,2094,6,230,199,31,7,0,0
209276,1876,5,200,171,29,6,0,0
16887,204,5,49,39,10,4,0,0
6002,29,1,2,2,0,0,0,0
477717,2183,3,163,91,72,24,0,0
63483,318,2,50,12,38,0,1,0
78826,1182,1,207,201,6,6,1,0
608614,3456,1,477,469,8,1,1,0
200481,701,4,115,100,15,7,1,0
54474,597,3,151,151,0,9,0,0
13460,193,3,32,32,0,4,0,0
2287686,5266,3,324,270,54,18,1,0
110237,725,6,121,114,7,58,1,0
100188,604,17,101,95,6,11,1,0
0,0,0,0,0,0,0,0,0
0,0,0,0,0,0,0,0,0
0,0,0,0,0,0,0,0,0
0,0,0,0,0,0,0,0,0
66522,894,1,201,199,2,3,1,0
0,0,0,0,0,0,0,0,0
27547,407,4,108,91,17,0,0,0
441410,1135,3,99,82,17,1,1,0
121506,566,4,64,55,9,3,1,0
61249,69,4,5,5,0,0,0,0
580305,602,4,85,80,5,18,1,0
208988,2596,12,265,226,39,16,0,0
14491,101,8,4,4,0,1,0,0
22868,37,0,2,1,1,0,1,0
12679,80,3,14,9,5,6,1,0
0,0,0,0,0,0,0,0,0
0,0,0,0,0,0,0,0,0
144917,67,0,8,3,5,5,0,0
190195,849,8,120,107,13,51,1,0
75764,1237,2,252,249,3,6,1,0
72362,706,2,153,135,18,5,1,0
218036,387,7,60,58,2,0,1,0
176726,1725,4,266,254,12,50,1,0
352263,1693,7,217,36,181,12,1,0
281302,837,9,11,5,6,6,1,0
784914,3477,6,396,388,8,11,1,0
1841849,6917,8,881,628,253,24,1,0
1743400,5665,8,516,342,174,26,1,0
33842,118,10,2,1,1,4,1,0
114996,745,2,88,72,16,4,0,0
472200,3531,9,546,516,30,6,1,0
0,0,0,0,0,0,0,0,0
188493,1798,8,287,286,1,9,1,0
10122,69,3,5,5,0,0,1,0
78303,666,6,123,119,4,3,0,0
0,0,0,0,0,0,0,0,0
10543,115,2,9,5,4,1,1,0
304556,2523,6,765,561,204,20,0,0
0,0,0,0,0,0,0,0,0
492945,355,6,49,44,5,10,1,0
16843,75,2,5,4,1,2,0,0
97864,996,2,253,249,4,0,1,1
126566,1177,5,191,184,7,10,1,0
244434,978,4,154,137,17,36,0,0
268682,825,8,39,26,13,18,1,0
83578,164,4,1,1,0,4,0,0
34069,542,0,142,133,9,2,1,0
0,0,0,0,0,0,0,0,0
74516,1178,4,327,327,0,2,1,0
787487,2172,0,162,158,4,1,0,0
684274,2009,0,154,150,4,1,0,0
250792,1659,1,138,137,1,4,1,0
24512,290,1,11,9,2,0,1,0
73698,700,8,116,109,7,7,1,0
0,0,0,0,0,0,0,0,0
142117,815,13,49,39,10,0,1,0
392899,1545,4,40,11,29,1,1,0
0,0,0,0,0,0,0,0,0
403658,1886,7,240,227,13,98,1,0
185918,581,5,88,81,7,13,1,0
937343,8068,9,648,633,15,58,1,0
0,0,0,0,0,0,0,0,0
241013,874,2,62,49,13,2,1,0
21357,326,4,73,71,2,0,1,0
282734,1380,9,275,274,1,0,0,0
207585,1723,7,365,318,47,17,1,0
50324,91,1,7,4,3,6,1,0
112574,440,10,82,77,5,23,1,0
0,0,0,0,0,0,0,0,0
152200,1601,3,244,208,36,7,1,0
99861,1165,2,128,126,2,10,0,0
105141,1117,6,202,182,20,2,1,0
119631,1622,6,286,280,6,7,1,0
892234,720,5,83,35,48,3,1,0
0,0,0,0,0,0,0,0,0
167440,1283,3,160,142,18,33,1,0
167441,1283,3,160,146,14,33,1,0
1113137,2026,6,191,160,31,29,1,0
0,0,0,0,0,0,0,0,0
1298950,4350,7,227,189,38,2,1,0
238371,1892,1,145,143,2,0,0,0
141171,1178,5,318,244,74,4,1,0
253814,272,10,29,23,6,18,1,0
1155119,2470,11,416,363,53,11,1,0
282981,2245,10,399,352,47,51,0,0
161257,1427,0,171,138,33,1,1,0
184740,602,4,93,84,9,9,1,0
177450,1433,4,358,303,55,1,1,0
230335,2211,13,237,221,16,5,1,0
79852,802,2,221,221,0,2,1,0
11288,129,1,19,18,1,0,1,0
562515,4401,11,513,509,4,91,1,0
124283,1158,9,134,134,0,89,0,0
0,0,0,0,0,0,0,0,0
360980,2032,6,577,563,14,1,1,0
30107,120,6,7,7,0,2,0,0
0,0,0,0,0,0,0,0,0
2183,20,1,0,0,0,0,0,0
2183,20,1,0,0,0,0,0,0
51477,313,4,55,55,0,26,0,0
397111,4863,1,1382,1369,13,8,1,0
0,0,0,0,0,0,0,0,0
795460,2178,3,418,371,47,0,1,0
51690,779,5,203,202,1,2,1,0
4356,50,1,0,0,0,0,0,0
234369,830,9,198,181,17,5,1,0
886550,2357,0,89,86,3,0,1,0
59240,238,0,11,10,1,0,1,0
0,0,0,0,0,0,0,0,0
108601,984,4,330,327,3,3,0,0
0,0,0,0,0,0,0,0,0
226958,971,13,116,109,7,2,1,0
174877,558,12,92,85,7,2,1,0
2138693,1986,5,408,405,3,8,1,0
677443,3924,4,696,693,3,35,1,0
620259,1732,13,269,257,12,20,1,0
0,0,0,0,0,0,0,0,0
0,0,0,0,0,0,0,0,0
718439,1424,6,81,67,14,20,1,0
551483,331,6,6,6,0,14,0,0
490609,1702,4,370,359,11,27,1,0
526180,1928,4,361,347,14,27,1,0
0,0,0,0,0,0,0,0,0
0,0,0,0,0,0,0,0,0
0,0,0,0,0,0,0,0,0
0,0,0,0,0,0,0,0,0
391822,2440,5,537,526,11,57,1,0
160552,1704,8,296,270,26,17,1,0
0,0,0,0,0,0,0,0,0
158925,573,10,24,24,0,0,1,0
305716,610,1,82,78,4,44,1,0
261915,1399,9,85,76,9,17,0,0
0,0,0,0,0,0,0,0,0
213157,1543,1,285,273,12,1,1,0
96892,558,3,153,147,6,0,1,0
69592,158,3,48,45,3,0,1,0
105019,1096,6,86,48,38,9,1,0
68674,1100,9,266,241,25,0,1,0
6679,70,8,7,2,5,2,1,0
416042,4554,3,904,893,11,2,1,0
0,0,0,0,0,0,0,0,0
346294,1977,2,306,269,37,1,1,0
0,0,0,0,0,0,0,0,0
210885,1156,14,213,207,6,44,1,0
109877,718,8,117,80,37,1,0,0
32360,93,5,5,4,1,2,0,0
490333,2271,9,647,641,6,28,1,0
6431,71,2,0,0,0,0,0,0
23199,254,1,66,66,0,1,1,0
111110,374,2,81,64,17,0,0,0
10757,143,2,28,28,0,1,0,0
161533,1178,13,183,177,6,10,1,0
147404,1016,13,159,153,6,11,1,0
0,0,0,0,0,0,0,0,0
159349,1311,6,324,320,4,4,1,0
141834,1135,5,308,304,4,6,1,0
0,0,0,0,0,0,0,0,0
0,0,0,0,0,0,0,0,0
0,0,0,0,0,0,0,0,0
101659,588,6,101,97,4,8,1,0
1579144,7011,13,897,861,36,24,1,0
755469,4670,12,645,579,66,17,1,0
76853,1173,3,284,270,14,2,1,0
0,0,0,0,0,0,0,0,0
0,0,0,0,0,0,0,0,0
14703,178,0,6,2,4,2,0,0
14699,178,0,6,6,0,2,0,0
146978,1078,5,164,152,12,0,1,0
92720,482,5,117,106,11,3,1,0
182749,1363,2,310,221,89,9,1,0
229595,1090,3,6,4,2,1,0,0
132046,1222,3,151,123,28,5,1,0
0,0,0,0,0,0,0,0,0
6666,135,2,43,37,6,0,1,0
0,0,0,0,0,0,0,0,0
19034,195,4,57,45,12,3,0,0
694943,536,0,3,3,0,2,1,1
0,0,0,0,0,0,0,0,0
10732,297,0,46,45,1,0,0,0
2269132,20412,14,180,34,146,9,0,0
2188720,17597,8,171,155,16,10,0,0
190779,876,4,97,90,7,1,1,0
13748,192,4,18,18,0,0,1,0
690333,536,0,3,0,3,2,1,1
165610,424,4,36,23,13,0,1,0
53599,123,1,12,3,9,0,0,0
0,0,0,0,0,0,0,0,0
24647,491,3,87,79,8,0,1,0
132446,1298,1,128,121,7,4,1,0
51814,715,1,38,32,6,1,1,0
0,0,0,0,0,0,0,0,0
5176,33,1,0,0,0,0,0,0
268616,2845,6,534,471,63,15,0,0
0,0,0,0,0,0,0,0,0
27689,411,4,82,81,1,0,0,0
0,0,0,0,0,0,0,0,0
0,0,0,0,0,0,0,0,0
250114,1231,5,166,159,7,0,1,0
0,0,0,0,0,0,0,0,0
279897,1831,7,203,158,45,1,1,0
22285,232,5,13,10,3,3,0,0
168754,2161,7,574,406,168,8,0,0
0,0,0,0,0,0,0,0,0
0,0,0,0,0,0,0,0,0
0,0,0,0,0,0,0,0,0
234584,539,3,70,55,15,41,1,0
146119,1672,7,153,144,9,10,1,0
210767,1647,9,374,345,29,5,1,0
0,0,0,0,0,0,0,0,0
914709,3906,11,588,573,15,1,1,0
914708,3906,11,588,573,15,1,1,0
38572,417,6,24,16,8,0,0,0
0,0,0,0,0,0,0,0,0
87815,827,1,227,223,4,8,0,0
0,0,0,0,0,0,0,0,0
1052,10,1,0,0,0,0,0,0
0,0,0,0,0,0,0,0,0
0,0,0,0,0,0,0,0,0
0,0,0,0,0,0,0,0,0
2546,37,1,4,4,0,0,0,0
0,0,0,0,0,0,0,0,0
0,0,0,0,0,0,0,0,0
386271,1900,3,312,297,15,0,0,0
0,0,0,0,0,0,0,0,0
232821,345,0,17,9,8,0,1,0
868378,6847,13,249,23,226,25,1,0
121772,1578,6,257,198,59,17,1,0
0,0,0,0,0,0,0,0,0
0,0,0,0,0,0,0,0,0
0,0,0,0,0,0,0,0,0
88622,649,4,89,89,0,0,1,0
0,0,0,0,0,0,0,0,0
244272,968,10,115,112,3,6,1,0
224148,763,11,78,76,2,6,1,0
0,0,0,0,0,0,0,0,0
1458075,3590,8,445,387,58,16,1,0
80206,502,3,5,5,0,1,0,0
350867,2226,7,441,432,9,46,1,0
19241,137,3,5,4,1,0,0,0
84225,611,3,102,78,24,1,1,0
186521,1146,3,277,254,23,0,1,0
28112,43,0,3,1,2,0,0,0
318421,2789,11,564,536,28,3,1,0
536526,1696,4,192,191,1,9,0,0
737833,2850,5,702,693,9,8,1,0
0,0,0,0,0,0,0,0,0
975123,3213,13,595,506,89,18,1,1
18345,110,4,4,0,4,2,1,0
41215,603,2,122,104,18,0,1,0
2668173,5501,13,268,258,10,249,1,0
181209,284,11,2,1,1,9,1,0
0,0,0,0,0,0,0,0,0
98993,1468,5,212,205,7,5,1,0
137871,578,0,81,64,17,0,1,0
498056,2887,6,220,218,2,6,0,0
0,0,0,0,0,0,0,0,0
611854,5713,8,913,749,164,37,0,0
536172,2698,10,290,283,7,61,1,0
0,0,0,0,0,0,0,0,0
36731,77,5,4,3,1,1,1,0
5873,74,5,4,3,1,1,1,0
366951,6989,2,3994,3975,19,0,0,0
0,0,0,0,0,0,0,0,0
5155,64,1,8,5,3,0,0,0
220625,2426,8,502,434,68,33,1,0
37787,193,5,10,10,0,4,1,0
740636,4522,6,746,738,8,30,0,1
0,0,0,0,0,0,0,0,0
0,0,0,0,0,0,0,0,0
288278,1764,10,411,371,40,19,1,0
1675985,6240,2,674,660,14,0,1,0
0,0,0,0,0,0,0,0,0
138898,911,7,148,142,6,10,1,0
38215,282,4,41,35,6,0,1,0
0,0,0,0,0,0,0,0,0
129793,2175,6,374,344,30,3,1,0
28756,384,2,21,11,10,3,1,0
115383,1198,4,208,205,3,18,1,0
43833,236,3,17,14,3,0,1,0
570,7,0,0,0,0,0,0,0
332769,1813,1,378,329,49,1,1,0
418256,3060,7,271,220,51,4,1,0
229250,623,8,107,85,22,0,1,0
0,0,0,0,0,0,0,0,0
138910,467,16,59,57,2,2,1,0
179092,941,10,107,107,0,3,1,0
19863,283,0,42,41,1,0,1,0
6246,149,3,38,38,0,0,1,0
18569,248,3,35,24,11,0,1,0
32729,273,3,42,29,13,2,1,0
98835,1826,3,328,327,1,2,1,0
0,0,0,0,0,0,0,0,0
0,0,0,0,0,0,0,0,0
103319,377,5,33,16,17,0,1,0
329403,1518,3,210,61,149,6,1,0
73575,620,6,115,110,5,0,1,0
52994,316,5,41,36,5,0,1,0
183836,594,2,118,109,9,0,0,0
82761,610,9,92,33,59,48,1,0
14067,119,6,11,10,1,2,1,0
121135,710,10,29,27,2,6,1,0
4195204,9281,4,1027,1017,10,15,0,0
495394,2441,7,386,371,15,15,0,0
100873,373,2,36,25,11,0,1,0
116458,753,7,119,103,16,10,1,0
16287,89,0,15,1,14,0,1,0
0,0,0,0,0,0,0,0,0
0,0,0,0,0,0,0,0,0
520940,5031,12,883,759,124,13,1,0
89014,2100,2,714,708,6,3,1,0
101154,827,4,196,179,17,10,0,0
77266,530,3,45,22,23,0,1,0
0,0,0,0,0,0,0,0,0
0,0,0,0,0,0,0,0,0
207985,702,2,126,74,52,3,0,1
0,0,0,0,0,0,0,0,0
244813,2484,4,598,577,21,9,1,0
24102,470,1,116,112,4,0,0,0
20939,145,1,8,7,1,3,0,0
419779,1521,5,104,91,13,12,1,0
1029069,3463,6,229,227,2,1,1,0
425295,1169,6,307,305,2,3,1,0
204737,343,1,9,8,1,0,0,0
391841,1558,3,122,115,7,20,1,0
0,0,0,0,0,0,0,0,0
470905,2801,3,485,475,10,354,1,0
476882,4005,14,601,590,11,63,1,0
242187,1676,14,415,409,6,22,1,0
29144,516,1,202,201,1,8,1,0
152920,995,3,295,273,22,2,1,0
127570,320,2,31,31,0,2,1,0
624940,1555,10,205,198,7,22,1,0
394837,751,12,129,120,9,20,1,0
123365,995,7,202,132,70,12,1,0
53170,587,2,128,103,25,3,0,0
8998,149,5,26,25,1,1,0,0
0,0,0,0,0,0,0,0,0
260690,1527,3,348,311,37,2,1,0
126276,325,2,37,28,9,2,1,0
0,0,0,0,0,0,0,0,0
522143,4334,3,545,534,11,2,1,0
0,0,0,0,0,0,0,0,0
64423,699,8,160,135,25,8,1,0
112885,870,2,237,201,36,4,1,0
0,0,0,0,0,0,0,0,0
107029,364,3,60,54,6,0,1,0
296152,2389,4,142,52,90,19,1,0
0,0,0,0,0,0,0,0,0
134371,1024,13,195,182,13,7,1,0
278463,818,6,110,95,15,3,1,0
0,0,0,0,0,0,0,0,0
0,0,0,0,0,0,0,0,0
38532,272,2,32,26,6,3,1,0
365401,1161,2,96,93,3,11,1,0
138252,179,0,6,3,3,0,1,0
295118,3691,13,710,689,21,6,1,0
106589,710,13,147,89,58,1,1,0
789017,994,12,139,104,35,7,1,0
0,0,0,0,0,0,0,0,0
0,0,0,0,0,0,0,0,0
306217,380,1,95,46,49,0,1,0
210991,178,0,47,32,15,1,1,0
424990,1037,3,60,49,11,0,1,0
229049,2094,11,513,505,8,2,1,0
305100,1176,2,340,315,25,28,1,0
57981,509,5,71,70,1,2,1,0
158064,794,9,131,98,33,7,1,0
0,0,0,0,0,0,0,0,0
1465905,13742,2,1755,1744,11,27,1,0
0,0,0,0,0,0,0,0,0
163266,781,3,92,77,15,2,1,0
60818,113,3,7,7,0,3,1,0
0,0,0,0,0,0,0,0,0
681793,1874,0,197,189,8,0,1,0
179533,1052,3,88,78,10,1,0,0
30436,276,1,38,29,9,2,1,0
185803,1068,9,127,110,17,4,1,0
0,0,0,0,0,0,0,0,0
0,0,0,0,0,0,0,0,0
261276,1766,9,198,169,29,19,1,0
215418,1214,8,127,99,28,17,1,0
49277,543,4,53,53,0,3,0,0
0,0,0,0,0,0,0,0,0
310625,1075,8,199,153,46,7,1,0
0,0,0,0,0,0,0,0,0
0,0,0,0,0,0,0,0,0
359037,1943,3,402,371,31,22,1,0
37624,149,6,10,4,6,1,0,0
288778,997,1,220,192,28,1,0,0
0,0,0,0,0,0,0,0,0
770773,4285,13,787,735,52,40,1,0
48182,537,4,119,107,12,0,1,0
898026,967,6,193,173,20,9,1,0
0,0,0,0,0,0,0,0,0
111018,1654,1,468,464,4,0,1,0
215326,918,1,94,89,5,0,1,0
0,0,0,0,0,0,0,0,0
892216,720,5,83,33,50,3,1,0
0,0,0,0,0,0,0,0,0
86603,636,7,40,31,9,9,1,0
0,0,0,0,0,0,0,0,0
0,0,0,0,0,0,0,0,0
3071175,21755,6,262,246,16,8,1,0
56143,200,3,45,10,35,0,1,0
314703,1195,18,156,16,140,2,1,0
13008,166,3,25,23,2,0,1,0
26185,138,4,27,23,4,4,1,0
1605420,847,8,114,107,7,0,1,0
0,0,0,0,0,0,0,0,0
319497,1650,14,405,373,32,21,1,0
0,0,0,0,0,0,0,0,0
0,0,0,0,0,0,0,0,0
230903,346,0,17,12,5,0,1,0
0,0,0,0,0,0,0,0,0
229806,2181,6,243,233,10,15,1,0
127320,2306,3,502,403,99,16,1,0
15151,99,1,14,14,0,0,1,0
756003,3527,6,582,444,138,7,1,0
170227,722,6,42,21,21,13,1,0
489502,1102,9,61,58,3,23,1,0
48010,453,10,50,43,7,24,1,0
98002,475,2,15,13,2,11,1,0
61797,812,5,198,194,4,8,1,0
1086890,4367,3,1105,502,603,1,0,0
109402,761,1,142,137,5,15,1,0
93021,301,1,79,27,52,1,0,0
0,0,0,0,0,0,0,0,0
3239129,1889,13,222,202,20,63,1,1
273763,1938,10,248,208,40,7,1,0
201154,665,11,49,46,3,2,1,0
169075,420,9,43,40,3,1,1,0
70935,589,1,277,276,1,7,1,0
236860,2075,2,185,165,20,3,0,0
43629,237,4,25,19,6,7,1,0
26040,170,4,18,12,6,6,1,0
115853,761,5,119,113,6,5,0,0
324870,2197,7,228,203,25,11,1,0
202867,1279,10,150,121,29,11,1,0
0,0,0,0,0,0,0,0,0
267290,2415,10,212,160,52,50,0,0
89447,708,10,100,96,4,4,0,0
698282,2804,7,130,114,16,2,1,0
707495,1320,3,145,81,64,0,1,0
543123,636,3,118,101,17,0,1,0
0,0,0,0,0,0,0,0,0
51799,1132,4,267,264,3,1,1,0
37529,986,5,298,277,21,9,1,0
251067,1437,16,311,310,1,58,0,0
192524,848,13,152,152,0,37,0,0
52052,663,6,82,75,7,2,1,0
22912,259,8,38,35,3,2,1,0
0,0,0,0,0,0,0,0,0
0,0,0,0,0,0,0,0,0
21075,469,0,45,19,26,0,0,0
0,0,0,0,0,0,0,0,0
3665,50,0,9,9,0,0,0,0
0,0,0,0,0,0,0,0,0
96942,1415,3,277,116,161,0,1,0
68360,530,13,79,66,13,3,1,0
0,0,0,0,0,0,0,0,0
4615,62,1,4,4,0,0,0,0
404777,8025,5,1229,1218,11,39,1,0
88088,897,5,132,131,1,29,1,0
281730,1789,8,427,236,191,8,1,0
204613,2559,4,756,738,18,37,1,0
172954,2235,4,667,651,16,36,1,0
107917,1300,10,199,188,11,19,1,0
109982,667,12,103,91,12,1,0,0
325772,1842,1,379,359,20,1,1,0
84295,896,10,199,161,38,2,1,0
84295,896,10,199,161,38,2,1,0
15553,171,0,47,38,9,0,1,0
278825,1178,8,232,211,21,15,1,0
133469,890,7,140,123,17,10,1,0
0,0,0,0,0,0,0,0,0
131528,624,8,22,18,4,3,0,0
145227,1500,11,368,359,9,17,1,0
62788,201,3,27,17,10,2,1,0
66405,475,6,45,41,4,0,0,0
140744,1944,1,462,461,1,0,0,0
84862,630,4,131,128,3,8,0,0
178849,1296,11,182,152,30,0,1,1
0,0,0,0,0,0,0,0,0
228894,2501,5,301,270,31,5,1,0
22995,117,5,8,7,1,4,1,0
0,0,0,0,0,0,0,0,0
2086,65,1,17,17,0,0,1,0
7749,157,2,37,37,0,0,1,0
667336,517,0,5,2,3,1,1,1
560747,1361,8,131,96,35,2,1,0
0,0,0,0,0,0,0,0,0
367920,684,13,97,93,4,22,1,0
506333,1303,2,187,184,3,1,1,0
0,0,0,0,0,0,0,0,0
0,0,0,0,0,0,0,0,0
0,0,0,0,0,0,0,0,0
502022,1654,2,203,174,29,10,1,0
385551,2824,2,409,390,19,29,0,0
186695,1608,2,332,315,17,2,0,0
106238,400,3,5,4,1,7,1,0
99637,2637,2,899,899,0,2,1,0
86304,706,6,137,73,64,13,1,0
0,0,0,0,0,0,0,0,0
515171,5145,5,784,751,33,5,1,0
179094,876,14,119,95,24,2,1,0
0,0,0,0,0,0,0,0,0
0,0,0,0,0,0,0,0,0
24539,351,2,30,18,12,0,1,0
5671,51,1,3,3,0,0,0,0
0,0,0,0,0,0,0,0,0
65320,689,7,142,138,4,14,1,0
147860,1138,6,367,341,26,32,1,0
43138,459,3,92,78,14,2,1,0
0,0,0,0,0,0,0,0,0
31775,467,2,180,22,158,1,1,0
0,0,0,0,0,0,0,0,0
126097,847,4,107,107,0,9,1,0
189508,859,5,132,125,7,1,1,0
0,0,0,0,0,0,0,0,0
298994,2346,6,771,754,17,10,0,0
1705,19,1,1,1,0,0,0,0
751980,2369,3,259,246,13,2,1,0
429874,2385,1,336,317,19,4,1,0
387278,2365,1,336,317,19,4,1,0
0,0,0,0,0,0,0,0,0
0,0,0,0,0,0,0,0,0
0,0,0,0,0,0,0,0,0
192513,1574,6,208,174,34,17,0,0
401307,1897,8,209,208,1,9,1,0
358166,1445,7,171,170,1,6,1,0
0,0,0,0,0,0,0,0,0
120459,1214,4,403,371,32,4,1,0
234392,3278,5,857,850,7,6,1,0
25315,129,3,7,6,1,3,1,0
63865,191,4,41,40,1,0,1,0
329410,646,1,159,150,9,1,1,0
110429,148,1,6,6,0,1,0,0
0,0,0,0,0,0,0,0,0
27654,241,0,42,28,14,2,1,0
9725,107,4,6,6,0,4,1,0
42389,710,2,82,74,8,3,1,0
8873,107,1,8,8,0,6,0,0
95505,751,3,132,129,3,2,0,0
13421,121,3,10,7,3,2,0,0
220453,1098,0,42,39,3,0,0,0
7009,22,0,0,0,0,0,0,0
0,0,0,0,0,0,0,0,0
0,0,0,0,0,0,0,0,0
31128,403,5,69,61,8,2,1,0
10485,172,5,25,19,6,2,1,0
41104,246,2,40,39,1,0,1,0
9988,111,1,19,18,1,0,1,0
0,0,0,0,0,0,0,0,0
19279,384,1,117,115,2,5,1,0
4377,56,1,3,2,1,0,0,0
311987,1550,8,231,228,3,9,0,0
0,0,0,0,0,0,0,0,0
169457,1302,3,210,195,15,23,1,0
40511,282,2,27,27,0,3,0,0
0,0,0,0,0,0,0,0,0
0,0,0,0,0,0,0,0,0
24900,299,6,73,69,4,12,1,0
999876,9330,4,385,364,21,1,1,0
0,0,0,0,0,0,0,0,0
399901,1004,8,107,83,24,25,1,0
62139,1101,8,251,234,17,3,1,0
0,0,0,0,0,0,0,0,0
91860,475,4,124,113,11,5,1,0
84233,601,7,93,90,3,2,1,0
0,0,0,0,0,0,0,0,0
918103,1713,4,656,647,9,1,1,0
0,0,0,0,0,0,0,0,0
199561,3020,6,1376,1372,4,19,1,0
406314,3086,6,535,527,8,32,1,0
122289,896,2,237,206,31,4,1,0
0,0,0,0,0,0,0,0,0
0,0,0,0,0,0,0,0,0
79547,841,5,152,117,35,3,1,0
37246,356,7,44,40,4,4,1,0
37442,350,7,48,43,5,4,1,0
1116962,1333,7,146,128,18,11,1,0
1169191,126,3,5,3,2,0,1,0
808341,4782,8,270,268,2,19,1,0
123094,1203,8,279,271,8,5,0,0
0,0,0,0,0,0,0,0,0
0,0,0,0,0,0,0,0,0
0,0,0,0,0,0,0,0,0
170805,950,7,119,90,29,0,1,0
37786,108,7,6,6,0,1,0,0
0,0,0,0,0,0,0,0,0
429373,871,1,60,52,8,6,0,0
0,0,0,0,0,0,0,0,0
79447,551,2,17,11,6,0,1,1
0,0,0,0,0,0,0,0,0
0,0,0,0,0,0,0,0,0
76980,204,3,25,23,2,12,1,0
14803,133,2,24,21,3,2,1,0
346631,2370,1,274,268,6,67,1,0
0,0,0,0,0,0,0,0,0
177539,3337,2,933,933,0,1,1,0
0,0,0,0,0,0,0,0,0
0,0,0,0,0,0,0,0,0
323632,1126,13,93,91,2,1,1,1
0,0,0,0,0,0,0,0,0
673608,2071,5,131,87,44,1,1,0
261675,2036,6,107,39,68,39,1,0
17691,131,5,10,5,5,2,0,0
205390,1248,6,75,12,63,9,0,0
83618,498,10,33,2,31,5,1,0
73456,807,5,132,124,8,2,0,1
0,0,0,0,0,0,0,0,0
0,0,0,0,0,0,0,0,0
73296,874,4,204,181,23,2,0,0
61512,531,4,167,134,33,2,0,0
583869,1683,2,142,11,131,6,1,0
571315,816,4,137,114,23,8,1,0
56306,440,2,84,79,5,34,1,0
121210,1816,9,390,381,9,8,1,0
257424,2029,6,462,454,8,8,1,0
145119,556,3,109,105,4,0,1,0
112902,157,3,27,26,1,0,1,0
0,0,0,0,0,0,0,0,0
0,0,0,0,0,0,0,0,0
0,0,0,0,0,0,0,0,0
348442,1107,4,95,81,14,0,1,0
130946,1009,4,166,166,0,0,1,0
61597,1083,5,208,184,24,30,0,0
18947,115,7,9,9,0,3,1,0
986603,1826,9,257,215,42,15,1,0
0,0,0,0,0,0,0,0,0
235910,314,5,34,25,9,6,1,0
0,0,0,0,0,0,0,0,0
166195,356,5,18,9,9,0,0,0
166195,356,5,18,16,2,0,0,0
692198,3471,3,412,355,57,1,0,0
45538,315,0,71,68,3,2,1,0
31188,181,6,18,5,13,2,1,0
102207,206,4,2,1,1,10,0,0
329160,1841,10,177,160,17,11,1,0
444272,2218,4,213,187,26,3,1,1
374402,1315,4,254,219,35,0,1,0
53007,295,9,24,19,5,16,1,0
7370,71,4,12,10,2,3,1,0
124509,1651,2,693,579,114,8,0,0
217907,3221,5,766,754,12,5,1,0
15388,62,2,3,3,0,1,0,0
465755,716,8,89,64,25,14,1,0
329043,178,7,7,7,0,10,1,0
34003,571,2,108,97,11,3,1,0
65303,1037,7,248,241,7,5,1,0
228603,876,13,87,35,52,6,1,0
49781,380,7,61,61,0,3,0,0
19658,157,4,41,41,0,1,0,0
44833,374,5,76,76,0,0,1,0
0,0,0,0,0,0,0,0,0
301057,1314,5,317,311,6,4,1,0
0,0,0,0,0,0,0,0,0
46717,498,4,135,129,6,8,1,0
205327,909,6,174,145,29,2,1,0
1096348,6685,1,1394,1317,77,2,1,0
64196,93,5,4,4,0,0,0,0
365599,602,10,78,74,4,4,1,0
313993,2788,5,533,395,138,34,0,0
0,0,0,0,0,0,0,0,0
558696,2269,3,224,187,37,9,1,0
172321,2166,7,525,500,25,17,1,0
8408,79,3,12,11,1,5,0,0
212004,2708,17,145,138,7,5,0,0
1964083,2055,13,256,246,10,3,1,0
7215,64,0,1,1,0,0,0,0
0,0,0,0,0,0,0,0,0
119112,1347,6,225,215,10,3,1,0
77093,740,3,161,157,4,9,1,0
237051,747,5,131,131,0,10,1,0
236977,1875,9,294,111,183,16,0,0
16661,92,0,16,1,15,0,1,0
107835,1967,2,257,249,8,9,1,0
32547,286,3,43,35,8,0,1,0
0,0,0,0,0,0,0,0,0
37009,444,4,55,53,2,3,0,0
0,0,0,0,0,0,0,0,0
698306,2856,5,342,330,12,36,1,0
751439,1811,4,218,199,19,14,1,0
55903,323,2,45,44,1,0,1,0
15451,118,0,22,21,1,0,1,0
0,0,0,0,0,0,0,0,0
0,0,0,0,0,0,0,0,0
907050,2301,7,391,380,11,5,1,0
229295,1010,11,164,161,3,26,1,0
0,0,0,0,0,0,0,0,0
0,0,0,0,0,0,0,0,0
239916,794,1,81,68,13,0,1,0
302630,3132,4,630,612,18,4,0,0
39012,418,4,85,73,12,0,0,0
35945,249,12,59,2,57,0,1,0
11820,141,6,24,18,6,2,1,0
330287,2184,9,149,141,8,7,1,0
0,0,0,0,0,0,0,0,0
63691,678,7,106,103,3,1,0,0
132405,485,5,42,34,8,7,0,0
0,0,0,0,0,0,0,0,0
871710,2362,0,89,86,3,0,1,0
58783,232,0,11,10,1,0,1,0
117818,1223,4,94,80,14,12,1,0
21998,192,5,8,6,2,1,1,0
0,0,0,0,0,0,0,0,0
0,0,0,0,0,0,0,0,0
325536,911,10,35,20,15,52,1,0
82403,156,4,1,1,0,2,0,0
434663,1211,4,234,221,13,6,1,0
60399,650,7,136,131,5,6,0,0
230266,644,4,125,122,3,3,1,0
345380,2545,0,309,299,10,11,1,0
84669,566,0,73,68,5,5,1,0
673412,1387,3,222,173,49,12,1,0
0,0,0,0,0,0,0,0,0
110787,1444,6,254,241,13,15,0,0
71862,775,6,222,209,13,14,0,0
186020,1472,9,378,277,101,4,1,0
88154,254,0,48,24,24,0,1,1
739921,6389,2,350,323,27,6,1,0
296041,3147,3,156,152,4,3,1,0
260183,892,10,110,95,15,1,1,0
0,0,0,0,0,0,0,0,0
16666,158,3,19,15,4,2,0,0
15810,192,3,16,16,0,5,0,0
568814,3177,7,481,453,28,19,1,0
8947,101,6,10,5,5,2,1,0
191463,1147,6,142,107,35,6,1,0
159051,367,2,65,49,16,0,1,0
231393,2259,0,270,263,7,3,0,0
73900,966,7,215,207,8,3,0,0
861358,4219,2,380,367,13,1,1,0
76062,41,4,0,0,0,0,1,0
629875,1471,7,132,126,6,5,1,0
408464,570,6,71,66,5,2,1,0
257452,1510,4,139,132,7,4,1,0
15747,127,5,17,12,5,10,1,0
271688,1589,4,261,254,7,17,1,0
0,0,0,0,0,0,0,0,0
98120,849,14,60,53,7,4,1,0
57393,173,15,4,2,2,10,0,0
173763,2571,5,503,493,10,3,1,0
9224,91,0,2,2,0,0,0,0
627078,1152,4,300,286,14,5,1,0
0,0,0,0,0,0,0,0,0
15147,159,1,14,5,9,6,0,0
11856,121,2,15,14,1,6,0,0
0,0,0,0,0,0,0,0,0
1945722,3499,11,679,672,7,24,1,0
0,0,0,0,0,0,0,0,0
0,0,0,0,0,0,0,0,0
126026,877,5,102,51,51,0,1,0
0,0,0,0,0,0,0,0,0
22186,35,0,1,1,0,0,1,0
119908,1213,4,287,284,3,3,1,0
258377,1529,8,249,196,53,5,1,0
0,0,0,0,0,0,0,0,0
130269,1445,5,289,169,120,13,1,0
127568,1604,4,252,233,19,4,1,0
19329,216,3,46,37,9,0,1,0
70072,207,6,34,31,3,18,1,0
475956,2788,9,474,463,11,22,1,0
209887,1743,5,466,452,14,16,1,0
0,0,0,0,0,0,0,0,0
216801,1324,3,80,69,11,0,1,0
275831,3169,4,2,2,0,3,0,0
118314,333,10,58,57,1,12,0,0
481903,2701,5,466,410,56,1,1,0
0,0,0,0,0,0,0,0,0
187344,2054,10,379,308,71,0,1,0
0,0,0,0,0,0,0,0,0
47857,524,7,120,87,33,10,1,0
1333163,369,8,29,17,12,3,1,0
520290,1825,6,202,171,31,16,0,0
581431,2093,8,238,225,13,2,1,0
216122,482,5,20,14,6,2,0,0
0,0,0,0,0,0,0,0,0
0,0,0,0,0,0,0,0,0
0,0,0,0,0,0,0,0,0
1227837,186,2,26,14,12,0,1,0
9689,121,3,10,10,0,1,1,0
832679,2378,7,346,319,27,18,1,0
240786,423,7,6,5,1,5,0,0
115280,1491,4,154,150,4,2,1,0
161054,1282,3,90,76,14,15,1,0
271749,1611,9,243,221,22,30,1,0
292575,1107,19,174,141,33,14,1,0
224144,410,18,24,18,6,14,1,0
0,0,0,0,0,0,0,0,0
971935,649,9,35,30,5,2,1,0
3892,56,1,9,9,0,0,0,0
115491,1618,4,593,537,56,8,1,0
413118,2289,12,591,564,27,13,1,0
72053,356,8,14,12,2,0,1,0
7431,90,7,4,4,0,2,1,0
0,0,0,0,0,0,0,0,0
0,0,0,0,0,0,0,0,0
0,0,0,0,0,0,0,0,0
455232,3659,2,579,542,37,21,0,0
200049,1908,2,333,113,220,21,0,0
0,0,0,0,0,0,0,0,0
270192,875,1,218,148,70,1,1,0
102294,376,6,42,33,9,0,1,0
195698,1031,4,125,103,22,1,1,0
159045,1179,13,171,155,16,20,1,0
0,0,0,0,0,0,0,0,0
22126,35,0,1,1,0,0,1,0
207926,1985,5,420,403,17,2,1,0
351290,674,0,61,61,0,28,0,0
248699,1119,8,139,82,57,49,1,0
0,0,0,0,0,0,0,0,0
0,0,0,0,0,0,0,0,0
0,0,0,0,0,0,0,0,0
0,0,0,0,0,0,0,0,0
0,0,0,0,0,0,0,0,0
617465,2130,7,469,441,28,4,1,0
5161823,1050,5,186,177,9,0,1,0
39245,517,3,142,134,8,0,0,0
0,0,0,0,0,0,0,0,0
0,0,0,0,0,0,0,0,0
1133178,3040,3,252,109,143,515,1,0
127954,804,4,97,62,35,12,1,0
17332,118,4,6,6,0,0,0,0
169183,921,5,147,132,15,26,1,0
0,0,0,0,0,0,0,0,0
0,0,0,0,0,0,0,0,0
356139,892,1,25,5,20,0,1,0
338539,791,2,4,4,0,2,0,0
29436,46,0,0,0,0,0,1,0
849138,2356,7,175,164,11,19,1,0
506836,465,7,18,13,5,6,1,0
72552,529,5,58,22,36,0,1,0
349638,2259,10,250,235,15,139,1,0
0,0,0,0,0,0,0,0,0
0,0,0,0,0,0,0,0,0
64098,1049,1,94,88,6,0,0,0
644042,3395,7,379,322,57,0,1,0
0,0,0,0,0,0,0,0,0
1033251,1962,8,209,182,27,9,1,0
149615,1263,11,250,236,14,3,1,0
27573,121,9,5,5,0,3,0,0
68597,524,6,117,112,5,10,1,0
0,0,0,0,0,0,0,0,0
0,0,0,0,0,0,0,0,0
175415,1262,9,535,519,16,8,0,0
67544,611,0,27,26,1,10,0,0
321391,1760,3,317,302,15,7,1,0
0,0,0,0,0,0,0,0,0
1323683,3606,3,251,147,104,1,1,0
190692,1791,6,405,397,8,1,1,0
95393,895,6,135,132,3,7,1,0
188697,1255,9,196,185,11,8,1,0
0,0,0,0,0,0,0,0,0
0,0,0,0,0,0,0,0,0
0,0,0,0,0,0,0,0,0
0,0,0,0,0,0,0,0,0
48830,716,2,220,219,1,2,1,0
0,0,0,0,0,0,0,0,0
244674,1743,2,75,65,10,1,1,0
0,0,0,0,0,0,0,0,0
96763,781,5,74,42,32,4,1,0
21427,202,6,41,33,8,0,1,0
1401480,4391,6,920,854,66,14,1,0
553282,620,6,114,79,35,13,1,0
119032,1239,1,491,487,4,1,1,0
83219,348,3,50,45,5,12,1,0
0,0,0,0,0,0,0,0,0
239342,1690,13,234,195,39,4,0,0
0,0,0,0,0,0,0,0,0
0,0,0,0,0,0,0,0,0
8097,233,0,28,28,0,0,0,0
4584,128,0,23,23,0,0,0,0
0,0,0,0,0,0,0,0,0
3259,40,1,2,2,0,0,0,0
0,0,0,0,0,0,0,0,0
0,0,0,0,0,0,0,0,0
151508,707,4,77,73,4,37,0,0
92419,186,4,2,2,0,5,0,0
0,0,0,0,0,0,0,0,0
223057,1174,10,157,50,107,0,0,0
82488,619,7,91,63,28,1,1,0
260994,1218,11,424,406,18,1,1,0
55084,541,8,141,110,31,3,1,0
24974,299,8,33,28,5,4,1,0
267674,1888,10,403,402,1,6,1,0
169154,361,9,45,43,2,4,1,0
0,0,0,0,0,0,0,0,0
686917,2346,5,392,362,30,2,1,0
0,0,0,0,0,0,0,0,0
568513,1451,5,64,45,19,10,0,0
351290,1297,4,296,266,30,4,1,0
216600,2313,6,397,254,143,6,1,0
0,0,0,0,0,0,0,0,0
0,0,0,0,0,0,0,0,0
91459,311,1,60,35,25,4,0,0
0,0,0,0,0,0,0,0,0
1589238,5076,4,272,265,7,20,1,0
0,0,0,0,0,0,0,0,0
27502,512,2,50,50,0,1,0,0
14532,101,2,16,14,2,2,0,0
0,0,0,0,0,0,0,0,0
0,0,0,0,0,0,0,0,0
0,0,0,0,0,0,0,0,0
0,0,0,0,0,0,0,0,0
0,0,0,0,0,0,0,0,0
69466,91,4,14,12,2,1,0,0
8440,82,4,13,13,0,0,0,0
8472,68,3,6,6,0,0,0,0
768517,752,6,90,69,21,7,1,0
0,0,0,0,0,0,0,0,0
0,0,0,0,0,0,0,0,0
0,0,0,0,0,0,0,0,0
223252,1012,4,91,57,34,1,1,0
88589,458,5,8,7,1,0,0,0
257997,758,10,41,35,6,0,1,0
12557,261,0,17,13,4,0,0,0
3367,81,0,4,4,0,0,0,0
108504,1025,14,200,197,3,9,1,0
0,0,0,0,0,0,0,0,0
479801,2086,10,229,216,13,21,1,0
280280,832,9,11,5,6,6,1,0
32251,287,1,67,55,12,0,1,0
195122,1116,2,209,193,16,0,1,0
97123,289,4,69,55,14,0,1,0
0,0,0,0,0,0,0,0,0
201926,2601,9,447,428,19,5,1,0
22784,108,9,2,2,0,3,0,0
97251,854,2,264,235,29,6,0,1
233755,2567,8,571,556,15,5,1,0
12755,94,9,11,8,3,0,1,0
943105,10360,6,1623,1563,60,43,1,0
102085,1317,4,232,212,20,6,1,0
122537,657,6,125,94,31,2,1,0
10438,140,0,23,22,1,1,1,0
611547,876,5,132,85,47,8,1,0
552698,2834,5,388,337,51,2,1,0
378702,2310,10,445,429,16,37,1,1
144695,1729,5,307,301,6,7,1,0
1145861,2888,10,404,388,16,3,1,0
525733,3589,9,66,60,6,1,1,0
0,0,0,0,0,0,0,0,0
0,0,0,0,0,0,0,0,0
281353,1481,5,107,66,41,6,1,0
27471,379,4,62,45,17,2,0,0
0,0,0,0,0,0,0,0,0
44528,562,4,176,176,0,3,1,0
0,0,0,0,0,0,0,0,0
195459,1001,9,210,190,20,14,1,0
0,0,0,0,0,0,0,0,0
339711,1292,5,226,206,20,0,1,0
221271,200,6,15,12,3,12,0,0
166796,832,10,167,162,5,7,1,0
7313,17,0,2,0,2,0,0,0
22054,33,0,1,1,0,0,1,0
0,0,0,0,0,0,0,0,0
0,0,0,0,0,0,0,0,0
11453,323,0,34,32,2,0,1,0
4412,95,0,13,11,2,0,1,0
280641,1010,9,183,179,4,11,1,0
0,0,0,0,0,0,0,0,0
62925,807,4,133,123,10,17,1,0
4622,56,0,4,1,3,0,0,0
283026,464,3,84,76,8,0,1,0
763685,1422,7,79,64,15,15,1,0
706062,705,6,52,39,13,15,1,0
0,0,0,0,0,0,0,0,0
946476,11488,9,245,228,17,7,0,0
782359,2463,6,403,386,17,7,1,0
166419,1198,6,278,261,17,7,1,0
0,0,0,0,0,0,0,0,0
128783,1017,1,104,92,12,1,1,1
276401,5332,2,1320,1086,234,35,1,0
15123,241,2,60,56,4,3,1,0
562512,5264,11,1097,1069,28,9,1,0
0,0,0,0,0,0,0,0,0
0,0,0,0,0,0,0,0,0
0,0,0,0,0,0,0,0,0
0,0,0,0,0,0,0,0,0
614965,513,4,5,3,2,1,1,0
628133,641,6,25,17,8,1,1,0
170491,783,5,115,89,26,7,1,0
0,0,0,0,0,0,0,0,0
350874,1553,3,183,183,0,34,0,0
0,0,0,0,0,0,0,0,0
95437,804,3,198,193,5,4,1,1
137897,529,7,56,45,11,15,1,0
197266,270,4,3,2,1,14,1,0
867336,1320,2,66,50,16,8,1,0
58821,289,6,33,31,2,3,0,0
66389,273,6,33,30,3,4,0,0
0,0,0,0,0,0,0,0,0
218436,2015,9,360,351,9,5,1,0
132304,1389,3,36,29,7,7,1,0
85919,722,3,5,5,0,8,0,0
0,0,0,0,0,0,0,0,0
0,0,0,0,0,0,0,0,0
100004,1369,7,263,238,25,1,1,0
570325,3734,2,453,437,16,1,1,0
0,0,0,0,0,0,0,0,0
87637,66,0,4,2,2,4,1,0
684137,2811,7,571,483,88,66,1,0
424620,2892,9,40,30,10,29,1,0
424620,2892,9,40,37,3,29,1,0
0,0,0,0,0,0,0,0,0
0,0,0,0,0,0,0,0,0
11402,207,6,22,20,2,0,1,0
141151,510,8,93,53,40,0,0,0
0,0,0,0,0,0,0,0,0
0,0,0,0,0,0,0,0,0
229855,1622,6,329,301,28,12,1,0
0,0,0,0,0,0,0,0,0
0,0,0,0,0,0,0,0,0
0,0,0,0,0,0,0,0,0
120305,974,7,124,113,11,0,1,0
1516743,1152,2,172,14,158,0,1,0
384642,93,0,3,3,0,0,1,0
0,0,0,0,0,0,0,0,0
476944,966,2,96,83,13,4,1,0
0,0,0,0,0,0,0,0,0
146833,57,1,13,12,1,0,0,0
0,0,0,0,0,0,0,0,0
40377,460,2,15,5,10,9,0,0
315085,2261,7,466,179,287,20,1,0
50458,830,10,226,214,12,7,1,0
128535,736,1,90,77,13,0,1,0
119096,975,9,214,196,18,13,1,0
95864,569,2,53,53,0,11,1,0
0,0,0,0,0,0,0,0,0
0,0,0,0,0,0,0,0,0
62031,666,3,186,144,42,9,1,0
19829,129,2,22,16,6,0,1,0
0,0,0,0,0,0,0,0,0
21912,33,0,1,1,0,0,1,0
0,0,0,0,0,0,0,0,0
0,0,0,0,0,0,0,0,0
142735,881,8,111,26,85,20,1,0
565140,1431,2,193,146,47,1,1,0
48418,660,5,40,28,12,3,0,0
47633,171,5,14,10,4,9,1,0
88161,847,7,172,139,33,6,1,0
1223628,6579,11,1395,1204,191,20,1,0
0,0,0,0,0,0,0,0,0
0,0,0,0,0,0,0,0,0
0,0,0,0,0,0,0,0,0
65260,721,5,225,224,1,1,1,0
48730,639,5,215,214,1,1,1,0
0,0,0,0,0,0,0,0,0
0,0,0,0,0,0,0,0,0
0,0,0,0,0,0,0,0,0
0,0,0,0,0,0,0,0,0
0,0,0,0,0,0,0,0,0
0,0,0,0,0,0,0,0,0
49245,362,5,68,47,21,0,1,0
11977,171,4,28,27,1,1,1,0
18177,331,4,29,28,1,1,1,0
0,0,0,0,0,0,0,0,0
268244,1324,9,267,254,13,11,1,0
97302,369,2,81,52,29,0,1,0
120644,803,8,104,91,13,2,1,0
64655,912,1,82,74,8,0,0,0
22307,383,3,61,54,7,1,0,0
0,0,0,0,0,0,0,0,0
53006,660,5,66,60,6,0,0,0
0,0,0,0,0,0,0,0,0
120101,806,9,68,24,44,0,0,0
0,0,0,0,0,0,0,0,0
1856005,655,8,98,71,27,2,1,0
449487,1311,13,110,108,2,7,1,0
85607,108,0,15,8,7,0,1,0
273689,1466,10,247,203,44,15,1,0
0,0,0,0,0,0,0,0,0
0,0,0,0,0,0,0,0,0
0,0,0,0,0,0,0,0,0
50815,559,6,0,0,0,7,0,0
349807,2273,18,283,258,25,17,1,0
0,0,0,0,0,0,0,0,0
22021,35,0,1,1,0,0,1,0
1043386,3535,7,551,508,43,16,1,0
0,0,0,0,0,0,0,0,0
0,0,0,0,0,0,0,0,0
162149,2355,8,429,370,59,7,1,0
49298,384,10,77,67,10,1,1,0
0,0,0,0,0,0,0,0,0
1076368,2912,1,495,476,19,15,1,0
195607,919,7,81,78,3,5,1,0
22730,37,0,2,1,1,0,1,0
50356,413,5,59,34,25,1,0,0
314604,1972,8,240,204,36,3,1,0
0,0,0,0,0,0,0,0,0
140553,1538,5,148,117,31,2,1,0
68037,410,6,57,46,11,7,1,0
22488,323,2,56,55,1,0,0,0
190,5,0,0,0,0,0,0,1
0,0,0,0,0,0,0,0,0
0,0,0,0,0,0,0,0,0
0,0,0,0,0,0,0,0,0
108103,1176,3,164,104,60,12,1,0
280800,1123,8,6,2,4,9,0,0
46320,528,8,122,106,16,3,1,0
0,0,0,0,0,0,0,0,0
373221,2525,11,381,280,101,0,0,0
66000,486,3,128,115,13,0,1,0
629818,1181,15,96,84,12,11,1,0
57158,416,8,148,148,0,5,1,0
75948,229,10,39,32,7,0,1,0
0,0,0,0,0,0,0,0,0
295413,2226,7,300,296,4,26,1,1
72632,1267,3,320,306,14,6,0,0
0,0,0,0,0,0,0,0,0
145845,685,11,54,52,2,2,0,0
0,0,0,0,0,0,0,0,0
207071,1432,3,286,275,11,1,1,0
70388,958,3,218,213,5,1,1,0
0,0,0,0,0,0,0,0,0
132041,1555,11,61,58,3,3,1,0
0,0,0,0,0,0,0,0,0
66486,504,5,63,61,2,6,0,0
0,0,0,0,0,0,0,0,0
0,0,0,0,0,0,0,0,0
302028,2360,7,350,309,41,27,1,0
0,0,0,0,0,0,0,0,0
129244,409,4,32,28,4,5,1,0
5363,91,1,11,10,1,0,0,0
0,0,0,0,0,0,0,0,0
0,0,0,0,0,0,0,0,0
0,0,0,0,0,0,0,0,0
111541,475,10,36,24,12,25,1,0
11870,100,3,7,6,1,1,1,0
0,0,0,0,0,0,0,0,0
491214,1238,5,48,46,2,19,1,0
255353,3625,6,1146,1142,4,8,1,0
0,0,0,0,0,0,0,0,0
0,0,0,0,0,0,0,0,0
0,0,0,0,0,0,0,0,0
0,0,0,0,0,0,0,0,0
0,0,0,0,0,0,0,0,0
0,0,0,0,0,0,0,0,0
281828,789,4,52,44,8,14,1,0
57322,126,2,3,3,0,0,0,0
0,0,0,0,0,0,0,0,0
0,0,0,0,0,0,0,0,0
0,0,0,0,0,0,0,0,0
0,0,0,0,0,0,0,0,0
90294,1584,1,740,735,5,0,1,0
28525,44,0,4,3,1,0,0,0
0,0,0,0,0,0,0,0,0
0,0,0,0,0,0,0,0,0
0,0,0,0,0,0,0,0,0
0,0,0,0,0,0,0,0,0
0,0,0,0,0,0,0,0,0
267977,992,3,244,239,5,8,1,0
67393,340,2,117,117,0,1,0,0
0,0,0,0,0,0,0,0,0
195129,1299,11,39,7,32,3,1,0
0,0,0,0,0,0,0,0,0
56081,565,6,113,110,3,0,1,0
22619,362,2,75,55,20,1,1,0
148282,2147,6,644,637,7,0,1,0
0,0,0,0,0,0,0,0,0
0,0,0,0,0,0,0,0,0
0,0,0,0,0,0,0,0,0
0,0,0,0,0,0,0,0,0
0,0,0,0,0,0,0,0,0
0,0,0,0,0,0,0,0,0
0,0,0,0,0,0,0,0,0
450608,629,5,24,20,4,4,1,0
451697,479,7,21,17,4,2,1,0
92870,1852,8,369,310,59,16,1,0
44146,840,4,232,206,26,14,1,0
0,0,0,0,0,0,0,0,0
73377,452,11,82,82,0,7,1,0
0,0,0,0,0,0,0,0,0
394122,1167,2,163,44,119,2,1,0
41010,495,5,131,127,4,4,1,0
51958,719,1,64,26,38,0,1,0
189911,1569,7,149,143,6,10,1,0
0,0,0,0,0,0,0,0,0
43232,363,0,42,38,4,0,0,0
8044,44,0,3,3,0,0,0,0
0,0,0,0,0,0,0,0,0
923876,1173,13,204,187,17,3,1,0
0,0,0,0,0,0,0,0,0
0,0,0,0,0,0,0,0,0
82339,1014,5,286,285,1,4,0,0
0,0,0,0,0,0,0,0,0
0,0,0,0,0,0,0,0,0
201428,1156,7,224,212,12,8,1,0
0,0,0,0,0,0,0,0,0
39689,399,6,43,4,39,14,1,0
949215,2359,10,370,255,115,36,1,0
0,0,0,0,0,0,0,0,0
1232939,4367,13,725,619,106,21,1,1
17670,97,4,4,0,4,3,1,0
0,0,0,0,0,0,0,0,0
191612,1622,16,110,14,96,4,1,0
21965,33,0,1,1,0,0,1,0
696045,1685,2,112,105,7,3,1,0
64133,549,12,58,57,1,8,0,0
30505,289,5,42,42,0,3,0,0
3697,70,2,3,2,1,0,1,0
81501,444,4,74,73,1,2,1,0
0,0,0,0,0,0,0,0,0
405858,3291,2,247,225,22,2,1,0
0,0,0,0,0,0,0,0,0
46043,628,3,89,82,7,15,1,0
0,0,0,0,0,0,0,0,0
38596,461,6,98,91,7,5,1,0
223446,1861,4,169,142,27,8,1,0
185219,1321,4,124,96,28,15,1,0
0,0,0,0,0,0,0,0,0
556024,4157,6,377,375,2,10,1,0
418976,496,7,45,43,2,7,1,0
113948,1119,11,179,177,2,47,1,0
13250,29,1,0,0,0,0,1,0
248716,3098,12,515,496,19,12,0,0
0,0,0,0,0,0,0,0,0
199188,1892,11,287,209,78,12,1,0
505252,387,3,32,9,23,0,1,0
1453501,769,9,115,103,12,0,1,0
9265,91,5,7,4,3,0,0,0
34573,532,5,80,80,0,2,1,0
102359,876,6,76,75,1,15,1,0
0,0,0,0,0,0,0,0,0
6997,84,3,2,2,0,0,1,0
275926,1691,2,248,180,68,3,0,0
0,0,0,0,0,0,0,0,0
467583,1313,8,223,203,20,28,1,1
22749,37,0,2,1,1,0,1,0
114651,788,14,81,76,5,5,1,0
64715,320,14,42,41,1,7,0,0
498729,1705,4,177,172,5,20,1,0
484036,958,3,10,7,3,8,1,0
50854,778,2,146,146,0,2,1,0
9681,173,1,34,34,0,0,1,0
0,0,0,0,0,0,0,0,0
403690,1509,7,274,257,17,8,0,0
0,0,0,0,0,0,0,0,0
0,0,0,0,0,0,0,0,0
188705,1516,3,293,233,60,4,1,0
0,0,0,0,0,0,0,0,0
24990,188,2,3,1,2,2,1,0
0,0,0,0,0,0,0,0,0
0,0,0,0,0,0,0,0,0
58824,934,5,333,313,20,1,1,0
0,0,0,0,0,0,0,0,0
812093,5231,10,514,500,14,123,1,0
0,0,0,0,0,0,0,0,0
19313,337,1,133,132,1,0,1,0
0,0,0,0,0,0,0,0,0
0,0,0,0,0,0,0,0,0
0,0,0,0,0,0,0,0,0
0,0,0,0,0,0,0,0,0
0,0,0,0,0,0,0,0,0
163749,255,2,3,3,0,1,1,0
17640,105,2,3,0,3,4,0,0
53506,669,4,89,73,16,1,0,0
81380,874,5,185,168,17,2,1,0
25687,279,4,62,58,4,0,1,0
0,0,0,0,0,0,0,0,0
68066,431,1,54,51,3,1,1,0
39786,610,1,46,41,5,1,1,0
1066488,3531,10,402,390,12,4,1,0
402920,1625,10,251,239,12,4,1,0
263086,2093,11,499,489,10,10,1,0
225885,1723,13,398,388,10,10,1,0
0,0,0,0,0,0,0,0,0
0,0,0,0,0,0,0,0,0
162585,2840,4,463,250,213,7,0,0
48106,373,9,57,57,0,0,1,0
419501,1656,12,164,138,26,7,1,0
0,0,0,0,0,0,0,0,0
0,0,0,0,0,0,0,0,0
43797,382,7,55,19,36,0,1,0
781840,2586,17,391,12,379,28,1,0
53166,831,2,11,2,9,1,0,0
125952,577,10,44,34,10,6,1,0
0,0,0,0,0,0,0,0,0
0,0,0,0,0,0,0,0,0
0,0,0,0,0,0,0,0,0
1068010,1277,8,136,82,54,17,1,0
49323,138,5,7,6,1,8,0,0
0,0,0,0,0,0,0,0,0
17858,307,0,56,55,1,0,0,0
0,0,0,0,0,0,0,0,0
0,0,0,0,0,0,0,0,0
103839,907,1,138,136,2,2,0,0
84697,545,9,50,50,0,0,0,0
0,0,0,0,0,0,0,0,0
716079,3413,5,229,210,19,6,1,0
0,0,0,0,0,0,0,0,0
313315,1540,11,588,571,17,11,1,0
0,0,0,0,0,0,0,0,0
0,0,0,0,0,0,0,0,0
6155,92,0,5,5,0,0,0,0
0,0,0,0,0,0,0,0,0
1724,53,0,14,0,14,0,0,0
0,0,0,0,0,0,0,0,0
0,0,0,0,0,0,0,0,0
252654,815,5,48,47,1,0,1,0
0,0,0,0,0,0,0,0,0
0,0,0,0,0,0,0,0,0
66445,769,7,182,175,7,3,1,0
28756,429,12,29,22,7,2,1,0
19375,197,13,25,22,3,2,1,0
0,0,0,0,0,0,0,0,0
43452,480,7,123,108,15,10,1,0
163815,1996,9,333,326,7,2,1,0
214302,1993,8,358,344,14,8,1,0
21861,125,7,5,5,0,0,0,0
22901,191,6,25,22,3,1,1,0
0,0,0,0,0,0,0,0,0
188659,1794,11,522,517,5,9,1,0
0,0,0,0,0,0,0,0,0
0,0,0,0,0,0,0,0,0
4499,56,1,9,7,2,0,0,0
283246,2028,8,336,326,10,2,1,0
16349,249,6,45,31,14,0,1,0
69814,568,5,21,12,9,0,1,0
77804,268,4,50,50,0,0,1,0
36698,281,6,36,36,0,3,1,0
24260,313,10,27,10,17,2,1,0
12253,135,9,17,11,6,0,1,0
0,0,0,0,0,0,0,0,0
399621,1979,14,343,210,133,5,1,0
115617,200,8,23,3,20,2,1,0
106943,1478,5,435,408,27,8,1,0
193487,61,3,0,0,0,0,0,0
0,0,0,0,0,0,0,0,0
0,0,0,0,0,0,0,0,0
100973,1056,7,133,128,5,14,1,0
0,0,0,0,0,0,0,0,0
0,0,0,0,0,0,0,0,0
145014,1056,7,152,115,37,7,1,0
51818,451,7,23,23,0,1,0,0
172623,1398,14,186,180,6,11,1,0
0,0,0,0,0,0,0,0,0
130626,1340,7,216,194,22,11,1,0
454593,1591,11,189,157,32,26,1,0
0,0,0,0,0,0,0,0,0
0,0,0,0,0,0,0,0,0
0,0,0,0,0,0,0,0,0
54268,513,5,66,66,0,1,1,0
0,0,0,0,0,0,0,0,0
29032,549,2,123,112,11,0,0,0
10639,153,2,25,25,0,0,0,0
94186,1220,5,242,232,10,4,1,0
0,0,0,0,0,0,0,0,0
0,0,0,0,0,0,0,0,0
0,0,0,0,0,0,0,0,0
179511,1069,9,212,19,193,2,1,0
64547,105,2,5,5,0,2,1,0
16916,190,1,5,0,5,0,0,0
1015100,2999,9,649,599,50,47,1,0
160180,1139,5,195,190,5,0,1,0
0,0,0,0,0,0,0,0,0
0,0,0,0,0,0,0,0,0
204576,1779,12,264,210,54,4,1,0
0,0,0,0,0,0,0,0,0
398055,1182,13,106,100,6,10,1,0
0,0,0,0,0,0,0,0,0
3066416,2355,7,442,324,118,7,1,0
21990,35,0,1,1,0,0,1,0
0,0,0,0,0,0,0,0,0
441493,1512,8,126,104,22,23,1,0
3806316,355,8,36,26,10,4,1,0
25968,596,3,146,144,2,0,1,0
0,0,0,0,0,0,0,0,0
0,0,0,0,0,0,0,0,0
297544,747,7,117,111,6,1,1,0
0,0,0,0,0,0,0,0,0
539226,370,2,63,54,9,3,0,0
338135,2515,7,388,371,17,2,1,0
309153,1494,4,85,80,5,2,1,0
0,0,0,0,0,0,0,0,0
11717,174,9,21,21,0,0,0,0
0,0,0,0,0,0,0,0,0
76316,527,1,112,107,5,0,0,0
0,0,0,0,0,0,0,0,0
249908,814,8,110,15,95,0,1,0
0,0,0,0,0,0,0,0,0
78390,932,7,159,148,11,9,1,0
3133,77,0,29,13,16,0,0,0
412791,1747,3,160,17,143,10,0,0
536195,4615,2,604,598,6,21,0,0
16752,316,3,67,61,6,4,1,0
52254,268,4,32,27,5,7,1,0
550746,4007,8,506,494,12,61,1,0
158118,1955,5,364,359,5,6,1,0
0,0,0,0,0,0,0,0,0
771848,1496,5,59,40,19,2,0,0
15960,88,1,8,5,3,1,0,0
0,0,0,0,0,0,0,0,0
1678,61,0,0,0,0,0,1,0
830126,1971,1,121,104,17,0,1,0
317094,66,0,6,5,1,0,1,0
28595,45,0,4,1,3,0,0,0
287911,3342,4,465,407,58,1,1,0
60041,629,5,25,16,9,0,1,0
0,0,0,0,0,0,0,0,0
0,0,0,0,0,0,0,0,0
45261,560,11,89,82,7,4,1,0
0,0,0,0,0,0,0,0,0
18481,544,4,130,127,3,3,1,0
596653,5331,6,1551,1503,48,1,0,0
0,0,0,0,0,0,0,0,0
0,0,0,0,0,0,0,0,0
0,0,0,0,0,0,0,0,0
0,0,0,0,0,0,0,0,0
21933,35,0,1,1,0,0,1,0
11978,141,0,49,48,1,0,1,0
13319,222,4,44,39,5,1,1,0
0,0,0,0,0,0,0,0,0
39749,612,6,89,87,2,0,1,0
0,0,0,0,0,0,0,0,0
0,0,0,0,0,0,0,0,0
22494,39,0,3,1,2,0,1,0
1037452,2838,14,349,319,30,22,1,1
61886,368,6,52,16,36,0,0,0
0,0,0,0,0,0,0,0,0
86859,944,11,98,67,31,13,1,0
63676,593,9,76,63,13,9,1,0
95398,887,4,264,163,101,3,1,0
19510,156,1,6,4,2,1,0,0
344915,3846,6,1142,1142,0,2,1,0
70049,1928,2,568,568,0,2,1,0
0,0,0,0,0,0,0,0,0
0,0,0,0,0,0,0,0,0
274018,773,2,98,85,13,1,1,0
0,0,0,0,0,0,0,0,0
109024,1458,6,341,291,50,0,1,0
26592,328,5,66,63,3,0,1,0
41495,508,10,46,45,1,0,1,0
37242,361,6,43,41,2,4,1,0
20846,235,6,37,35,2,6,1,0
43773,642,12,115,108,7,3,1,0
0,0,0,0,0,0,0,0,0
277421,5335,4,511,510,1,0,1,0
0,0,0,0,0,0,0,0,0
177484,531,9,70,69,1,0,1,0
40206,514,11,84,71,13,0,1,0
0,0,0,0,0,0,0,0,0
165491,668,5,40,19,21,15,1,0
80671,513,3,66,59,7,10,1,0
0,0,0,0,0,0,0,0,0
188348,2776,12,526,523,3,2,1,0
158794,1367,6,288,231,57,16,1,0
97554,740,6,218,207,11,16,1,0
44924,559,4,116,113,3,2,1,0
22252,227,4,47,44,3,2,1,0
0,0,0,0,0,0,0,0,0
403217,857,4,200,196,4,1,1,0
77919,752,4,166,157,9,6,1,0
301656,2327,11,319,274,45,5,1,0
98463,505,8,69,69,0,3,1,0
264933,2701,1,335,146,189,3,0,0
30231,722,2,194,194,0,0,0,0
0,0,0,0,0,0,0,0,0
0,0,0,0,0,0,0,0,0
0,0,0,0,0,0,0,0,0
0,0,0,0,0,0,0,0,0
194245,2422,6,607,572,35,12,1,0
1656278,10181,4,830,822,8,386,1,0
157905,1399,4,284,276,8,30,1,0
17380,231,5,19,16,3,6,1,0
0,0,0,0,0,0,0,0,0
0,0,0,0,0,0,0,0,0
802082,1376,4,46,46,0,0,0,0
393077,1530,10,132,122,10,12,1,0
0,0,0,0,0,0,0,0,0
0,0,0,0,0,0,0,0,0
21031,270,0,57,38,19,0,1,0
134750,787,6,109,104,5,32,0,0
25818,139,4,8,8,0,1,0,0
606759,5607,13,1442,1403,39,13,1,0
0,0,0,0,0,0,0,0,0
114164,2501,3,653,652,1,0,0,0
12303,95,1,12,10,2,0,1,0
281078,1356,4,110,104,6,4,1,0
72344,882,6,92,90,2,4,0,0
285847,3157,8,298,270,28,52,1,0
121986,711,7,96,82,14,3,1,0
325114,2268,8,287,235,52,30,1,0
350626,1362,7,134,126,8,0,1,0
49156,427,4,79,71,8,1,0,0
454209,4667,7,506,496,10,147,1,0
150467,828,6,96,91,5,21,1,0
7522,56,3,1,1,0,2,0,0
1032693,2431,11,390,382,8,6,1,0
174821,2159,3,536,507,29,3,1,0
71683,411,2,27,22,5,0,0,0
0,0,0,0,0,0,0,0,0
96378,420,3,31,24,7,5,1,0
335053,811,8,185,153,32,5,1,0
0,0,0,0,0,0,0,0,0
24751,385,3,74,56,18,0,1,0
22389,362,3,53,36,17,2,1,0
0,0,0,0,0,0,0,0,0
100807,2846,3,669,662,7,0,0,0
309025,1962,16,534,519,15,20,1,0
0,0,0,0,0,0,0,0,0
230546,344,0,17,11,6,0,1,0
469394,84,4,2,1,1,0,0,0
0,0,0,0,0,0,0,0,0
201478,1559,6,260,234,26,20,1,0
553257,5860,16,1738,1710,28,68,1,0
30678,373,4,27,18,9,4,1,0
78887,315,9,48,47,1,2,0,0
740536,3372,3,203,149,54,3,0,0
252431,1546,2,95,67,28,2,0,0
113108,634,9,141,138,3,11,1,0
3263,40,0,1,1,0,0,1,0
111920,638,4,17,15,2,0,0,0
38516,65,3,3,3,0,0,0,0
170814,2160,8,408,61,347,8,0,0
0,0,0,0,0,0,0,0,0
629801,1826,4,490,490,0,1,1,0
561099,1698,3,453,452,1,0,1,0
22013,34,0,1,1,0,0,1,0
0,0,0,0,0,0,0,0,0
134955,268,2,17,9,8,0,1,0
0,0,0,0,0,0,0,0,0
0,0,0,0,0,0,0,0,0
389,7,0,0,0,0,0,0,0
461618,2946,13,442,410,32,10,1,0
380824,1363,16,222,196,26,8,1,0
158815,2466,8,664,663,1,2,1,0
0,0,0,0,0,0,0,0,0
0,0,0,0,0,0,0,0,0
0,0,0,0,0,0,0,0,0
0,0,0,0,0,0,0,0,0
70104,507,7,107,73,34,7,1,0
0,0,0,0,0,0,0,0,0
95855,1148,10,40,17,23,15,0,0
0,0,0,0,0,0,0,0,0
0,0,0,0,0,0,0,0,0
780794,2542,3,299,179,120,18,1,0
106378,257,4,41,31,10,5,1,0
0,0,0,0,0,0,0,0,0
190930,1116,10,248,230,18,10,1,0
0,0,0,0,0,0,0,0,0
0,0,0,0,0,0,0,0,0
0,0,0,0,0,0,0,0,0
585091,2975,4,294,232,62,23,1,0
63897,459,2,70,68,2,10,1,0
281720,767,6,102,67,35,16,1,0
32775,303,7,32,4,28,5,1,0
0,0,0,0,0,0,0,0,0
87761,718,9,49,47,2,2,0,0
223541,708,5,108,72,36,5,0,0
0,0,0,0,0,0,0,0,0
232152,1384,8,221,188,33,22,1,0
0,0,0,0,0,0,0,0,0
0,0,0,0,0,0,0,0,0
219390,201,7,13,11,2,6,1,0
0,0,0,0,0,0,0,0,0
4112683,2204,1,90,87,3,0,1,0
59831,240,1,11,10,1,0,1,0
131628,1401,3,113,107,6,9,0,0
235253,1153,3,112,101,11,5,1,0
946524,3647,1,202,177,25,0,1,0
0,0,0,0,0,0,0,0,0
0,0,0,0,0,0,0,0,0
8759,70,6,3,2,1,0,0,0
43039,334,4,39,38,1,0,0,0
0,0,0,0,0,0,0,0,0
104948,1808,2,428,414,14,37,1,0
0,0,0,0,0,0,0,0,0
454404,2513,14,452,350,102,34,1,0
0,0,0,0,0,0,0,0,0
40362,491,5,77,74,3,9,1,0
27028,453,4,6,0,6,2,0,0
405638,1760,7,162,141,21,37,1,0
405358,1758,7,162,141,21,37,1,0
0,0,0,0,0,0,0,0,0
0,0,0,0,0,0,0,0,0
228860,826,12,55,37,18,14,1,0
78099,1446,1,319,227,92,0,0,0
44247,96,4,6,4,2,3,0,0
437491,4685,5,460,194,266,19,1,0
0,0,0,0,0,0,0,0,0
0,0,0,0,0,0,0,0,0
28339,45,0,4,1,3,0,0,0
0,0,0,0,0,0,0,0,0
0,0,0,0,0,0,0,0,0
158903,1386,10,224,200,24,11,1,0
177779,1275,7,101,99,2,26,1,0
64059,476,7,75,70,5,0,1,0
0,0,0,0,0,0,0,0,0
0,0,0,0,0,0,0,0,0
141229,1147,6,209,195,14,5,1,0
29896,299,6,49,39,10,1,1,0
50145,596,11,93,58,35,5,1,0
0,0,0,0,0,0,0,0,0
0,0,0,0,0,0,0,0,0
0,0,0,0,0,0,0,0,0
4120831,32214,8,3326,1808,1518,7,0,0
107944,724,14,132,111,21,4,1,0
0,0,0,0,0,0,0,0,0
0,0,0,0,0,0,0,0,0
218522,905,0,186,146,40,2,1,0
0,0,0,0,0,0,0,0,0
171865,803,10,71,37,34,5,1,0
225755,1423,11,156,147,9,16,1,0
0,0,0,0,0,0,0,0,0
0,0,0,0,0,0,0,0,0
592112,11027,8,1781,1472,309,8,1,0
34124,402,8,21,15,6,0,1,0
0,0,0,0,0,0,0,0,0
0,0,0,0,0,0,0,0,0
621602,2853,4,180,168,12,1,1,0
47226,694,8,76,48,28,0,1,0
0,0,0,0,0,0,0,0,0
405969,1355,4,210,158,52,2,1,0
0,0,0,0,0,0,0,0,0
588182,400,2,68,67,1,3,1,0
0,0,0,0,0,0,0,0,0
0,0,0,0,0,0,0,0,0
226197,1456,5,596,594,2,12,1,0
183477,622,3,84,29,55,20,1,0
0,0,0,0,0,0,0,0,0
0,0,0,0,0,0,0,0,0
48248,301,3,23,23,0,16,1,0
25276,343,3,86,83,3,6,1,0
0,0,0,0,0,0,0,0,0
128722,1201,8,382,360,22,13,1,0
73120,298,3,24,24,0,16,1,0
0,0,0,0,0,0,0,0,0
268931,2528,7,561,443,118,1,1,0
5842,58,6,4,4,0,1,0,0
53169,637,4,166,135,31,0,0,0
241679,296,5,42,36,6,4,1,0
40652,151,2,26,21,5,0,1,0
0,0,0,0,0,0,0,0,0
0,0,0,0,0,0,0,0,0
167708,383,7,79,59,20,9,1,0
122152,1367,3,232,20,212,0,1,0
71171,32,0,0,0,0,0,0,0
18815,246,3,41,38,3,0,1,0
24967,168,7,44,30,14,3,1,0
154587,2282,5,567,493,74,17,1,0
37041,533,5,109,103,6,0,1,0
255222,821,0,227,214,13,0,0,0
0,0,0,0,0,0,0,0,0
106746,437,4,80,71,9,1,1,0
1172232,5044,15,294,288,6,5,1,0
3785,73,0,13,10,3,0,1,0
197346,792,7,10,4,6,5,1,0
0,0,0,0,0,0,0,0,0
55513,738,7,217,193,24,1,1,0
423740,2806,9,467,436,31,60,1,0
65204,950,7,177,163,14,13,1,0
59641,685,2,179,161,18,0,0,0
335084,2010,9,172,48,124,4,1,0
285561,1349,8,166,157,9,0,1,0
0,0,0,0,0,0,0,0,0
376359,3284,7,222,99,123,4,1,0
0,0,0,0,0,0,0,0,0
0,0,0,0,0,0,0,0,0
0,0,0,0,0,0,0,0,0
612726,3498,5,361,311,50,76,1,0
0,0,0,0,0,0,0,0,0
0,0,0,0,0,0,0,0,0
0,0,0,0,0,0,0,0,0
126010,842,10,45,1,44,1,0,0
0,0,0,0,0,0,0,0,0
22996,37,0,2,1,1,0,1,0
0,0,0,0,0,0,0,0,0
0,0,0,0,0,0,0,0,0
0,0,0,0,0,0,0,0,0
103765,932,5,173,31,142,2,1,0
89407,257,0,48,24,24,0,1,1
254726,1588,13,397,387,10,6,1,1
73588,1013,4,180,150,30,2,1,0
34912,399,4,102,95,7,2,1,0
4972539,37753,9,3368,1870,1498,15,1,0
47110,132,8,3,0,3,0,1,0
25859,392,4,75,11,64,0,1,0
18109,325,4,75,71,4,0,1,0
36956,277,4,9,6,3,0,1,0
0,0,0,0,0,0,0,0,0
0,0,0,0,0,0,0,0,0
0,0,0,0,0,0,0,0,0
10315,185,0,21,21,0,0,1,0
5237,120,0,19,19,0,0,1,0
408251,2748,2,97,88,9,0,1,0
0,0,0,0,0,0,0,0,0
0,0,0,0,0,0,0,0,0
0,0,0,0,0,0,0,0,0
34293,50,3,7,5,2,0,1,0
37221,712,3,280,280,0,5,1,0
0,0,0,0,0,0,0,0,0
0,0,0,0,0,0,0,0,0
0,0,0,0,0,0,0,0,0
262884,1370,12,318,306,12,10,1,0
449385,1374,8,213,185,28,14,1,0
0,0,0,0,0,0,0,0,0
0,0,0,0,0,0,0,0,0
268109,904,4,110,103,7,1,1,0
159965,1177,11,99,96,3,9,1,0
431162,1839,14,185,174,11,5,1,0
374813,1808,9,102,23,79,52,1,0
0,0,0,0,0,0,0,0,0
706956,1250,13,130,91,39,4,1,0
0,0,0,0,0,0,0,0,0
0,0,0,0,0,0,0,0,0
208751,1779,12,288,150,138,7,0,0
359818,712,7,82,71,11,2,1,0
21778,33,0,1,1,0,0,1,0
55337,1054,1,238,233,5,7,0,0
0,0,0,0,0,0,0,0,0
0,0,0,0,0,0,0,0,0
76010,380,11,20,20,0,3,1,0
27352,362,6,10,10,0,22,0,0
15894,160,4,13,8,5,2,0,0
0,0,0,0,0,0,0,0,0
287251,523,1,19,13,6,1,1,0
45226,771,5,138,133,5,9,1,0
0,0,0,0,0,0,0,0,0
0,0,0,0,0,0,0,0,0
0,0,0,0,0,0,0,0,0
0,0,0,0,0,0,0,0,0
109346,900,4,268,263,5,0,1,1
345652,1850,6,416,405,11,3,1,0
22816,37,0,2,1,1,0,1,0
176268,1071,4,158,130,28,4,1,0
0,0,0,0,0,0,0,0,0
0,0,0,0,0,0,0,0,0
0,0,0,0,0,0,0,0,0
0,0,0,0,0,0,0,0,0
0,0,0,0,0,0,0,0,0
215731,419,7,65,7,58,4,1,0
0,0,0,0,0,0,0,0,0
0,0,0,0,0,0,0,0,0
0,0,0,0,0,0,0,0,0
81034,919,5,120,108,12,2,1,0
15495,112,3,5,5,0,3,0,0
20576,345,4,69,68,1,0,0,0
0,0,0,0,0,0,0,0,0
22330,476,0,141,141,0,5,1,0
9871,173,0,28,28,0,6,1,0
0,0,0,0,0,0,0,0,0
33560,393,6,106,94,12,1,1,0
17965,35,0,2,1,1,0,1,0
369436,1908,9,320,194,126,6,1,0
452403,1564,17,273,252,21,10,1,0
115167,1373,4,125,117,8,1,1,0
0,0,0,0,0,0,0,0,0
92467,1041,2,60,33,27,2,1,0
0,0,0,0,0,0,0,0,0
0,0,0,0,0,0,0,0,0
0,0,0,0,0,0,0,0,0
0,0,0,0,0,0,0,0,0
501311,941,8,24,3,21,4,1,0
0,0,0,0,0,0,0,0,0
0,0,0,0,0,0,0,0,0
118640,413,3,111,107,4,10,1,0
0,0,0,0,0,0,0,0,0
98561,694,8,210,201,9,8,1,0
77970,669,11,85,9,76,4,1,0
11820,141,6,24,18,6,2,1,0
94209,520,10,142,135,7,4,0,0
130128,843,3,59,42,17,1,1,0
0,0,0,0,0,0,0,0,0
0,0,0,0,0,0,0,0,0
57468,578,4,126,126,0,18,1,0
0,0,0,0,0,0,0,0,0
271204,2373,5,494,488,6,3,1,0
371739,1349,8,138,138,0,8,1,0
127843,998,6,128,113,15,11,0,0
295003,3742,19,926,903,23,17,1,0
0,0,0,0,0,0,0,0,0
0,0,0,0,0,0,0,0,0
97464,412,2,73,63,10,11,1,0
133631,431,7,58,48,10,0,1,0
0,0,0,0,0,0,0,0,0
130763,1089,3,233,200,33,1,1,0
157743,1786,2,267,255,12,1,1,0
334285,1143,7,216,204,12,3,1,0
0,0,0,0,0,0,0,0,0
198123,855,4,76,67,9,21,1,0
49599,610,10,23,20,3,7,0,0
0,0,0,0,0,0,0,0,0
0,0,0,0,0,0,0,0,0
0,0,0,0,0,0,0,0,0
240434,2179,9,427,411,16,5,1,0
349661,4730,13,122,114,8,7,1,0
348522,4717,13,122,114,8,7,1,0
0,0,0,0,0,0,0,0,0
0,0,0,0,0,0,0,0,0
81294,1542,3,645,639,6,6,1,0
12354,219,2,42,42,0,0,1,0
23020,36,0,2,1,1,0,1,0
479746,1860,5,82,74,8,4,1,0
355417,2818,4,354,313,41,3,1,0
430527,1644,7,120,118,2,33,1,0
45285,294,9,46,44,2,0,0,0
147382,680,6,139,135,4,6,1,0
0,0,0,0,0,0,0,0,0
0,0,0,0,0,0,0,0,0
143441,1548,13,239,230,9,0,1,0
0,0,0,0,0,0,0,0,0
0,0,0,0,0,0,0,0,0
212785,1997,9,252,217,35,38,1,0
187099,955,4,220,212,8,9,0,0
1447402,1179,2,152,14,138,4,1,0
383342,93,0,3,3,0,0,1,0
0,0,0,0,0,0,0,0,0
37454,542,0,161,154,7,2,1,0
88783,687,9,138,125,13,3,1,0
0,0,0,0,0,0,0,0,0
0,0,0,0,0,0,0,0,0
118221,1286,8,188,178,10,0,1,0
71954,372,7,96,86,10,0,1,0
56535,369,8,24,24,0,3,1,0
72855,711,2,229,156,73,0,1,0
306612,1143,8,176,155,21,2,1,0
491550,631,9,138,124,14,4,1,0
0,0,0,0,0,0,0,0,0
515886,4411,15,771,666,105,7,1,0
0,0,0,0,0,0,0,0,0
0,0,0,0,0,0,0,0,0
0,0,0,0,0,0,0,0,0
0,0,0,0,0,0,0,0,0
0,0,0,0,0,0,0,0,0
118809,588,11,42,29,13,4,1,0
588055,2911,7,702,376,326,7,1,0
0,0,0,0,0,0,0,0,0
7171,93,5,1,0,1,3,0,0
493478,4114,7,528,519,9,12,1,0
0,0,0,0,0,0,0,0,0
71713,1405,2,176,155,21,8,1,0
7772,87,6,2,1,1,3,0,0
369049,6839,1,1158,1048,110,0,0,0
0,0,0,0,0,0,0,0,0
320908,2564,10,529,509,20,2,1,1
67678,763,11,122,120,2,5,1,0
56361,606,8,101,99,2,3,1,0
266613,1507,5,150,133,17,11,1,0
0,0,0,0,0,0,0,0,0
192789,1444,4,204,188,16,0,0,0
166792,842,3,71,47,24,15,1,0
53118,226,2,43,33,10,0,1,0
1096884,4898,17,457,441,16,16,1,0
660729,2792,14,347,334,13,14,1,0
21754,141,4,8,7,1,5,1,0
0,0,0,0,0,0,0,0,0
320739,2097,0,444,430,14,0,1,0
16538,358,1,95,85,10,0,1,0
12209,284,1,90,82,8,0,1,0
0,0,0,0,0,0,0,0,0
0,0,0,0,0,0,0,0,0
107184,800,4,119,45,74,0,1,0
256878,1993,9,484,478,6,7,1,0
80346,600,6,98,80,18,1,1,0
127943,2070,3,397,396,1,0,0,0
0,0,0,0,0,0,0,0,0
40050,686,5,123,118,5,24,1,0
0,0,0,0,0,0,0,0,0
0,0,0,0,0,0,0,0,0
0,0,0,0,0,0,0,0,0
0,0,0,0,0,0,0,0,0
0,0,0,0,0,0,0,0,0
0,0,0,0,0,0,0,0,0
101538,557,10,87,18,69,5,1,0
0,0,0,0,0,0,0,0,0
366128,3830,2,17,16,1,3,1,0
0,0,0,0,0,0,0,0,0
0,0,0,0,0,0,0,0,0
49992,480,6,116,116,0,5,1,0
25773,503,2,129,118,11,0,1,0
0,0,0,0,0,0,0,0,0
902145,2644,10,296,223,73,23,1,0
55115,487,3,130,125,5,2,1,0
37752,323,3,87,82,5,2,1,0
743204,2785,5,222,215,7,23,1,0
0,0,0,0,0,0,0,0,0
0,0,0,0,0,0,0,0,0
0,0,0,0,0,0,0,0,0
0,0,0,0,0,0,0,0,0
64283,249,1,33,31,2,7,0,0
72781,487,8,66,65,1,2,0,0
0,0,0,0,0,0,0,0,0
0,0,0,0,0,0,0,0,0
0,0,0,0,0,0,0,0,0
4353,55,0,4,0,4,0,0,0
0,0,0,0,0,0,0,0,0
0,0,0,0,0,0,0,0,0
445171,1597,10,243,99,144,118,1,0
256386,1551,5,96,92,4,3,1,0
56272,756,5,200,192,8,1,1,0
0,0,0,0,0,0,0,0,0
0,0,0,0,0,0,0,0,0
37031,488,6,128,121,7,0,1,0
277189,1604,13,286,277,9,19,1,0
142121,402,12,11,10,1,9,0,0
409114,4401,6,1539,967,572,8,1,0
9400,85,2,6,6,0,0,0,0
44961,642,2,117,104,13,6,1,0
106930,923,5,138,116,22,1,1,0
58049,621,8,100,16,84,2,1,0
173289,922,7,162,156,6,2,1,0
141681,546,6,41,35,6,0,1,0
0,0,0,0,0,0,0,0,0
215663,920,8,434,104,330,13,1,0
28062,581,6,137,129,8,9,1,0
33590,434,8,78,62,16,5,1,0
0,0,0,0,0,0,0,0,0
0,0,0,0,0,0,0,0,0
84729,963,0,61,33,28,2,1,0
1875468,1838,15,307,276,31,19,1,0
48457,357,3,32,30,2,1,1,0
0,0,0,0,0,0,0,0,0
0,0,0,0,0,0,0,0,0
124482,499,12,64,60,4,30,0,0
0,0,0,0,0,0,0,0,0
70458,543,8,103,96,7,13,1,0
47202,247,8,45,40,5,11,1,0
213257,1701,8,326,326,0,3,1,0
244146,508,2,32,23,9,0,1,0
0,0,0,0,0,0,0,0,0
42400,567,4,165,164,1,0,1,0
0,0,0,0,0,0,0,0,0
22827,292,0,84,62,22,0,1,0
205127,1157,12,208,198,10,3,1,0
0,0,0,0,0,0,0,0,0
132476,1084,1,134,116,18,1,0,0
410026,2313,5,173,165,8,119,1,0
151698,1072,0,69,65,4,1,0,0
21972,35,0,1,1,0,0,1,0
357570,3070,10,994,989,5,503,1,0
0,0,0,0,0,0,0,0,0
0,0,0,0,0,0,0,0,0
0,0,0,0,0,0,0,0,0
94470,412,6,76,74,2,1,1,0
0,0,0,0,0,0,0,0,0
0,0,0,0,0,0,0,0,0
58838,299,2,23,12,11,4,1,0
0,0,0,0,0,0,0,0,0
0,0,0,0,0,0,0,0,0
467738,367,4,79,62,17,2,1,0
33917,399,7,71,18,53,3,1,0
180853,1989,7,373,362,11,0,0,0
0,0,0,0,0,0,0,0,0
195460,967,4,117,103,14,12,1,0
0,0,0,0,0,0,0,0,0
21230,271,4,53,22,31,0,1,0
0,0,0,0,0,0,0,0,0
200122,1185,6,134,127,7,1,0,0
0,0,0,0,0,0,0,0,0
0,0,0,0,0,0,0,0,0
0,0,0,0,0,0,0,0,0
86997,810,8,248,245,3,8,1,0
5223,25,3,5,5,0,0,0,0
5357,79,1,6,6,0,0,0,0
0,0,0,0,0,0,0,0,0
447146,898,2,37,3,34,7,0,0
0,0,0,0,0,0,0,0,0
716233,5289,1,1207,1128,79,0,1,0
24335,205,0,5,5,0,0,1,0
12106,177,5,27,18,9,0,1,0
0,0,0,0,0,0,0,0,0
0,0,0,0,0,0,0,0,0
0,0,0,0,0,0,0,0,0
218163,1108,6,304,285,19,4,1,0
79339,338,8,63,61,2,0,1,0
0,0,0,0,0,0,0,0,0
110597,1345,4,221,186,35,7,1,0
186603,814,2,68,22,46,0,1,0
27622,42,0,2,1,1,0,0,0
35596,655,4,178,148,30,0,1,0
0,0,0,0,0,0,0,0,0
372140,1004,7,126,123,3,4,0,0
0,0,0,0,0,0,0,0,0
99374,1218,4,203,194,9,0,1,0
3459,43,4,3,3,0,0,1,0
122956,973,2,128,125,3,11,1,1
138271,682,10,76,72,4,10,1,0
76426,317,10,56,53,3,1,1,0
2986,18,1,0,0,0,0,0,0
412816,2460,4,296,259,37,11,0,0
276131,1574,4,237,203,34,2,0,0
317044,2038,8,194,178,16,12,1,0
19424,41,2,0,0,0,0,0,0
62873,526,10,89,67,22,0,0,0
50874,509,6,101,77,24,2,0,0
8887,137,5,51,49,2,0,0,0
0,0,0,0,0,0,0,0,0
52995,756,2,168,158,10,10,0,0
0,0,0,0,0,0,0,0,0
0,0,0,0,0,0,0,0,0
0,0,0,0,0,0,0,0,0
163625,1557,10,472,454,18,10,0,0
125790,924,9,385,370,15,4,0,0
70832,1065,7,242,208,34,0,1,1
0,0,0,0,0,0,0,0,0
636110,1973,5,167,149,18,8,1,0
47357,401,1,30,9,21,9,1,0
0,0,0,0,0,0,0,0,0
0,0,0,0,0,0,0,0,0
278465,946,8,87,86,1,5,1,0
0,0,0,0,0,0,0,0,0
0,0,0,0,0,0,0,0,0
0,0,0,0,0,0,0,0,0
0,0,0,0,0,0,0,0,0
0,0,0,0,0,0,0,0,0
0,0,0,0,0,0,0,0,0
0,0,0,0,0,0,0,0,0
44831,494,8,118,117,1,11,1,0
7166,137,2,27,27,0,2,1,0
0,0,0,0,0,0,0,0,0
106264,899,8,166,122,44,1,1,0
178875,792,8,121,110,11,9,1,0
0,0,0,0,0,0,0,0,0
80952,806,2,295,286,9,1,1,0
331787,1196,6,67,61,6,16,1,0
46884,191,6,43,43,0,7,1,0
28324,379,6,102,79,23,0,1,0
339045,1110,0,110,98,12,52,1,0
102321,803,11,154,146,8,10,0,0
3688,45,5,3,2,1,0,0,0
235491,1279,9,171,155,16,4,1,0
0,0,0,0,0,0,0,0,0
0,0,0,0,0,0,0,0,0
166992,906,7,246,238,8,4,0,0
119383,3590,3,1207,1205,2,0,1,0
15368,257,0,60,53,7,0,1,0
0,0,0,0,0,0,0,0,0
87565,1296,7,218,211,7,14,1,0
985,17,1,0,0,0,0,0,0
0,0,0,0,0,0,0,0,0
11196,134,1,11,6,5,1,1,0
0,0,0,0,0,0,0,0,0
45693,475,3,111,110,1,1,1,0
0,0,0,0,0,0,0,0,0
174547,913,4,118,92,26,1,1,0
0,0,0,0,0,0,0,0,0
261380,404,5,48,43,5,1,1,0
67066,510,10,108,106,2,2,1,0
6349,62,6,3,2,1,0,0,0
0,0,0,0,0,0,0,0,0
0,0,0,0,0,0,0,0,0
0,0,0,0,0,0,0,0,0
882946,2641,5,577,568,9,1,0,0
833009,2207,3,221,211,10,2,1,0
31753,248,3,22,21,1,8,1,0
0,0,0,0,0,0,0,0,0
0,0,0,0,0,0,0,0,0
21078,230,3,38,36,2,0,0,0
89290,566,4,124,120,4,2,1,0
8653,30,1,0,0,0,0,0,0
0,0,0,0,0,0,0,0,0
238247,1473,4,326,320,6,6,1,0
0,0,0,0,0,0,0,0,0
288922,4754,1,884,148,736,9,1,0
197893,958,9,141,116,25,1,0,0
7864,75,6,4,3,1,0,0,0
0,0,0,0,0,0,0,0,0
2422,60,0,7,4,3,0,0,0
453746,1617,10,285,217,68,6,1,0
56938,736,4,115,105,10,1,1,0
0,0,0,0,0,0,0,0,0
0,0,0,0,0,0,0,0,0
0,0,0,0,0,0,0,0,0
1098629,8755,5,3268,3255,13,7,1,0
0,0,0,0,0,0,0,0,0
34355,108,5,5,3,2,0,0,0
0,0,0,0,0,0,0,0,0
0,0,0,0,0,0,0,0,0
0,0,0,0,0,0,0,0,0
0,0,0,0,0,0,0,0,0
12093,362,1,92,92,0,1,1,0
0,0,0,0,0,0,0,0,0
79461,536,5,107,105,2,9,1,0
11763,190,4,61,59,2,2,1,0
0,0,0,0,0,0,0,0,0
0,0,0,0,0,0,0,0,0
364086,894,3,146,95,51,10,1,0
77233,97,1,9,6,3,2,0,0
27849,212,6,19,17,2,1,1,0
0,0,0,0,0,0,0,0,0
457132,1507,7,146,146,0,1,1,0
0,0,0,0,0,0,0,0,0
280652,1137,7,442,436,6,2,1,0
0,0,0,0,0,0,0,0,0
0,0,0,0,0,0,0,0,0
0,0,0,0,0,0,0,0,0
0,0,0,0,0,0,0,0,0
58298,797,1,149,119,30,12,1,0
0,0,0,0,0,0,0,0,0
122282,1691,5,344,321,23,3,0,0
0,0,0,0,0,0,0,0,0
0,0,0,0,0,0,0,0,0
0,0,0,0,0,0,0,0,0
11856,138,5,12,12,0,1,0,0
9586,117,5,10,10,0,1,0,0
0,0,0,0,0,0,0,0,0
245385,319,3,36,33,3,0,1,0
155960,748,0,97,82,15,5,1,0
0,0,0,0,0,0,0,0,0
0,0,0,0,0,0,0,0,0
175283,1448,7,360,353,7,2,1,0
61246,649,8,117,102,15,3,1,0
42537,382,10,81,79,2,2,1,0
542590,2004,6,356,337,19,49,1,0
198483,1170,12,232,223,9,15,0,0
3738,75,2,8,8,0,0,1,0
0,0,0,0,0,0,0,0,0
0,0,0,0,0,0,0,0,0
13085,186,3,32,32,0,0,0,0
806139,3714,5,765,697,68,29,1,0
0,0,0,0,0,0,0,0,0
131143,1514,9,100,94,6,4,0,0
168466,992,9,244,237,7,16,1,0
0,0,0,0,0,0,0,0,0
0,0,0,0,0,0,0,0,0
97703,380,8,44,31,13,1,1,0
0,0,0,0,0,0,0,0,0
0,0,0,0,0,0,0,0,0
0,0,0,0,0,0,0,0,0
703468,1575,6,253,231,22,3,1,0
0,0,0,0,0,0,0,0,0
0,0,0,0,0,0,0,0,0
0,0,0,0,0,0,0,0,0
848352,4300,7,611,604,7,10,1,0
0,0,0,0,0,0,0,0,0
611,10,0,1,0,1,0,0,0
12390,150,3,21,15,6,0,0,0
0,0,0,0,0,0,0,0,0
159883,1693,8,282,246,36,11,1,0
79891,511,8,67,49,18,10,1,0
0,0,0,0,0,0,0,0,0
0,0,0,0,0,0,0,0,0
91818,665,6,126,121,5,3,1,0
37384,171,6,22,17,5,1,1,0
0,0,0,0,0,0,0,0,0
27955,42,0,2,1,1,0,0,0
2650312,13879,13,2737,2462,275,207,1,0
1417911,6458,13,2311,2236,75,12,1,0
0,0,0,0,0,0,0,0,0
95597,1097,2,461,402,59,0,0,0
35125,339,3,44,37,7,0,1,0
0,0,0,0,0,0,0,0,0
891461,4497,2,403,372,31,7,1,0
198439,641,15,73,69,4,3,1,0
0,0,0,0,0,0,0,0,0
106300,1485,6,335,192,143,43,1,0
95080,44,2,4,0,4,0,1,0
0,0,0,0,0,0,0,0,0
343484,1685,12,163,123,40,0,1,0
3268652,4525,8,392,378,14,32,1,0
1204517,959,11,87,82,5,74,1,0
1254883,1062,0,40,16,24,4,1,0
66388,245,0,46,39,7,0,1,1
107246,3027,2,1062,1060,2,0,1,0
0,0,0,0,0,0,0,0,0
617828,3945,5,87,83,4,126,1,0
5891,58,1,4,4,0,0,0,0
0,0,0,0,0,0,0,0,0
25234,231,0,88,88,0,2,1,0
0,0,0,0,0,0,0,0,0
0,0,0,0,0,0,0,0,0
196638,1767,12,358,197,161,58,1,0
0,0,0,0,0,0,0,0,0
0,0,0,0,0,0,0,0,0
154039,1643,6,325,232,93,2,1,0
0,0,0,0,0,0,0,0,0
0,0,0,0,0,0,0,0,0
144193,1924,2,366,304,62,4,1,0
44316,723,2,81,49,32,1,1,0
13851,109,1,12,11,1,3,0,0
0,0,0,0,0,0,0,0,0
237567,1718,8,83,78,5,1,1,0
21950,355,2,52,46,6,5,1,0
0,0,0,0,0,0,0,0,0
0,0,0,0,0,0,0,0,0
104950,358,7,47,36,11,0,1,0
41808,240,6,36,27,9,0,1,0
0,0,0,0,0,0,0,0,0
21946,35,0,1,1,0,0,1,0
241375,931,12,46,39,7,0,1,0
59922,621,9,142,136,6,0,0,0
13762,233,9,59,53,6,0,0,0
8717,80,1,32,31,1,0,1,0
0,0,0,0,0,0,0,0,0
365995,410,4,51,42,9,1,1,0
0,0,0,0,0,0,0,0,0
69747,679,3,97,94,3,7,1,0
0,0,0,0,0,0,0,0,0
55176,677,4,177,175,2,6,1,0
12530,87,2,4,4,0,0,1,0
0,0,0,0,0,0,0,0,0
1660210,1132,6,97,89,8,8,1,0
0,0,0,0,0,0,0,0,0
0,0,0,0,0,0,0,0,0
4481,119,0,5,5,0,0,1,0
0,0,0,0,0,0,0,0,0
0,0,0,0,0,0,0,0,0
187732,920,3,138,131,7,7,1,0
0,0,0,0,0,0,0,0,0
0,0,0,0,0,0,0,0,0
135111,1007,12,226,216,10,11,1,0
16664,31,0,1,1,0,0,1,0
0,0,0,0,0,0,0,0,0
85627,991,13,203,190,13,9,1,0
0,0,0,0,0,0,0,0,0
0,0,0,0,0,0,0,0,0
0,0,0,0,0,0,0,0,0
0,0,0,0,0,0,0,0,0
237020,1818,2,218,215,3,8,1,0
58662,486,5,130,109,21,1,1,0
115565,1595,7,312,306,6,2,1,0
19404,357,9,69,67,2,2,1,0
17127,274,10,64,63,1,4,1,0
43635,242,7,30,21,9,0,1,0
780055,1536,2,140,126,14,0,1,0
24342,331,5,48,32,16,1,0,0
192061,1563,6,347,317,30,17,0,0
194422,1568,6,347,317,30,17,0,0
411098,3824,6,298,297,1,1,1,0
132700,952,6,83,82,1,0,1,0
0,0,0,0,0,0,0,0,0
122327,727,7,118,110,8,36,1,0
122293,727,7,118,111,7,36,1,0
0,0,0,0,0,0,0,0,0
40871,245,6,32,16,16,3,1,0
0,0,0,0,0,0,0,0,0
42930,336,2,57,0,57,9,0,0
217493,2668,8,394,363,31,0,0,0
92950,896,6,147,130,17,5,1,0
52293,504,5,65,54,11,7,1,0
93589,529,6,103,93,10,0,1,0
0,0,0,0,0,0,0,0,0
0,0,0,0,0,0,0,0,0
89264,978,8,199,198,1,8,0,0
173070,556,9,64,60,4,31,0,0
10475,123,2,17,6,11,1,1,0
381184,1147,8,108,99,9,2,1,0
0,0,0,0,0,0,0,0,0
0,0,0,0,0,0,0,0,0
0,0,0,0,0,0,0,0,0
83195,587,7,116,108,8,4,1,0
38826,318,7,89,85,4,3,1,0
0,0,0,0,0,0,0,0,0
167606,1015,1,273,265,8,0,0,0
104191,550,6,105,99,6,8,1,0
0,0,0,0,0,0,0,0,0
84550,1011,11,237,229,8,9,1,0
60964,791,11,178,172,6,9,1,0
151900,1109,9,178,161,17,2,1,0
0,0,0,0,0,0,0,0,0
0,0,0,0,0,0,0,0,0
0,0,0,0,0,0,0,0,0
70047,490,12,107,101,6,6,0,0
23832,176,3,38,38,0,2,1,0
0,0,0,0,0,0,0,0,0
184759,2950,8,584,580,4,20,1,0
71468,1266,6,430,424,6,16,1,0
331017,4583,12,892,675,217,7,1,0
290570,4845,6,1431,1240,191,5,0,0
139651,4311,7,1553,1540,13,6,0,0
677785,3514,6,773,765,8,13,1,0
470644,682,4,223,215,8,11,1,0
0,0,0,0,0,0,0,0,0
0,0,0,0,0,0,0,0,0
0,0,0,0,0,0,0,0,0
0,0,0,0,0,0,0,0,0
0,0,0,0,0,0,0,0,0
301002,2811,13,309,302,7,11,1,0
0,0,0,0,0,0,0,0,0
33681,518,2,110,107,3,1,0,0
117199,1400,7,438,418,20,2,1,0
0,0,0,0,0,0,0,0,0
119343,1388,2,30,19,11,3,1,0
307393,2111,9,354,325,29,109,1,0
229298,886,8,143,135,8,5,1,0
192048,1507,12,373,30,343,10,1,0
153033,2330,10,146,133,13,3,1,0
23281,286,1,6,4,2,0,1,0
182653,608,10,76,53,23,15,0,0
0,0,0,0,0,0,0,0,0
135404,1707,14,258,249,9,6,0,0
0,0,0,0,0,0,0,0,0
325348,2700,12,515,486,29,32,1,0
0,0,0,0,0,0,0,0,0
0,0,0,0,0,0,0,0,0
354611,5991,2,709,709,0,0,1,0
0,0,0,0,0,0,0,0,0
86761,221,8,11,10,1,0,1,0
57429,467,10,162,162,0,0,1,0
0,0,0,0,0,0,0,0,0
20355,438,4,153,142,11,0,1,0
0,0,0,0,0,0,0,0,0
0,0,0,0,0,0,0,0,0
30421,269,7,29,22,7,1,1,0
14517,74,8,1,1,0,1,0,0
0,0,0,0,0,0,0,0,0
133911,532,4,94,93,1,1,0,0
0,0,0,0,0,0,0,0,0
0,0,0,0,0,0,0,0,0
0,0,0,0,0,0,0,0,0
0,0,0,0,0,0,0,0,0
32108,359,5,68,60,8,2,1,0
223233,1765,11,238,207,31,0,1,0
6098,70,0,5,0,5,1,0,0
0,0,0,0,0,0,0,0,0
0,0,0,0,0,0,0,0,0
142262,1689,6,422,420,2,3,1,0
0,0,0,0,0,0,0,0,0
0,0,0,0,0,0,0,0,0
509413,2196,10,178,105,73,21,1,0
65306,677,0,83,77,6,4,1,0
27876,42,0,2,1,1,0,0,0
407547,1474,14,218,189,29,3,1,0
1634,11,0,1,1,0,0,0,0
0,0,0,0,0,0,0,0,0
0,0,0,0,0,0,0,0,0
0,0,0,0,0,0,0,0,0
0,0,0,0,0,0,0,0,0
0,0,0,0,0,0,0,0,0
0,0,0,0,0,0,0,0,0
428573,1676,8,219,205,14,4,1,0
0,0,0,0,0,0,0,0,0
0,0,0,0,0,0,0,0,0
0,0,0,0,0,0,0,0,0
0,0,0,0,0,0,0,0,0
2015,39,0,11,6,5,0,1,0
540914,2209,17,257,233,24,28,1,0
221355,1059,14,148,130,18,9,1,0
0,0,0,0,0,0,0,0,0
11482,109,5,20,17,3,0,0,0
192609,1639,8,292,279,13,11,1,0
0,0,0,0,0,0,0,0,0
174372,275,7,38,37,1,7,1,0
144707,1753,6,135,130,5,9,1,0
15583,99,7,2,2,0,3,1,0
0,0,0,0,0,0,0,0,0
0,0,0,0,0,0,0,0,0
0,0,0,0,0,0,0,0,0
0,0,0,0,0,0,0,0,0
311451,1362,11,222,215,7,11,1,0
105948,1141,6,322,296,26,3,0,0
0,0,0,0,0,0,0,0,0
0,0,0,0,0,0,0,0,0
0,0,0,0,0,0,0,0,0
174322,1295,7,129,128,1,3,1,0
25235,153,2,5,2,3,2,0,0
125919,627,13,21,18,3,4,1,0
0,0,0,0,0,0,0,0,0
15249,198,4,33,32,1,1,1,0
4287,73,0,5,4,1,0,0,0
6067,131,0,5,4,1,2,0,0
416212,1360,10,102,55,47,36,0,0
0,0,0,0,0,0,0,0,0
0,0,0,0,0,0,0,0,0
0,0,0,0,0,0,0,0,0
0,0,0,0,0,0,0,0,0
0,0,0,0,0,0,0,0,0
0,0,0,0,0,0,0,0,0
137358,1949,3,353,350,3,6,1,0
0,0,0,0,0,0,0,0,0
6938,124,2,19,19,0,0,0,0
0,0,0,0,0,0,0,0,0
0,0,0,0,0,0,0,0,0
34486,396,7,145,145,0,0,1,0
106588,674,6,92,6,86,0,1,0
0,0,0,0,0,0,0,0,0
40053,449,10,73,67,6,2,1,0
376032,1802,5,212,189,23,3,1,0
376032,1802,5,212,193,19,3,1,0
0,0,0,0,0,0,0,0,0
0,0,0,0,0,0,0,0,0
0,0,0,0,0,0,0,0,0
0,0,0,0,0,0,0,0,0
105695,804,8,108,94,14,6,0,0
48191,461,8,29,25,4,1,1,0
0,0,0,0,0,0,0,0,0
146795,1120,0,136,117,19,2,0,0
222127,2524,4,560,408,152,9,0,0
0,0,0,0,0,0,0,0,0
0,0,0,0,0,0,0,0,0
110109,679,4,7,6,1,0,0,0
23038,40,0,3,1,2,0,1,0
67324,395,8,125,108,17,3,1,0
0,0,0,0,0,0,0,0,0
36743,144,1,21,9,12,3,1,0
257315,743,1,153,124,29,0,1,0
207150,61,1,1,1,0,1,1,0
0,0,0,0,0,0,0,0,0
4704,74,2,12,12,0,0,0,0
0,0,0,0,0,0,0,0,0
0,0,0,0,0,0,0,0,0
73707,1035,4,180,162,18,1,1,0
867401,924,8,200,182,18,3,1,0
0,0,0,0,0,0,0,0,0
197320,1680,4,368,332,36,0,1,0
64906,562,6,115,113,2,23,1,0
108496,415,4,45,45,0,10,1,0
210504,1302,4,120,113,7,0,1,0
114761,361,7,40,25,15,5,1,0
0,0,0,0,0,0,0,0,0
89065,67,0,9,4,5,5,0,0
48245,422,7,59,45,14,4,1,0
98610,759,8,113,103,10,0,1,0
7096,146,1,48,24,24,0,1,0
128713,1046,15,202,139,63,11,1,0
0,0,0,0,0,0,0,0,0
166016,1205,9,191,180,11,33,1,0
167981,1214,9,191,180,11,33,1,0
0,0,0,0,0,0,0,0,0
25313,40,0,3,2,1,0,1,0
284409,2675,8,321,299,22,24,1,0
0,0,0,0,0,0,0,0,0
245605,2292,16,770,743,27,10,1,0
216815,2260,12,666,653,13,9,1,0
0,0,0,0,0,0,0,0,0
0,0,0,0,0,0,0,0,0
0,0,0,0,0,0,0,0,0
23529,38,0,2,1,1,0,1,0
169988,2056,10,617,595,22,2,1,0
173224,2297,11,510,463,47,1,1,0
79933,1037,6,188,160,28,20,1,0
42570,575,6,87,61,26,0,1,0
106528,1315,9,303,271,32,4,1,0
318920,526,4,108,93,15,0,1,0
0,0,0,0,0,0,0,0,0
0,0,0,0,0,0,0,0,0
169976,475,8,17,11,6,0,0,0
0,0,0,0,0,0,0,0,0
138037,808,4,124,113,11,3,1,0
0,0,0,0,0,0,0,0,0
68079,363,6,45,19,26,5,1,0
204426,1131,6,250,183,67,7,1,0
0,0,0,0,0,0,0,0,0
0,0,0,0,0,0,0,0,0
0,0,0,0,0,0,0,0,0
290705,3067,12,449,367,82,16,1,0
0,0,0,0,0,0,0,0,0
319254,3092,11,593,592,1,0,1,0
332771,3113,12,577,576,1,10,1,0
179629,1209,8,199,8,191,23,1,0
0,0,0,0,0,0,0,0,0
0,0,0,0,0,0,0,0,0
63082,482,8,94,23,71,0,1,0
0,0,0,0,0,0,0,0,0
0,0,0,0,0,0,0,0,0
64637,798,5,220,6,214,5,1,0
249806,274,10,27,23,4,20,1,0
19585,254,5,34,34,0,1,1,0
14722,189,5,35,35,0,1,1,0
0,0,0,0,0,0,0,0,0
26249,494,3,110,103,7,0,0,0
10632,143,3,24,24,0,0,0,0
0,0,0,0,0,0,0,0,0
238003,1750,3,310,271,39,5,0,0
80681,905,2,294,288,6,0,1,0
17640,239,2,75,73,2,0,1,0
0,0,0,0,0,0,0,0,0
0,0,0,0,0,0,0,0,0
329160,2362,12,527,38,489,21,1,0
18955,398,3,4,2,2,2,1,0
0,0,0,0,0,0,0,0,0
88712,1494,3,342,341,1,4,1,0
468643,2026,7,159,143,16,0,1,0
28774,597,2,298,294,4,0,0,0
250632,1128,15,154,130,24,5,1,0
57343,399,0,28,17,11,0,1,0
0,0,0,0,0,0,0,0,0
4536,47,3,1,1,0,0,0,0
41605,275,1,16,15,1,7,1,0
0,0,0,0,0,0,0,0,0
185977,1185,12,90,75,15,5,1,0
239968,1285,7,156,146,10,31,0,0
36148,522,1,180,179,1,1,1,0
5595,67,1,8,8,0,1,1,0
642941,1873,7,83,82,1,10,1,0
265120,1300,9,259,246,13,17,1,0
18439,299,1,33,29,4,0,0,0
59035,688,5,140,127,13,8,1,0
0,0,0,0,0,0,0,0,0
0,0,0,0,0,0,0,0,0
9532,78,3,7,0,7,2,0,0
0,0,0,0,0,0,0,0,0
0,0,0,0,0,0,0,0,0
422716,2699,8,297,276,21,9,1,0
58294,130,5,3,1,2,3,0,0
36385,168,8,6,6,0,8,0,0
9342,57,0,12,6,6,0,0,0
99829,745,5,132,27,105,1,1,0
0,0,0,0,0,0,0,0,0
71489,1378,1,267,266,1,1,1,0
0,0,0,0,0,0,0,0,0
167433,1015,3,50,50,0,80,1,0
174878,762,18,67,58,9,4,1,0
235616,1506,8,298,276,22,9,1,0
46429,779,2,171,140,31,0,1,0
84942,1118,5,158,155,3,2,1,0
27486,257,4,26,23,3,2,1,0
0,0,0,0,0,0,0,0,0
0,0,0,0,0,0,0,0,0
86221,972,2,241,239,2,1,1,0
0,0,0,0,0,0,0,0,0
645336,1290,10,171,152,19,22,1,0
0,0,0,0,0,0,0,0,0
0,0,0,0,0,0,0,0,0
22297,33,0,1,1,0,0,1,0
96916,817,12,55,39,16,5,1,0
163054,477,8,66,38,28,1,0,0
0,0,0,0,0,0,0,0,0
0,0,0,0,0,0,0,0,0
483785,901,13,157,142,15,9,0,0
5326,88,4,15,15,0,0,0,0
13344,253,1,27,24,3,0,0,0
0,0,0,0,0,0,0,0,0
222227,1386,10,238,222,16,1,1,0
0,0,0,0,0,0,0,0,0
238747,616,2,62,48,14,45,1,0
131681,941,6,91,80,11,8,1,0
75185,430,8,53,45,8,9,1,0
417455,4545,6,431,412,19,4,1,0
75166,593,11,127,122,5,9,1,0
307940,615,7,106,79,27,1,1,0
3181,39,0,6,2,4,0,1,0
180797,1508,8,168,164,4,33,1,0
72793,534,8,77,73,4,2,1,0
10461,215,2,18,12,6,0,0,0
0,0,0,0,0,0,0,0,0
128276,800,9,170,4,166,1,1,0
0,0,0,0,0,0,0,0,0
776657,3616,6,415,378,37,11,1,0
177943,1762,3,237,202,35,11,1,0
67961,134,1,5,5,0,5,0,0
0,0,0,0,0,0,0,0,0
221174,1190,12,52,48,4,13,1,0
8122,73,2,10,7,3,0,0,0
114460,614,8,72,71,1,7,1,0
83975,1103,3,121,121,0,4,0,0
36961,600,0,62,60,2,1,0,0
184937,1016,10,193,174,19,13,1,0
154677,820,10,178,161,17,12,1,0
237319,2833,8,399,380,19,8,1,0
0,0,0,0,0,0,0,0,0
23319,209,4,21,19,2,1,1,0
0,0,0,0,0,0,0,0,0
373247,2130,16,245,240,5,14,1,0
32582,208,5,2,2,0,6,0,0
151517,693,5,136,131,5,1,1,0
23962,181,0,20,20,0,0,0,0
0,0,0,0,0,0,0,0,0
1669834,5525,6,274,262,12,3,1,0
266816,2195,4,80,76,4,2,1,0
0,0,0,0,0,0,0,0,0
211266,1647,7,384,265,119,3,1,0
446771,5224,3,1163,1108,55,16,1,0
121595,213,6,8,7,1,4,1,0
0,0,0,0,0,0,0,0,0
151929,711,11,73,73,0,5,0,0
28229,554,3,178,176,2,0,1,0
0,0,0,0,0,0,0,0,0
428828,729,3,103,83,20,2,1,0
0,0,0,0,0,0,0,0,0
0,0,0,0,0,0,0,0,0
421521,3314,16,835,806,29,2,1,0
370021,2774,16,809,788,21,3,1,0
207397,650,12,77,75,2,25,1,0
0,0,0,0,0,0,0,0,0
0,0,0,0,0,0,0,0,0
13606,378,0,67,67,0,0,1,0
184794,1391,8,681,681,0,7,1,0
213273,911,3,111,109,2,0,1,0
34320,218,11,9,5,4,1,1,0
0,0,0,0,0,0,0,0,0
0,0,0,0,0,0,0,0,0
144926,1689,6,353,342,11,0,1,0
0,0,0,0,0,0,0,0,0
0,0,0,0,0,0,0,0,0
0,0,0,0,0,0,0,0,0
263528,2172,1,310,275,35,23,0,0
134723,1227,2,151,100,51,23,0,0
65758,394,2,113,113,0,0,1,0
7285,125,4,20,13,7,0,0,0
0,0,0,0,0,0,0,0,0
119556,1711,10,304,303,1,0,0,0
56344,628,9,173,172,1,4,0,0
205155,13374,8,298,298,0,0,1,0
0,0,0,0,0,0,0,0,0
0,0,0,0,0,0,0,0,0
27603,42,0,2,1,1,0,0,0
41130,270,1,49,49,0,0,0,0
36199,755,5,283,280,3,0,1,0
0,0,0,0,0,0,0,0,0
319074,1999,11,281,253,28,13,1,0
532238,4263,4,765,677,88,4,0,0
190889,966,4,105,90,15,0,1,0
165688,2003,8,332,262,70,6,1,0
0,0,0,0,0,0,0,0,0
66792,738,5,164,154,10,5,1,0
0,0,0,0,0,0,0,0,0
579775,2644,1,782,683,99,14,1,0
163401,330,1,74,24,50,0,1,0
0,0,0,0,0,0,0,0,0
0,0,0,0,0,0,0,0,0
105519,711,8,142,121,21,12,1,0
232162,3295,13,484,468,16,68,1,0
0,0,0,0,0,0,0,0,0
18076,225,9,55,52,3,0,1,0
74489,550,9,111,111,0,6,1,0
27735,219,9,29,29,0,2,1,0
0,0,0,0,0,0,0,0,0
0,0,0,0,0,0,0,0,0
84771,248,6,28,26,2,6,1,0
25057,325,4,61,44,17,0,1,0
74889,738,2,47,21,26,9,1,0
0,0,0,0,0,0,0,0,0
181061,5886,2,265,194,71,32,1,0
0,0,0,0,0,0,0,0,0
0,0,0,0,0,0,0,0,0
140159,484,13,19,9,10,5,1,0
68897,541,12,140,126,14,2,1,0
0,0,0,0,0,0,0,0,0
213635,4372,2,732,725,7,31,1,0
0,0,0,0,0,0,0,0,0
100716,1061,4,98,50,48,0,1,0
0,0,0,0,0,0,0,0,0
250803,1056,6,127,112,15,23,1,0
0,0,0,0,0,0,0,0,0
5790,60,4,4,4,0,0,1,0
569956,1070,10,194,183,11,11,1,0
140835,1326,6,201,187,14,5,1,0
0,0,0,0,0,0,0,0,0
0,0,0,0,0,0,0,0,0
0,0,0,0,0,0,0,0,0
242524,1547,2,241,229,12,2,1,0
374091,3223,7,700,634,66,32,1,0
84621,482,10,33,28,5,10,0,0
83097,681,8,76,72,4,5,1,0
21854,33,0,1,1,0,0,1,0
46832,380,4,39,33,6,4,1,0
121880,401,10,40,13,27,2,1,0
0,0,0,0,0,0,0,0,0
0,0,0,0,0,0,0,0,0
0,0,0,0,0,0,0,0,0
0,0,0,0,0,0,0,0,0
0,0,0,0,0,0,0,0,0
0,0,0,0,0,0,0,0,0
0,0,0,0,0,0,0,0,0
0,0,0,0,0,0,0,0,0
124461,1093,11,294,284,10,17,1,0
28182,564,2,253,228,25,0,1,0
78112,938,2,174,148,26,2,1,0
107015,76,2,2,2,0,0,0,0
0,0,0,0,0,0,0,0,0
134049,1444,7,186,173,13,5,1,0
0,0,0,0,0,0,0,0,0
0,0,0,0,0,0,0,0,0
402333,3729,11,332,252,80,6,0,0
43886,454,3,28,27,1,5,1,0
0,0,0,0,0,0,0,0,0
0,0,0,0,0,0,0,0,0
0,0,0,0,0,0,0,0,0
127190,1661,7,293,285,8,1,1,0
12123,166,4,30,24,6,0,0,0
4785,24,0,2,2,0,0,0,0
0,0,0,0,0,0,0,0,0
33192,182,1,57,57,0,1,1,0
32576,128,1,9,9,0,1,1,0
0,0,0,0,0,0,0,0,0
442478,3252,5,525,508,17,13,1,0
0,0,0,0,0,0,0,0,0
461407,1959,3,167,143,24,3,1,0
0,0,0,0,0,0,0,0,0
0,0,0,0,0,0,0,0,0
278529,997,8,149,118,31,3,0,0
17451,107,4,5,2,3,3,0,0
0,0,0,0,0,0,0,0,0
0,0,0,0,0,0,0,0,0
0,0,0,0,0,0,0,0,0
366613,1891,10,462,442,20,11,1,0
33778,531,2,71,65,6,0,1,0
14808,187,4,14,13,1,3,1,0
0,0,0,0,0,0,0,0,0
0,0,0,0,0,0,0,0,0
179119,1383,15,82,73,9,2,1,0
92474,365,14,36,31,5,0,1,0
197507,2235,7,390,333,57,11,1,0
32127,228,8,13,13,0,10,1,0
452343,2216,10,174,168,6,3,1,0
0,0,0,0,0,0,0,0,0
52219,143,2,108,107,1,0,0,0
0,0,0,0,0,0,0,0,0
37577,396,3,34,14,20,0,0,0
0,0,0,0,0,0,0,0,0
0,0,0,0,0,0,0,0,0
0,0,0,0,0,0,0,0,0
173148,2575,5,335,306,29,2,1,0
0,0,0,0,0,0,0,0,0
527963,2814,2,4,2,2,2,1,0
51572,643,7,142,114,28,1,0,0
15181,186,7,46,40,6,1,0,0
0,0,0,0,0,0,0,0,0
0,0,0,0,0,0,0,0,0
0,0,0,0,0,0,0,0,0
155695,819,9,306,304,2,0,1,0
159157,768,9,294,292,2,1,1,0
139707,996,11,128,118,10,5,1,0
84898,202,1,10,7,3,1,1,0
126895,1826,5,208,198,10,1,1,0
0,0,0,0,0,0,0,0,0
0,0,0,0,0,0,0,0,0
244243,1944,8,571,564,7,19,1,0
310304,2838,6,220,172,48,3,1,0
136786,1683,7,354,78,276,2,0,0
0,0,0,0,0,0,0,0,0
0,0,0,0,0,0,0,0,0
0,0,0,0,0,0,0,0,0
17914,201,1,3,0,3,0,0,0
4596,53,1,6,6,0,2,1,0
22323,39,0,3,1,2,0,1,0
0,0,0,0,0,0,0,0,0
0,0,0,0,0,0,0,0,0
0,0,0,0,0,0,0,0,0
195111,919,7,157,147,10,12,1,0
195160,919,7,157,148,9,12,1,0
23619,273,1,124,122,2,0,1,0
73135,840,4,167,158,9,0,1,0
22003,194,2,28,28,0,0,0,0
4130,71,2,7,7,0,0,0,0
267392,2271,7,579,557,22,27,1,0
217076,2385,7,534,518,16,30,1,0
74858,228,4,30,2,28,0,1,0
553,9,0,1,1,0,0,0,0
391308,469,10,48,41,7,0,0,0
0,0,0,0,0,0,0,0,0
794508,1300,3,238,193,45,3,1,0
121248,154,3,7,6,1,2,0,0
102232,597,11,96,3,93,8,1,0
0,0,0,0,0,0,0,0,0
0,0,0,0,0,0,0,0,0
75254,353,11,33,33,0,2,1,0
89984,1937,7,305,300,5,1,1,0
21036,400,7,53,48,5,1,1,0
209567,1500,10,332,308,24,9,1,0
0,0,0,0,0,0,0,0,0
18640,301,5,146,144,2,0,1,0
248261,2052,1,478,471,7,7,1,0
63328,502,3,67,55,12,6,1,0
33662,430,4,118,108,10,4,1,0
54700,497,9,117,108,9,0,1,0
0,0,0,0,0,0,0,0,0
607924,7182,16,1492,1478,14,38,0,0
0,0,0,0,0,0,0,0,0
0,0,0,0,0,0,0,0,0
140907,2073,13,488,462,26,26,1,0
58898,725,13,138,128,10,22,1,0
40214,1133,2,87,83,4,7,1,0
0,0,0,0,0,0,0,0,0
110900,437,10,53,52,1,3,0,0
0,0,0,0,0,0,0,0,0
75866,574,8,64,54,10,19,0,0
35285,408,1,43,38,5,17,1,0
324827,1309,13,180,166,14,4,1,0
275520,1161,12,178,158,20,4,1,0
0,0,0,0,0,0,0,0,0
32889,597,2,124,121,3,0,1,0
0,0,0,0,0,0,0,0,0
0,0,0,0,0,0,0,0,0
111935,1574,7,462,460,2,9,1,0
0,0,0,0,0,0,0,0,0
0,0,0,0,0,0,0,0,0
71354,641,5,92,91,1,1,1,0
68484,339,6,30,27,3,1,1,0
558983,2955,8,524,264,260,3,1,0
126930,178,0,6,3,3,0,1,0
319485,1730,4,117,113,4,212,1,0
79707,172,5,6,5,1,9,0,0
823965,1426,5,89,79,10,11,1,0
25981,526,7,120,116,4,3,0,0
0,0,0,0,0,0,0,0,0
22042,35,0,1,1,0,0,1,0
0,0,0,0,0,0,0,0,0
79258,411,13,68,51,17,3,0,0
0,0,0,0,0,0,0,0,0
292251,1530,9,287,271,16,22,0,0
0,0,0,0,0,0,0,0,0
76298,706,12,43,43,0,3,1,0
839010,407,5,84,75,9,1,1,0
0,0,0,0,0,0,0,0,0
43510,62,2,0,0,0,1,0,0
0,0,0,0,0,0,0,0,0
0,0,0,0,0,0,0,0,0
164865,2313,3,414,358,56,4,1,0
0,0,0,0,0,0,0,0,0
116982,785,10,127,117,10,180,1,0
43641,645,5,106,83,23,1,1,0
1567667,16386,3,829,486,343,17,1,1
18643,222,5,24,23,1,0,1,0
10118,48,4,4,4,0,0,0,0
22530,37,0,2,1,1,0,1,0
0,0,0,0,0,0,0,0,0
0,0,0,0,0,0,0,0,0
0,0,0,0,0,0,0,0,0
0,0,0,0,0,0,0,0,0
0,0,0,0,0,0,0,0,0
65707,623,4,82,45,37,4,0,0
0,0,0,0,0,0,0,0,0
0,0,0,0,0,0,0,0,0
100690,846,3,134,119,15,6,1,0
498865,1052,6,102,86,16,8,1,0
557048,1019,8,100,90,10,12,0,0
0,0,0,0,0,0,0,0,0
0,0,0,0,0,0,0,0,0
0,0,0,0,0,0,0,0,0
33488,467,1,67,66,1,0,1,0
33488,467,1,67,67,0,0,1,0
0,0,0,0,0,0,0,0,0
516442,2877,4,341,326,15,4,1,0
210285,1793,5,222,216,6,2,1,0
184805,619,2,99,86,13,8,1,0
9165,111,1,19,17,2,1,0,0
221970,2227,7,359,332,27,1,1,0
0,0,0,0,0,0,0,0,0
0,0,0,0,0,0,0,0,0
167390,1348,3,87,78,9,3,1,0
0,0,0,0,0,0,0,0,0
0,0,0,0,0,0,0,0,0
41712,495,2,63,40,23,0,1,0
27563,486,2,132,129,3,0,0,0
6150,113,2,15,15,0,0,0,0
0,0,0,0,0,0,0,0,0
40939,284,8,44,37,7,1,1,0
6614,103,6,9,7,2,1,0,0
0,0,0,0,0,0,0,0,0
227036,2495,8,333,61,272,16,1,0
255281,746,2,76,55,21,0,1,0
43170,362,3,104,102,2,0,1,0
0,0,0,0,0,0,0,0,0
37381,305,2,43,25,18,2,1,0
11503,81,1,8,5,3,1,1,0
0,0,0,0,0,0,0,0,0
129078,1149,3,195,187,8,127,1,0
104554,808,3,184,178,6,127,1,0
0,0,0,0,0,0,0,0,0
0,0,0,0,0,0,0,0,0
0,0,0,0,0,0,0,0,0
261934,1455,16,229,216,13,4,1,0
25775,381,5,72,70,2,0,0,0
13565,201,6,26,26,0,3,0,0
0,0,0,0,0,0,0,0,0
593342,1629,10,178,163,15,2,1,0
0,0,0,0,0,0,0,0,0
9466,96,5,26,20,6,0,0,0
0,0,0,0,0,0,0,0,0
203507,634,0,45,35,10,0,1,0
14605,121,6,8,6,2,0,0,0
61696,880,1,268,243,25,0,0,0
593327,2282,5,314,300,14,23,1,0
73351,524,10,65,60,5,3,1,0
0,0,0,0,0,0,0,0,0
0,0,0,0,0,0,0,0,0
111724,1156,7,313,299,14,7,1,0
217026,998,9,119,114,5,11,1,0
0,0,0,0,0,0,0,0,0
189972,966,10,156,145,11,5,1,0
0,0,0,0,0,0,0,0,0
67980,361,6,63,63,0,0,1,0
0,0,0,0,0,0,0,0,0
119348,467,11,99,99,0,8,1,0
0,0,0,0,0,0,0,0,0
180294,1135,9,183,177,6,7,1,0
126635,267,9,6,1,5,3,0,0
284444,2350,5,264,262,2,10,1,0
238263,1421,3,234,222,12,1,1,0
0,0,0,0,0,0,0,0,0
196106,2296,6,313,285,28,0,1,0
634113,2880,5,429,368,61,12,1,0
164110,1071,5,168,132,36,6,0,0
403874,868,10,51,36,15,5,0,0
211374,2671,12,339,328,11,2,1,0
25042,526,7,21,18,3,1,1,0
27170,382,3,42,38,4,1,1,0
60638,579,9,116,43,73,0,1,0
135608,935,11,198,161,37,2,1,0
51629,406,10,35,31,4,4,1,0
87521,254,11,4,4,0,4,1,0
0,0,0,0,0,0,0,0,0
0,0,0,0,0,0,0,0,0
0,0,0,0,0,0,0,0,0
144980,1379,13,345,341,4,4,1,0
0,0,0,0,0,0,0,0,0
0,0,0,0,0,0,0,0,0
300236,1897,9,410,38,372,16,1,0
463294,1617,8,330,301,29,11,1,0
41449,533,5,132,132,0,1,1,0
639099,3257,11,256,252,4,8,1,0
0,0,0,0,0,0,0,0,0
0,0,0,0,0,0,0,0,0
0,0,0,0,0,0,0,0,0
0,0,0,0,0,0,0,0,0
48390,533,5,27,16,11,0,1,0
0,0,0,0,0,0,0,0,0
0,0,0,0,0,0,0,0,0
23594,128,2,4,2,2,1,0,0
29428,206,2,7,2,5,1,0,0
0,0,0,0,0,0,0,0,0
85321,464,11,116,83,33,1,1,0
0,0,0,0,0,0,0,0,0
0,0,0,0,0,0,0,0,0
13203,118,2,13,11,2,1,1,0
8716,98,2,13,11,2,1,1,0
2842279,4399,3,150,122,28,0,1,0
17048,336,3,93,81,12,0,1,0
11096,243,2,70,60,10,0,1,0
0,0,0,0,0,0,0,0,0
0,0,0,0,0,0,0,0,0
70950,541,10,59,56,3,6,1,0
2702,54,0,12,6,6,0,0,0
0,0,0,0,0,0,0,0,0
75873,722,7,90,82,8,0,1,0
13817,150,6,22,15,7,0,1,0
487696,880,3,111,43,68,2,1,0
0,0,0,0,0,0,0,0,0
622164,1566,4,236,210,26,2,1,0
124136,691,16,79,64,15,2,1,0
10456,83,8,6,5,1,0,0,0
37217,478,0,27,27,0,1,1,0
0,0,0,0,0,0,0,0,0
97103,1350,2,155,132,23,3,0,0
42494,460,2,80,74,6,1,0,0
0,0,0,0,0,0,0,0,0
0,0,0,0,0,0,0,0,0
0,0,0,0,0,0,0,0,0
0,0,0,0,0,0,0,0,0
0,0,0,0,0,0,0,0,0
0,0,0,0,0,0,0,0,0
28425,45,0,4,1,3,0,0,0
0,0,0,0,0,0,0,0,0
0,0,0,0,0,0,0,0,0
72411,530,4,148,143,5,15,1,0
101991,786,9,210,198,12,12,1,0
0,0,0,0,0,0,0,0,0
6865,104,3,17,16,1,2,0,0
5929,100,3,15,14,1,2,0,0
26890,255,6,30,24,6,0,0,1
255647,555,1,45,1,44,0,0,0
23281,286,1,6,4,2,0,1,0
0,0,0,0,0,0,0,0,0
0,0,0,0,0,0,0,0,0
52865,373,2,50,48,2,4,1,0
126163,1030,4,192,129,63,15,0,0
0,0,0,0,0,0,0,0,0
88132,2020,2,767,761,6,8,1,0
73290,996,3,92,66,26,33,0,0
0,0,0,0,0,0,0,0,0
0,0,0,0,0,0,0,0,0
109716,893,11,158,144,14,2,1,0
74636,205,6,13,10,3,6,1,0
0,0,0,0,0,0,0,0,0
0,0,0,0,0,0,0,0,0
0,0,0,0,0,0,0,0,0
114361,1478,5,306,296,10,0,1,0
14543,242,0,57,36,21,0,1,0
0,0,0,0,0,0,0,0,0
0,0,0,0,0,0,0,0,0
0,0,0,0,0,0,0,0,0
0,0,0,0,0,0,0,0,0
44349,596,5,242,233,9,1,1,0
13857,196,4,46,35,11,1,1,0
23716,217,5,30,25,5,1,1,0
0,0,0,0,0,0,0,0,0
52414,92,3,8,6,2,0,0,0
0,0,0,0,0,0,0,0,0
1080952,1855,8,68,61,7,1,1,0
0,0,0,0,0,0,0,0,0
5553,99,0,24,24,0,0,1,0
25495,355,0,74,70,4,1,1,0
12028,173,2,32,29,3,3,1,0
0,0,0,0,0,0,0,0,0
0,0,0,0,0,0,0,0,0
0,0,0,0,0,0,0,0,0
83375,551,7,141,129,12,1,1,0
0,0,0,0,0,0,0,0,0
479941,2966,3,495,475,20,4,1,0
170254,1288,5,206,196,10,20,0,0
33061,734,3,243,239,4,3,1,0
144948,1371,9,192,178,14,18,1,0
970129,2545,1,361,357,4,32,1,0
152438,938,2,222,218,4,23,1,0
0,0,0,0,0,0,0,0,0
66553,207,1,25,17,8,9,0,0
5014,46,3,4,2,2,0,0,0
0,0,0,0,0,0,0,0,0
0,0,0,0,0,0,0,0,0
0,0,0,0,0,0,0,0,0
250391,1820,11,506,423,83,17,0,0
0,0,0,0,0,0,0,0,0
0,0,0,0,0,0,0,0,0
179783,1506,5,421,414,7,5,1,0
0,0,0,0,0,0,0,0,0
0,0,0,0,0,0,0,0,0
17046,285,0,18,15,3,1,1,0
303643,2811,12,632,615,17,45,0,0
146264,116,6,4,4,0,0,0,0
0,0,0,0,0,0,0,0,0
37702,471,9,74,58,16,4,0,0
190076,1520,10,335,171,164,9,1,0
0,0,0,0,0,0,0,0,0
287166,1999,7,177,145,32,25,1,0
46944,263,1,12,12,0,39,0,0
71255,601,6,51,1,50,1,1,0
0,0,0,0,0,0,0,0,0
11726,212,4,58,58,0,1,1,0
7733,88,4,9,9,0,1,1,0
237384,1517,13,229,170,59,9,1,0
503493,1211,0,111,106,5,7,1,0
90878,80,4,3,3,0,2,0,0
57730,468,5,63,59,4,1,1,0
43820,413,11,45,37,8,0,1,0
89838,2041,2,801,800,1,0,1,0
0,0,0,0,0,0,0,0,0
0,0,0,0,0,0,0,0,0
54994,662,8,64,60,4,0,1,0
103996,358,8,44,29,15,3,1,0
60699,435,2,91,89,2,0,1,0
0,0,0,0,0,0,0,0,0
0,0,0,0,0,0,0,0,0
226052,418,4,73,68,5,6,1,0
1006754,1609,11,414,388,26,3,0,0
0,0,0,0,0,0,0,0,0
276507,840,8,109,102,7,4,0,0
0,0,0,0,0,0,0,0,0
101069,880,8,133,128,5,0,1,0
15863,139,6,3,2,1,11,0,0
85791,1161,10,177,168,9,5,1,0
0,0,0,0,0,0,0,0,0
116530,1747,6,254,197,57,7,1,0
104440,913,5,284,281,3,121,1,0
234488,1149,11,134,119,15,6,1,0
49748,380,5,34,34,0,13,1,0
87898,1240,9,169,165,4,13,1,0
45203,1038,5,230,223,7,0,1,0
0,0,0,0,0,0,0,0,0
198967,1072,8,151,143,8,5,1,0
51021,202,3,28,28,0,3,1,0
67852,502,7,57,55,2,0,1,0
48669,361,4,57,47,10,0,1,0
76358,901,3,233,224,9,4,1,0
0,0,0,0,0,0,0,0,0
91257,700,3,173,132,41,22,1,0
47137,515,3,110,103,7,2,1,0
4675,45,0,1,1,0,0,0,0
179331,2080,3,372,336,36,1,1,0
0,0,0,0,0,0,0,0,0
48654,512,0,150,150,0,8,1,0
0,0,0,0,0,0,0,0,0
94421,711,11,52,34,18,0,1,0
4640,76,0,3,2,1,0,0,0
0,0,0,0,0,0,0,0,0
0,0,0,0,0,0,0,0,0
0,0,0,0,0,0,0,0,0
19381,218,8,24,24,0,4,1,0
581498,2748,10,88,68,20,3,1,0
71899,971,4,171,146,25,73,1,0
0,0,0,0,0,0,0,0,0
149240,990,3,81,55,26,13,1,0
149098,989,3,81,55,26,13,1,0
102856,649,2,179,0,179,0,0,0
0,0,0,0,0,0,0,0,0
174017,1148,9,128,104,24,11,1,0
23593,203,3,39,33,6,0,1,0
0,0,0,0,0,0,0,0,0
0,0,0,0,0,0,0,0,0
5663,85,2,19,19,0,0,0,0
75263,496,4,113,85,28,2,1,0
109752,1755,3,109,101,8,4,1,0
67394,1093,3,52,44,8,6,1,0
149715,958,14,175,162,13,12,0,0
66738,547,9,136,120,16,0,1,0
8536,68,6,3,2,1,0,0,0
0,0,0,0,0,0,0,0,0
0,0,0,0,0,0,0,0,0
0,0,0,0,0,0,0,0,0
0,0,0,0,0,0,0,0,0
97400,646,3,41,27,14,6,1,0
52975,402,2,39,35,4,0,1,0
297140,1270,8,214,197,17,39,1,0
301950,1389,2,106,102,4,0,1,0
0,0,0,0,0,0,0,0,0
0,0,0,0,0,0,0,0,0
0,0,0,0,0,0,0,0,0
6113,147,0,65,65,0,0,0,0
175020,1579,11,316,305,11,12,1,0
505570,1059,7,99,84,15,19,1,0
0,0,0,0,0,0,0,0,0
18703,86,7,9,9,0,0,0,0
22040,224,8,51,46,5,2,1,0
498080,747,5,10,8,2,1,1,0
0,0,0,0,0,0,0,0,0
0,0,0,0,0,0,0,0,0
83037,591,5,50,46,4,9,0,0
0,0,0,0,0,0,0,0,0
0,0,0,0,0,0,0,0,0
0,0,0,0,0,0,0,0,0
110569,807,1,122,115,7,16,1,0
32773,118,2,16,10,6,4,1,0
149941,2119,12,334,302,32,24,0,0
53327,504,11,114,96,18,6,0,0
0,0,0,0,0,0,0,0,0
404900,4864,6,335,324,11,49,1,0
392521,4857,6,282,268,14,38,1,0
394965,6161,5,585,560,25,465,1,0
227269,1297,1,329,323,6,16,1,0
0,0,0,0,0,0,0,0,0
0,0,0,0,0,0,0,0,0
0,0,0,0,0,0,0,0,0
371022,7723,7,1986,1972,14,14,0,0
217689,1855,14,243,233,10,6,1,0
0,0,0,0,0,0,0,0,0
0,0,0,0,0,0,0,0,0
1132,14,1,0,0,0,0,0,0
99159,1232,10,391,386,5,6,1,0
47231,710,8,189,184,5,6,1,0
0,0,0,0,0,0,0,0,0
150343,1969,8,252,220,32,4,0,0
344275,4763,6,975,958,17,5,1,0
128276,705,6,131,125,6,4,1,0
0,0,0,0,0,0,0,0,0
208573,1203,10,204,170,34,4,1,0
1043498,1639,7,230,208,22,3,1,0
0,0,0,0,0,0,0,0,0
57817,573,1,112,89,23,0,1,0
16315,207,1,38,32,6,0,1,0
236511,2146,3,715,711,4,1,1,0
32484,93,1,0,0,0,0,0,0
0,0,0,0,0,0,0,0,0
137719,808,7,115,100,15,0,1,0
58605,764,3,146,120,26,2,1,0
22791,285,4,74,70,4,0,1,0
19494,286,12,31,30,1,7,1,0
0,0,0,0,0,0,0,0,0
34939,248,5,47,4,43,5,1,0
32587,229,5,45,22,23,5,1,0
0,0,0,0,0,0,0,0,0
295134,2131,15,403,398,5,7,1,0
295578,2134,15,403,398,5,7,1,0
0,0,0,0,0,0,0,0,0
92430,1041,2,60,33,27,2,1,0
313196,2397,18,373,352,21,15,1,0
207999,1476,16,211,190,21,17,1,0
181654,836,9,135,126,9,10,1,0
0,0,0,0,0,0,0,0,0
60958,466,14,53,38,15,1,1,0
0,0,0,0,0,0,0,0,0
218463,489,8,26,20,6,7,1,0
0,0,0,0,0,0,0,0,0
0,0,0,0,0,0,0,0,0
446576,1735,10,335,290,45,17,1,0
0,0,0,0,0,0,0,0,0
33029,154,8,10,6,4,3,1,0
54098,730,4,176,176,0,1,1,0
1826,40,0,1,1,0,0,0,0
293970,769,12,98,95,3,1,1,0
423720,1449,3,128,117,11,2,0,0
38875,102,1,5,5,0,1,0,0
311240,2078,9,438,402,36,12,1,0
244586,1678,13,245,232,13,3,1,0
0,0,0,0,0,0,0,0,0
0,0,0,0,0,0,0,0,0
397170,983,10,135,124,11,1,1,0
42658,432,4,92,90,2,7,1,0
22062,35,0,1,1,0,0,1,0
1906143,1871,13,503,404,99,30,1,0
0,0,0,0,0,0,0,0,0
507991,1578,11,252,245,7,0,1,0
57868,1412,3,303,296,7,0,1,0
368616,1587,4,140,95,45,4,1,0
38643,285,2,48,32,16,0,1,0
22178,195,2,31,25,6,0,1,0
0,0,0,0,0,0,0,0,0
71918,649,5,131,126,5,1,1,0
0,0,0,0,0,0,0,0,0
0,0,0,0,0,0,0,0,0
58146,505,1,111,110,1,2,1,0
52952,383,1,97,96,1,2,1,0
0,0,0,0,0,0,0,0,0
0,0,0,0,0,0,0,0,0
114293,645,12,59,55,4,3,0,0
19477,217,8,53,51,2,0,0,0
287046,4072,7,1598,1285,313,3,1,0
0,0,0,0,0,0,0,0,0
224474,1903,10,152,116,36,8,1,0
0,0,0,0,0,0,0,0,0
127738,3063,1,933,916,17,0,1,0
450705,1046,12,148,128,20,8,1,0
63944,1104,2,280,268,12,6,0,0
56011,989,2,263,256,7,6,0,0
0,0,0,0,0,0,0,0,0
303903,1151,5,66,64,2,2,1,0
0,0,0,0,0,0,0,0,0
80938,1041,9,218,213,5,18,1,0
55221,771,8,184,182,2,20,1,0
0,0,0,0,0,0,0,0,0
0,0,0,0,0,0,0,0,0
22043,35,0,1,1,0,0,1,0
30555,192,12,12,10,2,0,1,0
551407,2219,11,453,444,9,1,0,0
0,0,0,0,0,0,0,0,0
72528,301,10,39,0,39,18,1,0
0,0,0,0,0,0,0,0,0
106660,389,1,19,17,2,0,1,0
0,0,0,0,0,0,0,0,0
132197,3428,0,1078,1077,1,0,0,0
397692,1038,2,78,74,4,1,1,0
0,0,0,0,0,0,0,0,0
0,0,0,0,0,0,0,0,0
0,0,0,0,0,0,0,0,0
173,7,0,0,0,0,0,0,0
366183,1092,8,44,42,2,1,1,0
0,0,0,0,0,0,0,0,0
168309,932,7,76,63,13,3,0,0
0,0,0,0,0,0,0,0,0
0,0,0,0,0,0,0,0,0
85742,558,10,101,101,0,1,0,0
0,0,0,0,0,0,0,0,0
0,0,0,0,0,0,0,0,0
0,0,0,0,0,0,0,0,0
389083,1364,7,216,199,17,12,1,0
0,0,0,0,0,0,0,0,0
239093,1844,7,310,268,42,6,1,0
0,0,0,0,0,0,0,0,0
67970,789,2,125,109,16,6,1,0
235914,4384,1,490,471,19,5,0,0
214422,1623,9,313,159,154,52,1,0
66533,616,13,137,80,57,2,0,0
43810,263,5,22,19,3,0,0,0
5237,21,0,5,5,0,0,0,0
0,0,0,0,0,0,0,0,0
0,0,0,0,0,0,0,0,0
222251,888,2,95,48,47,2,1,0
21478,181,6,34,26,8,0,1,0
144325,2749,5,109,67,42,18,1,0
368545,1292,14,131,116,15,19,1,0
0,0,0,0,0,0,0,0,0
0,0,0,0,0,0,0,0,0
356452,1740,7,408,368,40,11,1,0
0,0,0,0,0,0,0,0,0
0,0,0,0,0,0,0,0,0
16706,197,0,43,37,6,0,1,0
0,0,0,0,0,0,0,0,0
0,0,0,0,0,0,0,0,0
144843,479,3,26,25,1,0,1,0
583222,1453,18,144,133,11,2,1,0
587124,1536,18,144,133,11,2,1,0
0,0,0,0,0,0,0,0,0
0,0,0,0,0,0,0,0,0
168705,1468,1,219,219,0,6,1,0
88777,625,1,111,111,0,8,1,0
0,0,0,0,0,0,0,0,0
0,0,0,0,0,0,0,0,0
0,0,0,0,0,0,0,0,0
39864,565,6,133,125,8,4,1,0
12851,150,6,24,24,0,1,1,0
48909,493,4,36,33,3,8,1,0
0,0,0,0,0,0,0,0,0
186476,788,10,91,80,11,2,1,0
0,0,0,0,0,0,0,0,0
0,0,0,0,0,0,0,0,0
108852,799,1,177,154,23,2,0,0
19398,470,0,116,115,1,12,1,0
10821,188,0,36,35,1,6,1,0
27899,368,3,150,61,89,0,0,0
0,0,0,0,0,0,0,0,0
0,0,0,0,0,0,0,0,0
0,0,0,0,0,0,0,0,0
0,0,0,0,0,0,0,0,0
265168,1276,7,147,116,31,6,1,0
0,0,0,0,0,0,0,0,0
0,0,0,0,0,0,0,0,0
4513,30,0,2,2,0,0,1,0
108063,3197,3,1567,1539,28,0,1,0
232376,1886,9,283,274,9,1,1,0
250521,1220,8,168,157,11,8,1,0
0,0,0,0,0,0,0,0,0
106394,939,7,143,138,5,2,0,0
6692,71,6,3,2,1,0,0,0
238067,2702,3,646,643,3,10,1,0
27836,286,3,30,28,2,0,1,0
329411,1587,4,142,98,44,15,1,0
0,0,0,0,0,0,0,0,0
0,0,0,0,0,0,0,0,0
107235,873,4,130,123,7,6,1,0
0,0,0,0,0,0,0,0,0
155100,1041,10,114,110,4,3,1,0
0,0,0,0,0,0,0,0,0
146256,1899,11,314,299,15,4,1,0
146255,1899,11,314,299,15,4,1,0
205385,1746,6,295,256,39,18,0,0
63727,535,10,94,81,13,7,0,0
21914,35,0,1,1,0,0,1,0
141266,1214,4,294,0,294,3,0,0
51757,219,4,38,29,9,2,0,0
323990,1781,1,357,352,5,4,1,0
163400,330,1,74,24,50,0,1,0
0,0,0,0,0,0,0,0,0
0,0,0,0,0,0,0,0,0
297744,695,7,114,106,8,8,0,0
12589,121,5,11,4,7,1,1,0
0,0,0,0,0,0,0,0,0
0,0,0,0,0,0,0,0,0
137699,1458,10,324,292,32,10,1,0
31315,429,5,74,70,4,3,1,0
585,5,0,0,0,0,0,0,1
644398,1716,3,70,59,11,5,1,0
136254,1107,8,181,180,1,2,1,0
0,0,0,0,0,0,0,0,0
120304,471,1,42,29,13,1,1,0
0,0,0,0,0,0,0,0,0
704031,434,9,15,8,7,0,1,0
0,0,0,0,0,0,0,0,0
2759278,9193,5,632,592,40,62,1,0
28947,126,3,10,3,7,2,1,0
129187,1235,10,275,274,1,2,1,0
0,0,0,0,0,0,0,0,0
0,0,0,0,0,0,0,0,0
374733,1384,15,230,184,46,11,1,0
264844,2879,4,546,507,39,14,0,0
0,0,0,0,0,0,0,0,0
35047,248,5,47,4,43,5,1,0
32592,229,5,45,22,23,5,1,0
0,0,0,0,0,0,0,0,0
132451,904,2,182,0,182,0,1,0
244621,2708,1,201,179,22,2,1,0
53453,544,2,149,142,7,0,1,0
31411,446,2,142,142,0,0,1,0
0,0,0,0,0,0,0,0,0
0,0,0,0,0,0,0,0,0
29923,313,1,32,32,0,4,1,0
20676,51,1,2,2,0,0,1,0
456041,1096,2,142,121,21,0,1,0
80487,879,2,262,8,254,0,1,0
159380,864,12,153,150,3,0,1,0
54664,646,8,82,78,4,9,1,0
1018128,3407,17,373,316,57,33,1,0
178477,923,12,150,106,44,4,1,0
258716,2682,11,171,146,25,3,1,0
184665,967,13,67,12,55,6,1,0
13942,88,7,6,6,0,2,0,0
2999810,591,4,44,3,41,0,0,0
0,0,0,0,0,0,0,0,0
934,27,0,3,3,0,0,1,0
532043,1900,11,268,253,15,12,0,1
0,0,0,0,0,0,0,0,0
323752,2835,10,431,426,5,1,1,0
0,0,0,0,0,0,0,0,0
539341,2774,8,199,141,58,20,1,0
10386,49,1,0,0,0,0,0,0
0,0,0,0,0,0,0,0,0
0,0,0,0,0,0,0,0,0
19272,306,0,79,79,0,0,1,0
0,0,0,0,0,0,0,0,0
96679,1033,2,299,298,1,3,1,0
0,0,0,0,0,0,0,0,0
0,0,0,0,0,0,0,0,0
201294,1439,13,101,89,12,2,1,0
33217,140,9,14,14,0,2,0,0
0,0,0,0,0,0,0,0,0
0,0,0,0,0,0,0,0,0
0,0,0,0,0,0,0,0,0
0,0,0,0,0,0,0,0,0
72875,451,5,95,92,3,9,1,0
224333,1345,7,173,161,12,4,1,0
123630,2393,4,499,472,27,6,1,0
3880,58,6,3,3,0,0,0,0
46965,426,9,54,25,29,1,1,0
2852,50,0,6,6,0,0,1,0
0,0,0,0,0,0,0,0,0
0,0,0,0,0,0,0,0,0
0,0,0,0,0,0,0,0,0
617121,1856,8,204,184,20,43,1,0
11662,83,4,11,11,0,2,0,0
63164,931,3,255,254,1,4,0,0
0,0,0,0,0,0,0,0,0
0,0,0,0,0,0,0,0,0
26299,481,6,144,144,0,2,1,0
38795,419,7,65,56,9,8,0,0
66991,979,3,133,116,17,2,1,0
211907,1551,8,299,286,13,22,0,0
46283,300,7,49,45,4,1,0,0
0,0,0,0,0,0,0,0,0
92133,564,3,145,135,10,2,1,0
0,0,0,0,0,0,0,0,0
0,0,0,0,0,0,0,0,0
14492,219,1,41,39,2,2,1,0
322426,1670,4,203,173,30,0,0,0
0,0,0,0,0,0,0,0,0
79430,1061,3,191,183,8,27,1,0
41313,607,3,126,126,0,10,1,0
0,0,0,0,0,0,0,0,0
0,0,0,0,0,0,0,0,0
61084,659,9,66,32,34,0,1,0
61056,659,9,66,40,26,0,1,0
0,0,0,0,0,0,0,0,0
7691,99,2,4,4,0,2,0,0
383054,3911,11,688,682,6,11,0,0
55718,371,11,75,67,8,2,1,0
0,0,0,0,0,0,0,0,0
0,0,0,0,0,0,0,0,0
258264,282,4,32,24,8,0,1,0
251021,195,4,28,20,8,0,1,0
0,0,0,0,0,0,0,0,0
78371,758,14,105,100,5,10,1,0
0,0,0,0,0,0,0,0,0
602694,4444,8,756,731,25,3,0,0
48236,516,6,70,69,1,1,1,0
2653,34,2,0,0,0,0,0,0
0,0,0,0,0,0,0,0,0
0,0,0,0,0,0,0,0,0
85909,919,5,118,115,3,0,1,0
0,0,0,0,0,0,0,0,0
463527,1017,5,279,275,4,11,1,0
0,0,0,0,0,0,0,0,0
713856,5141,20,553,524,29,20,1,0
291258,790,2,34,27,7,2,1,0
270317,3691,1,1029,902,127,129,1,0
49028,357,0,91,85,6,1,1,0
557446,4360,1,427,395,32,2,1,0
0,0,0,0,0,0,0,0,0
0,0,0,0,0,0,0,0,0
21999,32,0,1,1,0,0,1,0
0,0,0,0,0,0,0,0,0
188819,1041,13,205,191,14,4,1,0
305085,1532,5,235,207,28,25,1,0
192924,1609,1,240,238,2,46,0,0
23164,36,0,2,1,1,0,1,0
0,0,0,0,0,0,0,0,0
49145,411,4,60,58,2,6,1,0
369476,5108,9,656,642,14,165,0,0
38341,519,2,120,120,0,0,1,0
322391,972,15,182,127,55,6,1,0
0,0,0,0,0,0,0,0,0
0,0,0,0,0,0,0,0,0
499335,1474,6,260,254,6,4,1,0
233278,2224,4,238,217,21,5,1,0
573800,1345,12,238,220,18,4,1,0
660568,2347,3,139,121,18,3,0,0
240343,1054,5,46,33,13,4,0,0
0,0,0,0,0,0,0,0,0
158132,432,16,60,60,0,3,1,0
0,0,0,0,0,0,0,0,0
342952,672,3,33,26,7,0,1,0
0,0,0,0,0,0,0,0,0
51626,680,2,136,132,4,0,1,0
145250,883,10,139,135,4,11,1,0
384291,2362,4,277,272,5,17,1,0
0,0,0,0,0,0,0,0,0
0,0,0,0,0,0,0,0,0
0,0,0,0,0,0,0,0,0
0,0,0,0,0,0,0,0,0
70167,1208,1,303,303,0,2,1,0
0,0,0,0,0,0,0,0,0
0,0,0,0,0,0,0,0,0
297894,1805,13,68,64,4,10,1,0
294469,4409,0,255,254,1,0,1,0
132717,2518,0,732,726,6,5,1,0
33780,481,4,77,74,3,0,1,0
0,0,0,0,0,0,0,0,0
0,0,0,0,0,0,0,0,0
0,0,0,0,0,0,0,0,0
0,0,0,0,0,0,0,0,0
299437,1942,11,629,543,86,3,1,0
0,0,0,0,0,0,0,0,0
0,0,0,0,0,0,0,0,0
374094,1962,8,404,374,30,10,1,0
0,0,0,0,0,0,0,0,0
1021093,1954,11,288,271,17,2,1,0
103579,1362,5,315,301,14,3,1,0
185423,203,1,11,8,3,0,1,0
38939,129,2,4,3,1,1,1,0
45180,207,2,7,3,4,1,1,0
0,0,0,0,0,0,0,0,0
16258,211,5,15,13,2,2,1,0
16035,175,4,20,13,7,0,1,0
133699,812,6,190,180,10,10,1,0
188397,638,6,117,117,0,7,0,0
0,0,0,0,0,0,0,0,0
78259,693,6,96,78,18,33,1,0
22749,262,2,39,37,2,6,1,0
0,0,0,0,0,0,0,0,0
212914,3325,5,560,550,10,2,1,0
21001,224,4,37,35,2,4,1,0
560609,1475,1,87,65,22,6,1,0
26527,147,1,14,12,2,0,1,0
432608,1818,14,436,418,18,18,1,0
8064,114,5,14,10,4,1,1,0
0,0,0,0,0,0,0,0,0
49874,241,3,29,4,25,0,1,0
3444,35,2,0,0,0,0,0,0
0,0,0,0,0,0,0,0,0
0,0,0,0,0,0,0,0,0
0,0,0,0,0,0,0,0,0
0,0,0,0,0,0,0,0,0
17931,35,0,2,1,1,0,1,0
0,0,0,0,0,0,0,0,0
0,0,0,0,0,0,0,0,0
393750,954,5,193,150,43,2,1,1
0,0,0,0,0,0,0,0,0
0,0,0,0,0,0,0,0,0
0,0,0,0,0,0,0,0,0
141092,1556,5,226,183,43,0,1,0
18878,53,1,1,1,0,1,0,0
0,0,0,0,0,0,0,0,0
92430,1041,2,60,33,27,2,1,0
298264,2632,9,333,316,17,2,1,0
64415,716,4,134,133,1,0,1,0
0,0,0,0,0,0,0,0,0
0,0,0,0,0,0,0,0,0
158253,1492,5,123,121,2,8,1,0
93899,241,6,32,31,1,6,1,0
136195,1400,9,235,234,1,11,0,0
47300,798,5,82,82,0,0,1,0
0,0,0,0,0,0,0,0,0
90921,1369,14,346,341,5,1,1,0
0,0,0,0,0,0,0,0,0
40616,368,1,17,12,5,1,1,0
165197,997,4,108,105,3,12,0,0
0,0,0,0,0,0,0,0,0
74714,451,4,53,31,22,1,0,0
301084,2159,2,275,272,3,6,0,0
376881,789,2,67,63,4,0,1,0
325531,150,2,18,11,7,0,1,0
14859,171,3,12,11,1,0,1,0
0,0,0,0,0,0,0,0,0
137013,2097,10,433,380,53,5,1,0
0,0,0,0,0,0,0,0,0
1562384,1585,4,114,107,7,1,1,0
32482,467,7,81,74,7,2,1,0
0,0,0,0,0,0,0,0,0
135831,1334,6,307,185,122,1,1,0
0,0,0,0,0,0,0,0,0
139370,1341,11,503,494,9,15,1,0
152554,1614,11,610,601,9,18,1,0
1322960,2174,7,63,63,0,3,1,0
418531,1731,14,150,139,11,0,1,0
458563,1045,11,118,106,12,4,1,0
843352,2367,16,281,195,86,1,1,0
195992,705,4,101,94,7,5,1,0
0,0,0,0,0,0,0,0,0
46013,541,5,104,95,9,20,1,0
35772,746,2,185,161,24,0,1,0
105107,1862,4,129,115,14,3,0,0
150379,1353,8,215,185,30,3,1,0
7760,76,1,5,5,0,0,0,0
0,0,0,0,0,0,0,0,0
0,0,0,0,0,0,0,0,0
205685,1383,8,121,107,14,28,1,0
139033,757,10,121,115,6,16,1,0
0,0,0,0,0,0,0,0,0
0,0,0,0,0,0,0,0,0
2396403,3395,14,432,431,1,98,1,0
303199,1278,14,169,169,0,27,1,0
0,0,0,0,0,0,0,0,0
127705,693,15,84,60,24,5,1,0
1568,31,0,3,1,2,0,0,0
259015,710,4,115,4,111,0,1,0
0,0,0,0,0,0,0,0,0
0,0,0,0,0,0,0,0,0
0,0,0,0,0,0,0,0,0
16166,313,3,54,37,17,0,0,0
53498,629,12,99,86,13,3,1,0
36402,396,10,97,87,10,2,1,0
425700,1947,9,328,328,0,20,1,0
84230,508,4,77,58,19,7,1,0
258420,976,4,146,123,23,8,1,0
158925,256,5,28,15,13,2,1,0
143049,70,5,5,5,0,2,1,0
0,0,0,0,0,0,0,0,0
44434,245,8,43,38,5,4,1,0
77910,829,7,138,133,5,4,1,0
0,0,0,0,0,0,0,0,0
147829,1193,7,264,239,25,6,1,0
0,0,0,0,0,0,0,0,0
0,0,0,0,0,0,0,0,0
609288,986,6,182,129,53,0,1,0
48567,140,2,5,3,2,0,1,0
25650,380,3,130,120,10,0,0,0
441603,1384,5,356,345,11,8,1,0
0,0,0,0,0,0,0,0,0
11313,140,2,21,19,2,0,0,0
0,0,0,0,0,0,0,0,0
0,0,0,0,0,0,0,0,0
55316,829,2,201,46,155,2,0,0
65714,697,9,125,103,22,2,1,0
0,0,0,0,0,0,0,0,0
293754,1746,9,167,137,30,24,1,0
0,0,0,0,0,0,0,0,0
0,0,0,0,0,0,0,0,0
198844,1891,10,287,252,35,12,1,0
505413,387,3,32,9,23,0,1,0
171005,1000,2,325,302,23,1,1,0
61190,1456,4,133,128,5,1,1,0
27085,129,5,5,4,1,8,1,0
0,0,0,0,0,0,0,0,0
436321,1501,4,203,169,34,5,0,0
0,0,0,0,0,0,0,0,0
0,0,0,0,0,0,0,0,0
0,0,0,0,0,0,0,0,0
196158,435,4,100,92,8,1,0,0
665424,30,1,1,1,0,0,0,0
0,0,0,0,0,0,0,0,0
507272,5603,8,871,804,67,7,1,0
17759,214,2,44,44,0,1,1,0
236606,1416,8,267,230,37,6,1,0
176645,608,5,88,78,10,3,0,0
0,0,0,0,0,0,0,0,0
290994,1262,8,199,167,32,14,1,0
0,0,0,0,0,0,0,0,0
213096,2285,4,444,369,75,12,1,0
64786,977,4,191,185,6,0,1,0
0,0,0,0,0,0,0,0,0
290078,1366,7,269,254,15,6,1,0
238175,2188,7,344,344,0,205,1,0
133040,450,7,136,136,0,15,1,0
162949,1162,5,251,235,16,0,1,0
2342,29,1,0,0,0,0,0,0
30272,222,1,18,18,0,6,1,0
1275539,2143,20,395,288,107,32,1,0
0,0,0,0,0,0,0,0,0
82445,238,3,20,17,3,0,0,0
625031,2375,1,85,84,1,1,1,0
58261,223,1,7,7,0,0,1,0
417537,1954,5,285,270,15,2,1,0
77021,889,5,238,223,15,1,1,0
0,0,0,0,0,0,0,0,0
142163,1119,9,217,186,31,4,1,0
12126,80,0,6,3,3,0,1,0
62924,503,9,79,76,3,2,1,0
0,0,0,0,0,0,0,0,0
38096,734,2,175,172,3,2,1,0
13851,282,2,38,34,4,7,1,0
0,0,0,0,0,0,0,0,0
0,0,0,0,0,0,0,0,0
0,0,0,0,0,0,0,0,0
0,0,0,0,0,0,0,0,0
3202,40,3,5,5,0,0,1,0
0,0,0,0,0,0,0,0,0
0,0,0,0,0,0,0,0,0
0,0,0,0,0,0,0,0,0
400974,1000,1,202,202,0,0,1,0
358215,1005,1,200,200,0,0,1,0
325213,2835,5,406,391,15,23,1,0
177699,1235,5,266,255,11,9,1,0
68062,724,6,101,94,7,7,1,0
26019,306,6,63,58,5,7,1,0
0,0,0,0,0,0,0,0,0
904218,12409,8,2297,2245,52,12,1,0
29577,217,8,27,25,2,3,0,0
0,0,0,0,0,0,0,0,0
855963,7122,9,412,288,124,37,0,0
0,0,0,0,0,0,0,0,0
3306956,1132,3,168,97,71,8,1,0
0,0,0,0,0,0,0,0,0
210856,728,5,168,159,9,5,1,0
0,0,0,0,0,0,0,0,0
127141,196,4,25,23,2,2,0,0
111702,198,5,26,23,3,2,0,0
0,0,0,0,0,0,0,0,0
0,0,0,0,0,0,0,0,0
0,0,0,0,0,0,0,0,0
644246,6236,7,118,110,8,1,1,0
166541,1658,8,399,377,22,13,1,0
185936,2514,3,673,554,119,1,1,0
71607,1095,1,333,333,0,0,1,0
21947,35,0,1,1,0,0,1,0
0,0,0,0,0,0,0,0,0
27687,42,0,2,1,1,0,0,0
152702,1044,4,196,180,16,21,1,0
356198,1061,9,198,189,9,0,1,0
5925,63,6,4,3,1,0,0,0
56311,486,11,113,104,9,2,0,0
10417,73,6,3,2,1,0,0,0
354527,1036,0,109,106,3,1,1,0
135131,1261,17,215,192,23,10,1,0
147360,1057,3,113,98,15,1,1,0
0,0,0,0,0,0,0,0,0
0,0,0,0,0,0,0,0,0
391481,3461,5,391,300,91,4,1,0
0,0,0,0,0,0,0,0,0
0,0,0,0,0,0,0,0,0
81822,680,3,124,120,4,0,1,0
0,0,0,0,0,0,0,0,0
102607,987,8,276,264,12,9,1,0
0,0,0,0,0,0,0,0,0
136858,1224,16,90,84,6,5,1,0
205890,1728,4,498,488,10,7,1,0
0,0,0,0,0,0,0,0,0
969636,3198,13,665,567,98,22,1,1
21371,170,4,4,0,4,3,1,0
159677,1269,6,296,265,31,8,1,0
0,0,0,0,0,0,0,0,0
0,0,0,0,0,0,0,0,0
169778,1180,6,163,155,8,9,1,0
177835,1146,6,167,164,3,5,1,0
19348,379,2,121,118,3,0,0,0
40759,1053,1,368,364,4,3,1,0
37287,204,9,17,16,1,19,1,0
0,0,0,0,0,0,0,0,0
5514,32,3,0,0,0,1,0,0
738392,5894,7,854,837,17,19,0,0
306798,4891,9,203,191,12,16,0,0
16129,187,4,15,14,1,0,1,0
0,0,0,0,0,0,0,0,0
0,0,0,0,0,0,0,0,0
0,0,0,0,0,0,0,0,0
488392,713,6,15,15,0,0,1,0
5434,65,6,2,2,0,0,1,0
0,0,0,0,0,0,0,0,0
0,0,0,0,0,0,0,0,0
46900,568,6,143,142,1,6,1,0
164072,373,7,29,19,10,25,0,0
43281,375,4,80,77,3,2,1,0
0,0,0,0,0,0,0,0,0
69698,329,2,51,38,13,1,1,0
0,0,0,0,0,0,0,0,0
64432,483,4,59,57,2,0,1,0
20826,247,1,36,36,0,0,1,0
143635,920,9,166,120,46,8,1,0
443392,4713,7,794,781,13,29,1,0
0,0,0,0,0,0,0,0,0
0,0,0,0,0,0,0,0,0
237778,1497,3,171,168,3,4,0,0
498490,776,3,59,56,3,4,0,0
73346,814,8,235,229,6,9,1,0
41528,550,8,121,115,6,8,1,0
1030658,1719,6,384,18,366,17,1,0
323154,601,6,117,81,36,14,1,0
0,0,0,0,0,0,0,0,0
23157,407,0,106,104,2,2,1,0
0,0,0,0,0,0,0,0,0
412976,2405,5,253,253,0,1,1,0
0,0,0,0,0,0,0,0,0
282313,1076,8,140,136,4,1,1,0
0,0,0,0,0,0,0,0,0
119193,1211,6,200,174,26,15,1,0
53567,613,5,193,193,0,7,1,0
0,0,0,0,0,0,0,0,0
0,0,0,0,0,0,0,0,0
307544,774,1,113,111,2,1,1,0
0,0,0,0,0,0,0,0,0
0,0,0,0,0,0,0,0,0
38387,132,7,7,1,6,0,0,0
62303,377,11,43,31,12,7,1,0
404453,3557,2,135,106,29,4,1,0
207842,2814,8,585,569,16,1,1,0
92779,1503,3,358,355,3,0,1,0
0,0,0,0,0,0,0,0,0
106340,852,9,72,67,5,10,1,0
113895,857,9,72,67,5,12,1,0
0,0,0,0,0,0,0,0,0
509357,460,10,43,40,3,2,1,0
113808,1344,7,199,172,27,0,1,0
259817,2737,4,190,132,58,4,0,0
0,0,0,0,0,0,0,0,0
0,0,0,0,0,0,0,0,0
0,0,0,0,0,0,0,0,0
1153,16,1,0,0,0,0,0,0
0,0,0,0,0,0,0,0,0
10929,63,2,1,1,0,1,1,0
0,0,0,0,0,0,0,0,0
100548,81,2,5,3,2,0,1,0
0,0,0,0,0,0,0,0,0
70366,610,9,54,51,3,3,1,0
0,0,0,0,0,0,0,0,0
22652,34,0,1,1,0,0,1,0
151233,676,9,102,23,79,4,1,0
162247,743,11,101,90,11,2,1,0
21569,493,5,25,24,1,0,0,0
0,0,0,0,0,0,0,0,0
34296,367,10,49,46,3,4,1,0
146519,1039,5,79,65,14,70,1,0
0,0,0,0,0,0,0,0,0
0,0,0,0,0,0,0,0,0
0,0,0,0,0,0,0,0,0
18587,251,10,39,34,5,0,1,0
0,0,0,0,0,0,0,0,0
0,0,0,0,0,0,0,0,0
312453,1788,9,305,254,51,8,1,0
29263,363,5,12,11,1,1,0,0
43335,440,2,3,3,0,3,0,0
133190,1343,3,232,227,5,5,1,0
359928,1176,9,140,118,22,13,1,0
385745,2268,6,277,89,188,1,1,0
82280,907,6,192,188,4,3,1,0
0,0,0,0,0,0,0,0,0
0,0,0,0,0,0,0,0,0
0,0,0,0,0,0,0,0,0
0,0,0,0,0,0,0,0,0
506356,3716,10,625,621,4,0,1,0
895,11,0,2,0,2,0,0,0
0,0,0,0,0,0,0,0,0
84934,721,7,121,110,11,9,1,0
155087,281,6,12,7,5,10,0,0
0,0,0,0,0,0,0,0,0
299928,3127,4,654,650,4,121,1,0
146540,1624,4,483,480,3,32,1,0
0,0,0,0,0,0,0,0,0
87867,1844,3,411,397,14,7,1,0
924625,4340,6,1000,987,13,13,1,0
67297,834,8,141,137,4,0,1,0
70167,452,3,81,50,31,62,1,0
2882,55,1,6,6,0,0,0,0
0,0,0,0,0,0,0,0,0
0,0,0,0,0,0,0,0,0
115748,728,14,160,139,21,13,1,0
61616,738,9,138,97,41,9,0,0
0,0,0,0,0,0,0,0,0
0,0,0,0,0,0,0,0,0
183844,1479,11,281,217,64,9,1,0
90082,624,3,80,65,15,1,1,0
0,0,0,0,0,0,0,0,0
0,0,0,0,0,0,0,0,0
161856,694,12,118,116,2,34,1,0
350309,496,2,20,19,1,6,1,0
351639,342,4,17,16,1,4,1,0
220125,516,6,74,72,2,0,1,0
243900,1379,5,182,161,21,12,1,0
11757,78,3,3,3,0,5,0,0
96783,675,4,171,167,4,11,1,0
69425,355,4,36,32,4,11,1,0
210396,2694,6,257,248,9,6,0,0
0,0,0,0,0,0,0,0,0
233190,1186,9,95,86,9,32,1,0
46978,429,0,61,54,7,4,0,0
53433,487,7,76,67,9,0,1,0
196801,1415,9,165,154,11,2,1,0
111490,723,7,199,197,2,5,1,0
86740,543,7,167,165,2,6,1,0
392478,3425,4,584,571,13,1,0,0
0,0,0,0,0,0,0,0,0
54909,602,4,103,96,7,2,1,0
58231,459,2,40,40,0,0,0,0
0,0,0,0,0,0,0,0,0
0,0,0,0,0,0,0,0,0
0,0,0,0,0,0,0,0,0
19478,253,5,70,64,6,0,0,0
59951,313,4,41,0,41,0,0,0
222909,1106,4,149,130,19,2,0,0
46732,765,5,144,47,97,2,1,0
24738,421,5,61,52,9,2,1,0
0,0,0,0,0,0,0,0,0
342896,390,8,45,38,7,4,1,0
312382,189,8,21,17,4,2,1,0
0,0,0,0,0,0,0,0,0
0,0,0,0,0,0,0,0,0
0,0,0,0,0,0,0,0,0
284276,1589,5,256,239,17,14,1,0
77245,474,7,99,94,5,2,0,0
0,0,0,0,0,0,0,0,0
146969,1269,13,141,132,9,25,1,0
75804,696,4,65,63,2,3,1,0
0,0,0,0,0,0,0,0,0
276826,1290,1,237,231,6,12,1,0
0,0,0,0,0,0,0,0,0
123074,848,4,169,169,0,0,1,0
90915,1577,4,273,271,2,0,0,0
84241,631,6,69,39,30,0,1,0
299485,3005,7,494,440,54,40,1,0
65138,749,1,236,203,33,1,1,0
0,0,0,0,0,0,0,0,0
0,0,0,0,0,0,0,0,0
0,0,0,0,0,0,0,0,0
268650,3854,6,561,517,44,1,1,0
150561,610,8,99,94,5,16,1,0
0,0,0,0,0,0,0,0,0
226146,807,13,27,20,7,9,0,0
50139,84,3,1,0,1,0,0,0
0,0,0,0,0,0,0,0,0
114045,1223,2,101,95,6,1,1,0
320454,2133,9,336,225,111,27,1,0
0,0,0,0,0,0,0,0,0
0,0,0,0,0,0,0,0,0
320393,3004,9,433,379,54,51,1,0
0,0,0,0,0,0,0,0,0
118494,1909,9,434,425,9,2,0,0
26376,217,12,4,4,0,1,0,0
0,0,0,0,0,0,0,0,0
0,0,0,0,0,0,0,0,0
0,0,0,0,0,0,0,0,0
16771,259,0,50,43,7,1,1,0
0,0,0,0,0,0,0,0,0
123602,1004,0,77,70,7,25,0,0
0,0,0,0,0,0,0,0,0
0,0,0,0,0,0,0,0,0
187677,543,6,29,29,0,7,1,0
172557,2126,5,387,383,4,8,0,0
0,0,0,0,0,0,0,0,0
0,0,0,0,0,0,0,0,0
0,0,0,0,0,0,0,0,0
0,0,0,0,0,0,0,0,0
54218,574,2,60,40,20,3,1,0
0,0,0,0,0,0,0,0,0
93932,576,5,168,161,7,1,1,0
132878,321,5,47,41,6,1,1,0
90025,864,2,148,99,49,0,1,0
74747,619,6,25,24,1,4,1,0
642882,1534,8,84,83,1,33,0,0
39212,206,3,7,7,0,0,1,0
45261,507,3,153,149,4,9,1,0
820695,2529,9,291,206,85,50,1,0
89115,1494,2,373,372,1,3,1,0
0,0,0,0,0,0,0,0,0
0,0,0,0,0,0,0,0,0
0,0,0,0,0,0,0,0,0
14068,121,3,21,11,10,0,1,0
321062,1996,6,302,221,81,13,1,0
67410,239,6,30,23,7,1,1,0
33955,721,4,85,79,6,3,1,0
0,0,0,0,0,0,0,0,0
301209,1800,2,234,222,12,7,0,0
60709,696,1,1,0,1,0,0,0
45810,417,6,30,23,7,3,1,0
203971,1348,7,147,131,16,11,1,0
161916,900,6,128,117,11,1,1,0
43563,339,6,49,26,23,0,0,0
0,0,0,0,0,0,0,0,0
0,0,0,0,0,0,0,0,0
21997,35,0,1,1,0,0,1,0
879153,4032,4,422,359,63,12,1,0
1085532,1931,6,301,261,40,37,1,0
64395,83,4,13,11,2,0,0,0
413370,3546,10,751,716,35,14,1,0
0,0,0,0,0,0,0,0,0
175039,2766,4,88,88,0,3,1,0
0,0,0,0,0,0,0,0,0
61275,762,4,176,131,45,14,1,0
73584,764,14,138,136,2,7,0,0
60920,353,10,81,79,2,4,0,0
165806,1607,7,330,325,5,7,1,0
70804,1129,2,180,139,41,4,1,0
114820,744,13,75,70,5,5,1,0
4578,58,1,6,6,0,0,1,0
61573,389,7,79,75,4,6,0,0
117479,1766,4,473,357,116,0,1,0
203589,1370,6,220,194,26,93,1,0
0,0,0,0,0,0,0,0,0
87919,543,11,70,59,11,0,1,0
60879,228,10,38,35,3,0,1,0
0,0,0,0,0,0,0,0,0
0,0,0,0,0,0,0,0,0
0,0,0,0,0,0,0,0,0
0,0,0,0,0,0,0,0,0
94022,489,9,88,81,7,7,1,0
80928,475,10,92,85,7,7,1,0
34629,592,7,69,13,56,9,1,0
0,0,0,0,0,0,0,0,0
105670,1564,10,303,274,29,21,1,0
226787,2523,11,567,542,25,12,1,0
452558,2611,4,720,8,712,0,1,0
0,0,0,0,0,0,0,0,0
327516,1973,9,409,396,13,21,1,0
0,0,0,0,0,0,0,0,0
17663,199,1,72,64,8,0,1,0
0,0,0,0,0,0,0,0,0
0,0,0,0,0,0,0,0,0
241519,3048,9,572,432,140,3,0,0
0,0,0,0,0,0,0,0,0
382144,7285,5,487,472,15,17,1,0
15299,318,2,129,128,1,0,1,0
14377,127,3,9,9,0,3,1,0
56631,766,5,166,161,5,0,1,0
32791,446,6,98,94,4,0,1,0
0,0,0,0,0,0,0,0,0
189994,2098,10,414,389,25,21,1,0
552715,2659,12,417,397,20,5,1,0
552703,2659,12,417,397,20,5,1,0
0,0,0,0,0,0,0,0,0
0,0,0,0,0,0,0,0,0
0,0,0,0,0,0,0,0,0
0,0,0,0,0,0,0,0,0
217772,641,0,80,38,42,0,1,0
0,0,0,0,0,0,0,0,0
9552,137,7,26,26,0,1,1,0
118228,1360,8,307,267,40,16,1,0
248280,2046,8,287,264,23,16,1,0
0,0,0,0,0,0,0,0,0
208036,1325,4,127,81,46,1,1,0
119562,860,8,111,62,49,5,1,0
0,0,0,0,0,0,0,0,0
0,0,0,0,0,0,0,0,0
72970,346,2,39,37,2,2,1,0
1530255,413,9,35,17,18,7,1,0
631904,1094,4,163,163,0,7,0,0
48583,279,2,29,6,23,3,1,0
0,0,0,0,0,0,0,0,0
286473,753,9,120,101,19,5,1,0
0,0,0,0,0,0,0,0,0
59242,271,8,28,22,6,0,1,0
54283,638,3,90,77,13,7,1,0
206055,2188,10,376,356,20,16,1,0
2331,34,1,2,2,0,0,0,0
0,0,0,0,0,0,0,0,0
0,0,0,0,0,0,0,0,0
127411,667,8,105,96,9,13,1,0
21634,71,1,5,5,0,0,0,0
0,0,0,0,0,0,0,0,0
33066,685,2,262,262,0,0,1,0
45630,849,0,214,184,30,0,1,0
8942,232,0,74,49,25,0,1,0
653604,2789,5,223,204,19,7,1,0
0,0,0,0,0,0,0,0,0
0,0,0,0,0,0,0,0,0
71887,1932,2,568,568,0,2,1,0
0,0,0,0,0,0,0,0,0
520702,6863,7,2076,2002,74,12,1,0
304998,5007,10,1690,1677,13,16,1,0
91395,1274,2,305,289,16,2,1,0
29819,134,2,5,5,0,1,1,0
0,0,0,0,0,0,0,0,0
0,0,0,0,0,0,0,0,0
364271,1506,6,108,101,7,29,0,0
51640,138,5,8,8,0,4,0,0
0,0,0,0,0,0,0,0,0
0,0,0,0,0,0,0,0,0
0,0,0,0,0,0,0,0,0
0,0,0,0,0,0,0,0,0
118161,284,9,30,26,4,2,1,0
0,0,0,0,0,0,0,0,0
0,0,0,0,0,0,0,0,0
0,0,0,0,0,0,0,0,0
0,0,0,0,0,0,0,0,0
0,0,0,0,0,0,0,0,0
0,0,0,0,0,0,0,0,0
0,0,0,0,0,0,0,0,0
0,0,0,0,0,0,0,0,0
0,0,0,0,0,0,0,0,0
0,0,0,0,0,0,0,0,0
0,0,0,0,0,0,0,0,0
0,0,0,0,0,0,0,0,0
0,0,0,0,0,0,0,0,0
0,0,0,0,0,0,0,0,0
0,0,0,0,0,0,0,0,0
0,0,0,0,0,0,0,0,0
0,0,0,0,0,0,0,0,0
0,0,0,0,0,0,0,0,0
0,0,0,0,0,0,0,0,0
0,0,0,0,0,0,0,0,0
0,0,0,0,0,0,0,0,0
0,0,0,0,0,0,0,0,0
0,0,0,0,0,0,0,0,0
0,0,0,0,0,0,0,0,0
0,0,0,0,0,0,0,0,0
0,0,0,0,0,0,0,0,0
0,0,0,0,0,0,0,0,0
0,0,0,0,0,0,0,0,0
0,0,0,0,0,0,0,0,0
0,0,0,0,0,0,0,0,0
0,0,0,0,0,0,0,0,0
0,0,0,0,0,0,0,0,0
0,0,0,0,0,0,0,0,0
0,0,0,0,0,0,0,0,0
0,0,0,0,0,0,0,0,0
0,0,0,0,0,0,0,0,0
0,0,0,0,0,0,0,0,0
0,0,0,0,0,0,0,0,0
0,0,0,0,0,0,0,0,0
0,0,0,0,0,0,0,0,0
0,0,0,0,0,0,0,0,0
0,0,0,0,0,0,0,0,0
0,0,0,0,0,0,0,0,0
0,0,0,0,0,0,0,0,0
0,0,0,0,0,0,0,0,0
0,0,0,0,0,0,0,0,0
0,0,0,0,0,0,0,0,0
0,0,0,0,0,0,0,0,0
0,0,0,0,0,0,0,0,0
0,0,0,0,0,0,0,0,0
0,0,0,0,0,0,0,0,0
0,0,0,0,0,0,0,0,0
0,0,0,0,0,0,0,0,0
0,0,0,0,0,0,0,0,0
0,0,0,0,0,0,0,0,0
0,0,0,0,0,0,0,0,0
0,0,0,0,0,0,0,0,0
0,0,0,0,0,0,0,0,0
0,0,0,0,0,0,0,0,0
0,0,0,0,0,0,0,0,0
0,0,0,0,0,0,0,0,0
0,0,0,0,0,0,0,0,0
0,0,0,0,0,0,0,0,0
0,0,0,0,0,0,0,0,0
0,0,0,0,0,0,0,0,0
0,0,0,0,0,0,0,0,0
0,0,0,0,0,0,0,0,0
0,0,0,0,0,0,0,0,0
0,0,0,0,0,0,0,0,0
0,0,0,0,0,0,0,0,0
0,0,0,0,0,0,0,0,0
0,0,0,0,0,0,0,0,0
0,0,0,0,0,0,0,0,0
0,0,0,0,0,0,0,0,0
0,0,0,0,0,0,0,0,0
0,0,0,0,0,0,0,0,0
0,0,0,0,0,0,0,0,0
0,0,0,0,0,0,0,0,0
0,0,0,0,0,0,0,0,0
0,0,0,0,0,0,0,0,0
0,0,0,0,0,0,0,0,0
0,0,0,0,0,0,0,0,0
0,0,0,0,0,0,0,0,0
0,0,0,0,0,0,0,0,0
0,0,0,0,0,0,0,0,0
0,0,0,0,0,0,0,0,0
0,0,0,0,0,0,0,0,0
0,0,0,0,0,0,0,0,0
0,0,0,0,0,0,0,0,0
0,0,0,0,0,0,0,0,0
0,0,0,0,0,0,0,0,0
0,0,0,0,0,0,0,0,0
0,0,0,0,0,0,0,0,0
0,0,0,0,0,0,0,0,0
0,0,0,0,0,0,0,0,0
0,0,0,0,0,0,0,0,0
0,0,0,0,0,0,0,0,0
0,0,0,0,0,0,0,0,0
0,0,0,0,0,0,0,0,0
0,0,0,0,0,0,0,0,0
0,0,0,0,0,0,0,0,0
0,0,0,0,0,0,0,0,0
0,0,0,0,0,0,0,0,0
0,0,0,0,0,0,0,0,0
0,0,0,0,0,0,0,0,0
0,0,0,0,0,0,0,0,0
0,0,0,0,0,0,0,0,0
0,0,0,0,0,0,0,0,0
0,0,0,0,0,0,0,0,0
0,0,0,0,0,0,0,0,0
0,0,0,0,0,0,0,0,0
0,0,0,0,0,0,0,0,0
0,0,0,0,0,0,0,0,0
0,0,0,0,0,0,0,0,0
0,0,0,0,0,0,0,0,0
0,0,0,0,0,0,0,0,0
0,0,0,0,0,0,0,0,0
0,0,0,0,0,0,0,0,0
0,0,0,0,0,0,0,0,0
0,0,0,0,0,0,0,0,0
0,0,0,0,0,0,0,0,0
0,0,0,0,0,0,0,0,0
0,0,0,0,0,0,0,0,0
0,0,0,0,0,0,0,0,0
0,0,0,0,0,0,0,0,0
0,0,0,0,0,0,0,0,0
0,0,0,0,0,0,0,0,0
0,0,0,0,0,0,0,0,0
0,0,0,0,0,0,0,0,0
0,0,0,0,0,0,0,0,0
0,0,0,0,0,0,0,0,0
0,0,0,0,0,0,0,0,0
0,0,0,0,0,0,0,0,0
0,0,0,0,0,0,0,0,0
0,0,0,0,0,0,0,0,0
0,0,0,0,0,0,0,0,0
0,0,0,0,0,0,0,0,0
0,0,0,0,0,0,0,0,0
0,0,0,0,0,0,0,0,0
0,0,0,0,0,0,0,0,0
0,0,0,0,0,0,0,0,0
0,0,0,0,0,0,0,0,0
0,0,0,0,0,0,0,0,0
0,0,0,0,0,0,0,0,0
0,0,0,0,0,0,0,0,0
0,0,0,0,0,0,0,0,0
0,0,0,0,0,0,0,0,0
0,0,0,0,0,0,0,0,0
0,0,0,0,0,0,0,0,0
0,0,0,0,0,0,0,0,0
0,0,0,0,0,0,0,0,0
0,0,0,0,0,0,0,0,0
0,0,0,0,0,0,0,0,0
0,0,0,0,0,0,0,0,0
0,0,0,0,0,0,0,0,0
0,0,0,0,0,0,0,0,0
0,0,0,0,0,0,0,0,0
0,0,0,0,0,0,0,0,0
0,0,0,0,0,0,0,0,0
0,0,0,0,0,0,0,0,0
0,0,0,0,0,0,0,0,0
0,0,0,0,0,0,0,0,0
0,0,0,0,0,0,0,0,0
0,0,0,0,0,0,0,0,0
0,0,0,0,0,0,0,0,0
0,0,0,0,0,0,0,0,0
0,0,0,0,0,0,0,0,0
0,0,0,0,0,0,0,0,0
0,0,0,0,0,0,0,0,0
0,0,0,0,0,0,0,0,0
0,0,0,0,0,0,0,0,0
0,0,0,0,0,0,0,0,0
0,0,0,0,0,0,0,0,0
0,0,0,0,0,0,0,0,0
0,0,0,0,0,0,0,0,0
0,0,0,0,0,0,0,0,0
0,0,0,0,0,0,0,0,0
0,0,0,0,0,0,0,0,0
0,0,0,0,0,0,0,0,0
0,0,0,0,0,0,0,0,0
0,0,0,0,0,0,0,0,0
0,0,0,0,0,0,0,0,0
0,0,0,0,0,0,0,0,0
0,0,0,0,0,0,0,0,0
0,0,0,0,0,0,0,0,0
0,0,0,0,0,0,0,0,0
0,0,0,0,0,0,0,0,0
0,0,0,0,0,0,0,0,0
0,0,0,0,0,0,0,0,0
0,0,0,0,0,0,0,0,0
0,0,0,0,0,0,0,0,0
0,0,0,0,0,0,0,0,0
0,0,0,0,0,0,0,0,0
0,0,0,0,0,0,0,0,0
0,0,0,0,0,0,0,0,0
0,0,0,0,0,0,0,0,0
0,0,0,0,0,0,0,0,0
0,0,0,0,0,0,0,0,0
0,0,0,0,0,0,0,0,0
0,0,0,0,0,0,0,0,0
0,0,0,0,0,0,0,0,0
0,0,0,0,0,0,0,0,0
0,0,0,0,0,0,0,0,0
0,0,0,0,0,0,0,0,0
0,0,0,0,0,0,0,0,0
0,0,0,0,0,0,0,0,0
0,0,0,0,0,0,0,0,0
0,0,0,0,0,0,0,0,0
0,0,0,0,0,0,0,0,0
0,0,0,0,0,0,0,0,0
0,0,0,0,0,0,0,0,0
0,0,0,0,0,0,0,0,0
0,0,0,0,0,0,0,0,0
61524,490,4,63,30,33,5,1,0
28557,178,5,5,5,0,4,1,0
3274,54,2,2,0,2,0,0,0
19245,295,4,23,18,5,2,0,0
293077,1791,2,313,308,5,4,1,0
35068,329,0,15,14,1,2,1,0
0,0,0,0,0,0,0,0,0
116673,2472,4,63,61,2,5,1,0
0,0,0,0,0,0,0,0,0
0,0,0,0,0,0,0,0,0
268608,1868,3,442,18,424,5,1,0
0,0,0,0,0,0,0,0,0
0,0,0,0,0,0,0,0,0
0,0,0,0,0,0,0,0,0
9973,126,7,22,14,8,0,1,0
7732,118,6,23,15,8,0,1,0
0,0,0,0,0,0,0,0,0
97076,756,5,133,122,11,17,0,0
280421,1044,7,45,18,27,8,1,0
0,0,0,0,0,0,0,0,0
0,0,0,0,0,0,0,0,0
0,0,0,0,0,0,0,0,0
199940,1120,16,207,185,22,7,1,0
0,0,0,0,0,0,0,0,0
0,0,0,0,0,0,0,0,0
585,5,0,0,0,0,0,0,1
446680,1128,7,163,87,76,11,1,0
0,0,0,0,0,0,0,0,0
0,0,0,0,0,0,0,0,0
0,0,0,0,0,0,0,0,0
0,0,0,0,0,0,0,0,0
0,0,0,0,0,0,0,0,0
102990,1097,8,193,186,7,2,1,0
119670,1390,6,193,187,6,3,0,0
459031,4181,4,877,866,11,4,1,0
0,0,0,0,0,0,0,0,0
172843,566,10,106,106,0,6,0,0
54987,917,4,178,173,5,1,0,0
31673,507,8,151,135,16,0,1,0
39279,381,8,46,33,13,3,0,0
25515,175,7,37,30,7,1,0,0
0,0,0,0,0,0,0,0,0
0,0,0,0,0,0,0,0,0
182318,351,7,28,26,2,13,1,0
83914,647,5,131,122,9,8,0,0
0,0,0,0,0,0,0,0,0
0,0,0,0,0,0,0,0,0
161499,843,3,162,154,8,8,1,0
76527,256,3,52,46,6,7,1,0
0,0,0,0,0,0,0,0,0
0,0,0,0,0,0,0,0,0
102165,743,10,105,60,45,9,1,0
8872,113,1,23,14,9,0,1,0
122232,1728,12,330,306,24,2,1,0
20829,424,10,129,115,14,0,1,0
30710,312,2,5,2,3,6,1,0
153617,1243,13,309,302,7,3,1,0
203169,2198,13,336,327,9,7,1,0
59847,388,2,86,73,13,1,1,0
52126,315,3,48,35,13,3,1,0
57924,858,2,114,77,37,5,1,0
68521,404,8,40,39,1,0,1,0
36649,242,0,37,30,7,2,1,0
0,0,0,0,0,0,0,0,0
0,0,0,0,0,0,0,0,0
21451,183,4,40,39,1,1,1,0
39290,626,0,119,108,11,0,1,0
0,0,0,0,0,0,0,0,0
0,0,0,0,0,0,0,0,0
21865,33,0,1,1,0,0,1,0
709308,2620,8,231,162,69,14,1,0
178288,1376,10,306,95,211,30,1,0
0,0,0,0,0,0,0,0,0
366438,734,3,44,36,8,3,1,0
349679,1741,2,332,199,133,126,1,0
170503,1069,7,254,246,8,2,1,0
127954,1186,5,228,222,6,80,1,0
373076,1666,2,70,51,19,2,1,0
22411,334,4,76,52,24,8,1,0
36716,437,7,108,106,2,3,1,0
136147,1059,7,201,188,13,17,1,0
116374,986,6,179,164,15,15,1,0
232784,1588,13,240,226,14,18,0,0
0,0,0,0,0,0,0,0,0
0,0,0,0,0,0,0,0,0
27687,42,0,2,1,1,0,0,0
0,0,0,0,0,0,0,0,0
319678,3439,14,607,497,110,12,0,0
0,0,0,0,0,0,0,0,0
406338,3123,19,195,171,24,22,1,0
59391,310,6,29,21,8,1,0,0
0,0,0,0,0,0,0,0,0
2262,41,1,2,0,2,0,0,0
0,0,0,0,0,0,0,0,0
0,0,0,0,0,0,0,0,0
543294,1530,9,182,136,46,14,1,0
0,0,0,0,0,0,0,0,0
0,0,0,0,0,0,0,0,0
0,0,0,0,0,0,0,0,0
0,0,0,0,0,0,0,0,0
22720,37,0,2,1,1,0,1,0
0,0,0,0,0,0,0,0,0
328521,779,11,88,86,2,3,1,0
60026,910,3,209,185,24,7,0,0
0,0,0,0,0,0,0,0,0
0,0,0,0,0,0,0,0,0
57314,1397,7,207,203,4,1,0,0
191964,623,11,82,67,15,24,1,0
0,0,0,0,0,0,0,0,0
1168263,11782,4,371,362,9,3,1,0
254680,1178,11,220,214,6,15,1,0
79342,547,2,55,48,7,0,1,0
41401,257,3,18,18,0,2,1,0
392934,1458,15,188,156,32,10,1,0
0,0,0,0,0,0,0,0,0
16874,31,0,1,1,0,0,1,0
134776,608,13,47,6,41,7,0,0
0,0,0,0,0,0,0,0,0
84727,1588,4,403,400,3,0,1,0
0,0,0,0,0,0,0,0,0
108333,323,9,51,51,0,3,1,0
0,0,0,0,0,0,0,0,0
83087,1148,8,234,211,23,10,1,0
38784,411,6,71,67,4,8,1,0
0,0,0,0,0,0,0,0,0
79958,754,11,158,132,26,9,1,0
55694,589,0,114,110,4,0,1,0
24602,277,0,74,71,3,2,1,0
175139,1247,10,252,230,22,1,1,0
14254,171,3,107,105,2,1,1,0
180331,4000,1,2669,2666,3,4,1,0
13301,190,1,34,33,1,3,1,0
0,0,0,0,0,0,0,0,0
0,0,0,0,0,0,0,0,0
0,0,0,0,0,0,0,0,0
58483,580,3,120,107,13,2,1,0
199428,768,11,108,104,4,11,1,0
172962,371,9,73,70,3,0,1,0
0,0,0,0,0,0,0,0,0
0,0,0,0,0,0,0,0,0
0,0,0,0,0,0,0,0,0
151166,542,5,88,78,10,0,1,0
0,0,0,0,0,0,0,0,0
181009,1229,5,210,180,30,0,1,0
38040,440,9,91,88,3,2,1,0
24553,281,9,58,54,4,1,1,0
234119,1796,15,324,56,268,16,0,0
180083,1241,15,250,234,16,16,0,0
254325,2073,6,203,203,0,78,1,0
0,0,0,0,0,0,0,0,0
21932,242,0,10,8,2,1,0,0
0,0,0,0,0,0,0,0,0
113923,1185,9,276,273,3,2,0,0
68298,573,9,137,134,3,2,0,0
490232,1224,3,327,309,18,6,1,0
15542,271,2,32,32,0,1,0,0
7052,147,2,27,27,0,1,0,0
539601,149,4,20,20,0,0,1,0
544152,155,5,11,11,0,0,1,0
0,0,0,0,0,0,0,0,0
63780,672,10,99,91,8,1,1,0
291570,360,4,53,52,1,3,1,0
33060,399,1,82,82,0,3,1,0
3524,72,0,21,21,0,0,1,0
137262,113,6,3,3,0,0,1,0
134247,1131,10,213,203,10,3,1,0
64272,568,4,131,123,8,11,1,0
0,0,0,0,0,0,0,0,0
274025,2181,6,273,236,37,20,1,0
108284,715,9,156,152,4,0,1,0
39707,501,4,0,0,0,2,1,0
0,0,0,0,0,0,0,0,0
0,0,0,0,0,0,0,0,0
0,0,0,0,0,0,0,0,0
0,0,0,0,0,0,0,0,0
415814,2611,14,286,265,21,3,1,0
376856,2359,14,274,257,17,3,1,0
0,0,0,0,0,0,0,0,0
0,0,0,0,0,0,0,0,0
164659,1207,10,213,192,21,7,1,0
0,0,0,0,0,0,0,0,0
31260,139,8,10,9,1,0,1,0
51553,374,2,48,44,4,4,0,0
244130,1428,0,218,203,15,40,1,0
0,0,0,0,0,0,0,0,0
0,0,0,0,0,0,0,0,0
0,0,0,0,0,0,0,0,0
188367,681,8,66,26,40,3,1,0
311848,1398,3,170,166,4,4,1,0
0,0,0,0,0,0,0,0,0
0,0,0,0,0,0,0,0,0
0,0,0,0,0,0,0,0,0
0,0,0,0,0,0,0,0,0
0,0,0,0,0,0,0,0,0
0,0,0,0,0,0,0,0,0
74804,792,3,135,135,0,0,0,0
74804,792,3,135,135,0,0,0,0
21767,33,0,1,1,0,0,1,0
447126,2793,6,699,478,221,5,0,0
0,0,0,0,0,0,0,0,0
881944,2596,14,448,384,64,9,1,0
742130,2074,13,380,314,66,9,1,0
125397,708,11,128,52,76,2,1,0
13150,153,3,16,16,0,2,1,0
10539,115,3,13,13,0,2,1,0
24304,159,6,13,10,3,0,1,0
0,0,0,0,0,0,0,0,0
258730,731,11,83,42,41,33,1,0
23738,109,6,15,10,5,1,1,0
0,0,0,0,0,0,0,0,0
166487,1745,5,380,339,41,13,1,0
22741,37,0,2,1,1,0,1,0
0,0,0,0,0,0,0,0,0
24979,188,3,11,11,0,2,1,0
35515,349,4,36,32,4,1,0,0
199869,678,4,119,107,12,7,1,0
188183,538,4,79,67,12,7,1,0
0,0,0,0,0,0,0,0,0
615885,1981,14,284,238,46,16,0,0
628113,962,2,243,236,7,10,1,0
0,0,0,0,0,0,0,0,0
456178,1458,6,134,131,3,7,1,0
22023,35,0,1,1,0,0,1,0
9379,203,7,45,42,3,0,0,0
933423,2159,7,291,203,88,36,1,0
27039,348,5,60,50,10,0,1,0
0,0,0,0,0,0,0,0,0
72342,664,8,176,170,6,13,1,0
173458,781,14,177,173,4,8,1,0
5818,63,2,8,7,1,0,0,0
0,0,0,0,0,0,0,0,0
0,0,0,0,0,0,0,0,0
53479,1112,1,171,151,20,1,1,0
0,0,0,0,0,0,0,0,0
0,0,0,0,0,0,0,0,0
252217,2110,6,182,136,46,8,1,0
61001,330,10,41,37,4,2,1,0
0,0,0,0,0,0,0,0,0
292957,1116,10,156,125,31,7,1,0
0,0,0,0,0,0,0,0,0
0,0,0,0,0,0,0,0,0
86489,835,4,86,65,21,8,1,0
2839,56,0,1,1,0,0,0,0
86016,793,5,137,103,34,0,1,0
675528,2891,2,245,189,56,6,1,0
309308,1201,2,190,142,48,6,1,0
113207,468,0,48,45,3,8,1,0
0,0,0,0,0,0,0,0,0
0,0,0,0,0,0,0,0,0
643081,2845,12,365,312,53,24,1,0
190856,1149,10,195,143,52,4,1,0
98576,721,8,127,114,13,3,1,0
0,0,0,0,0,0,0,0,0
105072,369,7,50,49,1,1,1,0
89639,753,1,129,128,1,0,0,0
15923,282,2,38,38,0,0,0,0
25531,335,6,52,52,0,1,1,0
0,0,0,0,0,0,0,0,0
0,0,0,0,0,0,0,0,0
158198,920,10,201,200,1,3,0,0
2286331,2277,3,302,243,59,30,1,0
0,0,0,0,0,0,0,0,0
53047,437,5,125,118,7,16,1,0
0,0,0,0,0,0,0,0,0
15601,274,1,29,23,6,1,1,0
12480,76,2,11,11,0,0,1,0
46397,684,5,135,129,6,8,1,0
528723,1550,10,66,65,1,40,1,0
883571,3493,14,401,383,18,4,1,0
445254,1697,12,265,258,7,5,1,0
478284,1308,1,97,94,3,0,1,0
0,0,0,0,0,0,0,0,0
77015,673,9,104,91,13,0,1,0
0,0,0,0,0,0,0,0,0
0,0,0,0,0,0,0,0,0
217321,1739,10,194,181,13,13,0,0
121446,1086,6,175,168,7,0,1,0
90095,98,0,12,5,7,0,1,0
118138,2572,2,326,322,4,18,1,0
0,0,0,0,0,0,0,0,0
0,0,0,0,0,0,0,0,0
1093413,1035,10,94,84,10,17,1,0
0,0,0,0,0,0,0,0,0
0,0,0,0,0,0,0,0,0
68497,1175,3,303,288,15,6,0,0
56404,1034,2,281,274,7,6,0,0
173633,1510,11,246,237,9,17,1,0
237189,1755,4,433,431,2,7,0,0
144724,1739,0,81,77,4,1,0,0
330355,2134,4,194,194,0,1,1,0
5312,51,3,8,1,7,0,1,0
0,0,0,0,0,0,0,0,0
0,0,0,0,0,0,0,0,0
0,0,0,0,0,0,0,0,0
998898,315,6,7,2,5,0,1,0
26553,36,0,3,1,2,0,0,0
327055,2068,18,343,312,31,63,1,0
0,0,0,0,0,0,0,0,0
0,0,0,0,0,0,0,0,0
179302,1199,8,338,319,19,57,1,0
549951,1404,10,273,222,51,11,1,0
360107,2108,12,394,378,16,18,1,0
138827,611,6,72,53,19,0,1,0
0,0,0,0,0,0,0,0,0
245996,1452,9,408,403,5,67,0,0
68187,224,8,14,14,0,19,0,0
1049,12,1,0,0,0,0,0,0
0,0,0,0,0,0,0,0,0
0,0,0,0,0,0,0,0,0
449312,3145,2,286,277,9,3,1,0
117285,731,12,49,43,6,7,1,0
158896,1321,2,147,95,52,39,1,0
0,0,0,0,0,0,0,0,0
146339,2393,1,462,461,1,2,1,0
17253,215,1,32,32,0,1,1,0
61211,400,7,30,30,0,18,1,0
0,0,0,0,0,0,0,0,0
0,0,0,0,0,0,0,0,0
0,0,0,0,0,0,0,0,0
35843,283,8,32,14,18,8,1,0
12779,257,5,54,53,1,0,0,0
1074093,2255,10,392,346,46,25,1,0
1201395,1544,10,199,154,45,27,1,0
35065,551,7,67,67,0,1,1,0
828795,7398,6,186,157,29,89,1,0
51441,517,3,97,90,7,1,1,0
199871,1131,3,351,348,3,16,1,0
39853,171,1,67,67,0,1,1,0
0,0,0,0,0,0,0,0,0
0,0,0,0,0,0,0,0,0
338284,2643,7,538,523,15,8,1,0
108881,1479,3,341,335,6,0,1,0
0,0,0,0,0,0,0,0,0
138647,297,5,47,47,0,0,1,0
206465,696,14,91,78,13,1,0,0
1273248,4646,2,298,172,126,0,1,0
212935,311,2,35,34,1,1,1,0
82836,330,1,40,8,32,6,1,0
79469,151,5,11,1,10,0,1,0
166641,768,2,223,211,12,3,1,0
58269,799,5,168,153,15,12,1,0
0,0,0,0,0,0,0,0,0
0,0,0,0,0,0,0,0,0
0,0,0,0,0,0,0,0,0
553012,1936,9,403,393,10,6,1,0
130636,892,4,145,131,14,1,1,0
0,0,0,0,0,0,0,0,0
0,0,0,0,0,0,0,0,0
0,0,0,0,0,0,0,0,0
0,0,0,0,0,0,0,0,0
353692,1634,17,253,245,8,17,1,0
256315,870,17,142,134,8,16,1,0
0,0,0,0,0,0,0,0,0
369858,23,3,0,0,0,0,1,0
369581,2367,1,406,15,391,1,1,0
9989,122,3,10,10,0,1,1,0
0,0,0,0,0,0,0,0,0
251745,1035,16,134,126,8,5,1,0
0,0,0,0,0,0,0,0,0
0,0,0,0,0,0,0,0,0
0,0,0,0,0,0,0,0,0
112051,580,1,78,66,12,0,1,0
37411,147,2,2,2,0,0,1,0
56882,623,5,137,129,8,12,1,0
0,0,0,0,0,0,0,0,0
26088,311,4,55,49,6,4,1,0
10691,144,2,30,30,0,1,1,0
614828,2552,16,242,224,18,5,0,0
0,0,0,0,0,0,0,0,0
22038,36,0,1,1,0,0,1,0
0,0,0,0,0,0,0,0,0
46597,203,3,32,32,0,2,1,0
0,0,0,0,0,0,0,0,0
430396,2719,13,318,200,118,9,1,0
177362,793,14,108,104,4,8,0,0
0,0,0,0,0,0,0,0,0
778,31,0,6,6,0,0,0,0
0,0,0,0,0,0,0,0,0
1302,18,0,0,0,0,0,0,0
199268,1893,2,323,313,10,2,1,0
3570,63,1,5,5,0,0,1,0
0,0,0,0,0,0,0,0,0
0,0,0,0,0,0,0,0,0
121806,473,2,66,53,13,0,0,0
584812,2022,14,353,339,14,12,1,0
105093,1060,7,284,268,16,6,1,0
820915,4152,6,326,255,71,10,1,0
237881,1106,7,172,166,6,12,1,0
0,0,0,0,0,0,0,0,0
138224,430,7,65,61,4,5,1,0
138224,452,7,67,63,4,5,1,0
0,0,0,0,0,0,0,0,0
539687,2151,1,226,222,4,13,1,0
0,0,0,0,0,0,0,0,0
3673866,31375,7,3217,1730,1487,25,0,0
47110,132,8,3,0,3,0,1,0
0,0,0,0,0,0,0,0,0
0,0,0,0,0,0,0,0,0
1984,33,0,3,3,0,0,0,0
0,0,0,0,0,0,0,0,0
288325,4321,2,1281,1271,10,129,0,0
414568,1654,12,298,298,0,12,1,0
122782,1670,1,204,196,8,36,0,0
3350,50,4,1,1,0,0,0,0
0,0,0,0,0,0,0,0,0
20995,294,5,56,50,6,0,1,0
39924,623,3,163,160,3,0,0,0
23422,240,1,38,14,24,0,0,0
22707,319,5,90,88,2,1,1,0
0,0,0,0,0,0,0,0,0
92389,1209,13,245,241,4,3,0,0
168242,876,4,64,40,24,18,1,0
0,0,0,0,0,0,0,0,0
443862,2776,12,577,570,7,5,1,0
359730,2463,12,538,531,7,5,1,0
0,0,0,0,0,0,0,0,0
93177,927,4,202,202,0,3,1,0
0,0,0,0,0,0,0,0,0
51308,282,7,54,53,1,0,0,0
0,0,0,0,0,0,0,0,0
442921,848,6,178,173,5,3,1,0
452235,416,11,50,34,16,2,1,0
0,0,0,0,0,0,0,0,0
11283,344,2,29,27,2,7,1,0
4439,96,2,17,17,0,0,1,0
217647,2656,8,338,333,5,5,1,0
25287,408,8,74,69,5,0,1,0
41307,578,2,140,139,1,4,1,0
10955,90,8,9,5,4,2,0,0
0,0,0,0,0,0,0,0,0
533081,1724,8,172,154,18,23,1,0
1706623,11829,7,269,259,10,66,1,0
1555713,10245,7,166,154,12,65,1,0
997028,1430,2,145,128,17,0,1,0
163853,332,2,6,2,4,0,0,0
0,0,0,0,0,0,0,0,0
0,0,0,0,0,0,0,0,0
0,0,0,0,0,0,0,0,0
0,0,0,0,0,0,0,0,0
550342,3660,9,153,124,29,10,1,0
66335,345,4,51,41,10,0,1,0
0,0,0,0,0,0,0,0,0
584308,3145,9,180,102,78,58,0,0
721189,537,0,4,0,4,2,1,1
682031,1276,3,148,139,9,1,0,0
0,0,0,0,0,0,0,0,0
0,0,0,0,0,0,0,0,0
50085,639,3,53,52,1,4,1,0
23445,135,1,11,11,0,0,0,0
72840,711,9,212,188,24,9,0,0
3006,50,0,2,2,0,0,0,0
86356,966,4,83,83,0,9,0,0
0,0,0,0,0,0,0,0,0
167476,996,13,107,20,87,10,1,0
176188,1129,8,246,235,11,10,1,0
489380,7129,3,435,415,20,12,1,0
44067,687,5,135,135,0,1,1,0
43346,687,5,135,135,0,1,1,0
474085,3677,14,671,633,38,14,1,0
457630,125,3,7,6,1,0,0,0
0,0,0,0,0,0,0,0,0
0,0,0,0,0,0,0,0,0
37395,320,7,33,11,22,1,1,0
8893,107,8,14,11,3,0,1,0
0,0,0,0,0,0,0,0,0
0,0,0,0,0,0,0,0,0
3746,75,2,8,8,0,0,1,0
0,0,0,0,0,0,0,0,0
0,0,0,0,0,0,0,0,0
188365,1534,8,204,197,7,12,1,0
102859,834,7,123,90,33,19,1,0
38444,315,6,57,51,6,0,1,0
322587,4417,10,677,670,7,4,1,0
95084,1447,11,452,448,4,6,1,0
411912,2715,8,393,351,42,22,1,0
246115,1248,7,115,82,33,8,1,0
4716,48,2,0,0,0,1,0,0
1147954,11014,7,112,99,13,2,0,0
0,0,0,0,0,0,0,0,0
0,0,0,0,0,0,0,0,0
319778,2671,8,274,263,11,17,1,0
201863,985,6,79,64,15,1,1,0
148499,431,7,41,34,7,5,1,0
0,0,0,0,0,0,0,0,0
88053,644,9,106,105,1,1,1,0
0,0,0,0,0,0,0,0,0
0,0,0,0,0,0,0,0,0
92467,1041,2,60,33,27,2,1,0
89060,904,4,58,36,22,28,1,0
314923,950,6,138,129,9,9,1,0
26320,404,1,25,21,4,0,1,0
0,0,0,0,0,0,0,0,0
289778,3956,4,518,503,15,0,1,0
0,0,0,0,0,0,0,0,0
27777,272,4,32,27,5,2,0,0
43809,883,4,191,189,2,4,1,0
0,0,0,0,0,0,0,0,0
0,0,0,0,0,0,0,0,0
108641,1121,5,314,314,0,7,1,0
0,0,0,0,0,0,0,0,0
142441,1796,2,450,445,5,3,0,0
6031,46,0,4,0,4,0,0,0
52234,669,5,141,132,9,6,1,0
79459,471,3,51,41,10,0,1,0
9054,110,0,16,14,2,2,1,0
0,0,0,0,0,0,0,0,0
0,0,0,0,0,0,0,0,0
0,0,0,0,0,0,0,0,0
305205,2271,5,253,243,10,3,0,0
135241,1220,5,165,155,10,3,0,0
0,0,0,0,0,0,0,0,0
84611,743,2,315,315,0,4,1,0
188212,1742,10,342,218,124,13,1,0
305982,1692,20,429,420,9,6,1,0
87514,510,8,15,9,6,1,1,0
0,0,0,0,0,0,0,0,0
0,0,0,0,0,0,0,0,0
8796,42,0,0,0,0,0,0,0
1041708,1751,12,520,506,14,7,1,0
82005,968,2,83,75,8,2,1,0
0,0,0,0,0,0,0,0,0
84397,695,6,112,111,1,3,1,0
50009,330,4,22,21,1,3,1,0
375552,4008,10,305,295,10,15,1,0
622075,4684,8,671,631,40,4,1,0
273529,2124,7,470,469,1,2,1,0
0,0,0,0,0,0,0,0,0
224177,1093,7,99,84,15,5,1,1
126646,192,7,8,8,0,2,0,0
20591,225,3,38,32,6,1,1,0
15526,157,3,25,19,6,1,1,0
561189,2112,7,273,265,8,62,1,0
459457,1326,7,196,190,6,6,1,0
0,0,0,0,0,0,0,0,0
0,0,0,0,0,0,0,0,0
0,0,0,0,0,0,0,0,0
0,0,0,0,0,0,0,0,0
24025,129,8,24,23,1,0,1,0
0,0,0,0,0,0,0,0,0
112755,624,8,237,229,8,14,1,0
14931,276,4,59,50,9,0,1,0
879,16,1,2,0,2,0,0,0
0,0,0,0,0,0,0,0,0
0,0,0,0,0,0,0,0,0
476601,460,18,95,89,6,1,1,0
0,0,0,0,0,0,0,0,0
0,0,0,0,0,0,0,0,0
0,0,0,0,0,0,0,0,0
973667,920,5,191,176,15,2,1,0
324868,1663,7,206,198,8,5,1,0
0,0,0,0,0,0,0,0,0
4727,55,0,1,1,0,0,0,0
16257,289,0,35,34,1,0,1,0
0,0,0,0,0,0,0,0,0
29656,402,3,79,66,13,2,1,0
44872,385,7,55,21,34,0,1,0
52267,243,6,39,30,9,0,1,0
36501,56,7,2,2,0,0,0,0
0,0,0,0,0,0,0,0,0
0,0,0,0,0,0,0,0,0
73161,517,8,66,59,7,3,1,0
8057,73,6,3,2,1,0,0,0
0,0,0,0,0,0,0,0,0
272059,2160,9,206,198,8,4,1,0
130004,760,9,107,100,7,4,1,0
0,0,0,0,0,0,0,0,0
0,0,0,0,0,0,0,0,0
0,0,0,0,0,0,0,0,0
0,0,0,0,0,0,0,0,0
54521,407,1,89,80,9,0,1,0
0,0,0,0,0,0,0,0,0
0,0,0,0,0,0,0,0,0
0,0,0,0,0,0,0,0,0
311338,2229,15,178,163,15,0,1,0
33446,231,4,5,4,1,2,1,0
23684,35,0,2,1,1,0,1,0
0,0,0,0,0,0,0,0,0
0,0,0,0,0,0,0,0,0
8095,93,2,39,38,1,1,1,0
0,0,0,0,0,0,0,0,0
0,0,0,0,0,0,0,0,0
0,0,0,0,0,0,0,0,0
607507,2555,5,378,342,36,2,1,0
134003,1057,14,223,210,13,67,0,0
59824,415,9,81,74,7,5,1,0
50524,326,4,77,59,18,9,0,0
20636,253,3,56,38,18,6,0,0
562442,2474,16,298,277,21,50,1,0
160855,1072,13,152,137,15,8,1,0
45377,456,12,56,52,4,1,0,0
285383,1820,13,472,466,6,18,1,0
341053,1723,7,241,133,108,21,1,0
0,0,0,0,0,0,0,0,0
0,0,0,0,0,0,0,0,0
60448,450,7,61,57,4,4,1,0
289870,1088,1,183,181,2,39,1,0
0,0,0,0,0,0,0,0,0
0,0,0,0,0,0,0,0,0
742321,1224,1,97,78,19,0,1,0
7085,106,3,3,3,0,1,0,0
175607,3980,5,884,856,28,15,1,0
56345,667,13,58,29,29,2,1,0
52339,471,5,62,56,6,9,1,0
25395,185,5,18,15,3,3,1,0
0,0,0,0,0,0,0,0,0
0,0,0,0,0,0,0,0,0
58810,732,6,108,103,5,1,0,0
43940,458,7,95,91,4,1,1,0
488491,1069,12,182,162,20,3,1,0
28202,46,0,4,1,3,0,0,0
176244,1289,5,97,74,23,6,1,0
65557,541,1,185,177,8,15,1,0
17816,72,0,5,2,3,0,1,0
0,0,0,0,0,0,0,0,0
0,0,0,0,0,0,0,0,0
0,0,0,0,0,0,0,0,0
15702,206,2,30,19,11,0,0,0
64392,417,13,70,70,0,2,1,0
0,0,0,0,0,0,0,0,0
52281,460,2,108,106,2,9,1,0
70285,821,8,214,202,12,8,1,0
56795,606,6,134,134,0,12,1,1
86938,1360,6,129,122,7,5,1,0
11685,183,4,26,22,4,0,1,0
0,0,0,0,0,0,0,0,0
11273,118,1,13,12,1,0,1,0
0,0,0,0,0,0,0,0,0
0,0,0,0,0,0,0,0,0
0,0,0,0,0,0,0,0,0
948549,2687,3,461,452,9,3,1,0
678311,544,4,11,8,3,3,1,0
64414,1062,1,215,213,2,3,1,0
433926,2810,3,113,98,15,0,1,0
63546,41,0,4,4,0,0,0,0
208122,1075,17,202,186,16,9,1,0
0,0,0,0,0,0,0,0,0
188026,2278,2,44,43,1,24,1,0
0,0,0,0,0,0,0,0,0
518505,1376,11,155,133,22,23,1,0
0,0,0,0,0,0,0,0,0
129384,654,7,62,59,3,2,1,0
0,0,0,0,0,0,0,0,0
115097,1381,4,319,299,20,0,1,0
0,0,0,0,0,0,0,0,0
260733,1957,4,730,684,46,12,1,0
205575,1695,4,592,547,45,11,1,0
0,0,0,0,0,0,0,0,0
0,0,0,0,0,0,0,0,0
0,0,0,0,0,0,0,0,0
0,0,0,0,0,0,0,0,0
0,0,0,0,0,0,0,0,0
0,0,0,0,0,0,0,0,0
0,0,0,0,0,0,0,0,0
0,0,0,0,0,0,0,0,0
171854,1805,6,419,406,13,3,1,1
0,0,0,0,0,0,0,0,0
197131,1327,9,265,252,13,12,1,0
492501,1607,18,46,45,1,36,1,0
28307,300,16,49,43,6,2,1,0
17060,80,12,4,4,0,2,0,0
119519,1181,8,146,124,22,2,1,0
1595,28,1,1,0,1,0,0,0
0,0,0,0,0,0,0,0,0
0,0,0,0,0,0,0,0,0
111549,461,5,67,47,20,4,1,0
0,0,0,0,0,0,0,0,0
87004,1070,9,131,124,7,3,1,0
324194,1994,12,288,263,25,20,1,0
609328,3410,9,395,382,13,6,0,0
305134,1980,4,212,184,28,27,0,0
25812,134,4,10,8,2,1,1,0
448412,2969,5,467,402,65,5,0,0
379473,2396,5,421,356,65,5,0,0
0,0,0,0,0,0,0,0,0
26908,473,3,127,89,38,0,1,0
391852,195,4,40,35,5,0,1,0
87003,388,8,23,20,3,7,1,0
192628,546,3,48,40,8,0,1,0
0,0,0,0,0,0,0,0,0
0,0,0,0,0,0,0,0,0
86500,570,7,82,77,5,4,1,0
59540,183,9,2,1,1,6,0,0
0,0,0,0,0,0,0,0,0
380687,1592,8,275,166,109,33,1,0
0,0,0,0,0,0,0,0,0
0,0,0,0,0,0,0,0,0
0,0,0,0,0,0,0,0,0
0,0,0,0,0,0,0,0,0
0,0,0,0,0,0,0,0,0
1821,31,0,0,0,0,0,0,0
1480219,2221,9,337,325,12,19,1,0
0,0,0,0,0,0,0,0,0
0,0,0,0,0,0,0,0,0
0,0,0,0,0,0,0,0,0
372107,2502,10,416,360,56,61,1,0
59219,581,11,74,61,13,9,1,0
0,0,0,0,0,0,0,0,0
104057,1723,8,32,26,6,5,1,0
30742,238,2,42,41,1,4,1,0
0,0,0,0,0,0,0,0,0
0,0,0,0,0,0,0,0,0
115729,1043,0,291,291,0,24,1,0
0,0,0,0,0,0,0,0,0
157367,653,4,98,91,7,2,1,0
0,0,0,0,0,0,0,0,0
0,0,0,0,0,0,0,0,0
167762,515,0,62,62,0,9,0,0
0,0,0,0,0,0,0,0,0
0,0,0,0,0,0,0,0,0
0,0,0,0,0,0,0,0,0
0,0,0,0,0,0,0,0,0
445483,2493,9,605,594,11,9,1,0
228598,566,8,98,92,6,8,1,0
28826,464,6,162,162,0,2,1,0
0,0,0,0,0,0,0,0,0
0,0,0,0,0,0,0,0,0
0,0,0,0,0,0,0,0,0
137129,1356,9,207,197,10,9,1,0
454573,5542,0,505,505,0,0,0,0
89251,1475,8,199,132,67,1,1,0
0,0,0,0,0,0,0,0,0
0,0,0,0,0,0,0,0,0
23026,37,0,2,1,1,0,1,0
323326,1263,6,176,149,27,1,1,0
229078,1643,9,300,271,29,2,1,0
506144,3847,6,1120,1110,10,4,1,0
393746,3015,6,992,982,10,6,1,0
95973,938,6,223,223,0,1,0,0
369847,2115,8,108,69,39,1,1,0
205585,1326,3,328,312,16,22,0,0
63229,500,0,90,84,6,1,1,0
91365,732,6,77,68,9,0,0,0
52318,603,6,115,108,7,7,1,0
5039,183,0,89,83,6,0,0,0
100078,2349,1,989,988,1,0,0,0
177847,369,7,46,45,1,0,1,0
397247,2987,18,201,34,167,69,0,0
102226,894,11,191,184,7,0,1,0
249630,1852,8,334,322,12,15,1,1
642261,2479,6,401,396,5,0,1,0
0,0,0,0,0,0,0,0,0
52094,731,4,145,138,7,1,1,0
140389,1076,6,142,135,7,3,0,0
81605,446,11,26,20,6,2,1,0
116665,340,6,57,57,0,11,1,0
0,0,0,0,0,0,0,0,0
0,0,0,0,0,0,0,0,0
71733,528,8,142,22,120,0,0,0
0,0,0,0,0,0,0,0,0
162476,1787,4,205,199,6,1,1,0
129078,905,10,213,183,30,10,1,0
0,0,0,0,0,0,0,0,0
82722,239,3,20,17,3,0,0,0
0,0,0,0,0,0,0,0,0
587854,3717,5,288,282,6,87,1,0
414827,1729,6,152,146,6,32,1,0
0,0,0,0,0,0,0,0,0
0,0,0,0,0,0,0,0,0
0,0,0,0,0,0,0,0,0
111252,728,9,154,135,19,3,1,0
0,0,0,0,0,0,0,0,0
265283,1593,6,238,224,14,4,1,0
262284,770,12,100,87,13,2,1,0
17807,232,5,59,51,8,0,1,0
17807,232,5,59,51,8,0,1,0
0,0,0,0,0,0,0,0,0
94484,554,13,66,61,5,3,1,0
0,0,0,0,0,0,0,0,0
0,0,0,0,0,0,0,0,0
0,0,0,0,0,0,0,0,0
35215,365,4,58,50,8,0,1,0
19818,169,4,33,29,4,2,1,0
433565,2710,7,453,254,199,25,1,0
0,0,0,0,0,0,0,0,0
0,0,0,0,0,0,0,0,0
249681,3132,11,962,932,30,25,1,0
9654,118,1,17,17,0,0,1,0
23939,40,0,2,2,0,0,0,0
47561,304,6,76,51,25,0,1,0
95547,1295,7,270,254,16,9,1,0
42931,257,5,22,8,14,3,1,0
0,0,0,0,0,0,0,0,0
2576,44,1,7,4,3,0,1,0
0,0,0,0,0,0,0,0,0
0,0,0,0,0,0,0,0,0
161372,457,5,67,62,5,1,1,0
35944,193,2,11,5,6,5,1,0
0,0,0,0,0,0,0,0,0
2086,27,3,1,1,0,0,0,0
0,0,0,0,0,0,0,0,0
585,5,0,0,0,0,0,0,1
0,0,0,0,0,0,0,0,0
0,0,0,0,0,0,0,0,0
127680,1096,2,88,67,21,5,1,0
0,0,0,0,0,0,0,0,0
196694,3493,2,970,967,3,0,0,0
16190,76,0,1,1,0,0,0,0
416325,2785,4,609,570,39,49,1,0
293074,2438,6,454,69,385,3,0,0
0,0,0,0,0,0,0,0,0
0,0,0,0,0,0,0,0,0
0,0,0,0,0,0,0,0,0
0,0,0,0,0,0,0,0,0
0,0,0,0,0,0,0,0,0
87112,1810,2,565,509,56,23,0,0
0,0,0,0,0,0,0,0,0
3905855,33568,12,3769,2188,1581,23,1,0
47110,132,8,3,0,3,0,1,0
0,0,0,0,0,0,0,0,0
140434,1247,6,195,143,52,6,1,0
97880,1185,6,159,128,31,6,1,0
904923,3092,6,457,128,329,22,1,0
120398,303,10,44,33,11,1,1,0
398759,2767,11,596,593,3,1,1,0
0,0,0,0,0,0,0,0,0
197842,777,4,56,46,10,1,1,0
350258,404,3,11,3,8,1,1,0
563776,5686,4,456,441,15,72,1,0
0,0,0,0,0,0,0,0,0
227262,1559,2,258,244,14,2,0,0
35733,457,2,71,69,2,7,1,0
28382,342,2,57,52,5,7,1,0
42531,370,3,82,76,6,0,1,0
27379,162,2,29,24,5,4,1,0
190746,1318,10,264,251,13,9,1,0
61708,1464,3,381,349,32,3,1,0
0,0,0,0,0,0,0,0,0
0,0,0,0,0,0,0,0,0
0,0,0,0,0,0,0,0,0
154825,1939,6,518,504,14,27,0,0
0,0,0,0,0,0,0,0,0
453408,3065,5,488,427,61,5,0,0
376495,2409,5,433,372,61,5,0,0
54711,968,4,302,277,25,4,0,0
22855,36,0,2,1,1,0,1,0
208927,953,8,122,4,118,0,1,0
30597,567,1,105,81,24,3,1,0
0,0,0,0,0,0,0,0,0
22825,502,0,87,43,44,0,1,0
0,0,0,0,0,0,0,0,0
0,0,0,0,0,0,0,0,0
0,0,0,0,0,0,0,0,0
758600,3388,8,289,271,18,140,1,0
7171,103,1,14,12,2,1,0,0
150336,691,2,18,16,2,14,1,0
0,0,0,0,0,0,0,0,0
84256,355,6,44,42,2,9,1,0
0,0,0,0,0,0,0,0,0
53062,780,3,104,100,4,2,1,0
241700,2148,4,662,649,13,4,0,0
180157,1532,5,509,497,12,3,0,0
2940,26,0,2,1,1,0,0,0
67154,418,2,38,34,4,1,1,0
77965,211,2,38,34,4,1,1,0
0,0,0,0,0,0,0,0,0
248924,1336,5,172,168,4,12,1,0
44758,240,3,24,24,0,7,0,0
199018,519,5,36,36,0,0,1,0
0,0,0,0,0,0,0,0,0
0,0,0,0,0,0,0,0,0
113094,237,6,16,12,4,0,1,0
0,0,0,0,0,0,0,0,0
50244,611,4,131,131,0,4,1,0
44996,385,7,55,19,36,0,1,0
152538,1074,3,129,126,3,0,0,0
0,0,0,0,0,0,0,0,0
0,0,0,0,0,0,0,0,0
0,0,0,0,0,0,0,0,0
311914,479,5,46,39,7,4,1,0
0,0,0,0,0,0,0,0,0
0,0,0,0,0,0,0,0,0
0,0,0,0,0,0,0,0,0
0,0,0,0,0,0,0,0,0
0,0,0,0,0,0,0,0,0
41704,311,5,45,44,1,9,1,0
0,0,0,0,0,0,0,0,0
61014,827,1,253,214,39,4,0,0
123359,1993,5,322,283,39,9,1,0
78406,137,0,1,1,0,9,0,0
152964,691,9,60,55,5,1,0,0
0,0,0,0,0,0,0,0,0
0,0,0,0,0,0,0,0,0
234107,829,2,78,71,7,1,1,0
0,0,0,0,0,0,0,0,0
168741,1543,11,205,154,51,10,0,0
16606,333,4,99,93,6,4,0,0
47449,320,5,72,43,29,7,0,0
535590,7632,9,2104,1941,163,29,1,0
36475,655,7,164,162,2,5,1,0
104149,450,10,68,68,0,2,1,0
175577,881,2,124,115,9,1,1,0
0,0,0,0,0,0,0,0,0
32716,332,8,24,13,11,45,1,0
23947,398,3,74,70,4,0,1,0
167146,554,5,83,77,6,7,1,0
0,0,0,0,0,0,0,0,0
0,0,0,0,0,0,0,0,0
46182,665,4,185,183,2,13,1,0
144665,1197,9,155,119,36,3,1,0
584011,6542,7,1070,1056,14,12,1,0
75149,561,13,61,58,3,1,1,0
57547,340,12,35,32,3,1,1,0
850110,2896,4,538,522,16,1,1,0
9959,131,0,5,4,1,0,0,0
0,0,0,0,0,0,0,0,0
0,0,0,0,0,0,0,0,0
0,0,0,0,0,0,0,0,0
0,0,0,0,0,0,0,0,0
29932,367,1,65,61,4,4,1,0
34406,536,6,91,56,35,0,1,0
34006,499,2,184,167,17,0,1,0
23346,240,3,68,66,2,0,1,0
31902,284,2,66,65,1,0,1,0
0,0,0,0,0,0,0,0,0
0,0,0,0,0,0,0,0,0
14519,206,1,58,53,5,0,1,0
0,0,0,0,0,0,0,0,0
0,0,0,0,0,0,0,0,0
70338,743,8,119,100,19,7,1,0
183877,882,14,140,121,19,2,1,0
0,0,0,0,0,0,0,0,0
0,0,0,0,0,0,0,0,0
218320,1173,5,300,293,7,0,1,0
0,0,0,0,0,0,0,0,0
0,0,0,0,0,0,0,0,0
406402,878,7,101,91,10,2,1,0
0,0,0,0,0,0,0,0,0
79616,591,11,108,69,39,2,1,0
48090,163,4,4,4,0,3,0,0
349661,838,8,101,92,9,17,1,0
148265,1903,0,312,262,50,1,1,0
0,0,0,0,0,0,0,0,0
102261,2088,1,517,517,0,0,0,0
187379,1567,9,413,409,4,1,1,0
0,0,0,0,0,0,0,0,0
92467,1041,2,60,33,27,2,1,0
69373,482,8,48,44,4,2,1,0
69375,482,8,48,44,4,2,1,0
193660,1697,6,260,254,6,4,0,0
0,0,0,0,0,0,0,0,0
47302,448,5,56,56,0,7,1,0
26214,163,5,21,21,0,7,1,0
35369,448,6,110,71,39,0,1,0
13441,229,3,33,26,7,1,0,0
35699,448,6,79,44,35,0,1,0
16931,197,7,37,29,8,0,1,0
80838,744,8,213,192,21,0,1,0
0,0,0,0,0,0,0,0,0
0,0,0,0,0,0,0,0,0
0,0,0,0,0,0,0,0,0
131249,1023,5,90,87,3,1,1,0
743892,3033,3,878,866,12,0,1,0
167949,507,8,94,82,12,5,1,0
9360,111,3,12,12,0,0,1,0
0,0,0,0,0,0,0,0,0
44765,520,4,136,130,6,1,1,0
0,0,0,0,0,0,0,0,0
0,0,0,0,0,0,0,0,0
9063,190,3,24,19,5,0,1,0
0,0,0,0,0,0,0,0,0
0,0,0,0,0,0,0,0,0
493679,2318,7,730,688,42,1,0,0
99125,799,11,140,131,9,0,0,0
0,0,0,0,0,0,0,0,0
0,0,0,0,0,0,0,0,0
19585,51,3,6,1,5,0,1,0
0,0,0,0,0,0,0,0,0
0,0,0,0,0,0,0,0,0
84705,557,8,159,149,10,5,0,0
0,0,0,0,0,0,0,0,0
0,0,0,0,0,0,0,0,0
22863,37,0,2,1,1,0,1,0
665389,7278,7,2794,2790,4,3,1,0
0,0,0,0,0,0,0,0,0
50778,716,2,139,111,28,3,1,0
68659,713,5,167,160,7,2,1,0
186566,2737,1,410,399,11,1,1,0
103113,136,3,17,17,0,0,1,0
168555,629,2,96,69,27,1,1,0
44622,133,3,2,2,0,1,0,0
0,0,0,0,0,0,0,0,0
86589,775,8,58,39,19,0,1,0
0,0,0,0,0,0,0,0,0
0,0,0,0,0,0,0,0,0
1694401,11327,11,1635,1576,59,43,1,0
1439305,5004,10,90,84,6,17,0,0
0,0,0,0,0,0,0,0,0
1825,39,1,3,3,0,0,1,0
0,0,0,0,0,0,0,0,0
434589,2084,16,251,231,20,27,1,0
153362,1081,12,157,143,14,8,1,0
25631,337,6,63,63,0,2,1,0
23674,319,5,59,59,0,0,1,0
44860,213,4,36,26,10,1,0,0
0,0,0,0,0,0,0,0,0
36318,687,5,83,80,3,0,1,0
0,0,0,0,0,0,0,0,0
0,0,0,0,0,0,0,0,0
57104,353,9,69,68,1,0,1,0
0,0,0,0,0,0,0,0,0
2089892,4026,8,619,614,5,11,1,0
33388,578,1,168,168,0,3,1,0
0,0,0,0,0,0,0,0,0
91592,1070,15,82,74,8,17,1,0
73607,693,7,112,96,16,23,1,0
41257,355,6,85,85,0,3,1,0
505724,2787,7,310,208,102,74,1,0
75072,615,7,37,33,4,0,1,0
48217,376,7,59,35,24,9,1,0
0,0,0,0,0,0,0,0,0
0,0,0,0,0,0,0,0,0
57011,501,7,96,84,12,2,1,0
68064,529,3,115,0,115,0,1,0
0,0,0,0,0,0,0,0,0
72486,1032,2,195,166,29,0,1,0
20167,150,2,5,4,1,0,1,0
0,0,0,0,0,0,0,0,0
0,0,0,0,0,0,0,0,0
0,0,0,0,0,0,0,0,0
241474,2105,5,136,127,9,7,1,0
70430,415,5,44,37,7,5,1,0
63644,716,2,202,199,3,5,1,0
31111,335,1,49,49,0,5,1,0
0,0,0,0,0,0,0,0,0
0,0,0,0,0,0,0,0,0
198094,1173,8,166,150,16,15,1,0
174485,799,8,143,124,19,5,1,0
0,0,0,0,0,0,0,0,0
0,0,0,0,0,0,0,0,0
0,0,0,0,0,0,0,0,0
0,0,0,0,0,0,0,0,0
102359,668,6,145,142,3,10,1,0
80109,644,3,397,395,2,0,0,0
0,0,0,0,0,0,0,0,0
173458,2219,8,292,280,12,49,1,0
168815,575,1,8,6,2,10,1,0
84502,486,11,52,33,19,4,1,0
0,0,0,0,0,0,0,0,0
161136,447,4,67,65,2,1,1,0
181934,1275,4,246,235,11,2,1,0
109232,1385,5,199,188,11,6,1,0
0,0,0,0,0,0,0,0,0
207323,432,9,82,71,11,3,1,0
16091,187,1,33,29,4,0,0,0
195,7,0,1,1,0,0,0,0
270114,3665,1,1024,899,125,129,1,0
34142,282,2,64,63,1,3,0,0
54994,530,3,37,37,0,0,1,0
12802,141,3,0,0,0,3,0,0
537361,1725,13,76,74,2,36,1,0
57925,472,2,89,86,3,1,1,0
0,0,0,0,0,0,0,0,0
70092,502,5,101,92,9,0,1,0
1122672,10201,2,2319,2315,4,16,1,0
94262,655,2,92,88,4,5,1,0
0,0,0,0,0,0,0,0,0
33645,357,6,47,46,1,0,1,0
0,0,0,0,0,0,0,0,0
0,0,0,0,0,0,0,0,0
0,0,0,0,0,0,0,0,0
32067,99,1,0,0,0,1,1,0
59961,826,1,43,33,10,0,1,0
13210,140,2,20,18,2,0,1,0
329176,3366,1,578,553,25,3,1,0
14456,275,3,58,57,1,1,1,0
0,0,0,0,0,0,0,0,0
27782,42,0,2,1,1,0,0,0
33645,139,8,18,10,8,1,1,0
33645,139,8,18,9,9,1,1,0
114397,741,2,166,160,6,12,1,0
0,0,0,0,0,0,0,0,0
0,0,0,0,0,0,0,0,0
61279,884,9,118,118,0,4,1,0
0,0,0,0,0,0,0,0,0
1122573,5613,14,427,351,76,12,1,0
143729,975,12,226,219,7,4,1,0
91330,991,4,244,238,6,0,0,0
30125,248,4,42,38,4,0,0,0
0,0,0,0,0,0,0,0,0
0,0,0,0,0,0,0,0,0
0,0,0,0,0,0,0,0,0
0,0,0,0,0,0,0,0,0
0,0,0,0,0,0,0,0,0
0,0,0,0,0,0,0,0,0
0,0,0,0,0,0,0,0,0
157878,93,0,2,1,1,1,1,0
0,0,0,0,0,0,0,0,0
127678,865,7,181,181,0,0,0,0
178731,1277,6,381,340,41,0,0,0
38920,342,5,25,14,11,0,1,0
0,0,0,0,0,0,0,0,0
467503,937,6,24,9,15,0,1,0
61419,389,6,55,53,2,0,0,0
0,0,0,0,0,0,0,0,0
0,0,0,0,0,0,0,0,0
31624,183,5,33,33,0,0,1,0
0,0,0,0,0,0,0,0,0
0,0,0,0,0,0,0,0,0
0,0,0,0,0,0,0,0,0
0,0,0,0,0,0,0,0,0
0,0,0,0,0,0,0,0,0
156604,1037,11,19,17,2,0,1,0
366185,3409,6,316,295,21,26,1,0
109241,548,6,82,67,15,0,1,0
0,0,0,0,0,0,0,0,0
57247,440,5,75,75,0,0,0,0
0,0,0,0,0,0,0,0,0
456793,4360,5,384,373,11,0,1,0
278469,193,0,0,0,0,1,1,0
0,0,0,0,0,0,0,0,0
0,0,0,0,0,0,0,0,0
0,0,0,0,0,0,0,0,0
92911,1294,7,166,147,19,6,1,0
55273,399,11,64,62,2,6,1,0
64789,1066,3,265,259,6,6,0,0
77739,552,11,103,100,3,3,1,0
839967,1251,5,116,111,5,8,1,0
408489,2828,12,600,572,28,50,1,0
0,0,0,0,0,0,0,0,0
0,0,0,0,0,0,0,0,0
175010,141,0,5,5,0,0,0,0
243641,1676,6,210,203,7,6,1,0
104455,708,3,156,155,1,8,1,0
12224,314,1,73,71,2,0,1,0
0,0,0,0,0,0,0,0,0
0,0,0,0,0,0,0,0,0
50175,264,4,47,36,11,0,1,0
0,0,0,0,0,0,0,0,0
0,0,0,0,0,0,0,0,0
0,0,0,0,0,0,0,0,0
0,0,0,0,0,0,0,0,0
318123,2993,7,405,292,113,8,1,0
252488,1259,7,184,168,16,5,1,0
177907,1025,7,58,57,1,0,1,0
0,0,0,0,0,0,0,0,0
17330,301,4,65,10,55,3,0,0
69147,390,0,76,34,42,0,1,0
60789,416,3,58,56,2,8,0,0
109472,198,4,22,16,6,3,0,0
0,0,0,0,0,0,0,0,0
33525,31,0,0,0,0,0,0,0
230190,985,8,156,130,26,11,0,0
101138,922,11,157,143,14,4,1,0
24659,328,8,63,54,9,2,1,0
152360,913,4,207,207,0,1,0,0
68918,1928,2,567,567,0,2,1,0
242289,1023,4,245,241,4,0,1,0
327779,2342,13,370,351,19,12,0,0
0,0,0,0,0,0,0,0,0
215542,1117,4,141,124,17,1,1,0
0,0,0,0,0,0,0,0,0
47517,381,5,21,13,8,0,1,0
403232,2445,5,396,364,32,22,1,0
0,0,0,0,0,0,0,0,0
32574,577,7,103,73,30,3,0,0
109623,219,5,47,41,6,0,1,0
248964,1020,6,135,119,16,3,1,0
0,0,0,0,0,0,0,0,0
268372,719,2,95,78,17,1,1,0
236523,482,2,84,69,15,0,1,0
0,0,0,0,0,0,0,0,0
0,0,0,0,0,0,0,0,0
119740,608,11,75,0,75,10,1,0
66467,947,1,197,188,9,2,1,0
0,0,0,0,0,0,0,0,0
705542,2342,6,488,419,69,16,1,0
315179,526,6,80,57,23,13,1,0
181,5,0,1,1,0,0,0,0
0,0,0,0,0,0,0,0,0
214920,2985,3,786,745,41,1,0,0
36542,436,3,36,17,19,1,0,0
298978,2578,10,206,205,1,45,1,0
142221,965,10,124,123,1,3,1,0
78599,532,12,122,122,0,4,1,0
0,0,0,0,0,0,0,0,0
92555,899,8,135,116,19,3,0,0
135984,742,10,121,18,103,3,1,0
0,0,0,0,0,0,0,0,0
0,0,0,0,0,0,0,0,0
58626,820,7,145,98,47,8,1,0
3707,36,3,2,0,2,0,0,0
14014,109,2,10,9,1,0,0,0
0,0,0,0,0,0,0,0,0
48248,355,3,52,43,9,0,1,0
6914,45,0,3,3,0,0,0,0
0,0,0,0,0,0,0,0,0
0,0,0,0,0,0,0,0,0
0,0,0,0,0,0,0,0,0
0,0,0,0,0,0,0,0,0
1690085,1358,3,105,103,2,2,1,0
193754,553,2,83,72,11,1,0,0
240598,994,7,44,40,4,1,1,0
53115,562,8,122,84,38,3,0,0
0,0,0,0,0,0,0,0,0
0,0,0,0,0,0,0,0,0
37329,458,4,43,42,1,2,1,0
1817,35,0,1,1,0,0,1,0
107990,224,6,8,6,2,0,1,0
0,0,0,0,0,0,0,0,0
82215,1486,3,235,175,60,0,1,0
21361,180,3,48,48,0,0,0,0
814868,1831,12,207,176,31,3,1,0
16208,125,8,8,7,1,0,1,0
281009,1479,11,221,65,156,6,1,0
94741,1507,3,367,362,5,3,0,0
0,0,0,0,0,0,0,0,0
272035,865,1,289,273,16,0,1,0
0,0,0,0,0,0,0,0,0
0,0,0,0,0,0,0,0,0
456572,343,1,15,15,0,3,0,0
0,0,0,0,0,0,0,0,0
0,0,0,0,0,0,0,0,0
0,0,0,0,0,0,0,0,0
155425,1707,11,427,412,15,21,1,0
128048,1785,8,226,204,22,4,1,0
0,0,0,0,0,0,0,0,0
0,0,0,0,0,0,0,0,0
165485,911,4,62,56,6,4,0,0
75336,487,11,128,121,7,8,1,0
93860,467,12,80,67,13,10,1,0
45603,792,3,323,321,2,0,1,0
6362,120,2,23,22,1,0,1,0
0,0,0,0,0,0,0,0,0
0,0,0,0,0,0,0,0,0
60220,441,6,38,36,2,15,1,0
168202,590,3,112,106,6,2,1,1
0,0,0,0,0,0,0,0,0
583205,7184,1,2057,2047,10,26,0,0
31995,399,3,70,43,27,3,1,0
86811,659,3,115,106,9,13,1,0
0,0,0,0,0,0,0,0,0
83110,518,9,50,39,11,5,1,0
390229,1976,4,189,177,12,41,1,0
0,0,0,0,0,0,0,0,0
359899,5402,13,705,692,13,7,1,0
54092,354,8,55,55,0,0,0,0
79704,455,8,58,53,5,2,0,0
0,0,0,0,0,0,0,0,0
0,0,0,0,0,0,0,0,0
0,0,0,0,0,0,0,0,0
0,0,0,0,0,0,0,0,0
272979,572,4,91,83,8,6,1,0
213233,1191,9,135,104,31,17,1,0
49141,78,5,2,2,0,0,0,0
0,0,0,0,0,0,0,0,0
34515,347,7,29,29,0,2,0,0
0,0,0,0,0,0,0,0,0
0,0,0,0,0,0,0,0,0
54761,446,6,112,110,2,0,1,0
0,0,0,0,0,0,0,0,0
730697,3523,9,218,94,124,3,1,0
450366,3692,14,762,734,28,43,1,0
0,0,0,0,0,0,0,0,0
0,0,0,0,0,0,0,0,0
0,0,0,0,0,0,0,0,0
0,0,0,0,0,0,0,0,0
296037,1653,19,155,148,7,23,1,0
178748,2312,5,139,68,71,0,0,0
10914,89,5,5,5,0,1,0,0
125396,2181,8,586,510,76,48,1,0
64546,1545,5,534,468,66,46,1,0
0,0,0,0,0,0,0,0,0
187142,1497,5,412,407,5,0,1,0
50724,367,6,62,62,0,6,1,0
0,0,0,0,0,0,0,0,0
0,0,0,0,0,0,0,0,0
0,0,0,0,0,0,0,0,0
0,0,0,0,0,0,0,0,0
11171,171,1,46,45,1,0,0,0
0,0,0,0,0,0,0,0,0
0,0,0,0,0,0,0,0,0
69587,1291,6,291,290,1,1,1,0
0,0,0,0,0,0,0,0,0
0,0,0,0,0,0,0,0,0
0,0,0,0,0,0,0,0,0
151002,1372,11,188,182,6,3,1,0
8098,68,6,3,2,1,0,0,0
148972,1539,12,351,343,8,74,1,0
0,0,0,0,0,0,0,0,0
28928,45,0,4,1,3,0,0,0
1024658,1717,7,94,85,9,0,1,0
747733,3528,11,915,907,8,69,1,0
0,0,0,0,0,0,0,0,0
287640,1631,14,259,243,16,8,1,0
35666,536,2,34,31,3,0,1,0
260316,3045,7,343,337,6,38,1,0
325606,3122,8,397,378,19,32,1,0
0,0,0,0,0,0,0,0,0
525018,1846,7,126,98,28,35,1,0
138908,1111,10,10,6,4,4,0,0
1909526,1710,4,89,37,52,0,1,0
159247,665,4,45,38,7,23,1,0
0,0,0,0,0,0,0,0,0
0,0,0,0,0,0,0,0,0
0,0,0,0,0,0,0,0,0
145,5,0,0,0,0,0,0,0
0,0,0,0,0,0,0,0,0
159495,1246,19,218,188,30,6,1,0
50731,292,4,55,3,52,5,1,0
0,0,0,0,0,0,0,0,0
95161,696,5,95,93,2,0,1,0
174897,1718,10,465,452,13,6,1,0
0,0,0,0,0,0,0,0,0
151978,1721,5,249,238,11,12,1,0
120549,1358,5,427,418,9,9,1,0
13501,8,0,0,0,0,0,0,0
22098,33,0,1,1,0,0,1,0
0,0,0,0,0,0,0,0,0
0,0,0,0,0,0,0,0,0
205055,1706,5,116,110,6,3,1,0
22099,35,0,1,1,0,0,1,0
45663,691,4,249,247,2,2,1,0
298897,599,4,80,58,22,0,1,0
0,0,0,0,0,0,0,0,0
87346,796,8,188,176,12,6,1,0
55603,669,8,165,155,10,7,1,0
0,0,0,0,0,0,0,0,0
582002,5702,10,92,82,10,9,1,0
0,0,0,0,0,0,0,0,0
63566,579,6,35,18,17,10,1,0
221043,748,1,230,120,110,1,1,0
1862423,266,6,21,15,6,4,1,0
0,0,0,0,0,0,0,0,0
285007,1528,9,156,147,9,2,0,0
0,0,0,0,0,0,0,0,0
432631,2822,10,348,319,29,28,1,0
0,0,0,0,0,0,0,0,0
756409,2232,2,104,85,19,1,1,0
0,0,0,0,0,0,0,0,0
231605,1460,10,96,74,22,1,1,0
542395,2985,13,977,971,6,4,1,0
0,0,0,0,0,0,0,0,0
0,0,0,0,0,0,0,0,0
103091,1724,4,233,214,19,18,1,0
0,0,0,0,0,0,0,0,0
0,0,0,0,0,0,0,0,0
5018,101,1,15,11,4,0,1,0
0,0,0,0,0,0,0,0,0
0,0,0,0,0,0,0,0,0
4856,35,4,3,1,2,0,1,0
206292,1127,7,271,262,9,5,1,0
335790,3992,12,1286,1269,17,10,0,0
324939,817,0,221,220,1,0,1,0
178794,74,6,4,4,0,0,1,0
0,0,0,0,0,0,0,0,0
258238,1137,5,195,190,5,0,1,0
151088,869,12,116,110,6,9,1,0
0,0,0,0,0,0,0,0,0
0,0,0,0,0,0,0,0,0
0,0,0,0,0,0,0,0,0
0,0,0,0,0,0,0,0,0
0,0,0,0,0,0,0,0,0
764415,427,6,11,8,3,0,1,0
248381,1354,14,211,180,31,1,1,0
0,0,0,0,0,0,0,0,0
93222,1537,2,511,494,17,0,1,0
21667,361,2,153,147,6,0,1,0
173601,2209,7,132,113,19,3,1,0
223406,180,0,47,37,10,1,1,0
270925,76,0,5,0,5,0,0,0
21944,33,0,1,1,0,0,1,0
439913,646,4,22,18,4,4,1,0
441137,496,6,19,15,4,2,1,0
0,0,0,0,0,0,0,0,0
0,0,0,0,0,0,0,0,0
91070,459,1,14,12,2,11,1,0
0,0,0,0,0,0,0,0,0
1341471,1065,15,141,108,33,6,1,0
5162,33,1,0,0,0,0,0,0
67034,1170,3,281,266,15,6,0,0
0,0,0,0,0,0,0,0,0
211251,2706,8,416,398,18,2,0,0
69885,616,9,125,122,3,3,0,0
0,0,0,0,0,0,0,0,0
99055,449,7,106,102,4,9,1,0
0,0,0,0,0,0,0,0,0
511330,2112,9,158,139,19,77,1,0
0,0,0,0,0,0,0,0,0
0,0,0,0,0,0,0,0,0
113741,646,7,117,109,8,6,1,0
102943,984,0,89,83,6,1,0,1
180616,1306,8,278,243,35,5,1,0
30472,349,4,72,72,0,2,0,0
0,0,0,0,0,0,0,0,0
0,0,0,0,0,0,0,0,0
0,0,0,0,0,0,0,0,0
23456,523,2,94,68,26,25,0,0
0,0,0,0,0,0,0,0,0
0,0,0,0,0,0,0,0,0
44313,533,2,174,148,26,1,0,0
0,0,0,0,0,0,0,0,0
213655,1046,10,107,105,2,2,1,0
0,0,0,0,0,0,0,0,0
0,0,0,0,0,0,0,0,0
66299,566,4,54,54,0,22,0,0
71261,747,1,122,109,13,2,1,1
0,0,0,0,0,0,0,0,0
201823,410,7,48,46,2,6,1,0
192610,248,7,38,37,1,3,1,0
249119,1643,1,92,73,19,4,1,0
145727,650,1,13,7,6,0,1,0
0,0,0,0,0,0,0,0,0
11227,58,0,3,3,0,0,0,0
0,0,0,0,0,0,0,0,0
133625,795,12,84,22,62,3,0,0
314421,1082,8,138,131,7,6,1,0
0,0,0,0,0,0,0,0,0
373055,2698,11,119,111,8,2,1,0
0,0,0,0,0,0,0,0,0
0,0,0,0,0,0,0,0,0
564765,2872,6,409,383,26,59,1,0
301092,1806,6,382,372,10,43,1,0
25035,526,5,153,147,6,0,1,0
0,0,0,0,0,0,0,0,0
0,0,0,0,0,0,0,0,0
0,0,0,0,0,0,0,0,0
0,0,0,0,0,0,0,0,0
0,0,0,0,0,0,0,0,0
0,0,0,0,0,0,0,0,0
239642,1294,9,219,179,40,8,1,0
0,0,0,0,0,0,0,0,0
145810,1487,2,296,255,41,0,1,0
103177,700,6,82,65,17,1,0,0
835523,6787,5,3045,3029,16,0,0,0
815837,6637,5,3009,2999,10,2,0,0
57199,238,3,23,23,0,7,0,0
0,0,0,0,0,0,0,0,0
0,0,0,0,0,0,0,0,0
0,0,0,0,0,0,0,0,0
0,0,0,0,0,0,0,0,0
99948,1853,8,65,31,34,16,0,1
0,0,0,0,0,0,0,0,0
0,0,0,0,0,0,0,0,0
64371,770,2,154,96,58,2,1,0
0,0,0,0,0,0,0,0,0
138276,864,5,72,59,13,82,1,0
157487,1152,5,253,253,0,76,1,0
408222,2872,11,436,70,366,46,1,0
316678,1846,5,257,236,21,15,1,0
0,0,0,0,0,0,0,0,0
164330,687,11,107,103,4,2,1,0
0,0,0,0,0,0,0,0,0
81983,1626,8,351,339,12,0,1,0
60660,1196,9,304,294,10,2,1,0
57118,385,6,144,19,125,0,0,0
58737,612,6,135,127,8,0,0,0
0,0,0,0,0,0,0,0,0
0,0,0,0,0,0,0,0,0
125826,514,12,50,46,4,5,1,0
0,0,0,0,0,0,0,0,0
48788,811,7,80,78,2,3,0,0
22330,265,7,42,42,0,3,0,0
0,0,0,0,0,0,0,0,0
0,0,0,0,0,0,0,0,0
155567,1087,3,210,201,9,2,1,0
51108,508,7,44,8,36,4,1,0
271736,765,9,131,110,21,7,1,0
0,0,0,0,0,0,0,0,0
249010,2340,7,328,324,4,957,0,0
272665,349,10,38,2,36,1,1,0
258105,338,12,43,38,5,2,1,0
23281,286,1,6,4,2,0,1,0
0,0,0,0,0,0,0,0,0
500331,16176,6,7751,7750,1,6,1,0
11376,70,4,3,3,0,1,0,0
0,0,0,0,0,0,0,0,0
169323,2123,3,459,450,9,8,0,0
28590,227,3,46,45,1,9,0,0
0,0,0,0,0,0,0,0,0
48034,924,2,159,149,10,7,0,0
8689,78,6,7,7,0,0,0,0
295874,2911,9,327,302,25,31,0,0
0,0,0,0,0,0,0,0,0
0,0,0,0,0,0,0,0,0
945037,1458,10,148,135,13,7,1,0
0,0,0,0,0,0,0,0,0
754996,4885,5,608,531,77,151,1,0
262793,1908,5,285,280,5,45,1,0
75375,1058,13,236,188,48,1,1,0
124429,967,17,126,100,26,25,1,0
241011,877,1,161,156,5,4,1,0
163400,330,1,74,24,50,0,1,0
0,0,0,0,0,0,0,0,0
0,0,0,0,0,0,0,0,0
216252,1613,7,530,478,52,9,1,1
400476,4523,12,1014,988,26,21,1,0
0,0,0,0,0,0,0,0,0
37086,441,3,47,35,12,3,0,0
47783,526,6,54,44,10,6,1,0
13271,306,0,89,43,46,0,1,0
3897,105,0,25,25,0,0,1,0
49444,220,5,28,15,13,0,1,0
0,0,0,0,0,0,0,0,0
0,0,0,0,0,0,0,0,0
202187,2883,8,1051,1033,18,10,1,0
28282,404,5,12,12,0,3,1,0
100249,424,0,57,2,55,2,1,0
0,0,0,0,0,0,0,0,0
0,0,0,0,0,0,0,0,0
0,0,0,0,0,0,0,0,0
0,0,0,0,0,0,0,0,0
638282,5033,8,470,454,16,1,1,0
73022,738,9,174,173,1,1,0,0
0,0,0,0,0,0,0,0,0
0,0,0,0,0,0,0,0,0
49824,381,11,60,40,20,15,1,0
119162,2002,3,400,387,13,0,0,0
20623,459,3,148,134,14,2,1,0
3367,43,2,2,2,0,0,0,0
0,0,0,0,0,0,0,0,0
178208,625,14,69,63,6,1,1,0
26837,34,0,2,1,1,0,0,0
0,0,0,0,0,0,0,0,0
0,0,0,0,0,0,0,0,0
0,0,0,0,0,0,0,0,0
83540,396,3,29,4,25,0,1,0
270262,545,1,69,64,5,7,1,0
0,0,0,0,0,0,0,0,0
0,0,0,0,0,0,0,0,0
0,0,0,0,0,0,0,0,0
40324,306,8,37,31,6,3,1,0
154466,1344,7,208,202,6,3,1,0
0,0,0,0,0,0,0,0,0
0,0,0,0,0,0,0,0,0
677983,557,0,4,0,4,2,1,1
1115098,767,2,49,39,10,5,1,0
0,0,0,0,0,0,0,0,0
68300,411,6,11,11,0,2,1,0
800101,4669,11,632,623,9,45,1,0
325870,1816,11,350,343,7,10,1,0
1682,28,0,0,0,0,0,0,1
3510,73,0,4,4,0,0,1,0
42222,954,4,62,61,1,2,0,0
409218,4237,9,1034,963,71,3,1,0
0,0,0,0,0,0,0,0,0
700615,1144,7,196,180,16,0,1,0
8685,41,2,0,0,0,0,0,0
0,0,0,0,0,0,0,0,0
0,0,0,0,0,0,0,0,0
22858,264,5,50,43,7,16,1,1
197100,1095,6,119,116,3,2,1,0
0,0,0,0,0,0,0,0,0
135127,639,9,150,146,4,11,1,0
0,0,0,0,0,0,0,0,0
24687,467,3,87,69,18,2,1,0
67448,627,10,142,136,6,3,1,0
0,0,0,0,0,0,0,0,0
0,0,0,0,0,0,0,0,0
0,0,0,0,0,0,0,0,0
84941,636,8,168,164,4,1,1,0
942941,8684,13,133,126,7,7,1,0
892951,8241,12,120,112,8,7,1,0
62965,447,15,48,13,35,4,1,0
0,0,0,0,0,0,0,0,0
22157,35,0,1,1,0,0,1,0
13614,203,0,28,22,6,0,1,0
0,0,0,0,0,0,0,0,0
0,0,0,0,0,0,0,0,0
189041,2511,6,799,792,7,4,1,0
0,0,0,0,0,0,0,0,0
4277,56,3,7,7,0,1,0,0
0,0,0,0,0,0,0,0,0
0,0,0,0,0,0,0,0,0
213449,1227,7,90,83,7,4,1,0
38274,675,3,121,115,6,1,1,0
4013,44,2,3,2,1,0,0,0
61319,736,4,185,184,1,4,1,0
23843,122,4,3,3,0,4,0,0
0,0,0,0,0,0,0,0,0
0,0,0,0,0,0,0,0,0
0,0,0,0,0,0,0,0,0
201623,1355,5,208,187,21,17,1,0
316439,2378,3,474,444,30,6,1,0
38760,492,2,68,67,1,2,1,0
21713,292,2,37,36,1,1,1,0
0,0,0,0,0,0,0,0,0
0,0,0,0,0,0,0,0,0
105497,960,5,101,91,10,8,1,0
7715,40,4,0,0,0,0,0,0
345705,849,5,85,84,1,0,1,0
220844,2551,6,820,812,8,0,1,0
301527,1340,7,44,31,13,17,0,0
126870,1332,3,408,340,68,6,1,0
125133,780,9,202,155,47,7,1,0
31998,351,7,56,45,11,7,1,0
14379,221,5,23,23,0,15,1,0
41737,364,9,79,76,3,7,1,0
35353,315,9,69,66,3,2,1,0
0,0,0,0,0,0,0,0,0
0,0,0,0,0,0,0,0,0
40392,387,6,50,43,7,4,0,0
0,0,0,0,0,0,0,0,0
138092,929,8,100,98,2,0,1,0
8504,140,6,24,19,5,0,0,0
0,0,0,0,0,0,0,0,0
0,0,0,0,0,0,0,0,0
119770,1484,7,239,235,4,1,1,0
0,0,0,0,0,0,0,0,0
89608,683,7,209,208,1,3,0,0
303595,2209,15,141,106,35,21,1,0
224936,1022,7,266,228,38,3,1,0
1060557,1864,9,239,211,28,17,1,0
562590,5235,14,972,961,11,52,1,0
376285,3425,13,821,811,10,37,1,0
0,0,0,0,0,0,0,0,0
205534,2471,7,607,584,23,0,1,0
0,0,0,0,0,0,0,0,0
0,0,0,0,0,0,0,0,0
0,0,0,0,0,0,0,0,0
0,0,0,0,0,0,0,0,0
238050,2178,10,278,259,19,8,0,0
182850,1129,11,221,198,23,13,1,0
113262,593,9,86,81,5,10,1,0
86951,335,8,52,47,5,4,1,0
72494,573,9,58,43,15,1,0,0
452635,3511,8,606,595,11,9,1,0
0,0,0,0,0,0,0,0,0
141464,893,4,89,69,20,15,1,0
351040,1995,10,213,191,22,16,1,0
0,0,0,0,0,0,0,0,0
0,0,0,0,0,0,0,0,0
35087,555,2,198,189,9,0,0,0
0,0,0,0,0,0,0,0,0
46723,798,3,165,158,7,6,1,0
2212257,11367,2,379,371,8,10,1,0
7585,94,0,12,4,8,0,1,0
43129,253,4,35,25,10,0,1,0
0,0,0,0,0,0,0,0,0
141239,576,7,105,86,19,4,1,0
1115771,4799,4,479,454,25,143,1,0
258459,133,3,6,3,3,7,0,0
0,0,0,0,0,0,0,0,0
0,0,0,0,0,0,0,0,0
67474,531,9,92,84,8,4,1,0
0,0,0,0,0,0,0,0,0
156457,1115,6,223,219,4,3,1,0
22654,210,7,40,36,4,1,1,0
7830,89,4,23,23,0,0,1,0
0,0,0,0,0,0,0,0,0
90621,388,10,46,46,0,1,1,0
0,0,0,0,0,0,0,0,0
15951,241,4,26,26,0,2,0,0
0,0,0,0,0,0,0,0,0
0,0,0,0,0,0,0,0,0
0,0,0,0,0,0,0,0,0
161218,1980,11,139,82,57,13,1,0
0,0,0,0,0,0,0,0,0
68339,271,9,3,1,2,9,1,0
37488,729,3,251,251,0,1,1,0
611589,4294,17,416,384,32,51,1,0
336428,1591,15,312,299,13,12,1,0
161748,1457,7,122,113,9,1,1,0
57028,562,6,105,99,6,0,0,0
0,0,0,0,0,0,0,0,0
0,0,0,0,0,0,0,0,0
0,0,0,0,0,0,0,0,0
23272,294,3,66,37,29,0,1,0
88812,837,13,70,60,10,10,0,0
0,0,0,0,0,0,0,0,0
125718,2094,6,351,327,24,7,1,0
247353,1100,4,151,137,14,4,1,0
58342,92,4,2,2,0,1,0,0
584325,5828,9,1064,1057,7,32,1,0
0,0,0,0,0,0,0,0,0
0,0,0,0,0,0,0,0,0
72219,663,8,109,81,28,5,1,0
11309,63,4,2,2,0,0,0,0
179544,1339,9,416,399,17,4,0,0
4300,90,1,36,32,4,0,0,0
2755,68,2,11,11,0,0,0,0
0,0,0,0,0,0,0,0,0
287926,1482,8,104,103,1,15,1,0
413362,4085,1,833,832,1,1,1,0
0,0,0,0,0,0,0,0,0
48821,542,9,90,85,5,0,0,0
28252,199,9,32,28,4,0,0,0
521619,14334,5,3174,3174,0,0,1,0
0,0,0,0,0,0,0,0,0
100296,835,9,257,244,13,11,1,0
28269,42,0,2,1,1,0,0,0
8759,33,1,0,0,0,1,0,0
0,0,0,0,0,0,0,0,0
0,0,0,0,0,0,0,0,0
0,0,0,0,0,0,0,0,0
158636,699,8,151,145,6,0,1,0
0,0,0,0,0,0,0,0,0
752016,3646,10,887,880,7,4,1,0
265351,3107,8,404,400,4,10,0,0
0,0,0,0,0,0,0,0,0
0,0,0,0,0,0,0,0,0
1755267,6132,9,514,498,16,11,1,0
935925,4498,17,689,621,68,33,1,1
0,0,0,0,0,0,0,0,0
0,0,0,0,0,0,0,0,0
323476,1283,10,262,231,31,19,1,0
138134,980,6,206,178,28,26,1,0
41355,687,1,112,106,6,1,1,0
145914,943,11,168,146,22,4,1,0
36090,436,10,80,70,10,1,1,0
0,0,0,0,0,0,0,0,0
70432,993,0,265,244,21,3,0,0
134067,932,11,237,231,6,2,1,0
62804,763,0,195,192,3,6,1,1
0,0,0,0,0,0,0,0,0
102946,1313,2,247,244,3,1,0,0
0,0,0,0,0,0,0,0,0
120266,1505,8,231,189,42,1,0,0
146238,2000,7,321,311,10,5,1,0
7329,126,1,11,9,2,0,1,0
83122,732,6,155,139,16,9,0,0
2801,41,4,3,3,0,0,1,0
149397,1252,1,222,200,22,1,1,0
71129,909,3,142,137,5,1,1,0
0,0,0,0,0,0,0,0,0
58340,494,1,20,19,1,0,1,0
146493,2261,6,21,18,3,28,0,0
0,0,0,0,0,0,0,0,0
15614,280,0,35,30,5,0,1,0
186078,2322,4,510,506,4,1,1,0
87444,1045,3,312,308,4,0,1,0
179257,1774,6,178,168,10,95,1,0
99587,902,0,147,132,15,0,1,0
35738,416,0,71,67,4,0,1,0
244346,476,6,62,61,1,6,1,0
0,0,0,0,0,0,0,0,0
181590,1632,1,198,197,1,0,1,0
0,0,0,0,0,0,0,0,0
0,0,0,0,0,0,0,0,0
30234,408,6,114,110,4,5,1,0
81297,1285,8,171,164,7,9,1,0
0,0,0,0,0,0,0,0,0
149006,773,12,163,141,22,7,1,0
0,0,0,0,0,0,0,0,0
14825,188,6,11,11,0,0,0,1
14825,188,6,11,11,0,0,0,1
0,0,0,0,0,0,0,0,0
1399,15,0,1,0,1,0,0,0
121075,582,6,43,39,4,0,1,0
93889,950,3,77,48,29,9,0,0
0,0,0,0,0,0,0,0,0
181601,2030,6,462,462,0,7,0,0
129550,1353,3,201,192,9,0,1,0
37996,304,5,4,4,0,1,0,0
749641,5196,5,439,399,40,168,1,0
14438,221,2,58,57,1,10,1,0
9584,111,3,23,22,1,3,1,0
0,0,0,0,0,0,0,0,0
52395,262,1,20,20,0,8,1,0
0,0,0,0,0,0,0,0,0
0,0,0,0,0,0,0,0,0
0,0,0,0,0,0,0,0,0
56239,694,4,59,47,12,2,1,0
0,0,0,0,0,0,0,0,0
203707,1870,3,262,214,48,6,1,0
28344,303,4,65,55,10,5,1,0
11855,130,4,21,12,9,1,1,0
9937,70,0,3,2,1,0,0,0
0,0,0,0,0,0,0,0,0
0,0,0,0,0,0,0,0,0
25488,166,6,25,21,4,0,1,0
0,0,0,0,0,0,0,0,0
26887,264,4,32,30,2,3,1,0
8592,81,3,4,3,1,1,0,0
611032,610,7,107,95,12,5,1,0
27773,173,6,23,14,9,3,0,0
188686,2209,0,47,47,0,0,1,0
86353,275,0,37,37,0,0,1,0
214120,1408,5,175,140,35,1,1,0
266792,2746,8,1030,1029,1,18,1,0
58857,1242,6,22,20,2,3,0,0
0,0,0,0,0,0,0,0,0
62188,888,1,124,112,12,0,1,0
15552,193,1,52,47,5,1,1,0
293732,4027,2,696,694,2,1,1,0
124216,1477,9,220,141,79,5,0,0
5057,71,2,5,4,1,0,0,0
0,0,0,0,0,0,0,0,0
0,0,0,0,0,0,0,0,0
0,0,0,0,0,0,0,0,0
0,0,0,0,0,0,0,0,0
102938,473,6,81,58,23,2,1,0
126528,1494,13,214,209,5,1,1,0
0,0,0,0,0,0,0,0,0
312896,1356,6,154,146,8,26,1,0
127683,585,6,68,61,7,4,0,0
115993,328,4,36,18,18,0,1,0
85506,1148,11,101,93,8,0,1,0
30742,290,9,61,55,6,0,1,0
246886,1494,5,82,68,14,4,1,0
132576,681,5,117,1,116,27,1,0
130474,170,8,3,2,1,8,0,0
349112,2501,8,871,850,21,1,1,0
0,0,0,0,0,0,0,0,0
178768,584,8,89,88,1,2,1,0
0,0,0,0,0,0,0,0,0
212740,1264,6,135,130,5,16,1,0
103673,659,6,98,93,5,4,1,0
127043,586,3,81,12,69,0,1,0
22047,33,0,1,1,0,0,1,0
55156,520,5,33,14,19,0,1,0
261636,2533,2,205,192,13,3,1,0
174992,1200,11,287,270,17,19,1,0
48702,163,4,4,2,2,3,0,0
78785,794,7,152,151,1,2,1,0
0,0,0,0,0,0,0,0,0
181555,1532,3,359,352,7,1,1,0
29605,349,3,60,56,4,0,1,0
22175,236,4,33,33,0,3,1,0
682102,2403,11,244,210,34,11,1,0
0,0,0,0,0,0,0,0,0
35618,457,4,53,48,5,1,1,0
46545,340,4,25,15,10,0,1,0
0,0,0,0,0,0,0,0,0
0,0,0,0,0,0,0,0,0
934332,1608,8,382,382,0,27,1,0
897931,1207,9,190,189,1,27,1,0
0,0,0,0,0,0,0,0,0
0,0,0,0,0,0,0,0,0
0,0,0,0,0,0,0,0,0
0,0,0,0,0,0,0,0,0
298324,2699,12,212,164,48,1,1,0
33373,410,6,51,44,7,0,1,0
135834,792,7,67,58,9,23,1,0
357286,1501,13,178,147,31,83,1,0
84766,963,0,61,33,28,2,1,0
0,0,0,0,0,0,0,0,0
258989,383,6,10,6,4,0,1,0
123570,772,9,106,96,10,6,1,0
189224,2605,6,477,408,69,5,1,0
0,0,0,0,0,0,0,0,0
0,0,0,0,0,0,0,0,0
0,0,0,0,0,0,0,0,0
220599,892,11,70,65,5,7,1,0
0,0,0,0,0,0,0,0,0
237059,1446,13,222,199,23,3,1,0
96830,828,3,153,151,2,2,1,0
0,0,0,0,0,0,0,0,0
198250,1127,7,190,181,9,12,0,0
0,0,0,0,0,0,0,0,0
0,0,0,0,0,0,0,0,0
30757,497,8,147,122,25,0,1,0
418048,384,7,10,4,6,0,1,0
17593,337,3,144,144,0,4,0,0
40005,705,5,168,140,28,2,1,0
1017992,4386,7,125,100,25,11,1,0
12119,162,5,20,19,1,0,1,0
3605,31,3,2,2,0,0,0,0
0,0,0,0,0,0,0,0,0
0,0,0,0,0,0,0,0,0
75560,562,4,101,66,35,26,1,1
0,0,0,0,0,0,0,0,0
337008,600,10,45,27,18,15,1,0
129414,1610,3,328,312,16,4,0,0
59332,637,5,160,155,5,16,1,0
0,0,0,0,0,0,0,0,0
0,0,0,0,0,0,0,0,0
22051,419,2,118,92,26,1,1,0
0,0,0,0,0,0,0,0,0
143689,1383,5,129,129,0,2,1,0
0,0,0,0,0,0,0,0,0
125826,983,4,128,127,1,9,1,0
68597,514,4,93,93,0,9,1,0
10756,144,1,4,4,0,0,0,0
0,0,0,0,0,0,0,0,0
144700,1152,6,411,399,12,2,1,0
0,0,0,0,0,0,0,0,0
0,0,0,0,0,0,0,0,0
0,0,0,0,0,0,0,0,0
0,0,0,0,0,0,0,0,0
0,0,0,0,0,0,0,0,0
59039,707,1,152,150,2,7,1,0
0,0,0,0,0,0,0,0,0
51335,716,5,133,133,0,0,0,0
14558,153,7,28,28,0,0,0,0
0,0,0,0,0,0,0,0,0
0,0,0,0,0,0,0,0,0
75048,570,0,100,97,3,0,1,0
31566,619,2,168,157,11,0,1,0
36755,903,4,96,92,4,3,1,0
2464,34,0,1,1,0,0,0,0
0,0,0,0,0,0,0,0,0
364897,1352,8,233,223,10,38,1,0
66717,803,5,161,158,3,13,1,0
85686,586,9,77,11,66,3,0,0
4738,46,1,3,2,1,0,0,0
636706,3471,7,209,191,18,5,1,0
22699,268,3,55,40,15,0,1,0
40089,557,8,4,4,0,4,0,0
0,0,0,0,0,0,0,0,0
14202,192,7,42,33,9,0,0,0
0,0,0,0,0,0,0,0,0
12667,133,0,21,21,0,1,0,0
28303,42,0,2,1,1,0,0,0
16590,250,3,22,21,1,0,1,0
165020,296,0,13,7,6,36,0,0
0,0,0,0,0,0,0,0,0
88382,725,7,108,93,15,10,1,0
0,0,0,0,0,0,0,0,0
0,0,0,0,0,0,0,0,0
0,0,0,0,0,0,0,0,0
0,0,0,0,0,0,0,0,0
0,0,0,0,0,0,0,0,0
368803,1797,7,293,263,30,0,1,0
28022,351,1,106,105,1,0,0,0
0,0,0,0,0,0,0,0,0
0,0,0,0,0,0,0,0,0
265996,3634,1,1014,891,123,125,1,0
80904,1224,5,295,262,33,7,1,0
38387,402,7,22,22,0,10,0,0
1001205,5271,12,322,305,17,50,1,0
361360,1323,12,194,178,16,15,1,0
6551,114,3,12,0,12,0,1,0
0,0,0,0,0,0,0,0,0
270621,2344,14,290,66,224,3,1,0
345395,881,10,197,8,189,3,1,0
111327,1001,7,258,247,11,7,1,0
0,0,0,0,0,0,0,0,0
286080,1572,11,131,120,11,5,1,0
866003,51,4,0,0,0,0,1,0
89071,780,10,111,90,21,9,1,0
440126,3121,3,215,184,31,1,0,0
9847,66,2,0,0,0,0,0,1
70088,994,1,223,223,0,0,1,0
725909,2899,6,249,185,64,9,1,0
0,0,0,0,0,0,0,0,0
0,0,0,0,0,0,0,0,0
784073,1290,3,114,95,19,5,1,0
301254,2604,6,481,382,99,52,1,0
111977,1793,7,221,207,14,4,1,0
18729,233,4,19,15,4,2,1,0
0,0,0,0,0,0,0,0,0
261239,2388,2,164,140,24,45,1,0
0,0,0,0,0,0,0,0,0
0,0,0,0,0,0,0,0,0
131708,940,4,18,15,3,3,1,0
0,0,0,0,0,0,0,0,0
3741,41,0,4,3,1,0,1,0
22915,37,0,2,1,1,0,1,0
119550,683,8,33,28,5,7,1,0
0,0,0,0,0,0,0,0,0
0,0,0,0,0,0,0,0,0
115955,1203,7,161,151,10,0,1,0
0,0,0,0,0,0,0,0,0
318796,660,0,104,90,14,1,1,0
0,0,0,0,0,0,0,0,0
0,0,0,0,0,0,0,0,0
552934,1837,21,65,52,13,39,1,0
0,0,0,0,0,0,0,0,0
91866,675,5,141,111,30,2,0,0
0,0,0,0,0,0,0,0,0
721851,4266,9,132,127,5,0,1,0
192402,1352,8,206,199,7,5,1,1
156842,2982,4,423,413,10,14,1,0
0,0,0,0,0,0,0,0,0
0,0,0,0,0,0,0,0,0
0,0,0,0,0,0,0,0,0
413556,2312,7,367,273,94,26,1,0
817000,2565,13,163,160,3,43,1,0
0,0,0,0,0,0,0,0,0
499215,1526,9,101,97,4,5,1,0
143157,816,8,117,113,4,5,1,0
6580,65,6,3,2,1,0,0,0
0,0,0,0,0,0,0,0,0
0,0,0,0,0,0,0,0,0
0,0,0,0,0,0,0,0,0
2181570,15734,8,3533,3509,24,22,1,0
0,0,0,0,0,0,0,0,0
54713,135,0,30,20,10,0,1,0
100788,1029,3,311,8,303,2,1,0
385516,3613,10,838,477,361,17,1,0
0,0,0,0,0,0,0,0,0
84397,612,2,176,157,19,11,1,0
57844,661,6,93,85,8,0,0,0
0,0,0,0,0,0,0,0,0
367974,3710,9,1061,1048,13,19,1,0
105172,585,12,81,72,9,9,1,0
23281,286,1,6,4,2,0,1,0
49408,743,10,137,87,50,6,1,0
206771,574,7,105,5,100,0,1,0
231354,1461,14,252,223,29,10,1,0
0,0,0,0,0,0,0,0,0
282733,2428,12,292,283,9,73,1,0
8758,33,1,0,0,0,1,0,0
259268,1533,9,264,216,48,27,1,0
19524,480,1,128,128,0,1,1,0
6049,62,4,6,5,1,0,0,0
21958,35,0,1,1,0,0,1,0
0,0,0,0,0,0,0,0,0
16842,361,1,83,83,0,0,1,0
0,0,0,0,0,0,0,0,0
37644,149,4,2,2,0,1,1,0
0,0,0,0,0,0,0,0,0
135701,766,7,70,2,68,4,1,0
136046,1036,5,232,226,6,1,1,0
8122,73,2,10,7,3,0,0,0
2095068,3490,12,351,341,10,9,1,0
161085,1802,10,338,329,9,16,1,0
756913,4694,12,784,781,3,14,1,0
464224,3790,12,713,711,2,5,1,0
139178,2018,0,293,288,5,6,0,0
166994,1286,10,204,157,47,4,1,0
1871865,6316,4,296,241,55,115,0,0
132599,1103,10,244,222,22,13,1,0
140592,1857,9,332,325,7,68,1,0
48560,294,11,69,66,3,12,1,0
38024,330,5,30,25,5,0,1,0
37592,328,5,30,25,5,0,1,0
306577,2489,5,252,220,32,0,1,0
0,0,0,0,0,0,0,0,0
16962,31,0,1,1,0,0,1,0
0,0,0,0,0,0,0,0,0
0,0,0,0,0,0,0,0,0
599094,1231,3,229,217,12,3,1,0
7501,36,2,0,0,0,1,0,0
0,0,0,0,0,0,0,0,0
20578,190,5,4,4,0,4,0,0
0,0,0,0,0,0,0,0,0
0,0,0,0,0,0,0,0,0
352185,1080,7,142,3,139,12,1,0
647863,3463,5,646,21,625,6,1,0
0,0,0,0,0,0,0,0,0
252381,705,4,98,90,8,1,1,0
109174,799,7,147,136,11,0,1,0
280762,1463,13,221,195,26,7,1,0
8851,72,6,3,2,1,0,0,0
0,0,0,0,0,0,0,0,0
0,0,0,0,0,0,0,0,0
0,0,0,0,0,0,0,0,0
142171,487,11,46,46,0,0,1,0
46699,298,2,72,72,0,8,0,0
13198,210,3,48,46,2,2,0,0
7193,49,3,3,3,0,1,0,0
98023,889,9,259,255,4,9,1,0
0,0,0,0,0,0,0,0,0
205081,1269,5,270,260,10,1,1,0
2800,62,1,12,12,0,0,1,0
0,0,0,0,0,0,0,0,0
0,0,0,0,0,0,0,0,0
0,0,0,0,0,0,0,0,0
412348,271,2,18,12,6,1,0,0
0,0,0,0,0,0,0,0,0
18096,87,1,6,2,4,0,1,0
1135165,3393,11,918,854,64,70,1,0
38001,89,1,2,1,1,0,0,0
194230,1249,14,197,156,41,3,0,0
0,0,0,0,0,0,0,0,0
0,0,0,0,0,0,0,0,0
0,0,0,0,0,0,0,0,0
253401,2571,8,454,440,14,3,1,0
0,0,0,0,0,0,0,0,0
0,0,0,0,0,0,0,0,0
1110353,9658,12,1763,1744,19,9,1,0
3956,70,7,9,9,0,0,1,0
0,0,0,0,0,0,0,0,0
0,0,0,0,0,0,0,0,0
0,0,0,0,0,0,0,0,0
0,0,0,0,0,0,0,0,0
0,0,0,0,0,0,0,0,0
74415,793,1,231,228,3,1,1,0
979307,2932,6,88,72,16,53,1,0
84729,963,0,61,33,28,2,1,0
0,0,0,0,0,0,0,0,0
9179,74,5,0,0,0,0,0,0
0,0,0,0,0,0,0,0,0
0,0,0,0,0,0,0,0,0
230956,2225,4,247,148,99,0,0,0
164864,1491,5,259,247,12,7,0,0
0,0,0,0,0,0,0,0,0
161777,1014,0,76,76,0,4,1,0
13314,250,5,23,17,6,1,1,0
5403,65,3,11,11,0,0,1,0
93063,716,6,117,40,77,1,1,0
0,0,0,0,0,0,0,0,0
109623,732,16,75,57,18,3,1,0
10465,74,7,3,2,1,0,0,0
0,0,0,0,0,0,0,0,0
0,0,0,0,0,0,0,0,0
206985,636,8,47,36,11,1,1,0
0,0,0,0,0,0,0,0,0
15497,161,3,32,29,3,1,1,0
197265,896,11,183,179,4,3,1,1
0,0,0,0,0,0,0,0,0
21936,33,0,1,1,0,0,1,0
41693,1231,2,478,477,1,0,1,0
0,0,0,0,0,0,0,0,0
247485,553,5,54,51,3,13,1,0
0,0,0,0,0,0,0,0,0
0,0,0,0,0,0,0,0,0
0,0,0,0,0,0,0,0,0
278246,1102,7,199,87,112,0,1,0
124253,799,7,136,121,15,1,1,0
0,0,0,0,0,0,0,0,0
0,0,0,0,0,0,0,0,0
468791,2185,11,128,98,30,0,1,0
17604,212,5,37,32,5,2,0,0
266204,1083,20,212,200,12,26,1,0
256161,481,9,38,23,15,14,1,0
0,0,0,0,0,0,0,0,0
573702,3456,10,343,319,24,8,1,0
12611,196,1,21,10,11,0,0,0
20177,351,0,130,122,8,0,1,0
8172,113,0,8,8,0,0,1,0
0,0,0,0,0,0,0,0,0
421038,1214,13,185,161,24,3,1,0
0,0,0,0,0,0,0,0,0
0,0,0,0,0,0,0,0,0
335805,807,2,192,155,37,0,1,0
287681,188,3,5,4,1,3,0,0
1313316,4498,3,177,174,3,0,1,0
0,0,0,0,0,0,0,0,0
137519,573,1,15,13,2,8,1,0
186491,1133,0,77,72,5,3,1,0
0,0,0,0,0,0,0,0,0
72329,780,7,123,114,9,2,0,0
0,0,0,0,0,0,0,0,0
0,0,0,0,0,0,0,0,0
0,0,0,0,0,0,0,0,0
0,0,0,0,0,0,0,0,0
349337,1687,7,297,224,73,4,1,0
60303,412,11,70,45,25,5,1,0
37271,410,5,74,61,13,11,1,0
22809,246,5,44,39,5,7,1,0
1032724,2979,7,609,571,38,0,1,0
69944,864,5,147,143,4,3,1,0
13787,136,1,6,5,1,2,0,0
0,0,0,0,0,0,0,0,0
0,0,0,0,0,0,0,0,0
0,0,0,0,0,0,0,0,0
256745,1081,13,196,152,44,32,1,0
31226,298,8,40,29,11,3,0,0
528832,993,7,191,165,26,3,1,0
40365,529,7,95,89,6,1,0,0
550360,2025,19,243,194,49,12,1,0
14764,259,3,37,37,0,0,1,0
7687,125,3,19,19,0,0,1,0
102452,698,8,46,39,7,0,1,0
11377,70,6,4,4,0,0,0,0
166250,517,3,66,63,3,0,1,0
496504,3821,10,639,639,0,3,1,0
57487,218,1,11,11,0,1,0,0
34358,88,3,4,2,2,0,0,0
350531,731,16,99,86,13,2,1,0
0,0,0,0,0,0,0,0,0
396739,1300,10,215,213,2,11,1,0
506968,1679,6,206,204,2,7,1,0
23161,326,2,52,17,35,0,0,0
92679,298,1,78,15,63,1,0,0
180534,1436,9,261,245,16,4,1,0
281884,1338,11,191,186,5,8,1,0
213606,1240,7,103,92,11,3,1,0
28367,466,4,128,123,5,4,1,0
205107,1468,2,317,294,23,0,0,0
0,0,0,0,0,0,0,0,0
214912,2541,5,630,586,44,4,0,0
77845,740,7,138,118,20,2,1,0
0,0,0,0,0,0,0,0,0
113189,1385,2,201,197,4,7,1,0
119869,163,2,18,15,3,0,1,0
1058994,2053,1,470,449,21,5,1,0
942175,6841,2,1113,1059,54,8,0,0
0,0,0,0,0,0,0,0,0
0,0,0,0,0,0,0,0,0
290044,4374,6,917,879,38,7,1,0
210627,911,12,136,129,7,2,1,0
155014,702,11,119,112,7,2,1,0
0,0,0,0,0,0,0,0,0
0,0,0,0,0,0,0,0,0
76137,530,6,74,65,9,0,1,0
402923,1065,14,194,181,13,19,1,0
0,0,0,0,0,0,0,0,0
106281,743,9,103,86,17,14,1,0
1411,29,0,0,0,0,0,0,0
127083,674,5,94,88,6,2,1,0
0,0,0,0,0,0,0,0,0
114013,1226,6,157,146,11,12,1,0
0,0,0,0,0,0,0,0,0
305675,1478,11,257,245,12,22,1,0
0,0,0,0,0,0,0,0,0
270104,3476,3,369,335,34,1,1,0
44467,777,3,190,180,10,1,1,0
0,0,0,0,0,0,0,0,0
88413,523,12,140,124,16,8,1,0
0,0,0,0,0,0,0,0,0
102502,1184,7,130,114,16,32,0,0
0,0,0,0,0,0,0,0,0
0,0,0,0,0,0,0,0,0
0,0,0,0,0,0,0,0,0
311403,1399,3,112,82,30,1,1,0
0,0,0,0,0,0,0,0,0
3505098,2463,5,106,95,11,0,1,0
36477,75,1,3,2,1,0,0,0
0,0,0,0,0,0,0,0,0
0,0,0,0,0,0,0,0,0
0,0,0,0,0,0,0,0,0
25767,279,8,20,16,4,0,1,0
64169,1041,4,322,282,40,3,1,0
0,0,0,0,0,0,0,0,0
0,0,0,0,0,0,0,0,0
25237,520,0,93,51,42,0,1,0
0,0,0,0,0,0,0,0,0
132839,1387,3,307,297,10,19,0,0
79586,401,11,144,144,0,7,1,0
175610,771,6,144,13,131,3,1,0
901096,1480,3,125,103,22,22,1,0
0,0,0,0,0,0,0,0,0
0,0,0,0,0,0,0,0,0
0,0,0,0,0,0,0,0,0
256429,205,1,18,10,8,0,1,0
0,0,0,0,0,0,0,0,0
0,0,0,0,0,0,0,0,0
0,0,0,0,0,0,0,0,0
0,0,0,0,0,0,0,0,0
70734,505,7,76,57,19,1,1,0
0,0,0,0,0,0,0,0,0
118924,600,13,55,47,8,16,0,0
2720910,807,4,87,86,1,5,1,0
0,0,0,0,0,0,0,0,0
0,0,0,0,0,0,0,0,0
0,0,0,0,0,0,0,0,0
148611,1301,10,137,128,9,7,1,0
0,0,0,0,0,0,0,0,0
0,0,0,0,0,0,0,0,0
182360,1228,10,235,222,13,11,1,0
0,0,0,0,0,0,0,0,0
50552,864,6,102,100,2,2,0,0
0,0,0,0,0,0,0,0,0
0,0,0,0,0,0,0,0,0
0,0,0,0,0,0,0,0,0
0,0,0,0,0,0,0,0,0
104162,1898,1,351,342,9,2,1,0
0,0,0,0,0,0,0,0,0
66011,338,4,93,93,0,3,1,0
182920,839,3,177,132,45,2,1,0
0,0,0,0,0,0,0,0,0
353462,2372,1,541,449,92,23,1,0
35812,566,1,145,144,1,9,1,0
436,6,0,0,0,0,0,0,0
0,0,0,0,0,0,0,0,0
79723,983,5,88,81,7,2,1,0
43471,363,6,129,122,7,1,1,0
0,0,0,0,0,0,0,0,0
0,0,0,0,0,0,0,0,0
0,0,0,0,0,0,0,0,0
0,0,0,0,0,0,0,0,0
152967,1444,8,227,202,25,10,1,0
0,0,0,0,0,0,0,0,0
0,0,0,0,0,0,0,0,0
0,0,0,0,0,0,0,0,0
532942,1666,9,274,262,12,15,1,0
0,0,0,0,0,0,0,0,0
123153,1289,3,268,264,4,0,0,0
26833,359,5,61,53,8,6,1,0
0,0,0,0,0,0,0,0,0
19111,308,1,76,75,1,0,1,0
36516,470,5,83,82,1,6,1,0
22776,210,2,60,57,3,2,0,0
0,0,0,0,0,0,0,0,0
950090,507,5,68,13,55,4,1,0
0,0,0,0,0,0,0,0,0
0,0,0,0,0,0,0,0,0
105383,407,10,51,51,0,1,1,0
238484,2837,7,400,285,115,12,1,0
214359,843,12,65,51,14,2,1,0
0,0,0,0,0,0,0,0,0
110172,1709,3,400,400,0,1,1,0
502928,2554,6,381,313,68,13,1,0
356372,1359,5,162,152,10,0,1,0
0,0,0,0,0,0,0,0,0
659124,2451,14,282,266,16,11,1,0
70249,1929,2,568,567,1,2,1,0
0,0,0,0,0,0,0,0,0
0,0,0,0,0,0,0,0,0
77480,796,6,95,80,15,3,1,0
0,0,0,0,0,0,0,0,0
0,0,0,0,0,0,0,0,0
122582,259,5,8,8,0,0,1,0
0,0,0,0,0,0,0,0,0
0,0,0,0,0,0,0,0,0
0,0,0,0,0,0,0,0,0
94156,481,2,27,3,24,11,1,0
0,0,0,0,0,0,0,0,0
113818,605,3,48,39,9,2,1,0
103781,1128,1,136,127,9,0,1,0
0,0,0,0,0,0,0,0,0
599708,4636,9,1152,1127,25,9,1,0
163322,1264,7,328,327,1,11,1,0
439297,1554,4,167,163,4,12,0,0
29269,429,3,163,159,4,0,0,0
16341,103,4,6,3,3,0,0,0
75716,1080,3,307,297,10,10,1,0
0,0,0,0,0,0,0,0,0
0,0,0,0,0,0,0,0,0
0,0,0,0,0,0,0,0,0
0,0,0,0,0,0,0,0,0
0,0,0,0,0,0,0,0,0
0,0,0,0,0,0,0,0,0
30186,498,5,337,337,0,0,1,0
18133,127,4,18,17,1,0,1,0
0,0,0,0,0,0,0,0,0
0,0,0,0,0,0,0,0,0
0,0,0,0,0,0,0,0,0
75310,1323,6,258,217,41,0,1,0
0,0,0,0,0,0,0,0,0
0,0,0,0,0,0,0,0,0
0,0,0,0,0,0,0,0,0
0,0,0,0,0,0,0,0,0
92467,1041,2,60,33,27,2,1,0
0,0,0,0,0,0,0,0,0
157327,887,2,101,76,25,8,0,0
199673,3545,1,1841,1840,1,12,0,0
0,0,0,0,0,0,0,0,0
115477,809,10,135,134,1,1,1,0
205875,1784,11,285,269,16,7,1,0
0,0,0,0,0,0,0,0,0
23589,37,0,2,1,1,0,1,0
140697,1848,6,289,209,80,8,1,0
3423,38,0,0,0,0,0,0,0
57136,1019,4,149,68,81,3,1,0
0,0,0,0,0,0,0,0,0
0,0,0,0,0,0,0,0,0
0,0,0,0,0,0,0,0,0
50591,408,5,67,66,1,6,1,0
143078,803,3,111,33,78,0,1,0
145652,888,4,77,76,1,8,1,0
98283,519,4,61,60,1,2,1,0
0,0,0,0,0,0,0,0,0
127418,748,11,91,82,9,10,1,0
77779,165,7,15,14,1,5,1,0
0,0,0,0,0,0,0,0,0
0,0,0,0,0,0,0,0,0
320636,756,9,112,91,21,11,1,0
170073,193,7,28,24,4,1,1,0
0,0,0,0,0,0,0,0,0
0,0,0,0,0,0,0,0,0
0,0,0,0,0,0,0,0,0
826607,2672,10,351,336,15,25,1,0
59318,530,10,140,137,3,1,0,0
433468,1550,3,224,182,42,1,1,0
0,0,0,0,0,0,0,0,0
81887,973,10,194,173,21,5,1,0
0,0,0,0,0,0,0,0,0
0,0,0,0,0,0,0,0,0
124422,926,1,47,41,6,2,1,0
66948,532,9,78,71,7,4,0,0
155951,700,12,88,71,17,8,1,0
0,0,0,0,0,0,0,0,0
123425,617,6,100,99,1,1,1,0
0,0,0,0,0,0,0,0,0
0,0,0,0,0,0,0,0,0
0,0,0,0,0,0,0,0,0
202439,1276,5,275,245,30,14,0,0
118388,610,6,139,139,0,6,0,0
0,0,0,0,0,0,0,0,0
0,0,0,0,0,0,0,0,0
9151,160,6,16,13,3,0,1,0
7209,116,6,19,16,3,0,1,0
0,0,0,0,0,0,0,0,0
50949,606,2,134,115,19,18,1,0
52012,534,8,104,62,42,7,0,0
208757,1493,9,292,268,24,8,1,0
64932,505,10,107,103,4,14,1,0
0,0,0,0,0,0,0,0,0
55314,522,0,86,80,6,0,1,0
87257,1055,8,194,73,121,4,1,0
144892,1549,11,282,274,8,1,1,0
0,0,0,0,0,0,0,0,0
9344,25,0,0,0,0,0,0,0
22877,37,0,2,1,1,0,1,0
5881,120,1,41,37,4,0,0,0
0,0,0,0,0,0,0,0,0
0,0,0,0,0,0,0,0,0
33795,908,1,132,132,0,0,1,0
0,0,0,0,0,0,0,0,0
43067,435,3,47,42,5,1,1,0
0,0,0,0,0,0,0,0,0
187191,933,8,130,124,6,5,1,0
0,0,0,0,0,0,0,0,0
68508,678,10,101,75,26,1,1,0
92439,593,8,60,1,59,0,1,0
71503,390,8,61,55,6,0,1,0
179963,1904,2,532,495,37,6,1,0
0,0,0,0,0,0,0,0,0
131029,434,10,67,59,8,3,1,0
1124137,381,2,33,28,5,8,1,0
150000,1628,8,217,205,12,1,1,0
0,0,0,0,0,0,0,0,0
0,0,0,0,0,0,0,0,0
0,0,0,0,0,0,0,0,0
36773,191,7,18,17,1,0,0,0
8129,67,6,3,2,1,0,0,0
0,0,0,0,0,0,0,0,0
212101,320,5,34,23,11,8,1,0
1191960,11431,13,746,721,25,10,1,0
28670,426,4,101,92,9,2,1,0
0,0,0,0,0,0,0,0,0
209187,526,6,73,61,12,8,1,0
204831,540,6,85,56,29,8,1,0
0,0,0,0,0,0,0,0,0
340581,536,5,33,22,11,0,1,0
32841,142,3,2,1,1,3,0,0
0,0,0,0,0,0,0,0,0
166447,759,4,162,151,11,3,1,0
0,0,0,0,0,0,0,0,0
0,0,0,0,0,0,0,0,0
81200,1011,5,274,273,1,0,1,0
182940,613,6,93,86,7,8,1,0
581445,3057,9,224,164,60,25,1,0
0,0,0,0,0,0,0,0,0
192763,2074,9,408,398,10,3,1,0
810581,5519,5,75,16,59,134,1,0
59215,220,7,38,28,10,3,1,0
20435,293,4,43,37,6,2,1,0
111967,692,15,72,71,1,48,1,0
253768,4817,5,2678,2612,66,1,0,0
54678,199,6,41,41,0,9,0,0
440601,3856,6,419,254,165,25,1,0
111917,800,6,88,85,3,3,1,0
0,0,0,0,0,0,0,0,0
0,0,0,0,0,0,0,0,0
38222,416,3,53,50,3,8,1,0
55879,738,4,172,166,6,5,0,0
31158,322,4,57,51,6,5,0,0
233743,341,0,16,3,13,0,1,0
0,0,0,0,0,0,0,0,0
0,0,0,0,0,0,0,0,0
382956,4569,10,1262,1253,9,1,1,0
104988,1613,10,478,470,8,4,1,0
0,0,0,0,0,0,0,0,0
74398,1012,10,194,174,20,3,1,0
19109,246,6,34,25,9,2,0,0
10438,123,6,21,20,1,0,0,0
0,0,0,0,0,0,0,0,0
58970,546,8,92,82,10,0,1,0
82158,499,4,40,33,7,18,1,0
57641,278,6,25,19,6,0,1,0
117318,1213,3,166,145,21,28,1,0
170793,1077,5,7,5,2,26,0,0
0,0,0,0,0,0,0,0,0
137889,1466,6,318,279,39,1,0,0
0,0,0,0,0,0,0,0,0
172677,1291,9,333,324,9,5,1,0
0,0,0,0,0,0,0,0,0
139093,930,11,222,185,37,8,1,0
0,0,0,0,0,0,0,0,0
48237,612,2,135,104,31,1,0,0
0,0,0,0,0,0,0,0,0
143836,1447,7,117,103,14,4,1,0
302293,2973,14,730,646,84,6,1,0
193021,2187,15,496,434,62,12,1,0
253645,1388,8,230,177,53,0,1,0
397522,1981,6,250,165,85,4,1,0
0,0,0,0,0,0,0,0,0
0,0,0,0,0,0,0,0,0
202848,4127,3,1634,1389,245,0,0,0
0,0,0,0,0,0,0,0,0
0,0,0,0,0,0,0,0,0
235718,1061,4,114,106,8,0,1,0
326884,1624,8,455,450,5,5,1,0
67107,419,8,111,106,5,4,1,0
31694,756,3,192,178,14,1,1,0
151752,1517,5,211,123,88,1,0,0
0,0,0,0,0,0,0,0,0
0,0,0,0,0,0,0,0,0
256594,3242,6,314,304,10,28,1,0
871258,5192,13,705,643,62,35,1,0
0,0,0,0,0,0,0,0,0
0,0,0,0,0,0,0,0,0
60042,425,4,79,76,3,16,1,0
4865,49,0,5,5,0,0,0,0
796837,6120,2,173,149,24,6,0,0
92636,279,2,16,14,2,3,0,0
0,0,0,0,0,0,0,0,0
0,0,0,0,0,0,0,0,0
84766,963,0,61,33,28,2,1,0
119792,1214,2,355,349,6,26,1,0
0,0,0,0,0,0,0,0,0
62142,354,3,48,40,8,0,1,0
29019,183,10,15,15,0,4,0,0
0,0,0,0,0,0,0,0,0
155690,2135,7,122,100,22,4,1,0
73468,689,12,173,166,7,18,0,0
0,0,0,0,0,0,0,0,0
68687,769,0,195,181,14,26,0,0
200582,637,9,100,90,10,3,1,0
233880,650,5,73,73,0,0,1,0
0,0,0,0,0,0,0,0,0
353161,2284,5,194,170,24,17,1,0
155400,347,6,26,22,4,2,1,0
0,0,0,0,0,0,0,0,0
20015,261,4,42,31,11,0,1,0
125855,1723,7,697,683,14,1,1,0
258670,1875,10,568,552,16,18,1,0
278967,527,4,80,72,8,8,1,0
163239,275,4,56,48,8,7,1,0
0,0,0,0,0,0,0,0,0
386008,1051,7,40,33,7,7,1,0
0,0,0,0,0,0,0,0,0
587523,4179,13,312,307,5,3,1,0
0,0,0,0,0,0,0,0,0
97698,1314,2,232,63,169,0,1,0
53459,529,8,104,76,28,7,0,0
14980,164,3,29,25,4,1,1,0
14391,153,3,25,21,4,1,1,0
0,0,0,0,0,0,0,0,0
0,0,0,0,0,0,0,0,0
0,0,0,0,0,0,0,0,0
138615,2115,2,627,626,1,69,1,0
40038,408,5,75,69,6,0,1,0
91806,670,6,145,127,18,0,1,0
0,0,0,0,0,0,0,0,0
314956,1407,8,121,30,91,6,1,0
0,0,0,0,0,0,0,0,0
40666,593,2,46,45,1,0,1,0
264370,1187,8,136,127,9,7,0,0
0,0,0,0,0,0,0,0,0
228062,1380,9,212,170,42,6,1,0
4780,69,2,12,5,7,0,1,0
48167,934,2,234,233,1,1,1,0
13843,146,3,18,17,1,4,1,0
42118,400,2,40,26,14,1,1,0
18500,173,2,17,16,1,1,1,0
0,0,0,0,0,0,0,0,0
0,0,0,0,0,0,0,0,0
66122,749,9,29,29,0,0,0,0
8504,69,6,3,2,1,0,0,0
93710,1567,3,371,325,46,0,1,0
0,0,0,0,0,0,0,0,0
0,0,0,0,0,0,0,0,0
62296,583,10,132,120,12,2,1,0
18841,247,2,28,28,0,0,1,0
14677,197,2,29,29,0,0,1,0
300337,1007,4,106,95,11,1,1,0
34448,247,4,5,4,1,3,1,0
0,0,0,0,0,0,0,0,0
52470,251,7,27,17,10,0,1,0
342730,3683,15,687,683,4,16,1,0
55948,742,5,148,135,13,4,1,0
0,0,0,0,0,0,0,0,0
152013,2551,3,291,287,4,3,0,0
894824,3345,2,278,269,9,1,1,0
633439,1704,2,206,197,9,1,1,0
25801,238,2,18,6,12,1,0,0
26563,241,2,10,8,2,1,0,0
0,0,0,0,0,0,0,0,0
98220,1177,6,63,48,15,17,1,0
0,0,0,0,0,0,0,0,0
0,0,0,0,0,0,0,0,0
13547,121,0,14,7,7,0,1,0
530073,780,8,47,40,7,0,1,0
60642,352,5,20,17,3,4,0,0
0,0,0,0,0,0,0,0,0
199137,464,4,70,58,12,1,1,0
14893,86,5,16,10,6,0,1,0
0,0,0,0,0,0,0,0,0
0,0,0,0,0,0,0,0,0
14226,168,8,15,15,0,2,1,0
165890,858,13,154,147,7,32,1,0
0,0,0,0,0,0,0,0,0
0,0,0,0,0,0,0,0,0
95741,251,4,19,19,0,0,0,0
314749,3250,1,628,603,25,3,1,0
0,0,0,0,0,0,0,0,0
0,0,0,0,0,0,0,0,0
133156,371,5,29,26,3,0,1,0
54272,304,2,57,36,21,2,1,0
704245,189,5,14,13,1,2,0,0
159889,1156,11,234,204,30,6,1,0
0,0,0,0,0,0,0,0,0
101670,1151,6,299,269,30,5,1,0
364540,3012,4,327,110,217,0,1,0
9346555,121,3,2,2,0,0,1,0
58530,1004,4,201,197,4,4,1,0
17279,299,4,79,75,4,4,1,0
628448,3319,6,208,161,47,130,1,0
363282,1235,6,44,41,3,12,1,0
0,0,0,0,0,0,0,0,0
22414,299,4,39,29,10,1,0,0
0,0,0,0,0,0,0,0,0
66275,585,5,97,93,4,3,1,0
31469,197,5,20,19,1,2,1,0
0,0,0,0,0,0,0,0,0
393903,1186,8,232,201,31,7,1,0
0,0,0,0,0,0,0,0,0
0,0,0,0,0,0,0,0,0
0,0,0,0,0,0,0,0,0
170406,595,4,66,66,0,20,1,0
383484,1349,4,130,112,18,0,1,0
108889,663,9,139,138,1,35,1,0
0,0,0,0,0,0,0,0,0
105461,1011,10,270,266,4,3,1,0
43968,256,10,43,39,4,1,1,0
171003,941,18,155,145,10,33,1,1
173615,961,18,155,145,10,33,1,1
31317,493,1,63,63,0,9,1,0
9995,65,0,3,3,0,0,0,0
73949,1176,8,169,144,25,0,1,0
0,0,0,0,0,0,0,0,0
0,0,0,0,0,0,0,0,0
0,0,0,0,0,0,0,0,0
307817,2728,9,489,477,12,4,1,0
0,0,0,0,0,0,0,0,0
0,0,0,0,0,0,0,0,0
0,0,0,0,0,0,0,0,0
63129,552,9,101,90,11,13,1,0
0,0,0,0,0,0,0,0,0
0,0,0,0,0,0,0,0,0
192968,2225,6,294,222,72,23,0,0
213926,1883,13,293,284,9,3,1,0
0,0,0,0,0,0,0,0,0
34042,452,6,67,65,2,0,0,0
94307,771,6,49,47,2,5,0,0
131981,912,4,221,211,10,8,1,0
0,0,0,0,0,0,0,0,0
0,0,0,0,0,0,0,0,0
289332,1474,4,196,164,32,9,1,0
0,0,0,0,0,0,0,0,0
202520,2625,6,505,462,43,3,1,0
68192,494,5,70,49,21,2,1,0
55710,241,2,23,11,12,43,1,0
32089,710,3,143,133,10,0,1,0
464138,2548,18,483,479,4,17,1,0
288359,831,7,197,178,19,6,0,0
49716,309,3,24,24,0,16,1,0
17631,379,3,103,87,16,2,0,0
0,0,0,0,0,0,0,0,0
35741,68,2,11,10,1,0,1,0
39205,169,2,18,17,1,0,1,0
0,0,0,0,0,0,0,0,0
0,0,0,0,0,0,0,0,0
114269,989,9,384,367,17,3,1,0
78334,656,8,313,307,6,2,1,0
1156005,846,3,152,134,18,1,1,0
133337,871,5,111,98,13,26,0,0
187562,1148,1,156,133,23,19,1,0
78730,340,1,2,2,0,13,1,0
64551,503,4,63,53,10,4,0,0
101474,766,7,83,18,65,10,1,0
15326,352,0,24,24,0,0,1,0
8714,189,0,20,20,0,0,1,0
0,0,0,0,0,0,0,0,0
0,0,0,0,0,0,0,0,0
0,0,0,0,0,0,0,0,0
0,0,0,0,0,0,0,0,0
0,0,0,0,0,0,0,0,0
0,0,0,0,0,0,0,0,0
57204,285,1,50,46,4,10,1,0
173956,548,0,67,56,11,1,1,0
66185,581,8,98,86,12,6,1,0
0,0,0,0,0,0,0,0,0
246251,2337,9,579,564,15,0,1,0
15485,239,0,47,42,5,1,0,0
17884,256,1,39,32,7,4,0,0
132744,1199,14,204,168,36,1,0,0
0,0,0,0,0,0,0,0,0
0,0,0,0,0,0,0,0,0
8639,98,2,9,6,3,0,0,0
0,0,0,0,0,0,0,0,0
128454,1561,12,186,47,139,1,0,0
644688,149,5,0,0,0,7,0,0
46666,502,7,59,27,32,0,0,0
29263,477,5,127,111,16,5,1,0
0,0,0,0,0,0,0,0,0
35539,293,0,104,102,2,0,1,0
604666,2290,3,242,130,112,1,1,0
141920,392,3,15,15,0,0,0,0
0,0,0,0,0,0,0,0,0
0,0,0,0,0,0,0,0,0
12169,204,4,31,24,7,0,1,0
15423,225,4,36,26,10,2,1,0
71893,302,5,42,35,7,4,0,0
38130,237,1,17,17,0,4,0,0
0,0,0,0,0,0,0,0,0
261504,1735,13,343,295,48,16,0,0
0,0,0,0,0,0,0,0,0
0,0,0,0,0,0,0,0,0
0,0,0,0,0,0,0,0,0
201237,1900,5,314,303,11,18,1,0
0,0,0,0,0,0,0,0,0
95470,1355,5,254,236,18,1,0,0
49112,553,5,73,73,0,2,0,0
0,0,0,0,0,0,0,0,0
396007,1278,9,172,172,0,76,1,0
258987,383,6,10,6,4,0,1,0
0,0,0,0,0,0,0,0,0
776082,2188,15,182,173,9,38,1,0
531180,1754,13,164,157,7,29,1,0
11877,213,4,10,10,0,0,0,0
9716,163,4,9,9,0,0,0,0
307737,2293,4,277,259,18,7,0,0
0,0,0,0,0,0,0,0,0
0,0,0,0,0,0,0,0,0
0,0,0,0,0,0,0,0,0
68201,482,6,146,137,9,7,0,0
0,0,0,0,0,0,0,0,0
382238,2680,9,443,429,14,4,1,0
0,0,0,0,0,0,0,0,0
36575,170,10,22,21,1,0,0,0
172513,1114,3,253,245,8,22,0,0
337493,823,1,59,57,2,0,1,0
74081,842,2,151,151,0,1,1,0
367688,1542,4,279,243,36,8,1,0
0,0,0,0,0,0,0,0,0
319238,682,7,66,61,5,15,1,0
104555,416,7,59,55,4,7,0,0
51630,660,6,162,162,0,9,1,0
33981,383,6,103,103,0,8,1,0
0,0,0,0,0,0,0,0,0
90392,654,17,36,20,16,5,0,0
4482,38,2,3,1,2,2,0,0
1213547,1138,2,130,108,22,5,1,0
328172,667,1,98,94,4,0,1,0
0,0,0,0,0,0,0,0,0
0,0,0,0,0,0,0,0,0
123875,850,8,170,160,10,3,1,0
195898,1529,5,588,581,7,32,0,0
0,0,0,0,0,0,0,0,0
68937,348,6,51,51,0,0,0,0
165507,1779,6,304,293,11,4,0,0
491683,1374,16,248,243,5,6,1,0
298671,3207,15,622,608,14,16,1,0
0,0,0,0,0,0,0,0,0
59487,693,7,175,154,21,3,1,0
34432,470,6,141,120,21,2,1,0
29504,354,4,42,36,6,2,1,0
59122,772,2,195,111,84,5,0,0
34241,382,2,107,54,53,2,0,0
0,0,0,0,0,0,0,0,0
443928,3550,8,849,829,20,18,0,0
18419,227,2,94,93,1,6,0,0
66452,363,7,66,66,0,6,1,0
200269,1624,4,118,96,22,6,1,0
609725,3032,7,753,699,54,71,1,0
368446,1893,8,583,577,6,7,1,0
0,0,0,0,0,0,0,0,0
0,0,0,0,0,0,0,0,0
78035,303,6,2,2,0,2,0,0
78035,303,6,2,2,0,2,0,0
0,0,0,0,0,0,0,0,0
95107,766,3,137,133,4,13,1,0
0,0,0,0,0,0,0,0,0
111887,1346,1,359,359,0,5,0,0
2076872,998,5,59,40,19,1,1,0
143087,328,4,65,47,18,0,1,0
0,0,0,0,0,0,0,0,0
0,0,0,0,0,0,0,0,0
0,0,0,0,0,0,0,0,0
0,0,0,0,0,0,0,0,0
0,0,0,0,0,0,0,0,0
0,0,0,0,0,0,0,0,0
0,0,0,0,0,0,0,0,0
0,0,0,0,0,0,0,0,0
52192,287,3,9,7,2,0,1,0
9724,52,3,3,3,0,0,0,0
31019,444,3,127,120,7,1,1,0
206399,608,8,106,96,10,8,1,0
0,0,0,0,0,0,0,0,0
0,0,0,0,0,0,0,0,0
314278,1036,5,31,26,5,2,0,0
0,0,0,0,0,0,0,0,0
257307,2262,3,343,282,61,7,1,0
213678,2691,5,206,196,10,0,0,0
0,0,0,0,0,0,0,0,0
0,0,0,0,0,0,0,0,0
455446,4150,5,950,894,56,0,1,0
2148653,12677,16,2728,2661,67,93,1,0
0,0,0,0,0,0,0,0,0
70983,599,9,116,115,1,0,0,0
134318,1062,6,243,232,11,2,0,0
0,0,0,0,0,0,0,0,0
376819,997,4,61,56,5,0,0,0
591147,1653,4,202,156,46,1,1,0
0,0,0,0,0,0,0,0,0
0,0,0,0,0,0,0,0,0
249012,1018,9,122,88,34,0,0,0
0,0,0,0,0,0,0,0,0
0,0,0,0,0,0,0,0,0
0,0,0,0,0,0,0,0,0
17992,35,0,2,1,1,0,1,0
23585,37,0,2,1,1,0,1,0
1653120,449,8,28,23,5,7,1,0
11111,116,0,5,4,1,4,1,0
38864,532,3,34,21,13,0,1,0
7764,115,3,18,18,0,0,1,0
0,0,0,0,0,0,0,0,0
42321,214,9,47,47,0,0,1,0
13867,168,3,21,18,3,1,0,0
216909,1312,10,190,185,5,1,1,0
172051,726,8,74,62,12,4,1,0
155627,636,8,62,52,10,5,1,0
127388,1670,6,103,103,0,19,1,0
21141,263,4,17,15,2,2,1,0
11483,73,5,3,3,0,0,1,0
286719,1321,6,243,236,7,0,1,0
123005,1140,8,144,142,2,2,1,0
0,0,0,0,0,0,0,0,0
88107,846,9,156,71,85,0,1,0
0,0,0,0,0,0,0,0,0
26861,242,4,31,29,2,3,1,0
415679,1773,2,217,131,86,0,0,0
0,0,0,0,0,0,0,0,0
0,0,0,0,0,0,0,0,0
704922,3331,5,229,210,19,6,1,0
0,0,0,0,0,0,0,0,0
0,0,0,0,0,0,0,0,0
0,0,0,0,0,0,0,0,0
0,0,0,0,0,0,0,0,0
0,0,0,0,0,0,0,0,0
430034,2022,6,168,125,43,13,1,0
339275,928,2,117,95,22,1,1,0
567011,1804,17,337,331,6,26,1,0
1006927,1051,6,159,144,15,1,1,0
0,0,0,0,0,0,0,0,0
97167,849,7,159,29,130,3,1,0
105674,588,3,78,58,20,23,1,0
41117,474,5,122,110,12,8,1,0
44819,503,5,131,108,23,11,1,0
0,0,0,0,0,0,0,0,0
62030,494,11,50,43,7,2,1,0
0,0,0,0,0,0,0,0,0
170084,1946,7,498,478,20,88,0,0
44730,394,5,91,91,0,8,1,0
22517,138,6,29,26,3,0,1,0
1027359,4001,7,299,296,3,16,1,0
0,0,0,0,0,0,0,0,0
701172,2588,9,116,103,13,9,1,0
189648,1250,11,172,158,14,4,1,0
0,0,0,0,0,0,0,0,0
28831,316,8,59,48,11,7,1,0
34890,521,3,130,126,4,1,0,0
123142,511,6,142,138,4,1,1,0
0,0,0,0,0,0,0,0,0
0,0,0,0,0,0,0,0,0
0,0,0,0,0,0,0,0,0
665588,1230,10,16,14,2,13,1,0
732373,8404,17,335,280,55,60,1,0
34558,225,5,3,1,2,17,0,0
0,0,0,0,0,0,0,0,0
0,0,0,0,0,0,0,0,0
162777,801,7,138,123,15,4,1,0
102186,178,6,10,4,6,2,1,0
79578,995,5,136,124,12,1,1,0
59365,742,4,77,73,4,1,1,0
25884,294,4,64,60,4,1,1,0
0,0,0,0,0,0,0,0,0
0,0,0,0,0,0,0,0,0
64967,803,6,190,122,68,11,1,0
0,0,0,0,0,0,0,0,0
0,0,0,0,0,0,0,0,0
0,0,0,0,0,0,0,0,0
154606,50,3,1,0,1,0,1,0
0,0,0,0,0,0,0,0,0
0,0,0,0,0,0,0,0,0
477256,1129,18,180,177,3,10,1,0
551925,2353,5,112,106,6,8,1,0
539018,2070,5,93,81,12,3,1,0
0,0,0,0,0,0,0,0,0
0,0,0,0,0,0,0,0,0
0,0,0,0,0,0,0,0,0
71059,977,7,144,125,19,2,1,0
0,0,0,0,0,0,0,0,0
0,0,0,0,0,0,0,0,0
0,0,0,0,0,0,0,0,0
133193,807,13,62,41,21,2,1,0
0,0,0,0,0,0,0,0,0
0,0,0,0,0,0,0,0,0
0,0,0,0,0,0,0,0,0
384586,2524,20,381,358,23,42,1,0
220887,1119,19,168,159,9,42,1,0
1321784,12394,9,106,102,4,1,1,0
103138,88,0,14,14,0,6,0,0
0,0,0,0,0,0,0,0,0
177462,1301,4,325,319,6,3,1,0
1551550,10360,5,593,568,25,24,0,0
0,0,0,0,0,0,0,0,0
53444,565,2,40,29,11,1,0,0
223437,4032,7,1242,1221,21,7,1,0
113832,220,8,16,10,6,0,1,0
244772,1286,7,271,267,4,7,1,0
119164,1183,7,242,234,8,9,1,0
0,0,0,0,0,0,0,0,0
240338,1091,13,266,242,24,8,1,0
98795,271,1,25,6,19,13,1,1
469394,2811,7,459,445,14,59,1,0
0,0,0,0,0,0,0,0,0
0,0,0,0,0,0,0,0,0
436221,773,5,90,79,11,15,1,0
0,0,0,0,0,0,0,0,0
31396,487,4,214,214,0,0,1,0
81932,297,5,71,39,32,1,1,0
0,0,0,0,0,0,0,0,0
0,0,0,0,0,0,0,0,0
0,0,0,0,0,0,0,0,0
18155,284,3,12,8,4,4,0,0
346672,2250,3,279,227,52,4,0,0
276335,1667,3,231,179,52,4,0,0
0,0,0,0,0,0,0,0,0
121419,860,10,186,146,40,3,0,0
116484,1114,9,119,112,7,4,1,0
128708,613,9,71,61,10,1,1,0
0,0,0,0,0,0,0,0,0
100214,1066,10,243,240,3,4,1,0
97661,712,10,230,223,7,7,1,0
112822,943,5,169,159,10,0,1,0
23358,217,2,33,33,0,1,1,0
0,0,0,0,0,0,0,0,0
243514,788,10,170,167,3,1,0,0
12022,190,9,22,13,9,0,1,0
420576,1444,4,5,4,1,2,0,0
0,0,0,0,0,0,0,0,0
0,0,0,0,0,0,0,0,0
0,0,0,0,0,0,0,0,0
12208,160,4,57,57,0,0,1,0
553991,2550,6,499,426,73,5,1,0
808977,2513,10,390,380,10,8,1,0
78465,841,6,107,91,16,7,1,0
65247,575,9,57,49,8,7,1,0
299560,1966,12,324,317,7,4,0,0
3523,44,3,3,3,0,0,0,0
89344,1879,4,604,511,93,14,1,0
0,0,0,0,0,0,0,0,0
0,0,0,0,0,0,0,0,0
52113,143,2,108,107,1,0,0,0
1802496,3348,4,215,162,53,6,1,0
186148,1111,3,188,167,21,4,1,0
0,0,0,0,0,0,0,0,0
1640,11,0,1,1,0,0,0,0
1024255,2568,7,276,263,13,5,1,0
622245,1392,9,229,205,24,15,1,0
0,0,0,0,0,0,0,0,0
174690,1672,10,456,423,33,5,1,0
32932,634,8,51,47,4,1,1,0
0,0,0,0,0,0,0,0,0
3030,29,3,3,1,2,0,0,0
39704,1271,2,211,207,4,0,1,0
0,0,0,0,0,0,0,0,0
141106,381,7,24,13,11,0,1,0
137353,125,3,0,0,0,0,0,0
127892,1560,8,312,277,35,6,1,0
0,0,0,0,0,0,0,0,0
811919,6261,6,480,480,0,125,1,0
358774,1425,6,267,267,0,4,1,0
0,0,0,0,0,0,0,0,0
68778,803,6,159,158,1,1,1,0
0,0,0,0,0,0,0,0,0
700793,1318,6,111,97,14,25,1,0
28181,185,5,4,3,1,11,1,0
0,0,0,0,0,0,0,0,0
47875,573,2,143,139,4,0,1,0
70666,1309,8,378,67,311,4,1,0
0,0,0,0,0,0,0,0,0
0,0,0,0,0,0,0,0,0
205561,3365,5,979,958,21,3,1,0
0,0,0,0,0,0,0,0,0
86919,858,6,191,174,17,4,1,0
3607,42,4,3,3,0,0,1,0
242100,1997,11,240,219,21,12,1,0
196387,669,4,46,21,25,7,1,0
129273,161,6,8,6,2,1,0,0
47002,830,2,180,163,17,1,1,0
69126,522,3,62,62,0,15,1,0
660,14,0,0,0,0,0,1,0
162278,1005,10,147,147,0,10,1,1
39892,265,1,37,35,2,2,1,0
253336,1956,14,584,577,7,0,1,0
146395,856,8,171,166,5,1,1,0
445174,1903,5,273,239,34,5,1,0
87326,774,2,70,64,6,0,1,0
75970,838,2,135,134,1,7,1,0
15982,284,0,29,28,1,4,1,0
88355,759,6,177,17,160,17,1,0
0,0,0,0,0,0,0,0,0
799401,1817,8,241,160,81,31,1,0
308736,835,3,108,92,16,1,1,0
0,0,0,0,0,0,0,0,0
0,0,0,0,0,0,0,0,0
245893,2248,15,466,32,434,7,1,0
0,0,0,0,0,0,0,0,0
0,0,0,0,0,0,0,0,0
67357,514,2,65,59,6,0,1,0
136182,2552,2,672,672,0,1,1,0
567752,1908,16,403,338,65,13,1,0
130981,1268,6,402,377,25,4,1,0
100608,586,10,116,91,25,18,1,0
29917,507,6,145,129,16,1,1,0
18551,282,6,57,41,16,1,1,0
1131385,3530,8,275,225,50,14,1,0
297617,1049,8,195,183,12,13,1,0
88309,566,11,44,35,9,1,1,0
43813,131,5,2,2,0,7,0,0
312397,2782,9,548,519,29,8,1,0
225987,1083,12,381,370,11,5,1,0
0,0,0,0,0,0,0,0,0
0,0,0,0,0,0,0,0,0
0,0,0,0,0,0,0,0,0
69046,467,10,118,117,1,5,1,0
0,0,0,0,0,0,0,0,0
52412,154,2,12,0,12,0,1,0
22431,184,3,38,30,8,0,0,0
259316,562,6,138,136,2,7,1,0
112192,485,2,69,52,17,1,1,0
702593,6684,6,68,62,6,8,1,0
394846,3606,7,54,48,6,10,1,0
0,0,0,0,0,0,0,0,0
934432,2645,11,219,207,12,13,1,0
165062,1525,5,404,399,5,9,1,0
0,0,0,0,0,0,0,0,0
182687,2143,6,204,58,146,1,1,0
197047,1375,16,103,93,10,2,1,0
0,0,0,0,0,0,0,0,0
163917,1535,4,372,275,97,8,0,0
261895,4705,3,1804,1803,1,0,1,0
108124,1349,5,161,150,11,35,1,0
141885,530,9,81,68,13,13,0,0
215931,691,6,150,130,20,0,1,0
0,0,0,0,0,0,0,0,0
450698,1685,11,249,199,50,11,1,0
18144,68,8,5,5,0,2,1,0
46263,883,0,88,80,8,0,1,0
6468,82,0,1,1,0,0,0,0
99357,59,4,1,1,0,7,0,0
0,0,0,0,0,0,0,0,0
3805,75,2,8,8,0,0,1,0
429375,4189,2,1644,1636,8,1,1,0
164758,3112,3,1252,1242,10,4,1,0
108686,889,7,122,118,4,1,1,1
118438,1944,8,236,221,15,4,1,0
199695,1553,10,266,266,0,2,1,0
0,0,0,0,0,0,0,0,0
30324,289,0,40,33,7,3,1,0
0,0,0,0,0,0,0,0,0
0,0,0,0,0,0,0,0,0
1191,20,1,0,0,0,0,0,0
81611,616,8,93,12,81,0,1,0
163502,727,1,75,26,49,20,1,0
3211139,552,8,114,101,13,12,1,0
0,0,0,0,0,0,0,0,0
76743,770,8,184,180,4,9,0,0
41651,737,9,239,235,4,0,1,0
0,0,0,0,0,0,0,0,0
152183,1359,3,314,207,107,2,1,0
0,0,0,0,0,0,0,0,0
0,0,0,0,0,0,0,0,0
88326,836,6,128,106,22,16,1,0
9698,228,1,31,25,6,0,1,0
0,0,0,0,0,0,0,0,0
0,0,0,0,0,0,0,0,0
0,0,0,0,0,0,0,0,0
11862,234,0,22,22,0,0,1,0
0,0,0,0,0,0,0,0,0
0,0,0,0,0,0,0,0,0
177990,750,7,61,56,5,2,0,0
742932,3073,20,394,385,9,13,1,0
0,0,0,0,0,0,0,0,0
58660,830,2,143,140,3,4,1,0
13191,112,4,18,2,16,1,1,0
0,0,0,0,0,0,0,0,0
0,0,0,0,0,0,0,0,0
111119,1238,9,255,237,18,2,1,0
29486,548,6,71,21,50,0,1,0
0,0,0,0,0,0,0,0,0
174974,1188,5,320,305,15,19,1,0
248390,1533,5,336,59,277,10,1,0
229678,1432,5,327,319,8,10,1,0
75328,804,3,96,94,2,35,1,0
409,7,0,0,0,0,0,0,0
0,0,0,0,0,0,0,0,0
77688,705,6,15,13,2,9,1,0
44567,191,8,20,17,3,12,1,0
220071,2007,14,381,357,24,23,1,0
0,0,0,0,0,0,0,0,0
0,0,0,0,0,0,0,0,0
0,0,0,0,0,0,0,0,0
96931,1196,4,107,97,10,8,1,0
41937,474,4,70,60,10,3,1,0
23550,37,0,2,1,1,0,1,0
0,0,0,0,0,0,0,0,0
0,0,0,0,0,0,0,0,0
0,0,0,0,0,0,0,0,0
0,0,0,0,0,0,0,0,0
571903,1310,14,192,182,10,6,1,0
19707,214,6,61,48,13,0,1,0
653227,5027,10,346,173,173,26,0,0
52361,608,8,119,109,10,0,1,0
1105165,2799,12,628,588,40,12,1,0
158372,1810,6,375,312,63,2,1,0
466393,2183,7,596,533,63,6,1,0
23184,256,5,32,20,12,2,1,0
327110,1430,13,267,231,36,16,1,0
114368,1581,6,463,462,1,0,1,0
79753,881,6,212,187,25,1,1,0
358665,1129,7,45,41,4,4,1,0
0,0,0,0,0,0,0,0,0
253147,1003,4,342,325,17,10,1,0
0,0,0,0,0,0,0,0,0
0,0,0,0,0,0,0,0,0
0,0,0,0,0,0,0,0,0
0,0,0,0,0,0,0,0,0
125051,1142,9,146,146,0,1,1,0
151942,271,6,31,31,0,7,1,0
110241,613,3,86,85,1,3,1,0
249838,963,0,119,100,19,3,1,0
27613,39,0,2,1,1,0,0,0
0,0,0,0,0,0,0,0,0
0,0,0,0,0,0,0,0,0
207228,2126,6,165,56,109,60,1,0
0,0,0,0,0,0,0,0,0
133892,964,7,76,72,4,2,1,0
0,0,0,0,0,0,0,0,0
40146,392,7,78,76,2,0,1,0
17801,397,2,124,106,18,0,1,0
16359,192,3,42,41,1,1,1,0
70042,446,8,104,99,5,2,1,0
57065,195,7,42,37,5,4,1,0
0,0,0,0,0,0,0,0,0
109203,162,5,19,19,0,4,1,0
0,0,0,0,0,0,0,0,0
81142,871,6,123,119,4,2,0,0
0,0,0,0,0,0,0,0,0
138674,133,1,11,5,6,3,1,0
10070,64,1,0,0,0,2,0,0
0,0,0,0,0,0,0,0,0
28288,42,0,2,1,1,0,0,0
0,0,0,0,0,0,0,0,0
0,0,0,0,0,0,0,0,0
1394248,8696,13,834,762,72,688,1,0
378933,1584,12,252,162,90,1,1,0
218980,1455,2,213,206,7,1,1,0
31435,517,8,73,16,57,1,1,0
0,0,0,0,0,0,0,0,0
117849,800,8,156,153,3,14,0,0
0,0,0,0,0,0,0,0,0
69015,540,10,120,117,3,8,1,0
5799,61,6,3,2,1,0,0,0
0,0,0,0,0,0,0,0,0
9407,80,8,7,3,4,2,0,0
27849,69,3,3,1,2,1,1,0
63513,763,3,128,126,2,3,1,0
386957,917,1,144,79,65,9,1,0
80292,108,1,10,10,0,2,0,0
306600,1895,6,221,125,96,7,1,0
0,0,0,0,0,0,0,0,0
0,0,0,0,0,0,0,0,0
0,0,0,0,0,0,0,0,0
198106,1236,8,265,256,9,9,1,0
63979,1166,2,208,176,32,1,1,0
0,0,0,0,0,0,0,0,0
509412,1994,5,93,63,30,36,1,0
0,0,0,0,0,0,0,0,0
0,0,0,0,0,0,0,0,0
233672,1589,11,351,329,22,9,1,0
394544,4602,0,1175,917,258,13,0,0
197033,254,6,13,12,1,3,1,1
267904,2304,6,567,561,6,2,1,0
29447,592,4,193,178,15,10,1,0
164933,886,8,87,82,5,1,1,0
0,0,0,0,0,0,0,0,0
791745,532,12,83,76,7,21,1,0
167203,1046,4,148,148,0,1,0,0
123974,796,4,90,71,19,2,1,0
22804,216,1,25,23,2,3,1,0
0,0,0,0,0,0,0,0,0
0,0,0,0,0,0,0,0,0
249822,2853,4,335,333,2,5,0,0
0,0,0,0,0,0,0,0,0
32707,406,12,114,92,22,2,1,0
0,0,0,0,0,0,0,0,0
384294,1201,2,166,136,30,1,1,1
0,0,0,0,0,0,0,0,0
391481,3131,9,266,254,12,9,1,0
4494,70,1,7,4,3,0,1,0
154113,1022,7,78,70,8,4,1,0
0,0,0,0,0,0,0,0,0
186192,676,13,74,66,8,1,1,0
180810,770,11,61,58,3,8,1,0
0,0,0,0,0,0,0,0,0
0,0,0,0,0,0,0,0,0
243455,1575,13,309,99,210,10,1,0
112971,141,0,1,1,0,9,0,0
0,0,0,0,0,0,0,0,0
0,0,0,0,0,0,0,0,0
1488445,4347,3,58,50,8,1,1,0
236564,2020,6,473,435,38,10,1,0
391757,559,12,62,54,8,36,1,0
75158,900,8,107,94,13,6,1,0
31570,218,2,44,43,1,7,1,0
82812,476,5,48,35,13,1,1,0
0,0,0,0,0,0,0,0,0
53643,714,5,144,130,14,10,1,0
0,0,0,0,0,0,0,0,0
0,0,0,0,0,0,0,0,0
0,0,0,0,0,0,0,0,0
0,0,0,0,0,0,0,0,0
0,0,0,0,0,0,0,0,0
0,0,0,0,0,0,0,0,0
52779,291,1,51,45,6,0,1,0
52751,751,4,194,188,6,3,1,0
23066,36,0,2,1,1,0,1,0
0,0,0,0,0,0,0,0,0
13364,259,3,49,40,9,0,1,0
0,0,0,0,0,0,0,0,0
0,0,0,0,0,0,0,0,0
0,0,0,0,0,0,0,0,0
0,0,0,0,0,0,0,0,0
13514,179,1,76,39,37,1,0,0
71245,421,5,93,91,2,14,1,0
0,0,0,0,0,0,0,0,0
256779,3115,4,319,301,18,6,1,0
172003,1179,9,178,170,8,15,1,0
95438,607,9,98,91,7,11,1,0
22942,666,3,270,232,38,0,1,0
85354,1027,8,274,273,1,1,1,0
7419,72,0,12,10,2,0,0,0
1128935,5990,9,1061,1056,5,31,1,0
2323,14,0,1,0,1,0,0,0
143820,767,11,155,111,44,7,0,0
0,0,0,0,0,0,0,0,0
57766,442,4,73,70,3,0,1,0
475967,874,7,162,149,13,2,1,0
368431,2944,2,871,866,5,14,1,0
332449,2743,2,838,833,5,14,1,0
0,0,0,0,0,0,0,0,0
48173,305,9,30,22,8,0,1,0
50278,592,6,69,55,14,2,1,0
98013,1020,7,205,118,87,4,1,0
197276,1643,7,168,153,15,6,1,0
77124,763,7,87,73,14,4,1,0
1593,9,0,1,0,1,0,0,1
26099,132,8,3,1,2,1,0,0
0,0,0,0,0,0,0,0,0
9824,180,1,13,10,3,0,1,0
341755,2283,15,163,49,114,3,1,0
0,0,0,0,0,0,0,0,0
331609,1211,8,122,111,11,1,0,0
99836,1972,2,1697,1682,15,0,1,0
45564,952,4,188,147,41,1,0,0
23097,295,4,72,60,12,1,0,0
92467,1041,2,60,33,27,2,1,0
404607,1428,9,220,218,2,17,1,0
0,0,0,0,0,0,0,0,0
6674,75,3,4,3,1,4,0,0
7306,81,3,1,1,0,4,0,0
150165,521,7,117,105,12,6,1,0
203865,1708,4,489,475,14,2,1,0
409426,2907,10,186,123,63,19,1,0
47894,327,7,46,46,0,0,1,0
0,0,0,0,0,0,0,0,0
0,0,0,0,0,0,0,0,0
5586,56,2,10,10,0,0,0,0
389541,1846,5,268,252,16,13,1,0
2889,44,0,9,9,0,3,0,0
148821,694,5,142,139,3,6,1,0
22056,33,0,1,1,0,0,1,0
16490,222,4,39,30,9,2,1,0
0,0,0,0,0,0,0,0,0
0,0,0,0,0,0,0,0,0
0,0,0,0,0,0,0,0,0
12824,338,2,106,87,19,0,0,0
2910,19,0,0,0,0,0,0,0
158945,702,8,74,48,26,6,1,0
129729,748,9,151,143,8,1,1,0
0,0,0,0,0,0,0,0,0
1590807,1732,18,337,329,8,19,1,0
1552085,1497,18,310,302,8,19,1,0
41350,438,0,128,128,0,1,0,0
34702,374,0,113,113,0,0,0,0
37521,180,4,25,21,4,0,1,0
38268,966,1,342,337,5,0,0,0
29292,433,2,125,122,3,0,0,0
0,0,0,0,0,0,0,0,0
0,0,0,0,0,0,0,0,0
0,0,0,0,0,0,0,0,0
140544,746,8,98,97,1,7,1,0
573945,2211,0,474,10,464,0,0,0
0,0,0,0,0,0,0,0,0
13162,135,0,13,9,4,4,0,0
48521,355,1,61,54,7,0,1,0
473490,3763,8,125,94,31,73,1,0
0,0,0,0,0,0,0,0,0
0,0,0,0,0,0,0,0,0
0,0,0,0,0,0,0,0,0
0,0,0,0,0,0,0,0,0
0,0,0,0,0,0,0,0,0
130430,1590,2,224,196,28,0,1,0
145327,862,2,196,176,20,16,1,0
47798,111,2,8,1,7,0,0,0
0,0,0,0,0,0,0,0,0
38790,266,6,28,27,1,0,1,0
13203,162,4,14,12,2,3,0,0
43802,522,6,64,54,10,2,1,0
0,0,0,0,0,0,0,0,0
0,0,0,0,0,0,0,0,0
0,0,0,0,0,0,0,0,0
126848,771,6,189,185,4,52,1,0
178476,945,9,248,241,7,1,1,0
0,0,0,0,0,0,0,0,0
259203,1467,11,382,318,64,4,1,0
129547,990,10,153,129,24,1,1,0
291327,3598,7,1063,1046,17,3,1,0
148912,732,1,169,142,27,9,0,0
90387,497,12,111,84,27,8,0,0
29345,308,8,58,58,0,0,1,0
0,0,0,0,0,0,0,0,0
147418,487,9,65,55,10,7,1,0
0,0,0,0,0,0,0,0,0
0,0,0,0,0,0,0,0,0
0,0,0,0,0,0,0,0,0
0,0,0,0,0,0,0,0,0
0,0,0,0,0,0,0,0,0
178714,296,2,40,39,1,2,1,0
238151,657,4,6,4,2,2,0,0
0,0,0,0,0,0,0,0,0
0,0,0,0,0,0,0,0,0
412074,1790,14,210,121,89,8,1,0
255846,1707,12,291,283,8,9,1,0
60687,691,17,140,136,4,1,1,0
36804,401,3,27,5,22,13,1,0
22061,35,0,1,1,0,0,1,0
273856,782,7,188,177,11,3,1,0
104096,1494,5,226,207,19,1,0,0
84655,640,9,40,35,5,5,1,0
153612,890,4,90,84,6,4,1,0
97984,189,3,43,43,0,0,1,0
0,0,0,0,0,0,0,0,0
52259,483,9,91,79,12,8,1,0
385059,631,1,73,63,10,18,0,0
99500,378,8,47,42,5,2,0,0
187434,639,15,118,58,60,12,1,0
22077,35,0,1,1,0,0,1,0
80902,451,3,12,11,1,0,0,0
0,0,0,0,0,0,0,0,0
0,0,0,0,0,0,0,0,0
65897,984,5,238,217,21,1,0,0
0,0,0,0,0,0,0,0,0
760636,1726,12,251,229,22,5,1,0
67128,221,2,23,0,23,0,1,0
0,0,0,0,0,0,0,0,0
0,0,0,0,0,0,0,0,0
0,0,0,0,0,0,0,0,0
0,0,0,0,0,0,0,0,0
2352,37,2,2,2,0,0,1,0
23922,254,8,27,27,0,2,1,0
245180,1277,14,323,312,11,0,1,0
268706,1508,3,231,222,9,5,1,0
789072,5903,5,899,548,351,4,1,0
100531,139,2,9,8,1,1,1,0
0,0,0,0,0,0,0,0,0
110063,1725,3,630,616,14,21,1,0
110008,1725,3,630,616,14,19,1,0
0,0,0,0,0,0,0,0,0
26775,36,0,3,1,2,0,0,0
0,0,0,0,0,0,0,0,0
0,0,0,0,0,0,0,0,0
344201,2796,6,303,243,60,5,1,0
244369,1859,11,134,91,43,5,1,0
263087,4535,2,1479,1479,0,2,1,0
694421,4114,4,159,137,22,82,1,0
138137,2022,4,328,302,26,1,1,0
0,0,0,0,0,0,0,0,0
261537,2102,12,100,7,93,3,1,0
203430,1524,14,194,194,0,3,1,0
0,0,0,0,0,0,0,0,0
166023,1050,6,220,211,9,2,1,0
0,0,0,0,0,0,0,0,0
0,0,0,0,0,0,0,0,0
0,0,0,0,0,0,0,0,0
144663,1310,7,295,290,5,3,1,0
0,0,0,0,0,0,0,0,0
0,0,0,0,0,0,0,0,0
40023,469,5,87,85,2,9,1,0
193795,969,6,135,90,45,10,0,0
82536,1675,2,379,342,37,1,1,0
300726,976,3,302,298,4,10,1,0
150767,1408,8,266,212,54,0,1,0
0,0,0,0,0,0,0,0,0
0,0,0,0,0,0,0,0,0
22576,241,7,4,1,3,0,1,0
533524,1852,11,111,75,36,20,1,0
181344,1582,13,214,213,1,4,1,0
0,0,0,0,0,0,0,0,0
76541,660,1,97,93,4,0,0,0
470869,1280,9,123,102,21,37,1,0
99676,663,9,123,120,3,0,1,0
242480,1325,6,123,119,4,3,1,0
45745,232,4,29,27,2,1,1,0
0,0,0,0,0,0,0,0,0
464597,1999,18,254,227,27,18,1,0
42308,287,4,35,28,7,3,1,0
227604,1426,14,134,124,10,7,1,0
2935017,619,3,56,24,32,0,0,0
34274,605,2,252,252,0,1,0,0
33600,593,2,253,253,0,1,0,0
1098433,3178,7,389,375,14,67,1,0
1296747,1077,3,112,90,22,1,1,0
0,0,0,0,0,0,0,0,0
44221,408,2,18,17,1,4,0,0
94119,838,13,167,108,59,8,1,0
22122,35,0,1,1,0,0,1,0
0,0,0,0,0,0,0,0,0
1690160,1144,3,118,101,17,0,1,0
306784,1819,5,343,306,37,6,1,0
0,0,0,0,0,0,0,0,0
487119,4236,8,1616,1607,9,13,0,0
0,0,0,0,0,0,0,0,0
0,0,0,0,0,0,0,0,0
299714,1219,10,162,148,14,10,1,0
225699,1674,5,352,320,32,2,1,0
0,0,0,0,0,0,0,0,0
0,0,0,0,0,0,0,0,0
223859,2540,8,137,121,16,59,1,0
129874,1112,5,204,200,4,13,1,0
0,0,0,0,0,0,0,0,0
432778,2365,13,491,474,17,95,1,0
8163,88,4,4,4,0,0,1,0
60806,587,8,112,107,5,1,1,0
56210,332,6,41,41,0,0,0,0
101473,1433,2,237,235,2,0,1,0
98874,547,10,51,0,51,2,1,0
0,0,0,0,0,0,0,0,0
89446,896,8,51,51,0,0,1,0
51143,252,8,17,17,0,2,1,0
92839,1342,6,193,171,22,11,1,0
269661,1072,10,194,188,6,46,1,0
257612,1002,11,190,183,7,48,1,0
0,0,0,0,0,0,0,0,0
21385,331,2,91,90,1,9,1,0
0,0,0,0,0,0,0,0,0
0,0,0,0,0,0,0,0,0
101719,982,6,221,221,0,5,1,0
0,0,0,0,0,0,0,0,0
13078,231,2,42,40,2,3,1,0
9588,154,1,24,22,2,1,1,0
0,0,0,0,0,0,0,0,0
187903,766,17,97,86,11,5,1,0
1211,15,1,0,0,0,0,0,0
10654,184,0,15,15,0,0,0,0
0,0,0,0,0,0,0,0,0
356057,2131,10,435,408,27,29,1,0
788625,3738,12,367,331,36,224,0,0
686464,3100,12,325,289,36,71,0,0
0,0,0,0,0,0,0,0,0
205024,1336,4,262,135,127,2,1,0
0,0,0,0,0,0,0,0,0
0,0,0,0,0,0,0,0,0
72835,2052,2,570,569,1,2,1,0
69963,684,5,137,133,4,0,1,0
76096,172,9,3,2,1,1,1,0
0,0,0,0,0,0,0,0,0
58712,376,3,66,66,0,0,1,0
892435,1748,5,238,238,0,2,1,0
812510,937,5,121,121,0,2,1,0
0,0,0,0,0,0,0,0,0
0,0,0,0,0,0,0,0,0
485474,2276,15,408,344,64,5,1,0
485469,2277,15,408,344,64,5,1,0
0,0,0,0,0,0,0,0,0
22058,35,0,1,1,0,0,1,0
23836,202,2,53,48,5,6,1,0
70017,551,2,65,59,6,0,1,0
242256,1833,3,448,421,27,8,1,0
89671,559,3,124,115,9,6,1,0
0,0,0,0,0,0,0,0,0
0,0,0,0,0,0,0,0,0
88028,243,5,19,19,0,7,1,0
0,0,0,0,0,0,0,0,0
700042,2654,4,235,231,4,19,1,0
300071,1155,10,197,73,124,3,1,0
59401,302,8,14,14,0,0,1,0
276192,1639,15,176,14,162,7,1,0
0,0,0,0,0,0,0,0,0
0,0,0,0,0,0,0,0,0
0,0,0,0,0,0,0,0,0
0,0,0,0,0,0,0,0,0
42685,341,9,63,24,39,1,1,0
174134,1502,8,282,272,10,1,1,0
7822,275,1,128,128,0,0,0,0
0,0,0,0,0,0,0,0,0
94186,783,9,114,102,12,0,1,0
263305,3206,11,919,879,40,7,1,0
65667,307,10,54,52,2,7,1,0
196412,1838,9,164,151,13,139,1,0
59405,392,10,21,16,5,6,1,0
52223,732,3,139,98,41,3,1,0
62514,487,5,121,98,23,0,0,0
0,0,0,0,0,0,0,0,0
0,0,0,0,0,0,0,0,0
23087,37,0,2,1,1,0,1,0
40666,418,8,53,47,6,3,1,0
73976,591,4,99,96,3,0,1,0
42766,64,2,5,5,0,0,0,0
97537,1146,3,179,165,14,7,1,0
193657,1510,9,103,88,15,2,1,0
864782,19386,1,102,102,0,0,1,0
67359,331,7,62,55,7,6,1,0
0,0,0,0,0,0,0,0,0
0,0,0,0,0,0,0,0,0
0,0,0,0,0,0,0,0,0
3223,89,1,6,6,0,0,1,0
330536,1498,8,140,108,32,4,1,0
155031,895,3,227,205,22,17,1,0
93853,1446,9,175,168,7,1,1,0
170462,1341,3,151,111,40,2,1,0
70829,661,1,57,44,13,10,1,0
141098,1933,3,423,420,3,0,1,0
337692,504,6,77,57,20,21,0,0
0,0,0,0,0,0,0,0,0
47445,503,4,40,32,8,0,1,0
28224,45,0,4,1,3,0,0,0
0,0,0,0,0,0,0,0,0
0,0,0,0,0,0,0,0,0
115158,1476,6,210,206,4,18,1,0
92467,1041,2,60,33,27,2,1,0
0,0,0,0,0,0,0,0,0
0,0,0,0,0,0,0,0,0
29265,550,0,86,84,2,0,0,0
19920,355,0,44,41,3,0,0,0
0,0,0,0,0,0,0,0,0
18104,227,4,47,34,13,14,0,0
0,0,0,0,0,0,0,0,0
0,0,0,0,0,0,0,0,0
0,0,0,0,0,0,0,0,0
31708,63,2,3,2,1,1,1,0
4559,41,1,2,2,0,0,1,0
529255,1078,12,135,118,17,5,1,0
0,0,0,0,0,0,0,0,0
152831,1187,7,264,240,24,7,1,0
269809,742,7,121,119,2,6,1,0
130094,1239,7,119,85,34,0,1,0
37299,170,6,22,13,9,0,0,0
23079,38,0,2,1,1,0,1,0
18924,287,1,33,30,3,0,1,0
292573,1060,3,185,184,1,31,1,0
39023,233,4,10,9,1,34,1,0
39545,332,4,23,15,8,0,1,0
102942,1070,3,212,207,5,13,1,0
20684,226,1,53,49,4,0,1,0
0,0,0,0,0,0,0,0,0
0,0,0,0,0,0,0,0,0
28333,225,5,40,29,11,6,0,0
50414,501,5,33,13,20,0,1,0
0,0,0,0,0,0,0,0,0
69637,1124,0,243,232,11,0,0,0
0,0,0,0,0,0,0,0,0
68769,828,5,76,70,6,5,1,0
0,0,0,0,0,0,0,0,0
21659,33,0,1,1,0,0,1,0
0,0,0,0,0,0,0,0,0
82114,945,3,65,62,3,0,0,0
0,0,0,0,0,0,0,0,0
0,0,0,0,0,0,0,0,0
0,0,0,0,0,0,0,0,0
88010,1245,5,187,168,19,256,1,0
120581,586,14,25,19,6,0,1,0
0,0,0,0,0,0,0,0,0
267732,1238,5,284,281,3,11,1,0
0,0,0,0,0,0,0,0,0
0,0,0,0,0,0,0,0,0
0,0,0,0,0,0,0,0,0
28595,45,0,4,1,3,0,0,0
50667,591,6,108,97,11,1,0,0
22240,242,6,65,57,8,1,0,0
165788,841,5,141,138,3,4,1,0
286347,1971,11,423,225,198,4,0,0
0,0,0,0,0,0,0,0,0
304980,1240,15,134,125,9,13,1,0
0,0,0,0,0,0,0,0,0
21122,59,1,0,0,0,1,0,0
424579,1823,1,125,79,46,2,1,0
358105,1583,8,117,15,102,5,1,0
39879,411,5,96,83,13,6,1,0
35369,237,6,36,18,18,6,1,0
84018,226,7,10,9,1,0,1,0
192577,1380,8,182,166,16,6,1,0
138442,839,8,131,126,5,5,1,0
336176,1406,18,66,1,65,4,0,0
280473,707,19,20,19,1,4,0,0
0,0,0,0,0,0,0,0,0
0,0,0,0,0,0,0,0,0
335779,4789,8,737,729,8,0,0,0
150309,333,9,25,22,3,0,0,0
0,0,0,0,0,0,0,0,0
11036,128,4,32,29,3,2,1,0
38729,327,8,56,51,5,7,1,0
0,0,0,0,0,0,0,0,0
58378,841,3,92,87,5,8,1,0
30850,280,2,57,53,4,4,1,0
172972,420,5,44,40,4,2,0,0
222501,895,8,168,156,12,24,1,0
7632,88,4,3,3,0,1,0,0
377772,1021,6,173,172,1,8,1,0
3726,75,2,8,8,0,0,1,0
0,0,0,0,0,0,0,0,0
30583,531,3,74,70,4,1,1,0
188456,1637,9,279,255,24,13,1,0
123290,939,9,117,108,9,15,1,0
64757,527,5,91,84,7,0,1,0
0,0,0,0,0,0,0,0,0
461834,1124,7,181,19,162,11,1,0
0,0,0,0,0,0,0,0,0
0,0,0,0,0,0,0,0,0
91698,601,2,116,114,2,6,1,0
506451,1850,18,172,164,8,39,0,0
18343,201,3,36,35,1,2,1,0
0,0,0,0,0,0,0,0,0
150491,1106,10,191,188,3,9,1,0
2994,35,3,3,3,0,0,0,0
257288,1247,10,242,229,13,14,1,0
195571,500,9,92,88,4,10,1,0
0,0,0,0,0,0,0,0,0
0,0,0,0,0,0,0,0,0
60042,463,4,74,74,0,2,0,0
46086,518,6,56,48,8,1,1,0
211244,1173,3,218,205,13,4,1,0
0,0,0,0,0,0,0,0,0
23241,257,2,66,66,0,3,1,0
0,0,0,0,0,0,0,0,0
0,0,0,0,0,0,0,0,0
0,0,0,0,0,0,0,0,0
128244,854,7,222,214,8,6,1,0
0,0,0,0,0,0,0,0,0
239140,1244,1,87,86,1,5,1,0
110290,552,1,60,60,0,6,1,0
0,0,0,0,0,0,0,0,0
0,0,0,0,0,0,0,0,0
72519,748,8,90,84,6,21,1,0
44891,390,8,43,38,5,19,1,0
8633,117,0,11,3,8,0,1,0
167914,858,13,182,173,9,8,1,0
30340,142,3,12,11,1,2,1,0
66339,885,7,254,236,18,2,1,0
25084,344,10,56,52,4,4,0,0
0,0,0,0,0,0,0,0,0
0,0,0,0,0,0,0,0,0
630057,7800,12,1446,1435,11,7,1,0
155441,1866,1,750,746,4,6,1,0
0,0,0,0,0,0,0,0,0
0,0,0,0,0,0,0,0,0
0,0,0,0,0,0,0,0,0
103265,303,9,51,20,31,2,1,0
139974,329,2,19,19,0,1,0,0
684849,143,1,4,2,2,3,1,0
684849,143,1,4,2,2,3,1,0
89439,1184,2,392,392,0,1,1,0
159148,398,5,47,37,10,1,1,0
165525,2289,6,465,455,10,0,1,0
0,0,0,0,0,0,0,0,0
0,0,0,0,0,0,0,0,0
28910,413,4,61,48,13,3,1,0
111748,1161,8,280,273,7,12,1,0
106823,1253,6,281,280,1,15,0,0
267839,1390,14,323,277,46,33,1,0
0,0,0,0,0,0,0,0,0
0,0,0,0,0,0,0,0,0
146551,359,5,22,17,5,5,1,0
15277,248,1,80,77,3,0,1,0
13242,233,1,56,53,3,0,1,0
0,0,0,0,0,0,0,0,0
0,0,0,0,0,0,0,0,0
180690,1005,10,153,147,6,3,1,0
55680,494,9,65,58,7,12,1,0
0,0,0,0,0,0,0,0,0
65987,148,10,2,1,1,5,0,0
47110,132,8,3,0,3,0,1,0
72144,502,0,83,74,9,5,1,0
22466,221,0,46,37,9,5,1,0
0,0,0,0,0,0,0,0,0
937143,895,5,84,34,50,3,1,0
0,0,0,0,0,0,0,0,0
0,0,0,0,0,0,0,0,0
118071,1312,7,114,52,62,9,0,0
52869,849,3,211,201,10,0,1,0
0,0,0,0,0,0,0,0,0
439974,4511,10,775,134,641,31,1,0
320836,1523,1,327,322,5,5,1,0
163818,332,1,74,24,50,0,1,0
37061,496,6,72,60,12,0,1,0
0,0,0,0,0,0,0,0,0
40825,330,3,42,37,5,0,0,0
39,3,0,0,0,0,0,0,0
0,0,0,0,0,0,0,0,0
77695,756,5,138,116,22,11,1,1
0,0,0,0,0,0,0,0,0
12433,106,2,12,9,3,0,1,0
61506,223,9,23,17,6,4,0,0
61508,223,9,23,17,6,4,0,0
0,0,0,0,0,0,0,0,0
0,0,0,0,0,0,0,0,0
274293,1978,2,140,134,6,7,1,0
21962,33,0,1,1,0,0,1,0
0,0,0,0,0,0,0,0,0
145731,1194,10,190,186,4,2,1,0
21487,243,9,45,42,3,2,1,0
68348,561,4,82,79,3,4,0,0
160059,1222,10,415,407,8,1,1,0
88095,305,10,47,40,7,1,1,0
0,0,0,0,0,0,0,0,0
0,0,0,0,0,0,0,0,0
0,0,0,0,0,0,0,0,0
0,0,0,0,0,0,0,0,0
19116,137,0,26,25,1,1,0,0
452775,1255,8,148,141,7,5,1,0
219717,1097,0,253,163,90,0,0,0
56642,1013,2,251,241,10,6,0,0
22106,35,0,1,1,0,0,1,0
0,0,0,0,0,0,0,0,0
504410,2209,15,576,19,557,6,1,0
106357,768,4,90,84,6,16,1,0
405770,3881,6,186,174,12,66,1,0
114797,653,6,90,78,12,2,1,0
0,0,0,0,0,0,0,0,0
59723,352,12,27,22,5,3,0,0
0,0,0,0,0,0,0,0,0
267664,2091,8,391,362,29,2,1,0
0,0,0,0,0,0,0,0,0
0,0,0,0,0,0,0,0,0
854,15,0,2,1,1,0,0,0
25292,220,1,1,1,0,8,0,0
115512,1170,1,146,8,138,0,1,0
0,0,0,0,0,0,0,0,0
0,0,0,0,0,0,0,0,0
16236,152,7,5,5,0,0,1,0
0,0,0,0,0,0,0,0,0
172204,1783,5,195,187,8,101,1,0
448859,2064,9,370,315,55,20,1,0
0,0,0,0,0,0,0,0,0
26090,590,0,228,140,88,0,1,0
0,0,0,0,0,0,0,0,0
188107,1418,12,221,209,12,17,1,1
187673,1549,13,163,162,1,2,1,0
16357,115,10,5,0,5,2,0,0
87476,464,1,83,83,0,0,0,0
0,0,0,0,0,0,0,0,0
1437,33,0,8,1,7,0,0,0
25147,619,1,72,70,2,1,1,0
0,0,0,0,0,0,0,0,0
0,0,0,0,0,0,0,0,0
39225,49,0,8,4,4,0,0,0
0,0,0,0,0,0,0,0,0
61734,662,2,113,89,24,1,1,0
0,0,0,0,0,0,0,0,0
47198,398,2,20,16,4,10,0,0
118302,653,17,46,34,12,3,1,0
46495,787,2,4,3,1,0,0,0
171597,2273,9,642,626,16,6,1,0
143305,2285,10,645,638,7,9,1,0
0,0,0,0,0,0,0,0,0
0,0,0,0,0,0,0,0,0
2287,32,1,2,2,0,0,1,0
0,0,0,0,0,0,0,0,0
8115,84,5,3,2,1,3,1,0
123426,913,6,112,102,10,0,0,1
0,0,0,0,0,0,0,0,0
0,0,0,0,0,0,0,0,0
31190,428,6,72,66,6,7,0,0
36649,411,7,63,49,14,1,0,0
0,0,0,0,0,0,0,0,0
188724,1198,2,216,197,19,6,1,0
4135,57,0,4,3,1,0,0,0
6111,84,3,4,3,1,0,1,0
12639,72,4,6,6,0,0,1,0
0,0,0,0,0,0,0,0,0
22831,177,2,23,23,0,10,1,0
418529,2484,4,250,237,13,0,1,0
0,0,0,0,0,0,0,0,0
24429,450,2,36,36,0,2,1,0
0,0,0,0,0,0,0,0,0
46729,398,6,106,103,3,9,1,0
0,0,0,0,0,0,0,0,0
52456,557,6,141,136,5,7,1,0
102151,489,1,31,14,17,0,1,0
36120,100,8,0,0,0,2,0,0
178261,863,10,162,146,16,6,1,0
177316,2551,6,397,378,19,8,1,0
198818,2145,5,390,385,5,38,1,0
0,0,0,0,0,0,0,0,0
373695,4479,3,1614,1108,506,5,1,0
242647,2724,2,1394,891,503,5,1,0
15091,168,1,1,1,0,0,1,0
577848,1500,13,273,221,52,5,1,0
0,0,0,0,0,0,0,0,0
22902,36,0,2,1,1,0,1,0
211272,1820,3,185,167,18,10,1,0
6282,62,2,7,6,1,0,1,0
100706,1101,6,193,193,0,8,1,0
184746,1950,7,12,11,1,167,1,0
0,0,0,0,0,0,0,0,0
0,0,0,0,0,0,0,0,0
0,0,0,0,0,0,0,0,0
22760,37,0,2,1,1,0,1,0
0,0,0,0,0,0,0,0,0
0,0,0,0,0,0,0,0,0
123412,1385,2,592,558,34,32,0,0
0,0,0,0,0,0,0,0,0
0,0,0,0,0,0,0,0,0
758688,1037,8,92,84,8,3,1,0
690574,546,7,45,42,3,3,1,0
0,0,0,0,0,0,0,0,0
714122,2871,5,434,429,5,5,1,0
396102,1788,22,212,187,25,11,1,0
331629,1837,1,339,334,5,5,1,0
163400,330,1,74,24,50,0,1,0
801795,5887,20,565,532,33,13,1,0
0,0,0,0,0,0,0,0,0
0,0,0,0,0,0,0,0,0
0,0,0,0,0,0,0,0,0
100654,1178,6,306,285,21,4,1,0
49672,613,6,169,149,20,4,1,0
151322,805,5,130,108,22,7,1,0
0,0,0,0,0,0,0,0,0
375391,459,12,18,15,3,3,1,0
199102,1384,13,265,250,15,10,1,0
146621,1505,8,291,257,34,6,1,1
101792,916,2,34,22,12,3,0,0
602610,2600,12,200,178,22,14,1,0
200164,1248,5,266,260,6,12,1,0
186680,1272,5,137,108,29,9,1,0
21702,121,11,11,10,1,7,0,0
0,0,0,0,0,0,0,0,0
40017,810,2,477,208,269,2,1,0
2893,52,1,7,5,2,0,1,0
0,0,0,0,0,0,0,0,0
255678,624,8,116,112,4,11,1,0
853853,1150,10,131,99,32,16,1,0
64491,658,4,131,119,12,2,1,0
309486,1657,6,367,342,25,2,1,0
0,0,0,0,0,0,0,0,0
4557075,3700,8,134,123,11,11,1,0
0,0,0,0,0,0,0,0,0
427977,3146,6,138,127,11,8,1,0
204663,796,5,88,78,10,4,1,0
44800,258,2,2,1,1,1,1,0
168243,994,15,173,151,22,2,1,0
0,0,0,0,0,0,0,0,0
499064,829,13,89,80,9,1,1,0
54608,61,1,5,5,0,0,1,0
75226,1155,3,343,283,60,0,1,0
0,0,0,0,0,0,0,0,0
121192,3374,0,51,10,41,44,0,0
0,0,0,0,0,0,0,0,0
0,0,0,0,0,0,0,0,0
317485,1118,10,183,177,6,8,1,0
67454,470,4,55,47,8,6,0,0
143551,1794,6,977,971,6,2,1,1
150129,851,7,86,67,19,4,0,0
6536,46,3,0,0,0,0,0,0
0,0,0,0,0,0,0,0,0
33093,435,5,101,97,4,6,0,0
0,0,0,0,0,0,0,0,0
0,0,0,0,0,0,0,0,0
132407,642,14,116,111,5,0,1,0
69698,1225,2,178,168,10,2,1,0
0,0,0,0,0,0,0,0,0
168110,1434,11,286,224,62,8,1,0
0,0,0,0,0,0,0,0,0
7939,28,3,4,0,4,0,0,0
128945,157,6,8,6,2,1,0,0
224902,1194,4,110,96,14,1,1,0
82179,399,3,28,28,0,6,1,0
0,0,0,0,0,0,0,0,0
98063,1182,7,211,205,6,3,1,0
87859,1318,7,257,243,14,10,1,0
0,0,0,0,0,0,0,0,0
0,0,0,0,0,0,0,0,0
128211,622,5,203,189,14,0,1,0
469476,4673,11,1546,1515,31,41,1,0
69705,398,6,74,73,1,0,1,0
658403,2096,6,273,269,4,0,0,0
331552,206,14,0,0,0,1,1,0
30335,410,7,57,57,0,4,1,0
12442,185,5,40,40,0,1,1,0
0,0,0,0,0,0,0,0,0
26095,262,4,48,48,0,6,0,0
83058,1017,3,213,190,23,6,1,0
0,0,0,0,0,0,0,0,0
208595,976,7,136,127,9,10,1,0
145344,615,7,104,95,9,10,1,0
0,0,0,0,0,0,0,0,0
108649,1169,7,169,140,29,5,0,0
61198,637,7,77,70,7,2,0,0
80684,916,1,234,223,11,4,1,0
0,0,0,0,0,0,0,0,0
0,0,0,0,0,0,0,0,0
113915,422,8,42,33,9,3,1,0
0,0,0,0,0,0,0,0,0
0,0,0,0,0,0,0,0,0
177925,1328,11,306,249,57,16,1,0
0,0,0,0,0,0,0,0,0
0,0,0,0,0,0,0,0,0
150562,926,7,49,31,18,5,1,0
0,0,0,0,0,0,0,0,0
1093447,1511,15,208,195,13,2,1,1
44951,535,5,127,114,13,3,1,0
20913,253,6,53,46,7,3,1,0
0,0,0,0,0,0,0,0,0
92430,1041,2,60,33,27,2,1,0
0,0,0,0,0,0,0,0,0
0,0,0,0,0,0,0,0,0
51307,687,6,168,148,20,1,1,0
0,0,0,0,0,0,0,0,0
291459,1690,7,338,308,30,3,1,0
0,0,0,0,0,0,0,0,0
0,0,0,0,0,0,0,0,0
146701,817,9,50,50,0,2,1,1
234651,1948,16,414,279,135,13,1,0
100856,139,2,9,8,1,1,1,0
0,0,0,0,0,0,0,0,0
110727,930,8,110,80,30,1,1,0
45425,549,4,127,119,8,5,1,0
522113,5849,20,244,232,12,3,1,0
160702,932,20,70,61,9,3,1,0
0,0,0,0,0,0,0,0,0
123670,379,8,107,105,2,3,1,0
0,0,0,0,0,0,0,0,0
47339,908,9,181,176,5,2,1,0
376125,2854,11,328,288,40,4,0,0
283168,2079,11,191,153,38,7,0,0
0,0,0,0,0,0,0,0,0
0,0,0,0,0,0,0,0,0
104967,1022,5,60,50,10,4,1,0
545527,186,6,9,6,3,2,0,0
74348,671,4,123,117,6,2,0,0
73499,666,4,118,109,9,5,0,0
0,0,0,0,0,0,0,0,0
204019,1528,5,398,381,17,0,0,0
0,0,0,0,0,0,0,0,0
230970,732,4,88,76,12,18,1,0
1766083,4635,1,916,62,854,4,1,0
675807,557,0,4,0,4,2,1,1
45329,508,4,75,74,1,0,0,0
23829,215,4,44,44,0,0,0,0
76000,605,9,83,43,40,2,1,0
0,0,0,0,0,0,0,0,0
85854,793,6,181,172,9,0,1,0
290891,343,0,4,3,1,1,1,0
46794,571,8,82,70,12,0,1,0
443780,2832,3,135,121,14,0,1,0
63073,43,0,6,6,0,0,0,0
604586,3090,7,182,119,63,17,1,0
0,0,0,0,0,0,0,0,0
35055,248,5,47,4,43,5,1,0
32592,229,5,45,22,23,5,1,0
0,0,0,0,0,0,0,0,0
2866,56,1,8,5,3,0,1,0
52789,863,3,47,46,1,1,1,0
0,0,0,0,0,0,0,0,0
3746,51,2,7,6,1,0,1,0
0,0,0,0,0,0,0,0,0
302897,848,8,146,128,18,7,1,0
2913735,170,3,7,7,0,0,0,0
90728,686,0,133,129,4,6,1,0
0,0,0,0,0,0,0,0,0
0,0,0,0,0,0,0,0,0
121306,1568,8,505,499,6,0,1,0
282834,1110,3,133,16,117,2,1,0
0,0,0,0,0,0,0,0,0
0,0,0,0,0,0,0,0,0
92181,1188,6,225,211,14,16,1,0
37866,449,6,77,64,13,13,1,0
0,0,0,0,0,0,0,0,0
75512,457,8,103,100,3,4,1,0
75481,457,8,103,100,3,4,1,0
0,0,0,0,0,0,0,0,0
163948,846,2,222,189,33,0,1,0
60997,813,7,151,121,30,8,1,0
0,0,0,0,0,0,0,0,0
0,0,0,0,0,0,0,0,0
0,0,0,0,0,0,0,0,0
0,0,0,0,0,0,0,0,0
1782394,1089,6,165,154,11,4,1,0
47672,513,4,137,131,6,11,0,0
0,0,0,0,0,0,0,0,0
0,0,0,0,0,0,0,0,0
33470,613,3,107,104,3,0,1,0
48317,505,4,161,161,0,0,1,0
369276,330,2,72,11,61,2,1,0
0,0,0,0,0,0,0,0,0
0,0,0,0,0,0,0,0,0
0,0,0,0,0,0,0,0,0
50778,666,2,165,65,100,7,0,0
28672,423,2,52,43,9,4,0,0
149488,1638,8,203,190,13,37,1,0
0,0,0,0,0,0,0,0,0
0,0,0,0,0,0,0,0,0
8301,127,0,13,1,12,0,0,0
0,0,0,0,0,0,0,0,0
221408,2378,13,402,400,2,9,1,0
0,0,0,0,0,0,0,0,0
25680,364,2,114,109,5,22,1,0
146927,769,8,172,163,9,4,1,0
132200,674,8,148,140,8,5,1,0
637593,744,2,130,122,8,1,1,0
403141,1510,15,144,141,3,9,1,0
26971,162,3,22,22,0,0,0,0
26971,162,3,22,22,0,0,0,0
0,0,0,0,0,0,0,0,0
75455,672,5,125,109,16,6,1,0
250104,1138,5,202,155,47,45,1,0
220497,2287,7,499,372,127,9,1,0
129706,1085,7,228,223,5,15,1,0
19229,315,8,53,45,8,1,1,0
17160,211,9,33,30,3,1,1,0
453912,1670,11,229,214,15,33,1,0
42675,137,10,4,3,1,4,1,0
0,0,0,0,0,0,0,0,0
20543,108,2,20,20,0,0,0,0
0,0,0,0,0,0,0,0,0
128269,608,8,81,7,74,13,1,0
0,0,0,0,0,0,0,0,0
17844,393,0,128,128,0,8,1,0
0,0,0,0,0,0,0,0,0
0,0,0,0,0,0,0,0,0
64186,960,4,97,89,8,0,1,0
0,0,0,0,0,0,0,0,0
0,0,0,0,0,0,0,0,0
0,0,0,0,0,0,0,0,0
92467,1041,2,60,33,27,2,1,0
0,0,0,0,0,0,0,0,0
0,0,0,0,0,0,0,0,0
307527,1361,9,167,156,11,10,1,0
76785,488,6,95,80,15,3,1,0
76785,488,6,95,80,15,3,1,0
2302075,5402,12,204,190,14,1,1,0
0,0,0,0,0,0,0,0,0
165808,467,1,114,13,101,8,1,0
155365,528,5,152,149,3,10,1,0
40271,597,5,40,40,0,3,1,0
0,0,0,0,0,0,0,0,0
16748,275,5,73,72,1,1,0,0
8623,109,5,15,14,1,1,0,0
802608,4939,12,652,642,10,98,1,0
480066,2029,12,509,499,10,9,1,0
31663,418,3,63,61,2,7,1,0
173044,1152,15,225,195,30,23,1,0
0,0,0,0,0,0,0,0,0
0,0,0,0,0,0,0,0,0
34873,351,8,33,31,2,4,1,0
0,0,0,0,0,0,0,0,0
127825,1524,9,345,332,13,6,1,0
0,0,0,0,0,0,0,0,0
2057885,500,6,90,83,7,5,1,0
152706,1525,2,11,11,0,8,0,0
0,0,0,0,0,0,0,0,0
719872,2344,14,165,153,12,2,1,0
114661,806,7,119,83,36,4,1,0
656032,2345,5,315,300,15,3,1,0
424693,909,4,140,125,15,2,1,0
0,0,0,0,0,0,0,0,0
132728,1190,11,267,197,70,6,1,0
9413,173,1,10,6,4,0,1,0
159815,994,11,20,16,4,1,1,0
143165,706,10,77,58,19,0,1,0
0,0,0,0,0,0,0,0,0
20755,434,1,83,75,8,5,1,0
14000,264,1,29,27,2,10,1,0
0,0,0,0,0,0,0,0,0
42060,661,1,172,148,24,0,0,0
290569,2377,8,296,286,10,6,1,0
168767,1361,8,252,247,5,5,1,0
0,0,0,0,0,0,0,0,0
106028,786,8,235,225,10,2,1,0
103524,805,8,235,222,13,2,1,0
0,0,0,0,0,0,0,0,0
0,0,0,0,0,0,0,0,0
889523,4025,4,824,47,777,27,1,0
315,6,0,0,0,0,0,0,0
21718,33,0,1,1,0,0,1,0
79034,759,9,242,228,14,7,1,0
355595,793,4,127,102,25,11,1,0
80135,108,1,10,7,3,2,0,0
116252,1570,3,227,218,9,42,1,0
95542,1355,3,208,201,7,42,1,0
128671,583,11,57,46,11,0,0,0
8990,97,1,1,1,0,2,0,0
28062,422,2,65,64,1,0,1,0
3435,76,3,18,18,0,0,1,0
115437,1085,8,292,277,15,3,1,0
0,0,0,0,0,0,0,0,0
264185,886,8,104,51,53,7,1,0
84945,464,8,103,98,5,1,1,0
0,0,0,0,0,0,0,0,0
0,0,0,0,0,0,0,0,0
752385,4570,9,675,658,17,7,0,0
752059,4569,9,675,658,17,7,0,0
0,0,0,0,0,0,0,0,0
213677,662,7,42,37,5,6,1,0
11270,85,2,5,5,0,0,0,0
255306,2121,10,305,286,19,11,1,0
101957,989,4,228,216,12,3,1,0
32145,222,4,36,33,3,1,1,0
0,0,0,0,0,0,0,0,0
0,0,0,0,0,0,0,0,0
0,0,0,0,0,0,0,0,0
58919,628,8,120,90,30,11,1,0
0,0,0,0,0,0,0,0,0
60547,832,4,284,277,7,0,1,0
32346,458,3,148,145,3,0,1,0
64696,699,4,208,206,2,6,1,0
100899,1557,6,167,156,11,1,1,0
23405,376,6,61,58,3,1,1,0
43741,646,6,110,105,5,15,1,0
0,0,0,0,0,0,0,0,0
127705,1037,4,224,223,1,6,1,0
0,0,0,0,0,0,0,0,0
0,0,0,0,0,0,0,0,0
0,0,0,0,0,0,0,0,0
0,0,0,0,0,0,0,0,0
0,0,0,0,0,0,0,0,0
85494,1047,10,194,136,58,10,1,0
132965,293,0,89,86,3,0,0,0
0,0,0,0,0,0,0,0,0
44460,474,3,95,70,25,2,1,0
34046,410,3,87,71,16,1,1,0
10029,181,3,27,26,1,0,1,0
0,0,0,0,0,0,0,0,0
92229,84,0,15,15,0,5,0,0
0,0,0,0,0,0,0,0,0
306094,1679,1,375,326,49,1,1,0
50543,657,7,160,153,7,4,1,0
7441,160,3,36,28,8,0,1,0
0,0,0,0,0,0,0,0,0
0,0,0,0,0,0,0,0,0
0,0,0,0,0,0,0,0,0
183264,2967,5,221,202,19,0,1,0
309355,1254,3,161,156,5,7,0,0
0,0,0,0,0,0,0,0,0
0,0,0,0,0,0,0,0,0
0,0,0,0,0,0,0,0,0
230345,166,6,7,1,6,0,1,0
84648,817,7,182,182,0,18,0,0
0,0,0,0,0,0,0,0,0
0,0,0,0,0,0,0,0,0
273684,1404,11,274,253,21,8,1,0
60403,1449,2,295,284,11,0,1,0
13047,166,2,41,32,9,1,1,0
0,0,0,0,0,0,0,0,0
0,0,0,0,0,0,0,0,0
0,0,0,0,0,0,0,0,0
101099,1258,7,76,45,31,9,0,0
12143,86,3,10,10,0,1,1,0
12462,87,3,10,10,0,1,1,0
180257,909,4,201,173,28,1,1,0
218819,1151,8,128,127,1,52,1,0
0,0,0,0,0,0,0,0,0
0,0,0,0,0,0,0,0,0
572926,1590,5,113,106,7,39,1,0
22956,36,0,2,1,1,0,1,0
0,0,0,0,0,0,0,0,0
121486,823,14,57,24,33,3,1,0
0,0,0,0,0,0,0,0,0
59313,934,4,296,249,47,7,1,0
2326,50,0,5,4,1,0,0,0
328290,480,8,56,37,19,1,1,0
0,0,0,0,0,0,0,0,0
69612,986,3,304,209,95,5,0,0
15563,215,3,23,20,3,5,0,0
0,0,0,0,0,0,0,0,0
143715,1678,2,314,300,14,11,0,0
57458,762,7,144,142,2,0,1,0
0,0,0,0,0,0,0,0,0
90617,443,5,119,116,3,0,1,0
451020,1213,11,127,115,12,6,1,0
76787,486,9,85,84,1,8,0,0
0,0,0,0,0,0,0,0,0
0,0,0,0,0,0,0,0,0
322807,3852,3,1058,1036,22,37,1,0
388815,4210,3,1000,979,21,34,1,0
0,0,0,0,0,0,0,0,0
439951,3167,11,926,750,176,25,0,0
79402,591,2,116,115,1,9,1,0
0,0,0,0,0,0,0,0,0
0,0,0,0,0,0,0,0,0
661745,1781,6,202,171,31,0,1,0
255847,2558,4,129,45,84,7,1,0
52671,249,7,56,53,3,0,1,0
0,0,0,0,0,0,0,0,0
0,0,0,0,0,0,0,0,0
130919,418,11,53,44,9,0,1,0
9740,111,5,12,11,1,2,0,0
112161,692,8,124,114,10,5,1,0
499616,1542,4,263,204,59,3,1,0
5416,42,5,3,2,1,0,0,0
762374,1660,5,165,146,19,15,1,0
0,0,0,0,0,0,0,0,0
0,0,0,0,0,0,0,0,0
0,0,0,0,0,0,0,0,0
0,0,0,0,0,0,0,0,0
0,0,0,0,0,0,0,0,0
243662,1796,12,362,356,6,23,1,0
416546,3857,11,334,300,34,10,0,0
55216,469,5,28,27,1,1,1,0
0,0,0,0,0,0,0,0,0
0,0,0,0,0,0,0,0,0
246383,1376,12,128,109,19,9,1,0
162695,540,6,42,37,5,10,1,0
0,0,0,0,0,0,0,0,0
0,0,0,0,0,0,0,0,0
22685,33,0,1,1,0,0,1,0
0,0,0,0,0,0,0,0,0
0,0,0,0,0,0,0,0,0
0,0,0,0,0,0,0,0,0
79469,336,14,27,22,5,3,1,0
59821,237,13,24,19,5,2,1,0
0,0,0,0,0,0,0,0,0
0,0,0,0,0,0,0,0,0
30972,101,1,10,9,1,2,1,0
30285,82,1,11,10,1,2,1,0
0,0,0,0,0,0,0,0,0
0,0,0,0,0,0,0,0,0
0,0,0,0,0,0,0,0,0
107033,1029,8,239,226,13,32,1,0
162996,1190,3,141,130,11,7,1,0
17898,37,0,3,1,2,0,1,0
0,0,0,0,0,0,0,0,0
9627,191,1,21,21,0,0,1,0
0,0,0,0,0,0,0,0,0
117473,703,3,116,111,5,14,1,0
717396,96,4,2,2,0,2,0,0
178201,814,7,85,83,2,0,1,0
72482,853,0,151,77,74,0,1,0
0,0,0,0,0,0,0,0,0
312149,3320,2,516,512,4,1,0,0
3162230,1394,9,277,231,46,12,1,0
155883,1021,5,353,345,8,0,0,0
0,0,0,0,0,0,0,0,0
112569,1054,0,168,154,14,2,1,0
0,0,0,0,0,0,0,0,0
7243,99,3,20,17,3,2,1,0
0,0,0,0,0,0,0,0,0
71826,505,4,18,9,9,1,1,0
2973583,22531,10,3226,3101,125,9,1,0
262511,2801,2,699,692,7,2,0,0
9956,59,4,3,0,3,0,0,0
297936,2193,4,214,208,6,0,0,0
204663,1395,3,148,142,6,0,0,0
0,0,0,0,0,0,0,0,0
89936,950,5,161,159,2,1,0,0
75721,1035,4,297,132,165,0,1,0
15612,137,4,15,15,0,0,1,0
84729,963,0,61,33,28,2,1,0
52289,164,11,14,13,1,3,0,0
0,0,0,0,0,0,0,0,0
188590,1776,2,378,366,12,0,1,0
108930,267,1,53,46,7,0,1,0
0,0,0,0,0,0,0,0,0
440764,1809,11,262,9,253,29,1,0
0,0,0,0,0,0,0,0,0
838810,460,6,97,90,7,5,1,0
848103,394,6,65,57,8,5,1,0
0,0,0,0,0,0,0,0,0
47174,543,11,104,104,0,1,1,0
47034,543,11,104,104,0,1,1,0
199003,920,2,153,150,3,2,1,0
133337,1164,12,263,257,6,5,1,0
37269,414,6,104,104,0,2,1,0
169357,672,11,90,84,6,27,1,0
92864,1261,2,291,276,15,2,1,0
146345,1572,4,207,204,3,2,1,0
45420,328,0,34,24,10,0,0,0
33669,395,7,97,92,5,0,1,0
365965,1427,13,317,265,52,8,1,0
111856,118,9,7,7,0,3,1,0
295841,1175,12,213,203,10,2,1,0
0,0,0,0,0,0,0,0,0
0,0,0,0,0,0,0,0,0
0,0,0,0,0,0,0,0,0
206031,1393,8,249,242,7,74,0,0
1913302,1348,13,320,310,10,9,1,0
46169,528,3,97,84,13,5,1,0
0,0,0,0,0,0,0,0,0
263247,938,11,153,145,8,5,1,0
0,0,0,0,0,0,0,0,0
406684,1005,8,178,14,164,3,0,0
23044,38,0,2,2,0,0,1,0
42715,151,2,5,1,4,0,0,0
0,0,0,0,0,0,0,0,0
168274,783,5,99,96,3,0,1,0
199339,1430,16,173,168,5,10,1,0
141242,1314,3,111,44,67,2,1,0
0,0,0,0,0,0,0,0,0
0,0,0,0,0,0,0,0,0
0,0,0,0,0,0,0,0,0
29759,162,3,7,3,4,3,0,0
35542,240,3,10,3,7,3,0,0
5210,60,2,4,4,0,0,0,0
28072,429,2,115,109,6,0,1,0
208859,1070,7,54,44,10,83,1,0
0,0,0,0,0,0,0,0,0
21990,33,0,1,1,0,0,1,0
221056,1097,12,163,161,2,10,1,0
183307,906,12,152,147,5,9,1,0
508918,1993,3,106,106,0,7,1,0
34921,420,6,78,48,30,0,1,0
0,0,0,0,0,0,0,0,0
166607,688,3,50,8,42,7,1,0
71360,449,3,81,57,24,61,1,0
0,0,0,0,0,0,0,0,0
14108,185,1,54,54,0,0,1,0
210947,180,0,47,32,15,1,1,0
0,0,0,0,0,0,0,0,0
89905,1238,7,149,113,36,5,1,0
0,0,0,0,0,0,0,0,0
0,0,0,0,0,0,0,0,0
80623,1161,4,142,137,5,3,1,0
0,0,0,0,0,0,0,0,0
49236,1008,1,214,213,1,6,0,0
0,0,0,0,0,0,0,0,0
0,0,0,0,0,0,0,0,0
180092,948,11,168,159,9,20,1,0
59558,280,5,56,54,2,8,0,0
74927,717,7,121,113,8,4,1,0
0,0,0,0,0,0,0,0,0
0,0,0,0,0,0,0,0,0
42129,332,4,52,50,2,6,1,0
41549,609,3,56,51,5,0,1,0
0,0,0,0,0,0,0,0,0
70215,459,2,34,34,0,1,0,0
129617,1989,0,217,214,3,0,0,0
137189,399,4,12,12,0,5,1,0
144970,1165,5,220,208,12,1,1,0
696472,2334,7,491,18,473,16,1,0
330082,669,6,125,92,33,13,1,0
0,0,0,0,0,0,0,0,0
0,0,0,0,0,0,0,0,0
255384,2634,8,513,504,9,14,1,0
28334,42,0,2,1,1,0,0,0
52480,604,2,71,70,1,0,1,0
178109,786,8,121,45,76,2,1,0
34698,380,6,84,82,2,8,1,0
281188,501,1,28,21,7,1,0,0
279123,472,1,33,26,7,1,0,0
171281,408,1,116,115,1,0,1,0
106785,813,8,57,51,6,17,1,0
46513,300,7,49,42,7,5,1,0
27612,312,1,32,12,20,3,1,0
61819,147,0,9,5,4,13,1,0
0,0,0,0,0,0,0,0,0
0,0,0,0,0,0,0,0,0
108471,564,3,103,103,0,11,1,0
180019,1193,7,298,293,5,6,1,0
0,0,0,0,0,0,0,0,0
0,0,0,0,0,0,0,0,0
239927,3551,4,1125,1094,31,45,0,0
0,0,0,0,0,0,0,0,0
38959,364,10,28,7,21,1,1,0
21799,33,0,1,1,0,0,1,0
371405,1591,5,250,230,20,8,1,0
332191,1403,5,234,215,19,8,1,0
145453,1278,6,185,180,5,10,1,0
94225,807,6,121,116,5,9,1,0
67756,277,5,28,13,15,1,1,0
0,0,0,0,0,0,0,0,0
85930,758,5,145,125,20,9,1,0
221811,2308,12,311,285,26,7,1,0
0,0,0,0,0,0,0,0,0
140540,2748,6,383,377,6,15,1,0
63463,1102,6,163,163,0,10,1,0
701852,2881,16,280,271,9,9,1,0
145464,925,6,198,147,51,1,1,0
0,0,0,0,0,0,0,0,0
352032,2277,7,435,395,40,50,1,0
348478,1844,12,229,109,120,3,1,0
372849,1652,11,339,336,3,5,1,0
231059,347,0,17,9,8,0,1,0
344692,1997,6,120,80,40,3,0,0
104165,564,3,60,51,9,3,0,0
27886,44,0,4,3,1,0,0,0
0,0,0,0,0,0,0,0,0
158263,1000,3,88,61,27,1,1,0
0,0,0,0,0,0,0,0,0
60300,262,8,22,19,3,14,1,0
29156,161,7,24,21,3,9,1,0
0,0,0,0,0,0,0,0,0
9753,114,4,27,25,2,0,1,0
0,0,0,0,0,0,0,0,0
1418754,3309,6,506,476,30,0,0,0
0,0,0,0,0,0,0,0,0
0,0,0,0,0,0,0,0,0
6974,89,3,9,2,7,0,1,0
0,0,0,0,0,0,0,0,0
334003,2224,1,416,395,21,8,1,0
5821,119,1,31,27,4,0,1,0
445902,2497,8,385,360,25,10,1,0
0,0,0,0,0,0,0,0,0
0,0,0,0,0,0,0,0,0
143312,872,0,173,159,14,6,1,0
53884,403,2,102,102,0,1,1,0
0,0,0,0,0,0,0,0,0
30215,429,0,220,206,14,0,0,0
228818,3270,12,576,511,65,28,1,0
22684,61,2,1,1,0,0,0,0
139284,994,8,134,52,82,9,1,0
167546,1123,6,209,159,50,5,1,0
64511,633,5,114,95,19,6,1,0
86922,444,2,17,13,4,12,1,0
62758,505,2,74,65,9,0,0,0
0,0,0,0,0,0,0,0,0
40556,610,8,114,82,32,6,1,0
33680,373,3,64,60,4,6,1,0
96220,1123,6,193,188,5,4,1,0
77704,568,7,84,78,6,1,1,0
324722,394,7,58,57,1,6,1,0
0,0,0,0,0,0,0,0,0
0,0,0,0,0,0,0,0,0
0,0,0,0,0,0,0,0,0
104687,1974,4,760,760,0,0,0,0
1292372,2415,9,146,127,19,3,1,0
1338418,2292,11,5,5,0,3,1,0
0,0,0,0,0,0,0,0,0
304172,1181,1,210,75,135,2,1,0
47748,321,4,58,58,0,0,1,0
0,0,0,0,0,0,0,0,0
46752,579,3,105,105,0,6,1,0
154425,798,5,78,37,41,0,1,0
470492,5041,11,2215,2201,14,2021,1,0
198863,602,11,84,71,13,4,1,0
0,0,0,0,0,0,0,0,0
75538,1513,3,464,432,32,5,1,0
0,0,0,0,0,0,0,0,0
2419777,825,9,159,153,6,17,1,0
242079,730,8,99,99,0,4,1,0
0,0,0,0,0,0,0,0,0
0,0,0,0,0,0,0,0,0
0,0,0,0,0,0,0,0,0
0,0,0,0,0,0,0,0,0
996934,8705,9,163,157,6,9,1,0
0,0,0,0,0,0,0,0,0
171548,1180,4,257,250,7,0,1,0
0,0,0,0,0,0,0,0,0
0,0,0,0,0,0,0,0,0
100753,831,9,257,253,4,18,1,0
33424,297,3,48,46,2,4,1,0
4640,97,0,22,22,0,0,0,0
52618,408,7,66,62,4,5,0,0
240903,991,13,186,177,9,11,1,0
216352,803,12,166,160,6,5,1,0
167037,1095,9,99,75,24,21,1,0
85329,546,2,13,9,4,4,1,0
0,0,0,0,0,0,0,0,0
0,0,0,0,0,0,0,0,0
51021,604,4,162,162,0,0,1,0
0,0,0,0,0,0,0,0,0
0,0,0,0,0,0,0,0,0
0,0,0,0,0,0,0,0,0
0,0,0,0,0,0,0,0,0
91672,1042,7,138,131,7,3,0,0
0,0,0,0,0,0,0,0,0
10192,176,0,27,22,5,0,1,0
51009,502,2,68,68,0,1,0,0
61513,1065,4,253,252,1,22,1,0
33391,583,2,127,125,2,2,1,0
75797,1070,1,207,200,7,2,1,0
26832,225,1,28,19,9,2,1,0
1161573,1076,9,151,130,21,4,1,0
307560,961,12,175,136,39,9,1,0
236943,588,4,60,33,27,1,1,0
40387,213,7,13,8,5,0,0,0
0,0,0,0,0,0,0,0,0
561780,1362,9,151,133,18,21,1,0
0,0,0,0,0,0,0,0,0
1008567,18886,7,1500,1478,22,39,0,0
122146,1404,9,492,394,98,12,1,0
71952,925,10,357,345,12,3,1,0
105216,1586,6,198,154,44,0,1,0
533442,2565,5,154,149,5,74,0,0
228282,1065,5,110,105,5,15,0,0
0,0,0,0,0,0,0,0,0
0,0,0,0,0,0,0,0,0
0,0,0,0,0,0,0,0,0
0,0,0,0,0,0,0,0,0
7048,46,3,3,3,0,2,0,0
0,0,0,0,0,0,0,0,0
22022,33,0,1,1,0,0,1,0
22863,37,0,2,1,1,0,1,0
290599,3752,5,232,183,49,13,1,0
67604,528,2,59,54,5,0,1,0
0,0,0,0,0,0,0,0,0
4261652,4320,6,332,325,7,4,1,0
40512,141,4,24,18,6,0,1,0
0,0,0,0,0,0,0,0,0
155812,391,12,24,20,4,1,1,0
0,0,0,0,0,0,0,0,0
0,0,0,0,0,0,0,0,0
305381,1109,10,226,206,20,6,1,0
3877,56,0,5,1,4,0,0,0
0,0,0,0,0,0,0,0,0
21792,33,0,1,1,0,0,1,0
0,0,0,0,0,0,0,0,0
91019,810,6,180,171,9,7,1,0
99772,1572,4,235,235,0,0,0,0
14096,213,5,48,48,0,3,0,0
0,0,0,0,0,0,0,0,0
0,0,0,0,0,0,0,0,0
16511,286,6,91,76,15,0,0,0
0,0,0,0,0,0,0,0,0
170793,2561,3,94,90,4,257,1,0
0,0,0,0,0,0,0,0,0
0,0,0,0,0,0,0,0,0
45725,455,9,80,72,8,0,1,0
0,0,0,0,0,0,0,0,0
147160,1012,8,204,204,0,0,0,0
0,0,0,0,0,0,0,0,0
0,0,0,0,0,0,0,0,0
83027,1050,9,114,89,25,3,1,0
19700,77,6,1,1,0,1,0,0
0,0,0,0,0,0,0,0,0
0,0,0,0,0,0,0,0,0
98879,952,8,212,204,8,22,1,0
144124,835,1,270,268,2,2,1,0
31540,499,0,196,189,7,0,1,0
17950,184,0,55,53,2,0,1,0
63093,553,9,116,110,6,0,1,0
92173,1119,11,90,17,73,5,1,0
57490,76,6,3,3,0,2,0,0
0,0,0,0,0,0,0,0,0
8801,42,0,0,0,0,0,0,0
0,0,0,0,0,0,0,0,0
85753,426,5,37,24,13,7,1,0
0,0,0,0,0,0,0,0,0
0,0,0,0,0,0,0,0,0
323534,4329,7,407,236,171,1,1,0
253461,2198,5,334,297,37,3,1,0
37017,337,5,60,31,29,0,1,0
0,0,0,0,0,0,0,0,0
0,0,0,0,0,0,0,0,0
47786,405,6,21,2,19,0,0,0
1624082,1488,10,61,7,54,9,1,0
0,0,0,0,0,0,0,0,0
0,0,0,0,0,0,0,0,0
232891,1747,10,385,380,5,13,1,0
5113,76,2,6,6,0,0,1,0
0,0,0,0,0,0,0,0,0
23098,538,0,191,189,2,4,1,0
7079,87,2,8,6,2,0,1,0
0,0,0,0,0,0,0,0,0
2753129,25936,9,172,159,13,1,1,0
1110,12,1,0,0,0,0,0,0
0,0,0,0,0,0,0,0,0
179911,916,11,78,75,3,3,0,0
179888,915,11,78,75,3,3,0,0
85861,723,3,144,135,9,6,1,0
173898,984,12,154,147,7,6,1,0
0,0,0,0,0,0,0,0,0
0,0,0,0,0,0,0,0,0
266487,1255,6,118,110,8,10,1,0
0,0,0,0,0,0,0,0,0
85198,786,3,65,52,13,7,0,0
187020,1817,2,411,407,4,0,0,0
28220,262,2,33,30,3,0,0,0
79263,369,7,53,45,8,21,1,0
0,0,0,0,0,0,0,0,0
0,0,0,0,0,0,0,0,0
43567,579,8,66,48,18,13,0,0
32105,398,9,48,39,9,0,0,0
0,0,0,0,0,0,0,0,0
0,0,0,0,0,0,0,0,0
231134,1431,11,211,190,21,19,1,0
247677,1289,10,280,262,18,5,1,0
176129,1839,7,286,274,12,4,1,0
716595,393,8,58,51,7,7,1,0
220428,1098,1,56,42,14,0,1,0
0,0,0,0,0,0,0,0,0
279061,1784,10,446,412,34,11,0,0
32139,116,3,8,3,5,0,1,0
28831,478,4,71,61,10,0,1,0
0,0,0,0,0,0,0,0,0
69535,1226,9,260,224,36,2,1,0
10398,152,4,26,26,0,0,1,0
81988,629,2,165,165,0,5,1,0
0,0,0,0,0,0,0,0,0
279626,1691,7,267,243,24,12,1,0
69841,123,5,2,2,0,2,0,0
14284,321,3,69,69,0,0,1,0
104211,829,13,79,71,8,14,1,0
47445,656,5,71,70,1,2,1,0
24856,273,6,48,46,2,0,1,0
28130,321,2,121,119,2,4,1,0
19692,168,2,53,9,44,0,1,0
0,0,0,0,0,0,0,0,0
85680,785,10,27,20,7,20,1,0
2604608,5766,5,311,247,64,2,1,0
323356,866,5,129,90,39,2,1,0
0,0,0,0,0,0,0,0,0
53786,831,3,198,190,8,0,0,0
57977,1042,2,171,171,0,0,1,0
107133,787,10,225,222,3,4,0,0
10929,86,7,6,5,1,0,0,0
90374,1279,5,175,171,4,54,1,0
0,0,0,0,0,0,0,0,0
135937,1280,5,313,307,6,4,0,0
282842,2041,13,338,320,18,19,0,0
0,0,0,0,0,0,0,0,0
34920,313,0,44,4,40,0,0,0
65610,232,5,30,15,15,2,1,0
429466,1587,3,100,93,7,0,1,0
0,0,0,0,0,0,0,0,0
0,0,0,0,0,0,0,0,0
315422,1728,3,235,226,9,1,1,0
0,0,0,0,0,0,0,0,0
0,0,0,0,0,0,0,0,0
173448,1615,6,368,353,15,1,1,0
30769,402,5,69,61,8,2,1,0
9930,165,5,24,19,5,2,1,0
748387,1685,6,206,205,1,17,1,1
0,0,0,0,0,0,0,0,0
236695,1415,7,329,241,88,7,1,0
60472,336,12,48,48,0,4,1,0
0,0,0,0,0,0,0,0,0
107220,859,8,152,132,20,0,1,0
218932,2263,4,386,117,269,2,1,0
31173,43,1,14,14,0,0,1,0
64543,1545,0,355,354,1,5,1,0
8799,213,0,46,45,1,3,1,0
245826,2437,13,330,223,107,11,1,0
18995,52,3,7,4,3,0,0,0
188765,670,6,51,51,0,4,1,0
117224,380,2,33,33,0,6,1,0
0,0,0,0,0,0,0,0,0
0,0,0,0,0,0,0,0,0
0,0,0,0,0,0,0,0,0
0,0,0,0,0,0,0,0,0
299543,2383,11,331,327,4,3,1,0
297640,2299,17,737,722,15,33,1,0
695525,1902,4,6,5,1,0,1,0
0,0,0,0,0,0,0,0,0
0,0,0,0,0,0,0,0,0
208848,857,13,208,191,17,0,1,0
85073,1156,4,232,191,41,0,0,0
21114,244,4,49,32,17,0,0,0
115702,793,4,281,272,9,3,1,0
38669,154,3,6,4,2,3,0,0
434793,1302,12,71,71,0,41,1,0
0,0,0,0,0,0,0,0,0
455104,606,8,89,87,2,0,1,0
279695,437,8,6,6,0,0,0,0
112244,1297,1,285,285,0,8,0,0
0,0,0,0,0,0,0,0,0
14684,199,8,23,22,1,4,1,0
60393,711,2,77,77,0,10,1,0
16634,169,3,17,17,0,8,1,0
0,0,0,0,0,0,0,0,0
0,0,0,0,0,0,0,0,0
0,0,0,0,0,0,0,0,0
0,0,0,0,0,0,0,0,0
0,0,0,0,0,0,0,0,0
300767,403,10,24,21,3,0,1,0
447747,3762,5,238,141,97,2,1,0
0,0,0,0,0,0,0,0,0
0,0,0,0,0,0,0,0,0
236530,1653,4,137,134,3,6,1,0
219759,1329,5,92,87,5,7,1,0
0,0,0,0,0,0,0,0,0
1168597,465,7,58,50,8,8,1,0
0,0,0,0,0,0,0,0,0
0,0,0,0,0,0,0,0,0
3275,11,0,0,0,0,0,0,0
162756,969,5,136,119,17,0,1,0
0,0,0,0,0,0,0,0,0
224206,2342,9,528,509,19,5,1,0
0,0,0,0,0,0,0,0,0
0,0,0,0,0,0,0,0,0
182762,799,12,120,100,20,9,1,0
0,0,0,0,0,0,0,0,0
483198,2495,7,375,284,91,26,1,0
71470,553,8,170,166,4,0,1,0
0,0,0,0,0,0,0,0,0
87180,1441,7,476,473,3,0,1,0
0,0,0,0,0,0,0,0,0
0,0,0,0,0,0,0,0,0
1407,32,0,4,4,0,0,0,0
19106,239,4,40,35,5,2,1,0
0,0,0,0,0,0,0,0,0
250541,485,4,28,27,1,1,0,0
0,0,0,0,0,0,0,0,0
0,0,0,0,0,0,0,0,0
42154,704,3,115,16,99,1,1,0
0,0,0,0,0,0,0,0,0
0,0,0,0,0,0,0,0,0
0,0,0,0,0,0,0,0,0
0,0,0,0,0,0,0,0,0
0,0,0,0,0,0,0,0,0
104750,479,10,189,184,5,4,1,0
10811,82,7,4,3,1,0,0,0
98060,782,11,104,74,30,5,1,0
69694,623,2,75,75,0,2,0,0
23655,86,0,1,1,0,5,1,0
14742,261,0,14,14,0,0,1,0
11246,135,0,18,18,0,0,1,0
210984,1233,5,120,114,6,0,1,0
210983,1233,5,120,114,6,0,1,0
0,0,0,0,0,0,0,0,0
431741,1596,11,122,112,10,28,1,0
636191,3001,9,454,432,22,0,1,0
0,0,0,0,0,0,0,0,0
0,0,0,0,0,0,0,0,0
231200,347,0,17,14,3,0,1,0
24339,247,4,23,17,6,0,1,0
0,0,0,0,0,0,0,0,0
0,0,0,0,0,0,0,0,0
57618,593,6,136,94,42,3,1,0
0,0,0,0,0,0,0,0,0
0,0,0,0,0,0,0,0,0
0,0,0,0,0,0,0,0,0
0,0,0,0,0,0,0,0,0
113555,846,7,97,95,2,3,1,0
104021,788,7,80,78,2,5,1,0
0,0,0,0,0,0,0,0,0
223916,1263,7,60,51,9,11,1,0
187282,714,7,41,35,6,12,1,0
89695,841,11,67,63,4,7,1,0
55569,421,3,39,37,2,4,1,0
0,0,0,0,0,0,0,0,0
36177,401,2,105,100,5,2,1,0
16750,165,1,17,17,0,7,1,0
3620,64,0,16,16,0,0,1,0
145894,818,11,98,93,5,37,1,0
0,0,0,0,0,0,0,0,0
1284423,13528,3,2035,2015,20,13,1,0
0,0,0,0,0,0,0,0,0
211109,215,2,7,7,0,11,1,0
124520,745,4,88,74,14,4,1,0
66222,509,8,81,70,11,3,0,0
84542,899,6,208,205,3,0,1,0
131386,1387,10,366,335,31,2,1,0
119917,815,5,58,29,29,6,1,0
5234,72,0,3,2,1,0,0,0
258599,1110,9,160,155,5,5,1,0
462753,723,10,85,43,42,6,1,0
218582,179,6,5,5,0,5,0,0
193931,674,10,90,76,14,1,1,0
0,0,0,0,0,0,0,0,0
19915,295,3,81,81,0,0,0,0
0,0,0,0,0,0,0,0,0
0,0,0,0,0,0,0,0,0
0,0,0,0,0,0,0,0,0
0,0,0,0,0,0,0,0,0
0,0,0,0,0,0,0,0,0
0,0,0,0,0,0,0,0,0
0,0,0,0,0,0,0,0,0
0,0,0,0,0,0,0,0,0
0,0,0,0,0,0,0,0,0
0,0,0,0,0,0,0,0,0
0,0,0,0,0,0,0,0,0
0,0,0,0,0,0,0,0,0
0,0,0,0,0,0,0,0,0
0,0,0,0,0,0,0,0,0
0,0,0,0,0,0,0,0,0
0,0,0,0,0,0,0,0,0
0,0,0,0,0,0,0,0,0
0,0,0,0,0,0,0,0,0
0,0,0,0,0,0,0,0,0
0,0,0,0,0,0,0,0,0
0,0,0,0,0,0,0,0,0
0,0,0,0,0,0,0,0,0
0,0,0,0,0,0,0,0,0
0,0,0,0,0,0,0,0,0
0,0,0,0,0,0,0,0,0
0,0,0,0,0,0,0,0,0
0,0,0,0,0,0,0,0,0
0,0,0,0,0,0,0,0,0
0,0,0,0,0,0,0,0,0
0,0,0,0,0,0,0,0,0
0,0,0,0,0,0,0,0,0
0,0,0,0,0,0,0,0,0
0,0,0,0,0,0,0,0,0
0,0,0,0,0,0,0,0,0
0,0,0,0,0,0,0,0,0
0,0,0,0,0,0,0,0,0
0,0,0,0,0,0,0,0,0
0,0,0,0,0,0,0,0,0
0,0,0,0,0,0,0,0,0
0,0,0,0,0,0,0,0,0
0,0,0,0,0,0,0,0,0
0,0,0,0,0,0,0,0,0
0,0,0,0,0,0,0,0,0
0,0,0,0,0,0,0,0,0
0,0,0,0,0,0,0,0,0
0,0,0,0,0,0,0,0,0
0,0,0,0,0,0,0,0,0
0,0,0,0,0,0,0,0,0
0,0,0,0,0,0,0,0,0
0,0,0,0,0,0,0,0,0
0,0,0,0,0,0,0,0,0
0,0,0,0,0,0,0,0,0
0,0,0,0,0,0,0,0,0
0,0,0,0,0,0,0,0,0
0,0,0,0,0,0,0,0,0
0,0,0,0,0,0,0,0,0
0,0,0,0,0,0,0,0,0
0,0,0,0,0,0,0,0,0
0,0,0,0,0,0,0,0,0
0,0,0,0,0,0,0,0,0
0,0,0,0,0,0,0,0,0
0,0,0,0,0,0,0,0,0
0,0,0,0,0,0,0,0,0
0,0,0,0,0,0,0,0,0
0,0,0,0,0,0,0,0,0
0,0,0,0,0,0,0,0,0
0,0,0,0,0,0,0,0,0
0,0,0,0,0,0,0,0,0
0,0,0,0,0,0,0,0,0
0,0,0,0,0,0,0,0,0
0,0,0,0,0,0,0,0,0
0,0,0,0,0,0,0,0,0
0,0,0,0,0,0,0,0,0
0,0,0,0,0,0,0,0,0
0,0,0,0,0,0,0,0,0
0,0,0,0,0,0,0,0,0
0,0,0,0,0,0,0,0,0
0,0,0,0,0,0,0,0,0
0,0,0,0,0,0,0,0,0
0,0,0,0,0,0,0,0,0
0,0,0,0,0,0,0,0,0
0,0,0,0,0,0,0,0,0
0,0,0,0,0,0,0,0,0
0,0,0,0,0,0,0,0,0
0,0,0,0,0,0,0,0,0
0,0,0,0,0,0,0,0,0
0,0,0,0,0,0,0,0,0
0,0,0,0,0,0,0,0,0
0,0,0,0,0,0,0,0,0
0,0,0,0,0,0,0,0,0
0,0,0,0,0,0,0,0,0
0,0,0,0,0,0,0,0,0
0,0,0,0,0,0,0,0,0
0,0,0,0,0,0,0,0,0
0,0,0,0,0,0,0,0,0
0,0,0,0,0,0,0,0,0
0,0,0,0,0,0,0,0,0
0,0,0,0,0,0,0,0,0
0,0,0,0,0,0,0,0,0
0,0,0,0,0,0,0,0,0
0,0,0,0,0,0,0,0,0
0,0,0,0,0,0,0,0,0
0,0,0,0,0,0,0,0,0
0,0,0,0,0,0,0,0,0
0,0,0,0,0,0,0,0,0
0,0,0,0,0,0,0,0,0
0,0,0,0,0,0,0,0,0
0,0,0,0,0,0,0,0,0
0,0,0,0,0,0,0,0,0
0,0,0,0,0,0,0,0,0
0,0,0,0,0,0,0,0,0
0,0,0,0,0,0,0,0,0
0,0,0,0,0,0,0,0,0
0,0,0,0,0,0,0,0,0
0,0,0,0,0,0,0,0,0
0,0,0,0,0,0,0,0,0
0,0,0,0,0,0,0,0,0
0,0,0,0,0,0,0,0,0
0,0,0,0,0,0,0,0,0
0,0,0,0,0,0,0,0,0
0,0,0,0,0,0,0,0,0
0,0,0,0,0,0,0,0,0
0,0,0,0,0,0,0,0,0
0,0,0,0,0,0,0,0,0
0,0,0,0,0,0,0,0,0
0,0,0,0,0,0,0,0,0
0,0,0,0,0,0,0,0,0
0,0,0,0,0,0,0,0,0
0,0,0,0,0,0,0,0,0
0,0,0,0,0,0,0,0,0
0,0,0,0,0,0,0,0,0
0,0,0,0,0,0,0,0,0
0,0,0,0,0,0,0,0,0
0,0,0,0,0,0,0,0,0
0,0,0,0,0,0,0,0,0
0,0,0,0,0,0,0,0,0
0,0,0,0,0,0,0,0,0
0,0,0,0,0,0,0,0,0
0,0,0,0,0,0,0,0,0
0,0,0,0,0,0,0,0,0
0,0,0,0,0,0,0,0,0
0,0,0,0,0,0,0,0,0
0,0,0,0,0,0,0,0,0
0,0,0,0,0,0,0,0,0
0,0,0,0,0,0,0,0,0
0,0,0,0,0,0,0,0,0
0,0,0,0,0,0,0,0,0
0,0,0,0,0,0,0,0,0
0,0,0,0,0,0,0,0,0
0,0,0,0,0,0,0,0,0
0,0,0,0,0,0,0,0,0
0,0,0,0,0,0,0,0,0
0,0,0,0,0,0,0,0,0
0,0,0,0,0,0,0,0,0
0,0,0,0,0,0,0,0,0
0,0,0,0,0,0,0,0,0
0,0,0,0,0,0,0,0,0
0,0,0,0,0,0,0,0,0
0,0,0,0,0,0,0,0,0
0,0,0,0,0,0,0,0,0
0,0,0,0,0,0,0,0,0
0,0,0,0,0,0,0,0,0
0,0,0,0,0,0,0,0,0
0,0,0,0,0,0,0,0,0
0,0,0,0,0,0,0,0,0
0,0,0,0,0,0,0,0,0
0,0,0,0,0,0,0,0,0
0,0,0,0,0,0,0,0,0
0,0,0,0,0,0,0,0,0
0,0,0,0,0,0,0,0,0
0,0,0,0,0,0,0,0,0
0,0,0,0,0,0,0,0,0
0,0,0,0,0,0,0,0,0
0,0,0,0,0,0,0,0,0
0,0,0,0,0,0,0,0,0
0,0,0,0,0,0,0,0,0
0,0,0,0,0,0,0,0,0
0,0,0,0,0,0,0,0,0
0,0,0,0,0,0,0,0,0
0,0,0,0,0,0,0,0,0
0,0,0,0,0,0,0,0,0
0,0,0,0,0,0,0,0,0
0,0,0,0,0,0,0,0,0
0,0,0,0,0,0,0,0,0
0,0,0,0,0,0,0,0,0
0,0,0,0,0,0,0,0,0
0,0,0,0,0,0,0,0,0
0,0,0,0,0,0,0,0,0
0,0,0,0,0,0,0,0,0
0,0,0,0,0,0,0,0,0
0,0,0,0,0,0,0,0,0
0,0,0,0,0,0,0,0,0
0,0,0,0,0,0,0,0,0
0,0,0,0,0,0,0,0,0
0,0,0,0,0,0,0,0,0
0,0,0,0,0,0,0,0,0
0,0,0,0,0,0,0,0,0
0,0,0,0,0,0,0,0,0
0,0,0,0,0,0,0,0,0
0,0,0,0,0,0,0,0,0
0,0,0,0,0,0,0,0,0
0,0,0,0,0,0,0,0,0
0,0,0,0,0,0,0,0,0
0,0,0,0,0,0,0,0,0
0,0,0,0,0,0,0,0,0
0,0,0,0,0,0,0,0,0
0,0,0,0,0,0,0,0,0
0,0,0,0,0,0,0,0,0
0,0,0,0,0,0,0,0,0
0,0,0,0,0,0,0,0,0
0,0,0,0,0,0,0,0,0
0,0,0,0,0,0,0,0,0
0,0,0,0,0,0,0,0,0
182815,971,11,139,113,26,11,0,0
52313,978,5,261,227,34,11,1,0
67935,404,7,51,23,28,1,1,0
15014,192,3,8,8,0,0,1,0
0,0,0,0,0,0,0,0,0
0,0,0,0,0,0,0,0,0
147644,928,10,219,13,206,0,1,0
0,0,0,0,0,0,0,0,0
21602,93,4,15,8,7,0,0,0
0,0,0,0,0,0,0,0,0
0,0,0,0,0,0,0,0,0
0,0,0,0,0,0,0,0,0
0,0,0,0,0,0,0,0,0
155412,1768,9,180,169,11,5,1,0
0,0,0,0,0,0,0,0,0
324320,1840,9,294,281,13,18,1,0
0,0,0,0,0,0,0,0,0
0,0,0,0,0,0,0,0,0
0,0,0,0,0,0,0,0,0
0,0,0,0,0,0,0,0,0
0,0,0,0,0,0,0,0,0
0,0,0,0,0,0,0,0,0
0,0,0,0,0,0,0,0,0
13772,123,0,30,30,0,3,1,0
999783,14993,5,160,151,9,15,1,0
54936,361,4,50,47,3,3,1,0
0,0,0,0,0,0,0,0,0
369037,1135,6,177,172,5,1,1,0
522618,4250,9,406,402,4,3,1,0
0,0,0,0,0,0,0,0,0
623102,571,2,48,47,1,6,1,0
0,0,0,0,0,0,0,0,0
0,0,0,0,0,0,0,0,0
445191,2569,2,365,209,156,14,1,0
0,0,0,0,0,0,0,0,0
268141,1808,7,401,393,8,20,1,0
242920,1480,8,172,167,5,8,1,0
234996,2389,10,299,279,20,63,0,1
0,0,0,0,0,0,0,0,0
0,0,0,0,0,0,0,0,0
43555,182,9,6,6,0,4,0,0
29000,180,4,28,14,14,6,1,0
97791,480,5,77,72,5,0,0,0
84061,296,5,34,29,5,0,0,0
0,0,0,0,0,0,0,0,0
358692,5012,3,1550,1545,5,1,0,0
130830,1261,8,332,314,18,3,1,0
134296,1188,7,259,255,4,20,1,0
51011,209,2,23,12,11,0,1,0
0,0,0,0,0,0,0,0,0
1214572,173,10,3,0,3,0,1,0
0,0,0,0,0,0,0,0,0
51996,349,1,53,51,2,0,0,0
20281,299,2,72,68,4,3,1,0
149397,1698,4,458,28,430,8,1,0
78764,1062,6,347,344,3,0,1,0
0,0,0,0,0,0,0,0,0
59877,263,12,31,28,3,2,1,0
122078,496,7,60,36,24,12,1,0
1036918,9613,8,297,252,45,11,1,0
105147,1477,3,311,263,48,13,1,0
0,0,0,0,0,0,0,0,0
24025,213,6,47,45,2,1,1,0
0,0,0,0,0,0,0,0,0
346748,5264,8,943,901,42,7,1,0
372794,3428,8,863,847,16,10,1,0
0,0,0,0,0,0,0,0,0
266502,875,8,89,86,3,1,1,0
151608,284,8,6,5,1,1,1,0
104044,545,1,14,8,6,0,0,0
0,0,0,0,0,0,0,0,0
0,0,0,0,0,0,0,0,0
0,0,0,0,0,0,0,0,0
0,0,0,0,0,0,0,0,0
0,0,0,0,0,0,0,0,0
61164,409,1,34,26,8,0,0,0
0,0,0,0,0,0,0,0,0
0,0,0,0,0,0,0,0,0
79814,1555,5,274,268,6,12,1,0
7677,52,0,6,1,5,0,0,0
241512,1383,10,236,221,15,9,1,0
106142,1359,6,368,325,43,0,1,0
197452,457,1,10,10,0,1,1,0
135302,1568,5,283,196,87,7,1,0
0,0,0,0,0,0,0,0,0
184598,1902,4,512,478,34,9,1,0
7690,52,0,6,1,5,0,0,0
0,0,0,0,0,0,0,0,0
304284,2659,5,333,314,19,3,1,1
35628,400,2,11,5,6,10,1,0
0,0,0,0,0,0,0,0,0
210496,1235,12,258,243,15,4,0,0
8833,93,5,7,4,3,2,1,0
0,0,0,0,0,0,0,0,0
0,0,0,0,0,0,0,0,0
461171,3358,5,721,712,9,4,1,0
367090,2567,5,645,640,5,3,1,0
98879,1843,3,537,530,7,1,1,0
15583,283,1,83,78,5,2,1,0
15690,81,3,3,3,0,0,0,0
141414,488,7,41,41,0,0,1,0
0,0,0,0,0,0,0,0,0
2783673,18189,10,3903,3753,150,898,1,0
437399,3356,10,452,421,31,51,0,0
167891,681,13,168,168,0,1,1,0
0,0,0,0,0,0,0,0,0
0,0,0,0,0,0,0,0,0
0,0,0,0,0,0,0,0,0
0,0,0,0,0,0,0,0,0
0,0,0,0,0,0,0,0,0
0,0,0,0,0,0,0,0,0
3562,66,0,19,19,0,0,1,0
0,0,0,0,0,0,0,0,0
247586,2913,16,755,749,6,13,1,0
220659,2624,15,733,728,5,13,1,0
162751,354,2,17,17,0,0,1,0
0,0,0,0,0,0,0,0,0
74139,576,3,89,85,4,9,1,0
164602,1060,9,61,46,15,35,1,0
38236,897,1,162,162,0,0,1,0
178863,2061,7,474,472,2,4,1,0
0,0,0,0,0,0,0,0,0
87087,764,13,109,88,21,3,0,0
0,0,0,0,0,0,0,0,0
0,0,0,0,0,0,0,0,0
0,0,0,0,0,0,0,0,0
128297,1090,3,187,161,26,4,0,0
8799,42,0,0,0,0,0,0,0
123432,1142,9,55,43,12,2,1,0
1371540,784,3,165,118,47,1,1,0
0,0,0,0,0,0,0,0,0
0,0,0,0,0,0,0,0,0
0,0,0,0,0,0,0,0,0
0,0,0,0,0,0,0,0,0
0,0,0,0,0,0,0,0,0
178654,1921,13,244,241,3,9,0,0
56673,463,10,90,86,4,6,0,0
90855,1402,10,173,166,7,14,1,0
0,0,0,0,0,0,0,0,0
0,0,0,0,0,0,0,0,0
0,0,0,0,0,0,0,0,0
0,0,0,0,0,0,0,0,0
0,0,0,0,0,0,0,0,0
0,0,0,0,0,0,0,0,0
0,0,0,0,0,0,0,0,0
0,0,0,0,0,0,0,0,0
0,0,0,0,0,0,0,0,0
98414,1308,1,305,300,5,1,1,0
0,0,0,0,0,0,0,0,0
2418,32,3,1,0,1,0,0,0
0,0,0,0,0,0,0,0,0
20069,129,2,11,8,3,2,1,0
0,0,0,0,0,0,0,0,0
248075,657,1,46,30,16,0,1,0
513768,1286,12,39,33,6,34,1,0
0,0,0,0,0,0,0,0,0
3353249,29125,0,569,562,7,0,1,0
112374,142,0,11,7,4,0,1,0
552351,3847,3,663,645,18,0,1,0
300086,2804,3,611,603,8,0,1,0
0,0,0,0,0,0,0,0,0
655193,2086,11,358,312,46,16,1,0
18388,147,8,9,9,0,0,0,0
0,0,0,0,0,0,0,0,0
555759,1981,3,112,98,14,3,0,0
252579,1074,5,50,43,7,3,0,0
1099313,9017,6,944,734,210,211,1,0
214636,1571,13,415,407,8,10,1,0
387923,910,4,77,53,24,0,1,0
486003,1779,18,312,291,21,17,1,0
627586,4307,3,977,967,10,5,0,0
425388,3306,3,893,883,10,8,0,0
0,0,0,0,0,0,0,0,0
124569,443,10,50,42,8,9,1,0
125,5,0,0,0,0,0,0,0
0,0,0,0,0,0,0,0,0
0,0,0,0,0,0,0,0,0
338635,1322,11,164,154,10,11,1,0
0,0,0,0,0,0,0,0,0
134075,793,11,138,134,4,10,1,0
51406,238,12,20,20,0,7,0,0
0,0,0,0,0,0,0,0,0
0,0,0,0,0,0,0,0,0
572402,3773,8,641,629,12,30,1,0
17547,332,4,99,91,8,2,1,0
13095,219,4,92,85,7,2,1,0
89059,389,0,86,85,1,0,1,0
216266,2279,17,320,298,22,11,1,0
70088,883,17,169,149,20,12,1,0
0,0,0,0,0,0,0,0,0
0,0,0,0,0,0,0,0,0
168558,810,6,149,97,52,2,1,0
258746,2634,11,110,92,18,19,1,0
476323,2006,14,546,526,20,12,1,0
100647,175,2,15,15,0,1,0,0
0,0,0,0,0,0,0,0,0
0,0,0,0,0,0,0,0,0
0,0,0,0,0,0,0,0,0
225451,2681,11,376,352,24,20,1,0
0,0,0,0,0,0,0,0,0
441152,4446,7,521,513,8,3,1,0
179942,1742,8,310,303,7,3,1,0
1847,41,0,5,3,2,0,0,0
397190,3818,4,598,587,11,11,1,0
28190,552,1,174,172,2,0,1,0
12257,253,1,36,35,1,0,1,0
0,0,0,0,0,0,0,0,0
0,0,0,0,0,0,0,0,0
67689,702,6,59,52,7,7,0,0
51901,143,2,108,107,1,0,0,0
0,0,0,0,0,0,0,0,0
554852,3456,4,307,56,251,13,0,0
531102,2049,5,396,391,5,21,1,0
0,0,0,0,0,0,0,0,0
172577,476,7,104,103,1,31,1,0
119780,868,9,209,208,1,9,1,0
196843,1109,5,192,187,5,21,1,0
154290,542,5,92,89,3,17,1,0
0,0,0,0,0,0,0,0,0
22939,37,0,2,2,0,0,1,0
0,0,0,0,0,0,0,0,0
0,0,0,0,0,0,0,0,0
125624,1360,6,276,58,218,9,1,0
48333,608,3,91,91,0,2,0,0
0,0,0,0,0,0,0,0,0
119942,743,7,160,152,8,2,1,0
101299,235,1,0,0,0,0,0,0
210243,1122,2,107,85,22,19,0,0
64483,106,3,0,0,0,11,0,0
777255,3189,7,401,396,5,12,1,0
0,0,0,0,0,0,0,0,0
122653,655,5,125,124,1,0,1,0
0,0,0,0,0,0,0,0,0
0,0,0,0,0,0,0,0,0
848252,1014,11,97,97,0,0,1,0
76089,804,5,155,150,5,0,1,0
6196,51,4,5,5,0,0,1,0
0,0,0,0,0,0,0,0,0
0,0,0,0,0,0,0,0,0
0,0,0,0,0,0,0,0,0
681973,1018,4,192,192,0,0,1,0
198241,857,13,97,92,5,5,0,0
0,0,0,0,0,0,0,0,0
49903,246,4,25,20,5,16,1,0
202715,642,8,111,101,10,1,0,0
21809,33,0,1,1,0,0,1,0
0,0,0,0,0,0,0,0,0
92363,714,7,140,134,6,1,1,0
0,0,0,0,0,0,0,0,0
0,0,0,0,0,0,0,0,0
69191,397,9,75,71,4,2,0,0
30123,346,5,59,58,1,6,1,0
6433,40,3,0,0,0,0,0,0
22600,116,7,10,10,0,0,1,0
0,0,0,0,0,0,0,0,0
0,0,0,0,0,0,0,0,0
24979,293,3,32,28,4,0,1,0
54839,663,4,186,183,3,2,1,0
671292,1580,8,221,202,19,0,0,0
5196,84,1,0,0,0,0,0,0
55224,580,9,139,139,0,4,1,0
65349,1046,3,245,242,3,3,1,0
69324,1062,2,292,292,0,2,1,0
10129,112,5,13,12,1,0,1,0
946678,720,4,142,136,6,0,1,0
0,0,0,0,0,0,0,0,0
27835,42,0,2,1,1,0,0,0
96419,368,4,40,39,1,4,0,0
222638,3617,3,480,475,5,17,1,0
32500,504,3,152,147,5,4,1,0
1267208,12679,7,106,91,15,7,1,0
45583,314,7,40,24,16,1,1,0
0,0,0,0,0,0,0,0,0
0,0,0,0,0,0,0,0,0
268798,683,12,75,57,18,4,0,0
192156,345,1,113,79,34,3,1,0
159094,59,0,2,2,0,0,1,0
0,0,0,0,0,0,0,0,0
161871,1032,5,127,113,14,1,1,0
0,0,0,0,0,0,0,0,0
239555,824,7,52,50,2,1,1,0
0,0,0,0,0,0,0,0,0
325063,2691,4,509,407,102,7,1,0
266574,1590,12,393,388,5,6,1,0
0,0,0,0,0,0,0,0,0
1249362,2356,8,342,257,85,38,1,0
0,0,0,0,0,0,0,0,0
172533,739,1,41,40,1,0,0,0
92655,269,3,5,3,2,4,0,0
34302,255,7,38,33,5,0,1,0
23141,144,7,12,12,0,0,1,0
0,0,0,0,0,0,0,0,0
177117,1842,6,454,442,12,10,1,0
199178,807,12,106,101,5,12,0,0
38514,419,7,107,87,20,3,1,0
1683951,864,9,199,186,13,2,1,0
0,0,0,0,0,0,0,0,0
250677,2511,8,606,579,27,10,1,0
0,0,0,0,0,0,0,0,0
1475946,2916,5,300,279,21,0,1,0
45276,390,4,95,89,6,5,1,0
0,0,0,0,0,0,0,0,0
0,0,0,0,0,0,0,0,0
73150,707,1,178,175,3,27,0,0
585,5,0,0,0,0,0,0,1
0,0,0,0,0,0,0,0,0
49224,290,1,49,41,8,1,0,0
93082,1092,7,375,375,0,7,0,0
31915,291,1,58,50,8,0,1,0
0,0,0,0,0,0,0,0,0
0,0,0,0,0,0,0,0,0
8029,163,0,59,43,16,0,1,0
22186,66,0,11,1,10,0,0,0
0,0,0,0,0,0,0,0,0
203259,549,4,85,66,19,0,1,0
398442,893,8,140,125,15,2,1,0
227821,2989,6,439,411,28,6,0,0
0,0,0,0,0,0,0,0,0
0,0,0,0,0,0,0,0,0
0,0,0,0,0,0,0,0,0
0,0,0,0,0,0,0,0,0
0,0,0,0,0,0,0,0,0
0,0,0,0,0,0,0,0,0
877979,836,6,98,94,4,1,1,0
33586,59,5,0,0,0,3,0,0
32686,478,2,154,154,0,2,0,0
999256,2135,4,293,217,76,28,1,0
250807,1269,4,259,252,7,2,1,0
95897,798,5,145,137,8,3,1,0
101600,2134,3,655,654,1,1,1,0
475658,641,5,24,21,3,4,1,0
478226,492,7,21,18,3,2,1,0
0,0,0,0,0,0,0,0,0
105014,640,10,138,137,1,8,1,0
33307,216,1,15,12,3,2,1,0
16097,74,5,9,1,8,1,1,0
0,0,0,0,0,0,0,0,0
199721,911,9,145,132,13,0,0,0
199721,911,9,145,132,13,0,0,0
0,0,0,0,0,0,0,0,0
0,0,0,0,0,0,0,0,0
147088,1174,13,77,71,6,10,1,0
108124,632,14,36,35,1,10,1,0
55070,220,4,19,19,0,0,1,0
0,0,0,0,0,0,0,0,0
15772,81,6,1,1,0,1,0,0
0,0,0,0,0,0,0,0,0
489434,3752,6,455,239,216,34,1,0
697946,4728,12,321,311,10,63,1,0
373039,373,14,71,62,9,3,1,0
191290,1805,4,366,357,9,3,1,0
226292,998,11,100,26,74,5,1,0
119046,664,17,104,100,4,9,1,0
0,0,0,0,0,0,0,0,0
248634,1181,9,292,272,20,12,1,0
44936,260,2,21,18,3,10,1,0
138196,1162,12,261,251,10,4,0,0
179992,1026,11,243,227,16,2,1,0
0,0,0,0,0,0,0,0,0
0,0,0,0,0,0,0,0,0
108936,1116,9,180,158,22,1,1,0
179475,568,5,100,93,7,1,0,0
74667,118,3,5,5,0,0,0,0
48427,533,5,27,16,11,0,1,0
0,0,0,0,0,0,0,0,0
41776,551,1,159,146,13,0,1,0
763520,5342,9,1605,1434,171,20,1,0
660324,4329,8,1494,1325,169,16,1,0
25026,274,7,26,11,15,0,0,0
14828,146,8,13,13,0,0,0,0
0,0,0,0,0,0,0,0,0
10567,174,1,51,51,0,0,1,0
83665,1068,4,168,111,57,4,1,0
20409,222,5,27,22,5,6,1,0
0,0,0,0,0,0,0,0,0
0,0,0,0,0,0,0,0,0
287927,2328,11,489,134,355,10,1,0
0,0,0,0,0,0,0,0,0
0,0,0,0,0,0,0,0,0
0,0,0,0,0,0,0,0,0
74988,1029,3,177,153,24,2,1,0
103638,1467,7,19,2,17,8,1,0
117167,889,7,133,128,5,8,1,0
20241,114,3,7,7,0,7,1,0
43847,716,8,170,165,5,1,1,0
792769,7293,10,869,837,32,2,1,0
407993,2392,10,512,511,1,1,1,0
267795,3658,1,1023,1016,7,127,1,0
636028,6460,4,214,203,11,5,1,0
125597,1685,9,164,155,9,2,1,0
703527,1892,2,475,340,135,2,1,0
240733,1065,5,115,103,12,5,1,0
123009,648,4,75,63,12,1,1,0
0,0,0,0,0,0,0,0,0
22997,37,0,2,1,1,0,1,0
185381,1208,12,294,292,2,7,1,0
127360,881,12,236,234,2,7,1,0
0,0,0,0,0,0,0,0,0
7392,71,4,12,10,2,3,1,0
41828,334,5,81,71,10,1,1,0
0,0,0,0,0,0,0,0,0
0,0,0,0,0,0,0,0,0
0,0,0,0,0,0,0,0,0
144528,1812,3,289,280,9,0,0,0
79355,212,5,35,33,2,0,0,0
0,0,0,0,0,0,0,0,0
0,0,0,0,0,0,0,0,0
0,0,0,0,0,0,0,0,0
27746,42,0,2,1,1,0,0,0
299569,2627,10,658,534,124,26,1,0
0,0,0,0,0,0,0,0,0
0,0,0,0,0,0,0,0,0
25236,266,4,64,64,0,2,1,0
8878,104,2,27,27,0,0,1,0
0,0,0,0,0,0,0,0,0
49831,424,4,27,15,12,0,1,0
0,0,0,0,0,0,0,0,0
0,0,0,0,0,0,0,0,0
0,0,0,0,0,0,0,0,0
173441,1692,9,195,175,20,18,1,0
122985,1410,9,107,87,20,23,1,0
120897,572,5,103,103,0,5,0,0
206799,2265,5,341,321,20,5,1,0
19489,144,3,14,10,4,2,1,0
88815,754,7,64,64,0,2,0,0
12187,58,1,0,0,0,0,0,0
129097,2104,5,274,268,6,1,1,0
254566,2017,3,431,391,40,8,0,0
0,0,0,0,0,0,0,0,0
37052,375,6,79,79,0,0,1,0
316061,2012,8,424,379,45,61,1,0
0,0,0,0,0,0,0,0,0
88831,1047,3,213,180,33,3,0,0
0,0,0,0,0,0,0,0,0
30602,534,5,181,181,0,6,0,0
51668,895,4,241,222,19,92,1,0
0,0,0,0,0,0,0,0,0
0,0,0,0,0,0,0,0,0
36828,352,1,32,26,6,30,1,0
0,0,0,0,0,0,0,0,0
663560,6805,5,1031,1026,5,311,0,0
0,0,0,0,0,0,0,0,0
0,0,0,0,0,0,0,0,0
45290,646,3,107,93,14,2,1,0
0,0,0,0,0,0,0,0,0
0,0,0,0,0,0,0,0,0
375750,921,2,155,92,63,7,1,0
79908,108,1,10,7,3,2,0,0
0,0,0,0,0,0,0,0,0
101402,3726,8,161,161,0,0,1,0
0,0,0,0,0,0,0,0,0
0,0,0,0,0,0,0,0,0
179995,1376,1,141,118,23,0,1,0
68508,559,8,110,107,3,1,1,0
268113,1381,5,205,202,3,1,1,0
505855,914,8,93,86,7,1,1,0
847626,4626,10,282,217,65,13,1,0
755207,4233,9,247,189,58,9,1,0
32243,421,8,17,17,0,0,1,0
303078,1319,5,190,16,174,2,1,0
77108,536,0,19,12,7,17,0,0
344138,1356,7,133,96,37,1,1,0
0,0,0,0,0,0,0,0,0
0,0,0,0,0,0,0,0,0
385117,856,5,100,77,23,20,1,0
221627,4277,15,201,190,11,2,1,0
180443,994,11,178,170,8,9,1,0
0,0,0,0,0,0,0,0,0
80072,469,7,127,122,5,9,1,0
70837,663,9,93,88,5,10,1,0
0,0,0,0,0,0,0,0,0
477166,1429,12,154,113,41,31,1,0
369190,379,0,44,28,16,11,1,1
841509,8897,6,2192,2086,106,4,1,0
515054,4756,6,1538,1533,5,3,1,0
779379,7604,3,601,439,162,17,1,1
0,0,0,0,0,0,0,0,0
0,0,0,0,0,0,0,0,0
27646,42,0,2,1,1,0,0,0
300887,1946,16,224,183,41,12,0,0
3589,39,4,4,0,4,0,0,0
138142,1113,10,221,217,4,6,1,0
8944,64,5,6,6,0,0,0,0
75318,1189,2,243,218,25,6,0,0
15568,141,2,21,19,2,6,0,0
246566,6636,12,46,21,25,3,1,0
39862,420,3,113,110,3,2,1,0
505431,3301,10,436,36,400,9,1,0
0,0,0,0,0,0,0,0,0
0,0,0,0,0,0,0,0,0
5615,108,2,0,0,0,0,0,0
0,0,0,0,0,0,0,0,0
317273,1443,4,292,284,8,1,1,0
326967,1511,5,285,276,9,4,1,0
0,0,0,0,0,0,0,0,0
443366,1171,6,306,295,11,11,1,0
0,0,0,0,0,0,0,0,0
0,0,0,0,0,0,0,0,0
2410,34,0,8,0,8,0,0,0
0,0,0,0,0,0,0,0,0
343482,2587,9,310,259,51,31,0,0
20888,256,1,15,15,0,0,1,0
7777,103,1,14,14,0,0,1,0
68964,454,7,100,98,2,3,1,0
0,0,0,0,0,0,0,0,0
54093,761,7,178,172,6,3,1,0
0,0,0,0,0,0,0,0,0
22519,123,6,7,6,1,5,1,0
22519,123,6,7,6,1,5,1,0
268481,2871,7,555,539,16,4,1,0
93303,1289,6,234,218,16,3,1,0
17321,266,4,82,81,1,0,0,0
4976,85,4,12,11,1,0,0,0
0,0,0,0,0,0,0,0,0
38323,250,1,46,42,4,8,1,0
1021205,2506,5,242,235,7,5,1,0
0,0,0,0,0,0,0,0,0
0,0,0,0,0,0,0,0,0
67645,248,10,11,9,2,0,1,0
92467,1041,2,60,33,27,2,1,0
75934,616,3,104,89,15,3,0,0
0,0,0,0,0,0,0,0,0
0,0,0,0,0,0,0,0,0
268193,3638,1,1015,1010,5,128,1,0
1087165,4359,15,610,576,34,27,1,0
739618,1968,15,339,329,10,29,1,0
490687,2855,6,459,251,208,31,1,0
575666,2917,3,100,91,9,6,0,0
534371,4926,4,817,729,88,36,1,0
0,0,0,0,0,0,0,0,0
186631,1247,8,218,195,23,6,1,0
0,0,0,0,0,0,0,0,0
65424,631,9,114,97,17,3,1,0
0,0,0,0,0,0,0,0,0
211253,1645,10,250,209,41,7,1,0
0,0,0,0,0,0,0,0,0
0,0,0,0,0,0,0,0,0
0,0,0,0,0,0,0,0,0
156356,665,7,102,91,11,28,1,0
145448,550,6,32,24,8,26,1,0
87337,887,9,190,183,7,1,1,0
320921,1047,3,80,74,6,4,1,0
0,0,0,0,0,0,0,0,0
0,0,0,0,0,0,0,0,0
93160,1143,1,276,268,8,2,1,0
4558,64,2,2,2,0,0,1,0
0,0,0,0,0,0,0,0,0
161488,1188,5,110,99,11,10,1,0
9908,132,0,10,5,5,0,1,0
165645,1633,6,258,238,20,5,1,0
165694,1633,6,258,238,20,5,1,0
0,0,0,0,0,0,0,0,0
0,0,0,0,0,0,0,0,0
48613,510,7,94,71,23,2,1,0
24951,321,1,125,24,101,0,0,0
0,0,0,0,0,0,0,0,0
263051,1666,8,201,167,34,11,1,0
18759,186,2,18,15,3,13,1,1
0,0,0,0,0,0,0,0,0
0,0,0,0,0,0,0,0,0
0,0,0,0,0,0,0,0,0
0,0,0,0,0,0,0,0,0
0,0,0,0,0,0,0,0,0
531648,1179,7,230,218,12,13,1,0
472812,433,7,72,62,10,13,1,0
0,0,0,0,0,0,0,0,0
123982,1220,2,128,125,3,5,1,0
0,0,0,0,0,0,0,0,0
115079,1229,5,202,3,199,0,0,0
0,0,0,0,0,0,0,0,0
39996,545,2,63,60,3,0,1,0
0,0,0,0,0,0,0,0,0
0,0,0,0,0,0,0,0,0
148698,1535,3,226,183,43,5,0,0
0,0,0,0,0,0,0,0,0
0,0,0,0,0,0,0,0,0
0,0,0,0,0,0,0,0,0
0,0,0,0,0,0,0,0,0
46736,536,9,165,163,2,0,1,0
63413,615,7,95,89,6,2,1,0
279194,193,0,0,0,0,1,1,0
0,0,0,0,0,0,0,0,0
61704,598,5,102,71,31,1,1,0
0,0,0,0,0,0,0,0,0
8773,126,2,29,23,6,7,1,0
0,0,0,0,0,0,0,0,0
40336,377,5,84,74,10,4,1,0
0,0,0,0,0,0,0,0,0
0,0,0,0,0,0,0,0,0
0,0,0,0,0,0,0,0,0
3842,17,0,1,0,1,0,0,0
24444,316,4,28,19,9,1,0,0
357823,2510,10,883,870,13,0,0,0
343137,2494,10,883,870,13,0,0,0
198114,739,8,173,140,33,3,1,0
325604,1671,10,304,292,12,112,1,0
212664,2236,8,690,678,12,3,1,0
80028,679,3,146,138,8,0,0,0
36797,244,3,22,15,7,0,0,0
18327,414,1,70,66,4,0,0,0
0,0,0,0,0,0,0,0,0
377167,2321,12,173,161,12,13,1,0
314457,1470,12,60,59,1,15,1,0
142380,1267,6,264,260,4,2,1,0
27880,42,0,2,1,1,0,0,0
0,0,0,0,0,0,0,0,0
48964,385,8,80,61,19,0,1,0
187626,171,3,17,8,9,0,1,0
94151,1259,4,598,598,0,0,1,0
119947,1847,3,212,197,15,5,1,0
93776,1328,3,160,149,11,3,1,0
342559,2435,10,585,580,5,0,1,0
342329,2435,10,585,580,5,0,1,0
35740,467,6,108,106,2,2,1,0
1194471,2743,10,617,612,5,72,1,0
118578,1431,10,319,281,38,3,1,0
264529,926,12,128,126,2,32,0,0
0,0,0,0,0,0,0,0,0
0,0,0,0,0,0,0,0,0
108956,1379,7,314,312,2,4,1,0
0,0,0,0,0,0,0,0,0
12900,280,4,50,50,0,1,0,0
14157,149,2,23,20,3,5,0,0
41205,888,1,143,15,128,0,1,0
576657,6429,0,2719,1,2718,0,1,0
137061,1197,9,253,223,30,6,0,0
0,0,0,0,0,0,0,0,0
0,0,0,0,0,0,0,0,0
33812,391,6,103,50,53,1,0,0
76971,700,5,142,104,38,0,0,0
28485,45,0,4,1,3,0,0,0
82792,596,3,148,126,22,0,1,0
0,0,0,0,0,0,0,0,0
171863,1246,8,196,185,11,30,1,0
0,0,0,0,0,0,0,0,0
1085673,2759,5,714,705,9,36,1,0
842867,427,5,62,55,7,7,1,0
44801,332,10,22,14,8,0,1,0
0,0,0,0,0,0,0,0,0
829755,614,14,59,12,47,2,1,0
15773,136,5,18,6,12,7,0,0
206586,909,4,66,57,9,3,1,0
0,0,0,0,0,0,0,0,0
970512,2267,22,113,82,31,69,1,0
0,0,0,0,0,0,0,0,0
0,0,0,0,0,0,0,0,0
21245,592,2,153,108,45,0,0,0
127113,714,9,144,123,21,8,1,0
49596,817,4,180,147,33,11,1,0
0,0,0,0,0,0,0,0,0
0,0,0,0,0,0,0,0,0
0,0,0,0,0,0,0,0,0
0,0,0,0,0,0,0,0,0
4512,93,2,13,7,6,0,1,0
300091,3574,5,1113,1059,54,2,0,0
0,0,0,0,0,0,0,0,0
68204,409,8,84,81,3,0,0,0
235065,1065,3,129,120,9,20,1,0
153351,514,3,76,73,3,8,1,0
0,0,0,0,0,0,0,0,0
207531,4180,1,273,162,111,11,1,1
211951,1129,5,181,167,14,2,0,0
85027,1144,4,152,122,30,10,1,0
7549,86,7,5,5,0,0,0,0
213550,557,10,117,113,4,16,1,0
358963,2647,1,368,364,4,11,1,0
101337,684,1,134,134,0,5,1,0
111245,1100,3,260,218,42,3,0,0
169979,728,11,61,54,7,9,1,0
11962,191,3,21,21,0,0,1,0
79947,589,5,151,140,11,1,1,0
85220,504,6,97,86,11,5,1,0
0,0,0,0,0,0,0,0,0
0,0,0,0,0,0,0,0,0
0,0,0,0,0,0,0,0,0
108867,373,12,57,42,15,1,1,0
0,0,0,0,0,0,0,0,0
10544,72,5,12,10,2,2,0,0
0,0,0,0,0,0,0,0,0
110290,1226,8,256,237,19,1,1,0
692880,536,0,3,0,3,2,1,1
0,0,0,0,0,0,0,0,0
0,0,0,0,0,0,0,0,0
0,0,0,0,0,0,0,0,0
64457,953,5,175,117,58,0,1,0
255309,711,8,82,82,0,8,1,0
15431,104,0,1,0,1,0,0,0
130745,1380,0,216,213,3,0,1,0
59211,280,1,69,66,3,0,1,0
19829,399,3,99,75,24,0,1,0
0,0,0,0,0,0,0,0,0
945257,3500,9,409,388,21,2,0,0
257655,2453,8,342,293,49,20,1,0
363843,1439,10,128,97,31,70,1,0
136694,1764,6,414,412,2,8,0,0
129972,1205,7,198,173,25,5,1,0
125123,1202,7,198,173,25,5,1,0
0,0,0,0,0,0,0,0,0
731684,7639,5,1619,1609,10,10,1,0
140823,828,5,184,172,12,10,1,0
0,0,0,0,0,0,0,0,0
0,0,0,0,0,0,0,0,0
145220,953,8,143,136,7,1,1,0
51027,418,8,121,117,4,0,1,0
232500,1077,5,183,145,38,3,1,0
6673,95,0,17,14,3,1,0,0
25190,246,5,35,28,7,3,0,0
30598,455,1,64,62,2,2,1,0
221873,1601,4,174,173,1,3,1,0
1046959,836,5,113,98,15,8,1,0
18525,73,0,5,5,0,0,0,0
0,0,0,0,0,0,0,0,0
85597,1216,4,186,153,33,5,1,0
0,0,0,0,0,0,0,0,0
0,0,0,0,0,0,0,0,0
47431,558,2,216,212,4,7,1,0
94358,434,2,16,14,2,8,1,0
0,0,0,0,0,0,0,0,0
0,0,0,0,0,0,0,0,0
0,0,0,0,0,0,0,0,0
225555,1629,13,195,179,16,12,1,0
105942,1609,10,254,243,11,2,1,1
0,0,0,0,0,0,0,0,0
208952,1528,3,156,142,14,4,1,0
164205,1004,11,77,61,16,2,1,0
0,0,0,0,0,0,0,0,0
0,0,0,0,0,0,0,0,0
18262,344,2,84,78,6,0,0,0
15693,243,3,16,16,0,0,1,0
138014,1045,5,335,310,25,9,1,0
0,0,0,0,0,0,0,0,0
166223,547,14,99,6,93,7,1,0
0,0,0,0,0,0,0,0,0
0,0,0,0,0,0,0,0,0
754503,6670,10,1050,630,420,1,1,0
0,0,0,0,0,0,0,0,0
91554,1101,7,185,173,12,4,1,0
94873,1224,6,242,222,20,1,0,0
0,0,0,0,0,0,0,0,0
0,0,0,0,0,0,0,0,0
167576,551,5,85,81,4,1,0,0
47607,142,3,18,17,1,2,1,0
154370,290,3,28,27,1,0,1,0
249709,1265,10,154,142,12,4,1,0
84683,396,6,10,9,1,9,1,0
0,0,0,0,0,0,0,0,0
1077122,274,2,25,25,0,1,1,0
328297,2029,8,445,16,429,26,1,0
22941,38,0,2,2,0,0,1,0
0,0,0,0,0,0,0,0,0
0,0,0,0,0,0,0,0,0
434544,1265,7,106,99,7,0,0,0
0,0,0,0,0,0,0,0,0
150842,1159,7,343,198,145,7,0,0
0,0,0,0,0,0,0,0,0
66669,274,4,15,15,0,16,1,0
53003,169,7,11,11,0,12,1,0
27504,124,8,16,15,1,0,1,0
0,0,0,0,0,0,0,0,0
23438,37,0,2,1,1,0,1,0
0,0,0,0,0,0,0,0,0
320221,1358,12,216,182,34,13,1,0
711048,144,14,3,3,0,3,1,0
284671,2116,6,219,188,31,5,1,0
0,0,0,0,0,0,0,0,0
27534,40,0,2,1,1,0,0,0
1065000,3262,4,251,233,18,3,1,0
0,0,0,0,0,0,0,0,0
135953,369,5,60,53,7,2,1,0
757,16,0,0,0,0,0,0,0
116113,970,13,160,115,45,3,1,0
0,0,0,0,0,0,0,0,0
0,0,0,0,0,0,0,0,0
330858,2188,7,327,311,16,22,1,0
0,0,0,0,0,0,0,0,0
0,0,0,0,0,0,0,0,0
0,0,0,0,0,0,0,0,0
0,0,0,0,0,0,0,0,0
517896,4303,3,540,491,49,3,1,0
521992,570,9,78,69,9,19,1,0
0,0,0,0,0,0,0,0,0
936447,2100,3,221,202,19,2,1,0
1506522,55,1,0,0,0,0,1,0
88767,704,6,140,106,34,9,1,0
0,0,0,0,0,0,0,0,0
0,0,0,0,0,0,0,0,0
1002608,753,14,120,103,17,1,1,0
883716,425,14,76,57,19,1,1,0
749551,1625,13,430,420,10,23,1,0
47546,737,4,119,115,4,7,1,0
108172,688,2,146,141,5,5,1,0
0,0,0,0,0,0,0,0,0
0,0,0,0,0,0,0,0,0
0,0,0,0,0,0,0,0,0
123537,1401,3,437,436,1,3,1,0
18990,231,3,17,16,1,3,1,0
0,0,0,0,0,0,0,0,0
0,0,0,0,0,0,0,0,0
0,0,0,0,0,0,0,0,0
199662,1210,5,265,157,108,17,0,0
210210,898,9,198,197,1,4,1,0
0,0,0,0,0,0,0,0,0
0,0,0,0,0,0,0,0,0
114238,573,4,246,246,0,6,1,0
26682,168,4,12,6,6,9,0,0
0,0,0,0,0,0,0,0,0
0,0,0,0,0,0,0,0,0
0,0,0,0,0,0,0,0,0
0,0,0,0,0,0,0,0,0
0,0,0,0,0,0,0,0,0
295886,669,1,7,6,1,3,0,0
268565,1102,13,108,95,13,3,1,0
27868,346,3,43,10,33,0,1,0
0,0,0,0,0,0,0,0,0
0,0,0,0,0,0,0,0,0
0,0,0,0,0,0,0,0,0
0,0,0,0,0,0,0,0,0
132985,969,10,188,60,128,2,1,0
8352,46,2,3,2,1,0,1,0
0,0,0,0,0,0,0,0,0
39002,602,0,140,130,10,11,1,0
98805,463,10,89,89,0,0,1,0
0,0,0,0,0,0,0,0,0
531068,1854,3,89,75,14,3,0,0
250933,1065,5,45,35,10,3,0,0
0,0,0,0,0,0,0,0,0
115105,1519,8,396,148,248,0,1,0
35743,313,8,94,89,5,0,1,0
42356,194,10,19,12,7,12,0,0
68601,280,0,65,14,51,1,1,0
0,0,0,0,0,0,0,0,0
146714,1754,6,219,207,12,10,0,0
51975,359,4,43,39,4,2,0,0
80728,354,4,37,33,4,2,0,0
165971,518,10,69,56,13,0,1,0
598928,798,6,134,119,15,6,1,0
0,0,0,0,0,0,0,0,0
279701,1121,7,107,96,11,4,1,0
213251,1163,11,267,206,61,18,0,0
0,0,0,0,0,0,0,0,0
0,0,0,0,0,0,0,0,0
0,0,0,0,0,0,0,0,0
107960,856,7,200,196,4,3,1,0
100559,816,7,188,184,4,5,1,0
0,0,0,0,0,0,0,0,0
0,0,0,0,0,0,0,0,0
111902,709,8,90,82,8,12,1,0
37407,343,6,115,103,12,0,1,0
50276,850,4,119,118,1,3,0,0
16170,149,6,13,13,0,3,0,0
173594,2093,3,783,760,23,8,1,0
469464,989,6,136,109,27,6,1,0
0,0,0,0,0,0,0,0,0
0,0,0,0,0,0,0,0,0
206159,1548,4,213,195,18,9,0,0
0,0,0,0,0,0,0,0,0
0,0,0,0,0,0,0,0,0
7712,102,5,10,7,3,0,1,0
276463,1859,10,296,284,12,22,1,1
0,0,0,0,0,0,0,0,0
86874,914,12,83,76,7,1,1,0
49789,331,14,37,30,7,1,1,0
193177,2644,7,784,771,13,2,1,0
0,0,0,0,0,0,0,0,0
0,0,0,0,0,0,0,0,0
0,0,0,0,0,0,0,0,0
192899,911,13,98,66,32,11,1,0
0,0,0,0,0,0,0,0,0
16654,222,3,28,28,0,3,1,0
0,0,0,0,0,0,0,0,0
0,0,0,0,0,0,0,0,0
0,0,0,0,0,0,0,0,0
28485,320,3,32,29,3,1,1,0
7058,143,1,21,20,1,0,1,0
538228,2664,18,290,267,23,9,1,0
25091,48,1,1,1,0,0,0,0
0,0,0,0,0,0,0,0,0
579663,3086,12,645,126,519,3,1,0
26103,126,3,3,0,3,3,0,0
241718,1364,5,199,14,185,8,1,0
388507,2341,10,366,354,12,132,1,0
118059,22,1,0,0,0,0,0,0
226062,1134,5,160,132,28,10,1,0
332018,653,2,85,75,10,0,1,0
377304,135,2,9,8,1,2,1,0
441976,4582,13,633,252,381,8,1,0
14729,270,3,33,31,2,0,1,0
0,0,0,0,0,0,0,0,0
184654,918,12,101,89,12,5,1,0
0,0,0,0,0,0,0,0,0
0,0,0,0,0,0,0,0,0
114060,879,7,148,138,10,5,1,0
10203,68,2,5,5,0,0,1,0
314119,2187,6,162,142,20,43,1,0
0,0,0,0,0,0,0,0,0
0,0,0,0,0,0,0,0,0
0,0,0,0,0,0,0,0,0
0,0,0,0,0,0,0,0,0
0,0,0,0,0,0,0,0,0
223053,1466,9,231,218,13,20,1,0
263317,1503,10,217,204,13,36,1,0
348516,1874,4,215,180,35,2,1,0
0,0,0,0,0,0,0,0,0
404174,2433,16,430,411,19,23,1,0
245582,2492,1,244,178,66,0,1,0
37392,127,5,20,20,0,4,1,0
620283,6868,5,1815,1803,12,5,0,0
354241,4100,5,1429,1417,12,8,0,0
54657,1088,5,159,143,16,0,1,0
298776,661,5,115,113,2,0,1,0
74510,485,10,40,30,10,3,0,0
138738,1144,3,214,213,1,3,1,0
563688,4812,11,1222,1172,50,0,1,0
273246,593,6,141,136,5,1,1,0
192022,1830,14,319,316,3,8,1,1
411632,720,7,97,80,17,7,1,0
331249,5751,2,1941,1941,0,2,1,0
0,0,0,0,0,0,0,0,0
89152,1945,1,369,350,19,2,1,0
5169,87,2,8,6,2,0,1,0
71127,775,4,147,133,14,2,1,0
34234,185,6,20,18,2,6,0,0
28134,42,0,2,1,1,0,0,0
45223,791,3,133,131,2,0,0,0
6459,105,3,15,13,2,0,0,0
22905,37,0,2,1,1,0,1,0
0,0,0,0,0,0,0,0,0
0,0,0,0,0,0,0,0,0
0,0,0,0,0,0,0,0,0
0,0,0,0,0,0,0,0,0
6203,100,1,3,3,0,15,0,0
0,0,0,0,0,0,0,0,0
269808,1960,9,160,145,15,4,1,0
0,0,0,0,0,0,0,0,0
0,0,0,0,0,0,0,0,0
65794,367,8,40,15,25,4,1,0
286638,132,2,5,5,0,4,1,0
469395,2926,1,743,634,109,4,1,0
163400,330,1,74,24,50,0,1,0
0,0,0,0,0,0,0,0,0
0,0,0,0,0,0,0,0,0
0,0,0,0,0,0,0,0,0
346003,1840,6,223,220,3,52,1,0
0,0,0,0,0,0,0,0,0
0,0,0,0,0,0,0,0,0
0,0,0,0,0,0,0,0,0
25609,302,5,62,41,21,3,1,0
0,0,0,0,0,0,0,0,0
269312,2090,15,799,796,3,7,1,0
226052,1689,15,688,682,6,6,1,0
43585,446,9,22,20,2,9,1,0
6594,80,4,4,4,0,2,0,0
13599,211,7,24,20,4,2,1,0
302266,2978,5,1097,1062,35,0,0,0
29603,134,5,10,8,2,0,0,0
0,0,0,0,0,0,0,0,0
0,0,0,0,0,0,0,0,0
0,0,0,0,0,0,0,0,0
0,0,0,0,0,0,0,0,0
276342,2129,13,366,316,50,12,0,0
180617,1964,3,477,368,109,1,1,0
245161,987,1,74,39,35,0,0,0
740412,3034,7,310,303,7,11,1,0
0,0,0,0,0,0,0,0,0
28393,215,7,13,12,1,6,0,0
137241,845,4,94,83,11,5,0,0
128808,648,3,98,90,8,6,0,0
0,0,0,0,0,0,0,0,0
64503,593,1,101,94,7,6,1,0
104010,449,8,102,96,6,0,1,0
133329,1242,14,278,265,13,20,1,0
0,0,0,0,0,0,0,0,0
182353,1237,8,321,293,28,3,1,0
335987,1661,12,186,136,50,11,1,0
0,0,0,0,0,0,0,0,0
0,0,0,0,0,0,0,0,0
12009,178,2,19,10,9,0,0,0
205134,2313,6,513,493,20,15,1,0
112512,1452,6,319,310,9,3,1,0
147849,1190,4,309,276,33,2,1,0
478827,1170,7,155,143,12,0,1,0
0,0,0,0,0,0,0,0,0
128416,1328,16,242,232,10,22,1,1
0,0,0,0,0,0,0,0,0
586205,1326,2,146,133,13,8,1,0
132051,1870,8,277,276,1,2,1,0
0,0,0,0,0,0,0,0,0
12689,69,3,13,4,9,3,1,0
0,0,0,0,0,0,0,0,0
386034,1527,2,88,65,23,34,1,0
223126,383,2,48,33,15,3,1,0
0,0,0,0,0,0,0,0,0
80714,862,7,80,76,4,0,1,0
12795,101,7,10,8,2,0,0,0
0,0,0,0,0,0,0,0,0
0,0,0,0,0,0,0,0,0
539557,802,9,156,155,1,28,1,0
552660,659,9,133,132,1,25,1,0
143547,1202,7,371,339,32,2,0,0
88156,240,4,54,48,6,0,1,0
153477,1354,5,176,160,16,15,1,0
0,0,0,0,0,0,0,0,0
0,0,0,0,0,0,0,0,0
0,0,0,0,0,0,0,0,0
0,0,0,0,0,0,0,0,0
36351,165,1,48,37,11,0,1,0
269415,2162,7,383,370,13,92,1,1
50661,464,8,100,96,4,2,1,0
0,0,0,0,0,0,0,0,0
0,0,0,0,0,0,0,0,0
156461,1015,8,88,41,47,15,1,0
41595,72,7,0,0,0,0,0,0
96820,959,9,225,222,3,46,1,0
48796,524,2,178,175,3,2,1,0
0,0,0,0,0,0,0,0,0
0,0,0,0,0,0,0,0,0
0,0,0,0,0,0,0,0,0
0,0,0,0,0,0,0,0,0
23002,38,0,2,1,1,0,1,0
843311,523,7,96,76,20,0,1,0
0,0,0,0,0,0,0,0,0
105304,906,6,141,131,10,11,1,0
45174,231,5,30,29,1,0,1,0
43224,534,6,112,107,5,4,1,0
0,0,0,0,0,0,0,0,0
0,0,0,0,0,0,0,0,0
0,0,0,0,0,0,0,0,0
119119,1255,3,385,361,24,6,0,0
0,0,0,0,0,0,0,0,0
0,0,0,0,0,0,0,0,0
299384,2809,10,1071,972,99,5,1,0
62032,713,6,72,62,10,23,1,0
174089,2414,7,635,626,9,1,0,0
11929,134,3,31,30,1,0,0,0
431786,915,5,61,61,0,0,1,0
0,0,0,0,0,0,0,0,0
51489,366,7,95,94,1,0,1,0
550218,3649,4,244,231,13,17,1,0
0,0,0,0,0,0,0,0,0
0,0,0,0,0,0,0,0,0
0,0,0,0,0,0,0,0,0
0,0,0,0,0,0,0,0,0
126839,1644,8,368,326,42,7,1,0
0,0,0,0,0,0,0,0,0
14209,182,6,67,66,1,0,0,0
90824,674,5,170,164,6,4,1,0
0,0,0,0,0,0,0,0,0
63577,1108,2,210,206,4,9,1,0
47115,428,7,61,48,13,9,1,0
47117,428,7,61,39,22,9,1,0
0,0,0,0,0,0,0,0,0
4637,54,1,3,0,3,0,0,0
0,0,0,0,0,0,0,0,0
0,0,0,0,0,0,0,0,0
64117,126,4,16,14,2,1,1,0
77030,1001,6,206,186,20,8,1,0
0,0,0,0,0,0,0,0,0
0,0,0,0,0,0,0,0,0
17900,299,4,57,26,31,2,1,0
31748,284,4,31,18,13,5,1,0
185879,1239,6,186,117,69,20,1,0
243658,162,5,5,5,0,1,0,0
0,0,0,0,0,0,0,0,0
37844,205,1,31,31,0,2,1,0
5648,100,2,22,15,7,0,1,0
366803,1154,2,56,24,32,0,0,0
319573,2665,5,471,36,435,6,1,0
0,0,0,0,0,0,0,0,0
299178,591,5,142,124,18,9,0,0
24042,195,4,9,4,5,3,0,0
0,0,0,0,0,0,0,0,0
0,0,0,0,0,0,0,0,0
144612,397,4,71,71,0,0,1,0
356770,1912,7,150,108,42,2,1,0
87963,125,3,1,0,1,2,0,0
0,0,0,0,0,0,0,0,0
73299,432,5,27,24,3,0,0,0
0,0,0,0,0,0,0,0,0
0,0,0,0,0,0,0,0,0
92467,1041,2,60,33,27,2,1,0
0,0,0,0,0,0,0,0,0
0,0,0,0,0,0,0,0,0
254723,2177,17,452,396,56,6,1,0
467642,3799,3,905,875,30,6,0,0
188936,1173,15,242,232,10,4,1,0
2631,39,1,6,2,4,0,0,0
13224,108,3,7,6,1,2,0,0
35972,250,5,58,58,0,3,1,0
0,0,0,0,0,0,0,0,0
0,0,0,0,0,0,0,0,0
440487,2761,19,399,359,40,102,1,0
1688857,741,3,155,113,42,1,1,0
53888,1061,4,332,285,47,1,1,0
0,0,0,0,0,0,0,0,0
0,0,0,0,0,0,0,0,0
226199,1408,10,333,318,15,1,1,0
170011,643,8,52,37,15,7,1,0
0,0,0,0,0,0,0,0,0
221940,3101,7,219,210,9,3,1,0
0,0,0,0,0,0,0,0,0
108851,718,2,79,74,5,4,1,0
304578,815,1,0,0,0,3,0,0
0,0,0,0,0,0,0,0,0
119310,1521,5,320,311,9,3,1,0
0,0,0,0,0,0,0,0,0
90309,71,0,9,9,0,6,0,0
77069,617,8,82,71,11,6,1,0
0,0,0,0,0,0,0,0,0
0,0,0,0,0,0,0,0,0
0,0,0,0,0,0,0,0,0
25618,563,1,272,265,7,7,1,0
0,0,0,0,0,0,0,0,0
107765,945,3,71,64,7,1,1,0
21173,76,0,1,0,1,0,0,0
0,0,0,0,0,0,0,0,0
832732,362,6,53,50,3,0,1,0
0,0,0,0,0,0,0,0,0
0,0,0,0,0,0,0,0,0
68701,712,4,24,19,5,2,0,0
233604,1844,3,5,5,0,2,1,0
0,0,0,0,0,0,0,0,0
348881,691,5,49,47,2,0,1,0
0,0,0,0,0,0,0,0,0
0,0,0,0,0,0,0,0,0
179253,1431,21,226,201,25,10,1,0
178894,1431,20,226,201,25,9,1,0
0,0,0,0,0,0,0,0,0
0,0,0,0,0,0,0,0,0
0,0,0,0,0,0,0,0,0
0,0,0,0,0,0,0,0,0
0,0,0,0,0,0,0,0,0
22897,37,0,2,1,1,0,1,0
0,0,0,0,0,0,0,0,0
0,0,0,0,0,0,0,0,0
0,0,0,0,0,0,0,0,0
186026,2344,8,166,140,26,5,0,0
15931,186,4,36,36,0,2,1,0
0,0,0,0,0,0,0,0,0
325918,655,3,87,0,87,1,1,0
10206,230,0,34,24,10,3,0,0
52940,288,0,11,6,5,1,0,0
58200,304,8,66,58,8,2,1,0
0,0,0,0,0,0,0,0,0
7787,100,0,11,8,3,2,1,0
10318,54,1,2,2,0,0,1,0
165734,473,7,81,71,10,1,1,0
111189,1196,6,235,231,4,0,0,0
56897,339,6,51,49,2,6,0,0
43643,237,6,18,18,0,8,0,0
57943,728,13,96,94,2,1,0,0
0,0,0,0,0,0,0,0,0
48653,729,3,155,128,27,3,1,0
16473,182,2,56,54,2,0,1,0
120658,1627,12,292,286,6,11,1,1
0,0,0,0,0,0,0,0,0
195595,1649,3,230,227,3,5,1,0
115399,1147,3,43,40,3,5,1,0
2252,29,1,1,1,0,0,0,0
200041,702,6,89,89,0,0,1,0
32606,469,0,95,93,2,0,0,0
0,0,0,0,0,0,0,0,0
264021,2526,9,716,484,232,13,1,0
74312,489,12,95,76,19,2,1,0
10643,169,2,34,33,1,0,1,0
334677,1302,1,89,83,6,12,0,0
80204,787,6,76,76,0,27,1,0
0,0,0,0,0,0,0,0,0
62735,400,6,79,70,9,2,1,0
211578,3767,2,1129,1127,2,2,1,0
136187,2661,2,884,881,3,2,1,0
470002,2106,4,303,258,45,4,1,0
294948,2387,8,475,334,141,5,1,0
854144,1630,4,87,62,25,37,0,0
0,0,0,0,0,0,0,0,0
27320,136,2,20,20,0,0,1,0
13955,77,1,12,12,0,0,1,0
656605,371,9,22,21,1,21,1,0
0,0,0,0,0,0,0,0,0
0,0,0,0,0,0,0,0,0
1168888,924,4,75,60,15,4,1,0
0,0,0,0,0,0,0,0,0
54108,576,7,103,100,3,0,1,0
54108,576,7,103,100,3,0,1,0
153361,1192,18,124,57,67,4,1,0
153361,1192,18,124,57,67,4,1,0
444261,522,5,50,42,8,1,1,0
74921,414,5,44,36,8,1,1,0
198574,1896,10,290,209,81,12,1,0
3423,38,0,0,0,0,0,0,0
46158,654,3,147,127,20,2,1,0
0,0,0,0,0,0,0,0,0
0,0,0,0,0,0,0,0,0
0,0,0,0,0,0,0,0,0
186273,1228,14,261,253,8,11,1,0
57322,644,7,149,144,5,6,1,0
0,0,0,0,0,0,0,0,0
0,0,0,0,0,0,0,0,0
0,0,0,0,0,0,0,0,0
0,0,0,0,0,0,0,0,0
0,0,0,0,0,0,0,0,0
909986,2125,2,355,347,8,3,1,0
686539,545,4,11,8,3,3,1,0
412692,1725,6,476,430,46,2,1,0
433745,710,3,120,110,10,0,0,0
46404,117,2,7,7,0,0,0,0
0,0,0,0,0,0,0,0,0
0,0,0,0,0,0,0,0,0
0,0,0,0,0,0,0,0,0
64328,725,13,124,110,14,1,1,0
64327,725,13,124,110,14,1,1,0
0,0,0,0,0,0,0,0,0
0,0,0,0,0,0,0,0,0
31977,440,5,51,51,0,4,0,0
0,0,0,0,0,0,0,0,0
0,0,0,0,0,0,0,0,0
0,0,0,0,0,0,0,0,0
67149,215,3,23,22,1,0,1,0
90140,889,10,151,144,7,8,1,0
69309,638,10,133,126,7,8,1,0
217119,1403,7,185,135,50,8,1,0
419371,1872,9,318,258,60,11,1,0
348170,1424,10,284,273,11,16,1,0
294599,1549,5,233,206,27,1,0,0
125370,1309,1,179,171,8,1,1,0
0,0,0,0,0,0,0,0,0
0,0,0,0,0,0,0,0,0
54552,541,5,25,16,9,0,1,0
0,0,0,0,0,0,0,0,0
0,0,0,0,0,0,0,0,0
607575,1858,5,279,207,72,49,1,0
5905,95,0,15,15,0,0,1,0
40186,480,2,73,64,9,0,0,0
0,0,0,0,0,0,0,0,0
26955,34,0,2,1,1,0,0,0
178812,1301,3,176,170,6,12,1,0
228120,1559,15,243,196,47,14,1,0
0,0,0,0,0,0,0,0,0
0,0,0,0,0,0,0,0,0
74458,995,4,299,189,110,13,1,0
42007,291,1,35,31,4,2,1,0
0,0,0,0,0,0,0,0,0
80459,628,6,97,87,10,4,1,0
219585,963,14,63,42,21,0,1,0
597837,4127,18,582,516,66,23,1,0
599073,4126,18,582,516,66,23,1,0
111664,630,9,156,106,50,1,1,0
0,0,0,0,0,0,0,0,0
0,0,0,0,0,0,0,0,0
0,0,0,0,0,0,0,0,0
157186,87,0,2,1,1,1,1,0
759911,1194,5,95,79,16,0,1,0
0,0,0,0,0,0,0,0,0
103722,1717,2,522,492,30,9,0,0
114231,1364,4,301,71,230,3,1,0
9727,141,3,7,7,0,5,0,0
161671,1074,1,156,121,35,16,0,0
0,0,0,0,0,0,0,0,0
479073,1950,15,311,81,230,4,1,0
165402,309,2,14,14,0,2,1,0
16656,276,2,63,63,0,2,1,0
120090,1065,7,220,214,6,2,0,0
0,0,0,0,0,0,0,0,0
103243,922,7,153,145,8,20,1,0
195127,1142,11,215,199,16,2,1,0
34424,766,2,190,170,20,1,1,0
167100,1589,7,355,306,49,8,1,0
0,0,0,0,0,0,0,0,0
0,0,0,0,0,0,0,0,0
179874,933,9,77,71,6,11,1,0
66655,325,9,44,38,6,0,1,0
51226,623,7,122,110,12,15,0,0
98677,220,1,19,14,5,6,1,0
73077,455,5,78,75,3,5,1,0
1071123,8804,5,4,3,1,6,0,0
0,0,0,0,0,0,0,0,0
163598,1220,9,196,143,53,16,1,0
0,0,0,0,0,0,0,0,0
74048,503,11,144,143,1,7,1,0
0,0,0,0,0,0,0,0,0
117663,1067,3,133,103,30,1,1,0
64720,301,5,75,65,10,3,1,0
247592,883,6,148,108,40,2,0,0
328944,1845,8,255,252,3,33,1,0
21858,33,0,1,1,0,0,1,0
27078,36,0,3,1,2,0,0,0
0,0,0,0,0,0,0,0,0
48190,562,0,107,102,5,0,0,0
1311406,13232,9,2453,2412,41,864,1,0
62428,89,0,2,2,0,0,0,0
0,0,0,0,0,0,0,0,0
49540,682,10,114,69,45,4,1,0
66648,551,3,68,60,8,2,1,0
75863,594,7,38,31,7,14,1,0
0,0,0,0,0,0,0,0,0
0,0,0,0,0,0,0,0,0
0,0,0,0,0,0,0,0,0
109933,441,0,61,60,1,0,1,0
0,0,0,0,0,0,0,0,0
648716,5931,0,290,248,42,83,1,0
0,0,0,0,0,0,0,0,0
67119,301,4,36,36,0,0,1,0
58981,304,8,64,63,1,2,1,0
420113,1399,2,263,240,23,1,0,0
92467,1041,2,60,33,27,2,1,0
0,0,0,0,0,0,0,0,0
210998,1436,6,220,214,6,5,1,0
232478,991,9,302,261,41,106,1,0
28759,45,0,4,1,3,0,0,0
66304,1381,3,402,387,15,21,1,0
5926,41,1,2,1,1,0,0,0
113304,1307,5,145,106,39,2,1,0
0,0,0,0,0,0,0,0,0
103313,1337,7,220,200,20,3,1,0
12863,151,1,8,0,8,1,0,0
32587,417,6,89,86,3,2,0,0
0,0,0,0,0,0,0,0,0
0,0,0,0,0,0,0,0,0
79107,1031,8,239,210,29,5,1,0
0,0,0,0,0,0,0,0,0
200730,1050,6,122,88,34,12,0,0
0,0,0,0,0,0,0,0,0
0,0,0,0,0,0,0,0,0
57458,965,0,26,23,3,0,1,0
0,0,0,0,0,0,0,0,0
0,0,0,0,0,0,0,0,0
54309,164,3,13,8,5,0,0,0
41461,557,3,78,74,4,2,0,0
353136,1240,9,203,200,3,19,1,0
150575,432,9,126,115,11,39,1,0
0,0,0,0,0,0,0,0,0
156810,896,11,84,77,7,20,1,0
127224,525,9,85,76,9,10,1,0
197953,2343,4,56,2,54,21,1,0
51000,179,4,18,18,0,5,1,0
198755,1037,13,80,62,18,41,1,0
233158,1397,13,84,61,23,43,1,0
0,0,0,0,0,0,0,0,0
22170,35,0,1,1,0,0,1,0
38315,271,5,65,65,0,1,1,0
6495,67,2,1,0,1,0,0,0
52007,143,2,108,107,1,0,0,0
59193,913,3,122,121,1,0,1,0
0,0,0,0,0,0,0,0,0
0,0,0,0,0,0,0,0,0
306257,909,9,59,55,4,1,1,0
383062,1008,1,159,146,13,1,1,0
5973,21,0,1,1,0,0,1,0
38264,391,6,25,25,0,0,0,0
153139,804,8,15,15,0,3,1,0
0,0,0,0,0,0,0,0,0
251042,724,1,147,136,11,0,1,0
0,0,0,0,0,0,0,0,0
130573,71,1,0,0,0,0,0,0
520839,2106,12,145,126,19,11,1,0
0,0,0,0,0,0,0,0,0
272911,910,6,148,6,142,11,1,0
733715,6758,6,603,598,5,5,0,0
174838,1756,8,350,198,152,11,1,0
74939,1151,3,113,103,10,0,1,0
0,0,0,0,0,0,0,0,0
0,0,0,0,0,0,0,0,0
217114,1703,9,231,200,31,5,1,0
0,0,0,0,0,0,0,0,0
476388,998,6,126,119,7,13,1,0
0,0,0,0,0,0,0,0,0
290573,3052,9,665,638,27,9,1,0
103833,1200,3,311,299,12,2,1,0
27599,178,5,19,18,1,0,0,0
319425,1985,6,284,258,26,3,1,0
0,0,0,0,0,0,0,0,0
0,0,0,0,0,0,0,0,0
0,0,0,0,0,0,0,0,0
0,0,0,0,0,0,0,0,0
988,17,0,1,0,1,0,0,0
28838,42,0,2,1,1,0,0,0
72750,1578,2,594,592,2,1,0,0
0,0,0,0,0,0,0,0,0
0,0,0,0,0,0,0,0,0
243629,901,1,91,80,11,0,1,0
196500,782,5,34,26,8,1,0,0
0,0,0,0,0,0,0,0,0
91415,270,4,26,25,1,4,1,0
138674,1056,11,182,168,14,7,1,0
21526,243,5,56,43,13,5,1,0
191455,2890,7,438,420,18,2,1,0
0,0,0,0,0,0,0,0,0
84837,1116,8,121,68,53,3,1,0
147661,1525,8,348,334,14,1,0,0
0,0,0,0,0,0,0,0,0
118392,1437,6,268,252,16,32,1,1
161104,1030,6,163,139,24,4,1,0
0,0,0,0,0,0,0,0,0
0,0,0,0,0,0,0,0,0
0,0,0,0,0,0,0,0,0
1454770,1239,1,235,222,13,1,1,0
391279,120,0,5,5,0,0,1,0
82947,624,3,70,30,40,5,1,0
0,0,0,0,0,0,0,0,0
230584,1774,5,230,171,59,17,0,0
169048,1409,11,90,84,6,4,1,0
848552,2352,6,137,122,15,20,0,0
0,0,0,0,0,0,0,0,0
97045,955,5,240,0,240,0,0,0
112314,1603,7,225,214,11,4,1,0
206145,2324,14,450,436,14,16,1,0
290938,343,0,4,3,1,1,1,0
0,0,0,0,0,0,0,0,0
11643,211,2,69,28,41,0,1,0
0,0,0,0,0,0,0,0,0
411857,3623,6,320,298,22,18,1,0
0,0,0,0,0,0,0,0,0
364063,23,3,0,0,0,0,1,0
0,0,0,0,0,0,0,0,0
101914,1554,6,170,104,66,7,0,0
375321,2398,6,540,441,99,13,0,0
9051,82,2,2,2,0,0,0,0
60280,232,2,5,5,0,3,1,0
216828,559,2,78,69,9,0,1,0
72837,212,4,19,13,6,5,1,0
0,0,0,0,0,0,0,0,0
0,0,0,0,0,0,0,0,0
0,0,0,0,0,0,0,0,0
183330,814,3,77,74,3,1,1,0
144503,408,4,33,31,2,5,1,0
0,0,0,0,0,0,0,0,0
0,0,0,0,0,0,0,0,0
0,0,0,0,0,0,0,0,0
143194,2474,11,36,29,7,3,1,0
10955,79,6,3,2,1,1,0,0
46375,250,10,33,28,5,0,1,0
100182,1075,1,377,375,2,0,0,0
2979,46,0,0,0,0,0,0,0
0,0,0,0,0,0,0,0,0
0,0,0,0,0,0,0,0,0
215622,998,9,270,268,2,8,1,0
17053,339,2,88,77,11,0,0,0
234880,2284,11,775,762,13,5,1,0
214012,2098,11,752,739,13,6,1,0
0,0,0,0,0,0,0,0,0
0,0,0,0,0,0,0,0,0
157921,234,1,12,12,0,0,1,0
22438,185,1,13,13,0,0,1,0
0,0,0,0,0,0,0,0,0
0,0,0,0,0,0,0,0,0
3824138,31670,5,3312,1806,1506,8,1,0
47110,132,8,3,0,3,0,1,0
0,0,0,0,0,0,0,0,0
0,0,0,0,0,0,0,0,0
0,0,0,0,0,0,0,0,0
0,0,0,0,0,0,0,0,0
1245256,974,16,94,67,27,6,1,0
0,0,0,0,0,0,0,0,0
0,0,0,0,0,0,0,0,0
18734,424,3,169,167,2,0,1,0
9634,224,2,82,82,0,0,1,0
30835,249,4,27,21,6,0,0,0
430940,1278,8,195,158,37,5,1,0
0,0,0,0,0,0,0,0,0
637201,2274,6,295,270,25,2,0,0
0,0,0,0,0,0,0,0,0
21717,188,6,15,10,5,0,1,0
0,0,0,0,0,0,0,0,0
0,0,0,0,0,0,0,0,0
0,0,0,0,0,0,0,0,0
0,0,0,0,0,0,0,0,0
135737,2247,2,602,501,101,6,0,0
83956,1462,2,432,379,53,6,0,0
0,0,0,0,0,0,0,0,0
147519,820,6,178,174,4,6,1,0
1239395,366,5,14,13,1,2,1,0
53733,542,8,113,81,32,3,0,0
117680,1187,7,258,233,25,3,1,0
0,0,0,0,0,0,0,0,0
0,0,0,0,0,0,0,0,0
190034,1159,6,167,157,10,7,1,0
232538,2137,17,431,425,6,11,1,0
0,0,0,0,0,0,0,0,0
461641,972,12,183,173,10,14,1,0
101141,723,12,67,42,25,2,1,0
165647,781,12,145,131,14,6,1,0
1650,11,0,1,1,0,0,0,0
0,0,0,0,0,0,0,0,0
0,0,0,0,0,0,0,0,0
240267,620,6,97,96,1,2,1,0
801791,2090,15,427,418,9,2,1,0
386135,1140,9,311,302,9,0,1,0
0,0,0,0,0,0,0,0,0
606900,2333,7,210,194,16,9,1,0
0,0,0,0,0,0,0,0,0
34411,541,4,99,97,2,2,1,0
23034,302,6,85,85,0,1,1,0
108784,489,8,153,151,2,8,1,0
332434,464,2,67,53,14,0,1,0
95707,662,3,80,54,26,3,1,0
1018486,3877,2,734,730,4,73,0,0
0,0,0,0,0,0,0,0,0
0,0,0,0,0,0,0,0,0
0,0,0,0,0,0,0,0,0
243534,2005,6,397,373,24,8,1,1
98228,1326,9,253,240,13,3,0,0
61387,501,9,87,79,8,1,0,0
122962,1059,3,136,26,110,11,1,0
2376573,10427,15,255,61,194,9,1,0
0,0,0,0,0,0,0,0,0
0,0,0,0,0,0,0,0,0
86611,1009,6,195,189,6,15,1,0
77422,730,9,147,108,39,4,1,0
0,0,0,0,0,0,0,0,0
39250,344,6,42,30,12,1,1,0
0,0,0,0,0,0,0,0,0
0,0,0,0,0,0,0,0,0
0,0,0,0,0,0,0,0,0
0,0,0,0,0,0,0,0,0
0,0,0,0,0,0,0,0,0
0,0,0,0,0,0,0,0,0
189858,1488,8,273,252,21,7,1,0
0,0,0,0,0,0,0,0,0
616901,7973,12,1623,1621,2,22,0,0
96997,1008,2,205,171,34,20,1,0
0,0,0,0,0,0,0,0,0
0,0,0,0,0,0,0,0,0
44979,386,7,55,19,36,0,1,0
0,0,0,0,0,0,0,0,0
32963,138,8,7,7,0,0,1,0
61687,495,4,113,36,77,0,0,0
23395,297,3,15,3,12,0,1,0
198192,1084,7,146,124,22,1,0,0
282223,193,0,0,0,0,1,1,0
131002,1971,5,524,463,61,25,1,0
100321,1391,5,455,404,51,29,1,0
0,0,0,0,0,0,0,0,0
251515,1185,11,99,93,6,1,1,0
0,0,0,0,0,0,0,0,0
67691,268,3,14,9,5,2,1,0
0,0,0,0,0,0,0,0,0
270016,2444,5,420,386,34,3,1,0
71881,845,5,125,95,30,6,1,0
221870,429,3,87,79,8,0,0,0
34076,127,5,2,2,0,4,0,0
0,0,0,0,0,0,0,0,0
218541,2846,10,630,601,29,7,1,0
288790,3274,8,823,756,67,8,0,0
0,0,0,0,0,0,0,0,0
193377,1679,9,226,218,8,44,1,0
167976,1596,8,184,178,6,49,1,0
0,0,0,0,0,0,0,0,0
32804,474,4,54,52,2,1,0,0
0,0,0,0,0,0,0,0,0
0,0,0,0,0,0,0,0,0
27903,10,0,0,0,0,0,0,0
0,0,0,0,0,0,0,0,0
24954,245,4,71,71,0,4,1,0
0,0,0,0,0,0,0,0,0
0,0,0,0,0,0,0,0,0
61032,1088,3,249,232,17,6,0,0
110748,799,1,136,42,94,1,1,0
290927,343,0,4,3,1,1,1,0
0,0,0,0,0,0,0,0,0
0,0,0,0,0,0,0,0,0
223649,2033,15,237,215,22,14,1,0
0,0,0,0,0,0,0,0,0
281550,1415,8,136,75,61,19,1,0
0,0,0,0,0,0,0,0,0
93483,741,5,161,141,20,11,1,0
274767,1322,12,165,165,0,2,0,0
498347,2823,7,624,616,8,2,1,0
386950,1042,16,105,80,25,9,1,0
0,0,0,0,0,0,0,0,0
266307,1743,16,413,395,18,5,1,0
65730,721,5,74,71,3,15,1,0
0,0,0,0,0,0,0,0,0
31620,350,9,33,29,4,2,1,0
36123,314,10,30,23,7,8,1,0
0,0,0,0,0,0,0,0,0
0,0,0,0,0,0,0,0,0
30453,100,2,2,0,2,0,0,0
253961,1509,7,259,252,7,32,1,0
0,0,0,0,0,0,0,0,0
0,0,0,0,0,0,0,0,0
54793,260,9,20,20,0,0,1,0
494343,1168,7,99,84,15,10,1,0
61748,326,11,37,32,5,2,1,0
139044,886,16,135,120,15,5,1,0
4271,84,1,5,5,0,0,1,0
1781,37,0,2,2,0,0,1,0
0,0,0,0,0,0,0,0,0
42484,596,10,140,132,8,9,1,0
0,0,0,0,0,0,0,0,0
5988,49,2,13,13,0,0,1,0
437546,6413,1,862,760,102,15,1,0
65054,674,9,79,53,26,2,1,0
66868,392,7,25,19,6,13,1,0
0,0,0,0,0,0,0,0,0
0,0,0,0,0,0,0,0,0
51491,1168,3,250,248,2,4,1,0
11603,137,2,29,27,2,3,1,0
0,0,0,0,0,0,0,0,0
54049,489,6,72,51,21,9,0,0
0,0,0,0,0,0,0,0,0
511659,1367,6,108,100,8,49,1,0
0,0,0,0,0,0,0,0,0
266504,3796,17,645,625,20,11,1,0
624849,6641,15,1374,1366,8,140,1,0
819,41,0,0,0,0,0,0,0
0,0,0,0,0,0,0,0,0
0,0,0,0,0,0,0,0,0
0,0,0,0,0,0,0,0,0
0,0,0,0,0,0,0,0,0
711664,2631,15,206,195,11,26,1,0
616354,2411,15,117,109,8,14,1,0
222312,2531,8,171,133,38,0,1,0
222310,2531,8,171,133,38,0,1,0
218743,1369,9,116,95,21,0,0,0
129036,788,8,133,131,2,3,1,0
0,0,0,0,0,0,0,0,0
28950,297,6,41,29,12,4,1,0
11754,118,5,30,28,2,1,0,0
94648,978,1,220,216,4,1,1,0
290034,1083,11,142,128,14,68,1,0
173049,875,4,96,77,19,1,1,0
186054,1108,3,167,157,10,52,1,0
0,0,0,0,0,0,0,0,0
175530,1040,3,102,98,4,7,0,0
561,6,0,0,0,0,0,0,0
236067,2450,9,394,381,13,42,1,0
304975,1539,16,206,193,13,12,1,0
8913,154,4,15,3,12,0,0,0
0,0,0,0,0,0,0,0,0
0,0,0,0,0,0,0,0,0
554474,2862,21,375,360,15,9,1,0
0,0,0,0,0,0,0,0,0
167195,723,6,110,99,11,0,1,0
144312,322,6,43,42,1,1,1,0
77799,1767,2,502,476,26,0,1,0
0,0,0,0,0,0,0,0,0
134749,1133,12,100,91,9,6,0,0
160203,456,10,67,64,3,3,1,0
216289,4300,0,1166,1163,3,1,1,0
90072,1115,0,226,226,0,0,1,0
30825,300,5,35,22,13,0,1,0
5214,61,3,3,3,0,2,0,0
1390234,428,7,34,30,4,2,1,0
175665,878,7,85,78,7,6,1,0
0,0,0,0,0,0,0,0,0
5779,51,2,2,1,1,0,0,0
23193,38,0,2,2,0,0,1,0
0,0,0,0,0,0,0,0,0
247025,721,6,144,119,25,6,1,0
325211,3399,12,125,123,2,3,1,0
0,0,0,0,0,0,0,0,0
0,0,0,0,0,0,0,0,0
117573,446,10,44,32,12,1,1,0
106660,315,2,24,17,7,0,1,0
0,0,0,0,0,0,0,0,0
300171,3058,11,383,366,17,165,1,0
157674,1001,9,204,195,9,23,1,0
65575,433,7,60,59,1,0,1,0
0,0,0,0,0,0,0,0,0
0,0,0,0,0,0,0,0,0
67372,535,5,52,47,5,2,1,0
0,0,0,0,0,0,0,0,0
0,0,0,0,0,0,0,0,0
89251,1009,5,82,74,8,1,1,0
242337,1785,5,491,489,2,7,0,0
0,0,0,0,0,0,0,0,0
99133,767,9,149,119,30,4,0,0
0,0,0,0,0,0,0,0,0
0,0,0,0,0,0,0,0,0
72065,486,8,28,26,2,3,1,0
6317,54,2,10,7,3,0,1,0
0,0,0,0,0,0,0,0,0
137151,1252,4,366,281,85,11,1,0
3983,75,2,4,3,1,0,1,0
0,0,0,0,0,0,0,0,0
0,0,0,0,0,0,0,0,0
79983,686,8,99,22,77,12,1,0
170286,193,7,28,15,13,1,1,0
0,0,0,0,0,0,0,0,0
228865,787,1,136,131,5,4,1,0
163400,330,1,74,24,50,0,1,0
0,0,0,0,0,0,0,0,0
12090,306,2,16,14,2,0,1,0
399903,3597,8,146,133,13,3,1,0
0,0,0,0,0,0,0,0,0
0,0,0,0,0,0,0,0,0
35547,605,7,78,13,65,9,1,0
159431,2093,3,676,590,86,3,0,0
118279,1855,3,632,552,80,3,0,0
0,0,0,0,0,0,0,0,0
268704,1350,9,266,253,13,17,1,0
0,0,0,0,0,0,0,0,0
112853,876,9,115,113,2,8,1,0
0,0,0,0,0,0,0,0,0
0,0,0,0,0,0,0,0,0
252798,1991,7,325,78,247,54,1,0
0,0,0,0,0,0,0,0,0
780039,1684,12,230,224,6,10,1,0
789588,3962,4,187,150,37,3,1,0
0,0,0,0,0,0,0,0,0
1089423,4611,6,1087,825,262,9,1,1
131346,185,8,13,9,4,6,0,0
114835,159,4,4,4,0,6,1,0
435553,1049,1,106,98,8,2,1,0
296178,732,2,165,116,49,10,1,0
0,0,0,0,0,0,0,0,0
0,0,0,0,0,0,0,0,0
53693,202,1,58,58,0,1,1,0
206659,1079,7,33,20,13,0,1,0
51067,1359,2,399,230,169,1,1,0
0,0,0,0,0,0,0,0,0
210542,1518,7,259,256,3,7,0,0
151689,1255,11,211,97,114,5,1,0
0,0,0,0,0,0,0,0,0
0,0,0,0,0,0,0,0,0
26313,404,3,105,103,2,2,1,0
0,0,0,0,0,0,0,0,0
122663,2746,1,253,247,6,3,1,0
40718,650,8,43,17,26,2,1,0
68562,1000,3,223,193,30,2,1,0
3525,27,3,0,0,0,0,0,0
96303,184,3,11,6,5,3,1,0
444357,2572,7,400,296,104,27,1,0
737221,2363,3,638,609,29,2,1,0
538341,3391,12,191,144,47,31,1,0
331418,1468,11,115,71,44,14,1,0
0,0,0,0,0,0,0,0,0
160962,822,4,64,55,9,27,1,0
0,0,0,0,0,0,0,0,0
238771,1192,5,129,129,0,0,1,0
0,0,0,0,0,0,0,0,0
76801,1054,8,246,243,3,5,1,0
66095,485,7,54,51,3,11,1,0
0,0,0,0,0,0,0,0,0
0,0,0,0,0,0,0,0,0
44070,756,3,133,103,30,0,0,0
453285,2782,4,382,362,20,3,1,0
378852,1082,1,98,52,46,1,1,0
0,0,0,0,0,0,0,0,0
57043,776,7,206,206,0,12,1,0
178075,528,2,85,82,3,7,1,0
0,0,0,0,0,0,0,0,0
83248,1290,7,159,75,84,2,1,0
80798,467,1,75,41,34,2,1,0
40833,614,1,144,109,35,2,1,0
36524,565,1,127,96,31,1,1,0
759762,944,7,78,65,13,0,1,0
35675,449,4,76,73,3,6,1,0
0,0,0,0,0,0,0,0,0
21996,33,0,1,1,0,0,1,0
35534,279,5,63,63,0,2,1,0
31694,269,5,70,69,1,2,1,0
203097,379,4,39,33,6,0,1,0
457663,2079,8,152,80,72,16,1,0
0,0,0,0,0,0,0,0,0
0,0,0,0,0,0,0,0,0
8448,104,4,17,13,4,0,1,0
124831,1109,3,171,163,8,20,0,0
148666,567,3,148,129,19,0,0,0
56612,349,9,32,31,1,0,1,0
0,0,0,0,0,0,0,0,0
246579,1160,13,235,34,201,1,0,0
212718,1927,12,444,432,12,2,1,0
155599,1580,14,361,351,10,6,1,0
29639,507,4,133,130,3,0,1,0
1404923,4494,4,273,265,8,0,1,0
0,0,0,0,0,0,0,0,0
106679,1169,3,206,173,33,1,1,0
36929,106,0,1,0,1,0,1,0
132515,2096,11,547,542,5,4,1,0
62398,454,4,91,82,9,0,1,0
370230,2441,6,191,148,43,54,1,0
0,0,0,0,0,0,0,0,0
5208,99,0,29,29,0,0,1,0
2112853,2642,11,898,865,33,15,1,0
2044889,1322,11,439,406,33,8,1,0
110009,613,6,63,56,7,10,1,0
65645,246,7,9,9,0,10,1,0
7126,105,4,9,2,7,3,1,0
0,0,0,0,0,0,0,0,0
103411,642,12,42,37,5,1,1,0
60751,308,11,33,28,5,1,1,0
0,0,0,0,0,0,0,0,0
0,0,0,0,0,0,0,0,0
0,0,0,0,0,0,0,0,0
857553,6413,7,946,929,17,17,0,0
307151,4897,9,205,193,12,16,0,0
112051,2261,8,488,433,55,13,1,0
0,0,0,0,0,0,0,0,0
184105,410,5,68,55,13,1,1,0
28093,601,2,128,114,14,2,1,0
0,0,0,0,0,0,0,0,0
0,0,0,0,0,0,0,0,0
0,0,0,0,0,0,0,0,0
0,0,0,0,0,0,0,0,0
0,0,0,0,0,0,0,0,0
81381,1181,4,282,275,7,3,1,0
31139,396,4,90,84,6,2,1,0
130593,1089,3,184,147,37,30,1,0
0,0,0,0,0,0,0,0,0
0,0,0,0,0,0,0,0,0
34353,362,0,44,40,4,0,1,0
0,0,0,0,0,0,0,0,0
38060,356,2,67,60,7,7,1,0
482559,2953,16,267,205,62,6,1,0
17977,251,3,31,30,1,6,1,0
51901,143,2,108,107,1,0,0,0
0,0,0,0,0,0,0,0,0
32197,389,4,97,83,14,3,1,0
28759,45,0,4,1,3,0,0,0
0,0,0,0,0,0,0,0,0
379850,2332,13,197,155,42,3,1,0
114874,591,10,89,87,2,6,1,0
532572,3353,6,731,720,11,27,1,0
389638,2225,6,595,585,10,3,1,0
0,0,0,0,0,0,0,0,0
0,0,0,0,0,0,0,0,0
0,0,0,0,0,0,0,0,0
0,0,0,0,0,0,0,0,0
211960,845,12,215,207,8,9,1,0
0,0,0,0,0,0,0,0,0
17461,176,2,68,66,2,0,1,0
162221,636,5,149,144,5,18,1,0
272335,1208,12,150,108,42,15,1,0
0,0,0,0,0,0,0,0,0
0,0,0,0,0,0,0,0,0
67535,1323,4,261,252,9,5,1,0
16029,79,1,7,7,0,3,1,0
54441,391,4,42,41,1,8,1,0
35675,189,4,19,18,1,8,1,0
0,0,0,0,0,0,0,0,0
194886,2507,7,691,660,31,19,1,0
89093,980,2,257,9,248,0,1,0
96195,410,6,52,52,0,0,1,0
186531,641,7,78,71,7,1,0,0
9151,84,4,8,8,0,3,0,0
0,0,0,0,0,0,0,0,0
0,0,0,0,0,0,0,0,0
267830,1725,15,204,197,7,15,1,0
122567,1048,3,107,93,14,1,1,0
88803,1536,3,372,364,8,2,1,0
28712,45,0,4,1,3,0,0,0
0,0,0,0,0,0,0,0,0
47758,349,5,52,42,10,3,1,0
1439570,1291,2,171,159,12,1,1,0
357235,105,0,5,5,0,0,1,0
0,0,0,0,0,0,0,0,0
0,0,0,0,0,0,0,0,0
0,0,0,0,0,0,0,0,0
0,0,0,0,0,0,0,0,0
156004,428,3,79,74,5,0,1,0
0,0,0,0,0,0,0,0,0
0,0,0,0,0,0,0,0,0
0,0,0,0,0,0,0,0,0
0,0,0,0,0,0,0,0,0
8933,156,3,9,7,2,0,1,0
0,0,0,0,0,0,0,0,0
155971,1087,7,166,165,1,10,1,0
80800,212,0,46,23,23,0,1,1
0,0,0,0,0,0,0,0,0
97131,1044,8,93,83,10,0,0,0
524228,6561,6,479,474,5,287,1,0
415550,1701,1,502,437,65,24,1,0
163421,330,1,74,24,50,0,1,0
500958,3974,10,837,798,39,4,1,0
77203,666,2,175,167,8,0,0,0
32167,332,1,119,111,8,0,0,0
153516,1377,5,114,98,16,7,1,0
436278,2575,10,422,393,29,11,1,0
0,0,0,0,0,0,0,0,0
0,0,0,0,0,0,0,0,0
209584,3203,8,90,72,18,3,1,0
501605,1645,4,144,121,23,4,0,0
0,0,0,0,0,0,0,0,0
307940,3001,12,824,815,9,22,1,0
0,0,0,0,0,0,0,0,0
625558,8010,5,697,694,3,0,1,0
28822,231,4,32,32,0,2,1,0
87853,633,10,161,156,5,6,1,0
881855,8173,18,1271,1197,74,11,1,0
140899,1247,8,199,190,9,3,1,0
432814,3696,9,1181,1120,61,36,0,0
0,0,0,0,0,0,0,0,0
345175,2078,5,62,30,32,147,1,0
0,0,0,0,0,0,0,0,0
91855,1082,1,194,192,2,0,0,0
0,0,0,0,0,0,0,0,0
22896,37,0,2,1,1,0,1,0
1243198,7672,1,253,215,38,8,1,0
148043,1341,2,207,126,81,10,1,0
19525,138,3,3,3,0,0,0,0
205268,964,5,208,204,4,6,0,0
337237,1855,20,92,70,22,15,1,0
3017,79,0,8,8,0,0,1,0
0,0,0,0,0,0,0,0,0
0,0,0,0,0,0,0,0,0
277673,780,6,104,70,34,12,1,0
157145,1575,1,525,524,1,3,1,0
129273,165,1,22,17,5,0,1,0
50658,241,4,6,3,3,1,0,0
0,0,0,0,0,0,0,0,0
683879,1679,5,118,105,13,8,1,0
0,0,0,0,0,0,0,0,0
38923,514,3,125,107,18,0,1,0
0,0,0,0,0,0,0,0,0
314040,1773,13,390,341,49,73,1,0
371430,916,3,149,93,56,11,1,0
80620,108,1,10,7,3,2,0,0
0,0,0,0,0,0,0,0,0
0,0,0,0,0,0,0,0,0
92562,1230,8,67,67,0,10,1,0
15332,182,6,28,28,0,6,1,0
89544,696,4,40,28,12,0,1,0
6251,78,4,12,12,0,4,1,0
0,0,0,0,0,0,0,0,0
0,0,0,0,0,0,0,0,0
363232,887,2,142,76,66,8,1,0
79919,108,1,10,7,3,2,0,0
23910,171,3,1,0,1,3,0,0
89990,372,5,72,64,8,5,1,0
53905,553,4,133,126,7,6,1,0
0,0,0,0,0,0,0,0,0
61051,493,3,100,100,0,8,1,0
28730,426,6,99,95,4,0,1,0
13319,292,6,69,49,20,1,1,0
149509,900,11,27,17,10,1,0,0
61574,652,7,171,168,3,2,1,0
0,0,0,0,0,0,0,0,0
160708,3773,4,1350,1293,57,3,1,0
8893,96,3,28,28,0,0,1,0
0,0,0,0,0,0,0,0,0
138414,2208,3,789,788,1,6,1,0
683170,3571,9,522,513,9,12,1,0
330719,1961,8,456,451,5,12,1,0
0,0,0,0,0,0,0,0,0
0,0,0,0,0,0,0,0,0
76844,505,13,59,54,5,4,1,0
0,0,0,0,0,0,0,0,0
26413,265,12,13,13,0,2,1,0
49215,384,3,68,59,9,6,1,0
64770,732,4,153,150,3,14,1,0
0,0,0,0,0,0,0,0,0
241069,1902,6,213,169,44,2,0,0
231548,1462,4,93,58,35,4,0,0
209945,1677,9,457,388,69,7,1,0
0,0,0,0,0,0,0,0,0
104070,1001,10,218,204,14,3,1,0
0,0,0,0,0,0,0,0,0
16541,260,2,46,31,15,0,1,0
10913,166,2,25,23,2,1,1,0
5094,81,4,17,12,5,0,1,0
3922,55,4,7,5,2,0,1,0
41622,361,6,111,38,73,0,0,0
186208,950,1,185,182,3,0,1,0
25028,332,3,61,60,1,0,1,0
165886,3851,7,1530,1509,21,3,0,0
0,0,0,0,0,0,0,0,0
228910,1445,5,75,61,14,69,1,0
95262,731,7,128,118,10,1,0,0
32434,211,6,10,3,7,20,0,0
898,28,0,2,2,0,0,0,0
95262,1086,2,259,251,8,5,1,0
184071,451,2,55,49,6,8,0,0
7151,89,0,10,8,2,0,0,0
21599,234,2,24,11,13,0,1,0
0,0,0,0,0,0,0,0,0
246300,1037,10,205,163,42,10,1,0
113975,520,10,86,86,0,9,1,0
0,0,0,0,0,0,0,0,0
203182,1601,8,362,296,66,4,1,1
64515,1297,1,96,66,30,3,1,0
0,0,0,0,0,0,0,0,0
0,0,0,0,0,0,0,0,0
250058,2846,11,284,127,157,0,1,0
0,0,0,0,0,0,0,0,0
0,0,0,0,0,0,0,0,0
0,0,0,0,0,0,0,0,0
100094,1012,6,217,197,20,4,1,0
214752,1034,2,207,188,19,2,1,0
269189,882,14,125,121,4,6,1,0
0,0,0,0,0,0,0,0,0
533182,2795,8,395,389,6,15,1,0
43125,486,6,129,117,12,10,1,0
110250,402,7,61,61,0,2,1,0
100986,734,9,106,53,53,7,1,0
71567,915,8,91,59,32,6,0,0
0,0,0,0,0,0,0,0,0
1614184,2089,9,215,212,3,0,1,0
201442,100,2,6,6,0,0,1,0
123690,842,5,264,263,1,20,1,0
38665,261,5,13,12,1,4,1,0
36234,541,5,149,143,6,3,0,0
0,0,0,0,0,0,0,0,0
0,0,0,0,0,0,0,0,0
0,0,0,0,0,0,0,0,0
0,0,0,0,0,0,0,0,0
379057,1250,8,94,81,13,6,1,0
0,0,0,0,0,0,0,0,0
0,0,0,0,0,0,0,0,0
17658,247,9,50,50,0,0,1,0
0,0,0,0,0,0,0,0,0
160309,1398,10,283,277,6,17,1,0
10534,69,3,5,5,0,0,1,0
0,0,0,0,0,0,0,0,0
177814,669,9,136,116,20,1,1,0
55928,712,9,124,105,19,0,0,0
56637,1056,4,336,328,8,0,0,0
0,0,0,0,0,0,0,0,0
0,0,0,0,0,0,0,0,0
0,0,0,0,0,0,0,0,0
112131,1277,12,328,323,5,9,1,0
127867,1778,3,308,276,32,0,1,0
260093,1262,9,243,230,13,17,1,0
0,0,0,0,0,0,0,0,0
0,0,0,0,0,0,0,0,0
0,0,0,0,0,0,0,0,0
64306,1331,5,557,546,11,1,0,0
26029,178,5,16,15,1,1,0,0
21977,35,0,1,1,0,0,1,0
972,9,1,0,0,0,0,0,0
0,0,0,0,0,0,0,0,0
0,0,0,0,0,0,0,0,0
0,0,0,0,0,0,0,0,0
207534,2837,2,646,561,85,37,1,0
209194,1918,5,398,369,29,1,1,0
27587,97,0,7,6,1,5,1,0
1769506,8615,17,957,884,73,45,1,0
172842,1218,14,243,188,55,10,1,0
223749,1951,8,393,386,7,28,1,0
0,0,0,0,0,0,0,0,0
0,0,0,0,0,0,0,0,0
131337,1333,6,182,175,7,0,1,0
0,0,0,0,0,0,0,0,0
32673,677,1,93,72,21,4,1,0
69981,878,4,228,1,227,19,1,0
277827,2306,4,1171,1168,3,0,1,0
11102,119,4,16,13,3,0,1,0
511956,2387,13,266,257,9,48,1,0
227263,1062,12,175,166,9,19,1,0
156654,2085,8,372,365,7,0,1,0
142120,1243,2,9,1,8,0,0,0
177066,1582,3,377,338,39,4,1,0
0,0,0,0,0,0,0,0,0
0,0,0,0,0,0,0,0,0
0,0,0,0,0,0,0,0,0
127695,552,5,54,52,2,1,0,0
652712,1931,2,490,470,20,2,1,0
652671,1932,2,491,471,20,2,1,0
644443,2749,14,277,246,31,32,1,0
0,0,0,0,0,0,0,0,0
120686,1086,8,201,185,16,11,0,0
87674,254,0,48,24,24,0,1,1
0,0,0,0,0,0,0,0,0
0,0,0,0,0,0,0,0,0
0,0,0,0,0,0,0,0,0
244602,1291,3,138,99,39,3,1,0
116484,522,8,41,16,25,2,1,0
0,0,0,0,0,0,0,0,0
19737,106,8,1,1,0,0,1,0
0,0,0,0,0,0,0,0,0
0,0,0,0,0,0,0,0,0
83870,720,1,74,63,11,7,0,0
579,7,0,0,0,0,0,0,0
196520,504,6,23,20,3,0,1,0
90307,1432,2,299,162,137,15,1,0
24804,382,0,70,45,25,18,1,0
0,0,0,0,0,0,0,0,0
211390,1036,8,171,16,155,19,1,0
121800,1143,11,164,154,10,10,1,0
860666,510,6,65,53,12,5,1,0
108870,785,12,83,62,21,3,0,0
258141,2378,3,378,354,24,35,1,0
0,0,0,0,0,0,0,0,0
0,0,0,0,0,0,0,0,0
0,0,0,0,0,0,0,0,0
0,0,0,0,0,0,0,0,0
198921,1139,10,238,234,4,4,1,0
166248,1074,10,158,155,3,4,1,0
7780,101,1,17,15,2,0,1,0
27868,405,2,85,82,3,6,1,0
9177,155,2,24,21,3,0,1,0
518913,1744,2,432,431,1,8,1,0
419923,989,2,251,250,1,8,1,0
194086,1649,16,334,333,1,2,0,0
420899,802,8,92,91,1,2,1,0
287264,2869,9,315,308,7,14,1,0
8740,175,0,16,12,4,0,1,0
5132,92,0,13,11,2,0,1,0
53090,753,2,320,316,4,3,1,0
166483,1289,4,282,241,41,12,1,0
96965,1268,7,245,238,7,5,1,0
0,0,0,0,0,0,0,0,0
253149,1331,14,164,149,15,13,1,0
126435,1528,10,324,287,37,0,1,0
101748,902,9,227,220,7,3,1,0
0,0,0,0,0,0,0,0,0
0,0,0,0,0,0,0,0,0
0,0,0,0,0,0,0,0,0
0,0,0,0,0,0,0,0,0
92430,1041,2,60,33,27,2,1,0
0,0,0,0,0,0,0,0,0
84943,1138,14,214,125,89,0,1,0
16018,102,6,3,3,0,0,0,0
21729,33,0,1,1,0,0,1,0
52080,491,5,83,77,6,1,1,0
0,0,0,0,0,0,0,0,0
182863,2190,3,472,464,8,6,1,0
0,0,0,0,0,0,0,0,0
354937,935,7,46,32,14,1,1,0
0,0,0,0,0,0,0,0,0
335763,3918,15,395,372,23,15,1,0
14733,59,5,0,0,0,0,0,0
375848,588,5,42,24,18,5,1,0
1973830,849,4,106,93,13,1,1,0
0,0,0,0,0,0,0,0,0
62344,730,11,80,70,10,1,1,0
29891,288,5,42,32,10,0,1,0
0,0,0,0,0,0,0,0,0
87058,1012,3,178,174,4,22,0,0
0,0,0,0,0,0,0,0,0
0,0,0,0,0,0,0,0,0
199303,1631,2,347,339,8,0,0,0
0,0,0,0,0,0,0,0,0
0,0,0,0,0,0,0,0,0
0,0,0,0,0,0,0,0,0
171977,1263,4,343,195,148,3,1,0
35048,392,4,96,53,43,5,1,0
41517,256,2,46,46,0,8,1,0
62966,916,4,151,142,9,3,1,0
3815,110,1,14,13,1,0,0,0
884498,1501,4,207,175,32,5,1,0
108243,1033,6,281,258,23,13,1,0
8856,127,3,30,30,0,2,1,0
6734,122,2,28,28,0,0,1,0
55205,460,2,55,51,4,0,0,0
0,0,0,0,0,0,0,0,0
229789,1099,5,157,130,27,17,1,0
128446,761,4,142,121,21,17,1,0
107310,1319,7,90,76,14,0,1,0
120817,1181,5,152,152,0,13,1,0
0,0,0,0,0,0,0,0,0
193973,1676,10,390,372,18,15,1,0
0,0,0,0,0,0,0,0,0
0,0,0,0,0,0,0,0,0
337676,3474,6,212,193,19,6,1,0
84371,432,0,17,15,2,0,1,0
0,0,0,0,0,0,0,0,0
535857,1242,17,74,25,49,7,1,0
0,0,0,0,0,0,0,0,0
0,0,0,0,0,0,0,0,0
392043,3542,6,60,55,5,1,1,0
375016,3349,6,50,48,2,1,1,0
0,0,0,0,0,0,0,0,0
151229,531,6,93,21,72,0,1,0
132767,1094,5,239,204,35,2,1,0
0,0,0,0,0,0,0,0,0
0,0,0,0,0,0,0,0,0
0,0,0,0,0,0,0,0,0
0,0,0,0,0,0,0,0,0
34093,314,7,51,51,0,8,1,0
0,0,0,0,0,0,0,0,0
29986,325,8,54,52,2,1,1,0
75311,683,7,208,185,23,0,0,0
0,0,0,0,0,0,0,0,0
0,0,0,0,0,0,0,0,0
749523,2949,9,290,279,11,52,1,0
46379,134,4,7,5,2,0,1,0
0,0,0,0,0,0,0,0,0
0,0,0,0,0,0,0,0,0
0,0,0,0,0,0,0,0,0
94418,999,13,78,57,21,14,1,0
0,0,0,0,0,0,0,0,0
0,0,0,0,0,0,0,0,0
201949,664,4,16,6,10,4,1,0
3331,44,5,2,2,0,0,0,1
316401,46,0,6,4,2,0,0,0
109547,792,5,117,107,10,9,1,1
0,0,0,0,0,0,0,0,0
0,0,0,0,0,0,0,0,0
31549,265,8,14,14,0,4,1,0
82528,352,3,10,5,5,1,0,0
704430,2470,12,238,229,9,102,1,0
0,0,0,0,0,0,0,0,0
190647,1613,9,1195,1173,22,7,1,0
0,0,0,0,0,0,0,0,0
333296,2066,2,324,322,2,1,1,0
6745,96,2,3,3,0,0,1,0
331531,1327,9,167,125,42,13,1,0
199039,1093,6,119,112,7,4,1,0
257616,941,7,84,44,40,13,1,0
136837,581,5,111,108,3,0,1,0
0,0,0,0,0,0,0,0,0
0,0,0,0,0,0,0,0,0
46843,819,2,248,247,1,5,1,0
3288,62,1,4,4,0,0,1,0
573854,2897,11,261,245,16,7,1,0
266471,1120,10,187,174,13,4,1,0
914629,5995,4,845,790,55,0,1,0
0,0,0,0,0,0,0,0,0
0,0,0,0,0,0,0,0,0
498193,2609,7,394,288,106,28,1,0
364848,3682,8,719,665,54,0,1,0
0,0,0,0,0,0,0,0,0
0,0,0,0,0,0,0,0,0
214209,1732,8,72,1,71,1,1,0
107432,1044,4,499,499,0,10,1,0
0,0,0,0,0,0,0,0,0
0,0,0,0,0,0,0,0,0
0,0,0,0,0,0,0,0,0
65683,416,6,75,52,23,6,1,0
24261,51,1,1,1,0,0,0,0
184992,1718,6,440,407,33,1,1,0
195965,1951,4,127,110,17,0,0,0
0,0,0,0,0,0,0,0,0
884987,734,5,167,163,4,4,1,0
93743,500,14,67,56,11,3,1,0
0,0,0,0,0,0,0,0,0
186701,962,11,252,244,8,16,1,0
26480,81,0,3,1,2,5,1,0
403805,1724,8,221,201,20,30,1,0
0,0,0,0,0,0,0,0,0
126099,1650,11,356,344,12,10,1,0
600781,2066,4,209,152,57,8,1,0
0,0,0,0,0,0,0,0,0
252596,2252,12,635,593,42,12,0,0
112070,255,1,10,9,1,5,1,0
155747,1226,14,156,140,16,4,0,0
193516,642,12,113,106,7,13,1,0
97090,753,4,134,133,1,0,0,0
33602,512,2,233,232,1,2,1,0
0,0,0,0,0,0,0,0,0
0,0,0,0,0,0,0,0,0
101641,805,8,48,42,6,0,0,0
0,0,0,0,0,0,0,0,0
0,0,0,0,0,0,0,0,0
305997,809,1,122,97,25,0,1,0
217060,1446,8,247,236,11,5,1,0
0,0,0,0,0,0,0,0,0
24110,328,1,16,16,0,0,1,0
4161,74,2,12,11,1,0,1,0
0,0,0,0,0,0,0,0,0
557091,2285,7,185,178,7,6,1,0
0,0,0,0,0,0,0,0,0
6075,91,2,0,0,0,0,0,0
16979,595,4,221,218,3,5,0,0
0,0,0,0,0,0,0,0,0
0,0,0,0,0,0,0,0,0
8085,125,1,14,6,8,3,1,0
83733,536,9,75,65,10,0,1,0
0,0,0,0,0,0,0,0,0
3834,39,0,5,2,3,0,1,0
0,0,0,0,0,0,0,0,0
0,0,0,0,0,0,0,0,0
210123,1985,6,308,292,16,8,1,0
97677,755,4,130,122,8,7,1,0
0,0,0,0,0,0,0,0,0
53218,408,12,90,87,3,2,1,0
493586,2825,8,697,667,30,46,1,0
335027,2359,8,633,607,26,16,1,0
0,0,0,0,0,0,0,0,0
0,0,0,0,0,0,0,0,0
0,0,0,0,0,0,0,0,0
0,0,0,0,0,0,0,0,0
0,0,0,0,0,0,0,0,0
0,0,0,0,0,0,0,0,0
18828,114,2,19,17,2,3,0,0
45047,376,6,69,66,3,0,1,0
0,0,0,0,0,0,0,0,0
0,0,0,0,0,0,0,0,0
0,0,0,0,0,0,0,0,0
0,0,0,0,0,0,0,0,0
0,0,0,0,0,0,0,0,0
23638,301,2,134,134,0,1,0,0
340971,2835,13,579,504,75,8,1,0
30492,254,5,43,43,0,7,1,0
0,0,0,0,0,0,0,0,0
0,0,0,0,0,0,0,0,0
0,0,0,0,0,0,0,0,0
625951,2563,6,401,377,24,57,1,0
0,0,0,0,0,0,0,0,0
47187,678,4,183,165,18,1,1,0
82519,466,7,146,133,13,0,1,0
71681,329,8,61,52,9,2,1,0
8798,42,0,0,0,0,0,0,0
0,0,0,0,0,0,0,0,0
85494,816,5,103,94,9,5,1,0
0,0,0,0,0,0,0,0,0
282860,1957,11,349,325,24,2,1,0
256680,1888,4,260,256,4,15,1,0
149619,562,4,30,30,0,3,0,0
8608,246,1,16,16,0,0,1,0
98451,1492,5,300,253,47,2,1,0
155457,1025,9,192,36,156,1,1,0
0,0,0,0,0,0,0,0,0
0,0,0,0,0,0,0,0,0
0,0,0,0,0,0,0,0,0
449510,1498,8,307,297,10,5,1,0
205870,1622,11,181,139,42,0,0,0
159622,768,11,153,139,14,2,1,0
0,0,0,0,0,0,0,0,0
103555,1498,8,134,130,4,7,1,0
16725,278,2,51,50,1,2,1,0
0,0,0,0,0,0,0,0,0
87355,653,6,164,163,1,2,1,0
102,4,0,0,0,0,0,0,0
0,0,0,0,0,0,0,0,0
0,0,0,0,0,0,0,0,0
78899,1596,2,777,763,14,0,1,0
150927,814,13,137,122,15,5,1,0
108677,1209,7,165,137,28,3,1,0
19699,118,7,4,4,0,0,1,0
0,0,0,0,0,0,0,0,0
138938,1467,5,427,396,31,3,0,0
13631,99,6,8,5,3,2,1,0
54055,541,2,180,171,9,3,1,0
135023,1966,3,218,190,28,2,0,0
481986,1598,6,253,238,15,0,1,0
0,0,0,0,0,0,0,0,0
373972,2332,10,257,249,8,15,1,0
59426,1093,2,271,262,9,6,0,0
76083,1030,9,307,285,22,14,1,0
0,0,0,0,0,0,0,0,0
176933,2684,8,737,727,10,3,1,0
0,0,0,0,0,0,0,0,0
67136,984,2,215,205,10,1,0,0
0,0,0,0,0,0,0,0,0
0,0,0,0,0,0,0,0,0
1019734,2039,5,300,52,248,10,1,0
130130,1353,5,210,199,11,3,0,0
100319,555,8,74,72,2,2,1,0
135047,985,9,245,203,42,2,1,0
549125,1155,5,68,62,6,4,0,0
228480,1373,10,97,81,16,4,1,0
418724,3865,9,1082,1053,29,6,1,0
782044,9472,2,2071,2001,70,140,1,0
0,0,0,0,0,0,0,0,0
0,0,0,0,0,0,0,0,0
319965,697,9,124,93,31,2,1,0
0,0,0,0,0,0,0,0,0
0,0,0,0,0,0,0,0,0
62495,779,5,157,154,3,0,1,0
0,0,0,0,0,0,0,0,0
0,0,0,0,0,0,0,0,0
12896,178,4,52,49,3,0,0,0
24224,327,1,105,104,1,1,1,0
0,0,0,0,0,0,0,0,0
96628,1205,2,305,241,64,26,0,0
36048,176,1,33,28,5,0,0,0
70125,1935,2,571,571,0,2,1,0
238608,1310,9,216,201,15,1,0,0
393714,2578,9,398,279,119,22,1,0
0,0,0,0,0,0,0,0,0
102135,477,14,38,32,6,3,1,0
622128,1460,13,241,189,52,17,1,0
165785,2669,4,896,889,7,28,1,0
0,0,0,0,0,0,0,0,0
416679,1786,8,112,106,6,30,1,0
711095,4014,5,474,454,20,9,1,0
385079,1544,4,275,266,9,2,1,0
106404,620,9,86,82,4,4,0,0
142608,2476,2,635,629,6,9,1,0
825786,1686,4,178,172,6,2,0,0
585186,948,4,120,114,6,2,0,0
263054,2083,5,161,120,41,0,1,0
0,0,0,0,0,0,0,0,0
179249,932,3,28,18,10,68,1,0
218219,1439,3,338,322,16,8,0,0
1509561,1541,2,257,246,11,1,1,0
392089,120,0,5,5,0,0,1,0
60714,921,4,151,144,7,3,1,0
3815,110,1,14,13,1,0,0,0
0,0,0,0,0,0,0,0,0
0,0,0,0,0,0,0,0,0
0,0,0,0,0,0,0,0,0
64530,425,9,98,76,22,8,1,0
0,0,0,0,0,0,0,0,0
0,0,0,0,0,0,0,0,0
210831,2625,9,420,355,65,6,0,0
432400,695,0,107,96,11,0,1,0
0,0,0,0,0,0,0,0,0
273665,962,5,81,70,11,4,1,0
18664,326,4,101,101,0,0,1,0
160768,187,10,9,9,0,0,0,0
74559,1256,5,219,184,35,8,1,0
0,0,0,0,0,0,0,0,0
0,0,0,0,0,0,0,0,0
375187,1442,7,223,217,6,0,1,0
0,0,0,0,0,0,0,0,0
0,0,0,0,0,0,0,0,0
185363,679,6,28,26,2,31,1,1
0,0,0,0,0,0,0,0,0
382675,1259,8,260,23,237,0,1,0
5563,57,6,3,2,1,0,0,0
148802,815,10,148,117,31,6,1,0
207139,990,12,86,82,4,5,1,0
46507,486,2,175,171,4,8,1,0
0,0,0,0,0,0,0,0,0
0,0,0,0,0,0,0,0,0
334530,1677,6,279,263,16,1,1,0
133051,189,1,3,0,3,0,0,0
0,0,0,0,0,0,0,0,0
189404,1217,5,115,100,15,3,0,0
46173,563,4,102,88,14,5,1,0
7638,65,3,4,3,1,2,0,0
0,0,0,0,0,0,0,0,0
256501,1805,6,340,329,11,31,1,0
157231,1417,6,258,243,15,6,1,0
118800,837,4,103,79,24,1,0,0
180679,779,10,71,66,5,0,1,0
0,0,0,0,0,0,0,0,0
95222,1237,10,272,232,40,9,1,0
0,0,0,0,0,0,0,0,0
134627,620,6,96,73,23,0,1,0
43097,157,5,9,1,8,0,1,0
0,0,0,0,0,0,0,0,0
98034,904,9,231,231,0,0,1,0
984,20,0,0,0,0,0,0,0
194841,913,3,172,106,66,4,1,0
0,0,0,0,0,0,0,0,0
451499,2637,13,532,499,33,1,1,0
204965,903,11,161,147,14,0,1,0
117355,1513,4,357,279,78,14,1,0
191443,1536,3,302,288,14,18,1,0
0,0,0,0,0,0,0,0,0
0,0,0,0,0,0,0,0,0
113133,619,6,79,79,0,0,1,0
145493,401,12,74,68,6,4,1,0
0,0,0,0,0,0,0,0,0
0,0,0,0,0,0,0,0,0
715545,2564,5,180,173,7,23,1,0
110495,1634,8,296,289,7,4,1,0
43772,488,7,121,109,12,10,1,0
397083,1084,3,139,130,9,7,1,0
10164,173,1,37,25,12,1,0,0
0,0,0,0,0,0,0,0,0
135557,892,6,108,93,15,7,0,0
109248,636,6,76,59,17,7,0,0
131749,444,6,60,58,2,0,1,0
0,0,0,0,0,0,0,0,0
130116,858,5,186,156,30,2,1,0
812265,3411,7,518,504,14,12,1,0
23277,134,4,17,16,1,0,1,0
0,0,0,0,0,0,0,0,0
328612,1576,13,106,70,36,3,1,0
27935,50,1,0,0,0,0,0,0
82759,322,7,33,18,15,1,1,0
0,0,0,0,0,0,0,0,0
0,0,0,0,0,0,0,0,0
0,0,0,0,0,0,0,0,0
0,0,0,0,0,0,0,0,0
9074,176,3,53,50,3,1,1,0
0,0,0,0,0,0,0,0,0
313833,2503,7,532,359,173,25,1,0
205550,1392,12,175,146,29,22,1,0
233277,738,0,89,80,9,0,1,0
0,0,0,0,0,0,0,0,0
0,0,0,0,0,0,0,0,0
0,0,0,0,0,0,0,0,0
28065,42,0,2,1,1,0,0,0
249400,1273,6,269,251,18,7,0,0
195413,710,5,158,143,15,5,0,0
77905,825,9,126,126,0,0,1,0
18336,174,9,24,24,0,0,1,0
0,0,0,0,0,0,0,0,0
1359,29,0,2,0,2,0,0,0
0,0,0,0,0,0,0,0,0
782962,5364,5,841,494,347,3,1,0
0,0,0,0,0,0,0,0,0
0,0,0,0,0,0,0,0,0
0,0,0,0,0,0,0,0,0
1303163,15994,9,1196,1184,12,403,1,0
313809,2169,9,384,372,12,3,1,0
0,0,0,0,0,0,0,0,0
1415204,4390,1,556,555,1,1,0,0
1414714,4393,1,556,554,2,1,0,0
0,0,0,0,0,0,0,0,0
32841,343,6,31,3,28,25,0,0
0,0,0,0,0,0,0,0,0
163184,603,5,61,49,12,3,1,0
696111,1936,17,298,288,10,3,1,0
0,0,0,0,0,0,0,0,0
0,0,0,0,0,0,0,0,0
220732,574,4,123,123,0,6,1,0
0,0,0,0,0,0,0,0,0
83130,916,11,187,180,7,2,1,0
26465,206,9,10,10,0,3,0,0
0,0,0,0,0,0,0,0,0
292705,1017,0,59,56,3,0,1,0
0,0,0,0,0,0,0,0,0
122215,590,13,83,79,4,8,0,0
59871,386,3,73,60,13,0,1,0
127424,880,14,179,158,21,3,1,0
43118,673,7,134,130,4,1,1,0
57887,540,11,103,96,7,1,1,0
1753997,5753,9,515,508,7,8,1,0
43956,162,1,33,20,13,6,1,0
0,0,0,0,0,0,0,0,0
627057,5598,9,321,288,33,33,0,0
106351,851,5,131,121,10,1,1,0
0,0,0,0,0,0,0,0,0
0,0,0,0,0,0,0,0,0
31908,335,4,51,34,17,0,0,0
78833,1448,4,289,284,5,0,1,0
0,0,0,0,0,0,0,0,0
234810,1305,4,186,174,12,0,1,0
0,0,0,0,0,0,0,0,0
0,0,0,0,0,0,0,0,0
74775,1245,2,315,284,31,0,1,0
116569,564,4,128,124,4,0,1,0
1034053,1171,8,156,141,15,9,1,0
917000,551,8,95,90,5,10,1,0
0,0,0,0,0,0,0,0,0
0,0,0,0,0,0,0,0,0
0,0,0,0,0,0,0,0,0
7927,85,3,11,9,2,0,1,0
6947,69,4,10,8,2,0,1,0
0,0,0,0,0,0,0,0,0
0,0,0,0,0,0,0,0,0
0,0,0,0,0,0,0,0,0
0,0,0,0,0,0,0,0,0
0,0,0,0,0,0,0,0,0
83689,426,14,96,87,9,4,1,0
22931,412,3,99,73,26,1,1,0
484180,937,9,119,104,15,8,1,0
495478,3107,8,893,883,10,15,1,0
71413,837,6,266,263,3,11,1,0
254145,963,9,121,115,6,9,1,0
56297,491,13,57,54,3,3,0,0
222161,2344,13,349,288,61,68,1,0
357746,3411,10,541,537,4,1,1,0
80614,1011,7,256,252,4,0,1,0
122184,834,5,78,78,0,1,1,0
0,0,0,0,0,0,0,0,0
0,0,0,0,0,0,0,0,0
0,0,0,0,0,0,0,0,0
0,0,0,0,0,0,0,0,0
0,0,0,0,0,0,0,0,0
123287,603,10,92,87,5,2,0,0
0,0,0,0,0,0,0,0,0
0,0,0,0,0,0,0,0,0
753977,3675,14,293,269,24,46,1,0
0,0,0,0,0,0,0,0,0
40720,415,11,40,39,1,4,1,0
0,0,0,0,0,0,0,0,0
26371,376,2,103,57,46,2,1,0
39647,835,1,109,109,0,0,1,0
4046,84,0,16,16,0,3,1,0
156916,1709,10,562,535,27,2,1,0
158661,1050,9,181,114,67,1,0,0
86622,1020,7,256,243,13,12,1,0
1334480,5040,22,166,129,37,15,1,0
17990,35,0,2,1,1,0,1,0
0,0,0,0,0,0,0,0,0
60350,749,8,99,76,23,1,1,0
13349,88,0,23,22,1,0,1,0
84729,963,0,61,33,28,2,1,0
71324,871,4,164,154,10,7,0,0
881854,3093,3,504,497,7,11,1,0
340455,1139,13,190,158,32,7,0,0
131759,637,6,122,110,12,5,1,0
111968,366,8,72,61,11,5,1,0
210992,1466,4,25,22,3,21,0,0
3310,29,1,1,1,0,0,0,0
0,0,0,0,0,0,0,0,0
423799,2270,6,397,355,42,0,1,0
749330,751,4,100,45,55,11,1,0
0,0,0,0,0,0,0,0,0
223586,867,3,111,103,8,34,0,0
173347,572,3,58,50,8,29,0,0
620983,3363,5,90,55,35,6,0,0
0,0,0,0,0,0,0,0,0
330803,781,2,141,70,71,7,1,0
85855,1802,3,373,364,9,2,0,0
19583,213,3,106,103,3,1,0,0
93285,266,3,42,42,0,0,1,0
0,0,0,0,0,0,0,0,0
282536,2225,10,369,358,11,11,1,0
117086,1507,9,300,292,8,4,1,0
71864,662,3,148,147,1,13,1,0
288108,2595,8,401,378,23,4,1,0
25149,180,2,12,5,7,3,0,0
757592,2445,13,249,245,4,36,1,0
284949,1303,12,149,146,3,16,1,0
0,0,0,0,0,0,0,0,0
0,0,0,0,0,0,0,0,0
319089,691,2,9,5,4,0,1,0
434221,872,17,86,8,78,2,1,0
78511,738,12,207,186,21,0,1,0
0,0,0,0,0,0,0,0,0
402425,2685,6,710,700,10,14,1,0
403289,746,11,138,113,25,4,1,0
18385,310,3,102,102,0,0,1,0
46000,489,11,80,72,8,5,0,0
0,0,0,0,0,0,0,0,0
0,0,0,0,0,0,0,0,0
223991,2280,6,343,333,10,5,1,1
117831,2029,1,336,336,0,4,1,0
112074,460,10,75,67,8,5,1,0
254978,756,3,44,22,22,19,1,0
17697,85,7,3,3,0,0,0,0
36812,487,5,39,36,3,2,1,0
22747,273,5,50,9,41,7,1,0
284302,1662,7,449,440,9,6,1,0
246180,1388,5,392,380,12,7,1,0
101067,1427,3,455,445,10,3,1,0
57458,480,13,91,59,32,2,1,0
182178,2229,10,454,409,45,5,1,0
150690,1895,10,385,372,13,5,1,0
15545,314,6,11,11,0,0,0,0
56674,232,6,12,2,10,0,1,0
42803,523,3,133,101,32,1,1,1
68406,1441,2,116,116,0,0,1,0
268663,2189,3,354,327,27,0,1,0
0,0,0,0,0,0,0,0,0
146408,1715,5,316,309,7,0,1,0
43517,547,5,111,104,7,0,1,0
203203,1457,5,293,254,39,5,1,0
0,0,0,0,0,0,0,0,0
80504,919,12,190,190,0,1,1,0
30992,303,9,54,54,0,0,1,0
306646,2026,14,383,375,8,4,1,0
38057,464,3,78,72,6,0,0,0
1255180,1990,4,746,731,15,3,0,0
95931,1726,3,735,726,9,1,0,0
131957,2086,9,366,108,258,9,0,0
18416,293,7,27,11,16,6,1,0
174847,1290,5,210,200,10,32,1,0
22017,33,0,1,1,0,0,1,0
0,0,0,0,0,0,0,0,0
170273,1015,4,104,97,7,8,1,0
33831,438,3,72,57,15,1,1,0
623671,3741,7,505,491,14,1,1,0
308659,2563,3,527,520,7,23,0,0
51651,478,0,137,137,0,0,1,0
0,0,0,0,0,0,0,0,0
3283261,3006,6,158,144,14,1,1,0
2748051,96,4,4,4,0,1,1,0
22141,35,0,1,1,0,0,1,0
101798,442,6,81,73,8,7,0,0
33665,140,4,11,6,5,0,0,0
65506,426,5,103,3,100,3,1,0
192303,1091,12,228,214,14,9,1,0
189632,1505,10,92,72,20,31,1,0
330644,4868,2,322,286,36,28,0,0
0,0,0,0,0,0,0,0,0
5507,57,4,2,1,1,0,0,0
0,0,0,0,0,0,0,0,0
0,0,0,0,0,0,0,0,0
415127,2002,14,291,283,8,5,1,0
415162,2002,14,291,283,8,5,1,0
230794,1808,4,226,190,36,14,1,0
621516,2546,9,208,200,8,21,1,0
238909,857,16,56,44,12,1,1,0
0,0,0,0,0,0,0,0,0
369965,2842,5,246,225,21,35,1,0
8070,90,2,12,9,3,0,0,0
77243,1045,10,287,267,20,0,1,0
28444,42,0,2,1,1,0,0,0
0,0,0,0,0,0,0,0,0
88687,958,13,191,181,10,2,0,0
0,0,0,0,0,0,0,0,0
439721,1230,7,86,14,72,2,1,0
0,0,0,0,0,0,0,0,0
6411,138,2,31,28,3,0,1,0
0,0,0,0,0,0,0,0,0
97125,436,4,67,1,66,0,1,0
1632855,14109,5,159,149,10,3,1,0
559864,1562,7,221,175,46,2,1,1
7023,36,0,5,0,5,0,1,0
0,0,0,0,0,0,0,0,0
0,0,0,0,0,0,0,0,0
0,0,0,0,0,0,0,0,0
187373,608,11,90,31,59,16,1,0
61854,31,1,4,0,4,0,0,0
12002,96,2,9,2,7,0,1,0
10280,91,2,9,3,6,0,1,0
0,0,0,0,0,0,0,0,0
0,0,0,0,0,0,0,0,0
0,0,0,0,0,0,0,0,0
0,0,0,0,0,0,0,0,0
0,0,0,0,0,0,0,0,0
139015,643,9,42,39,3,26,1,0
82051,676,6,114,108,6,3,1,0
88952,864,1,229,223,6,7,0,0
107317,1736,4,756,739,17,17,0,0
0,0,0,0,0,0,0,0,0
170621,1529,16,372,368,4,6,1,0
0,0,0,0,0,0,0,0,0
0,0,0,0,0,0,0,0,0
143909,2875,5,1225,1202,23,3,1,0
0,0,0,0,0,0,0,0,0
81509,1049,3,185,177,8,6,1,0
0,0,0,0,0,0,0,0,0
0,0,0,0,0,0,0,0,0
0,0,0,0,0,0,0,0,0
0,0,0,0,0,0,0,0,0
284218,4264,6,1095,1006,89,26,1,0
40361,428,6,100,91,9,5,1,0
0,0,0,0,0,0,0,0,0
0,0,0,0,0,0,0,0,0
0,0,0,0,0,0,0,0,0
0,0,0,0,0,0,0,0,0
39402,298,1,89,89,0,6,1,0
0,0,0,0,0,0,0,0,0
77444,674,9,108,103,5,5,1,0
50306,225,7,25,15,10,4,1,0
63417,67,2,1,1,0,1,0,0
0,0,0,0,0,0,0,0,0
0,0,0,0,0,0,0,0,0
0,0,0,0,0,0,0,0,0
19818,136,2,26,25,1,12,1,0
0,0,0,0,0,0,0,0,0
0,0,0,0,0,0,0,0,0
22000,33,0,1,1,0,0,1,0
0,0,0,0,0,0,0,0,0
84995,1129,1,73,62,11,1,0,0
0,0,0,0,0,0,0,0,0
0,0,0,0,0,0,0,0,0
302152,1640,15,286,243,43,30,1,0
239857,1875,7,331,298,33,10,1,0
252764,2730,12,648,627,21,23,1,0
88864,1317,6,199,179,20,14,1,0
13690,98,3,7,7,0,0,0,0
57681,734,3,126,125,1,0,0,0
18666,117,3,3,3,0,0,1,0
73338,837,7,140,123,17,5,1,0
50878,672,2,173,171,2,4,1,0
0,0,0,0,0,0,0,0,0
0,0,0,0,0,0,0,0,0
0,0,0,0,0,0,0,0,0
0,0,0,0,0,0,0,0,0
216885,1383,6,320,302,18,4,0,0
8651,68,5,3,3,0,0,1,0
0,0,0,0,0,0,0,0,0
14882,233,5,23,21,2,0,1,0
119638,654,9,122,116,6,21,1,0
126570,679,10,66,42,24,1,1,0
70788,1153,7,482,473,9,6,1,0
105553,881,9,134,129,5,0,1,0
0,0,0,0,0,0,0,0,0
0,0,0,0,0,0,0,0,0
0,0,0,0,0,0,0,0,0
3925,46,4,5,4,1,0,0,0
186740,1634,12,188,186,2,22,1,0
117943,1200,0,296,267,29,0,0,0
0,0,0,0,0,0,0,0,0
67849,945,8,180,172,8,3,0,0
0,0,0,0,0,0,0,0,0
41401,133,4,16,15,1,6,0,0
7712,85,0,23,23,0,0,1,0
44034,384,7,55,19,36,0,1,0
138028,962,7,193,190,3,24,1,0
0,0,0,0,0,0,0,0,0
0,0,0,0,0,0,0,0,0
0,0,0,0,0,0,0,0,0
346858,1668,12,441,417,24,19,0,0
303555,1819,9,230,224,6,16,1,0
0,0,0,0,0,0,0,0,0
39364,357,10,63,59,4,0,1,0
0,0,0,0,0,0,0,0,0
81763,692,5,57,55,2,2,1,0
192588,417,10,43,39,4,8,1,0
0,0,0,0,0,0,0,0,0
0,0,0,0,0,0,0,0,0
114286,722,5,96,93,3,2,1,0
28119,42,0,2,1,1,0,0,0
0,0,0,0,0,0,0,0,0
26504,311,1,35,35,0,0,0,0
0,0,0,0,0,0,0,0,0
267083,1459,13,203,202,1,26,1,0
0,0,0,0,0,0,0,0,0
0,0,0,0,0,0,0,0,0
558275,5218,15,1019,965,54,137,1,0
400578,4510,15,955,912,43,22,1,0
0,0,0,0,0,0,0,0,0
184858,891,7,137,93,44,16,1,1
0,0,0,0,0,0,0,0,0
0,0,0,0,0,0,0,0,0
0,0,0,0,0,0,0,0,0
139025,1543,2,141,132,9,16,1,0
174647,1736,5,422,387,35,0,0,0
29609,134,5,10,8,2,0,0,0
27795,271,7,57,54,3,2,1,0
0,0,0,0,0,0,0,0,0
0,0,0,0,0,0,0,0,0
33553,408,3,94,72,22,16,0,0
0,0,0,0,0,0,0,0,0
217109,1996,4,267,252,15,5,1,0
573951,2211,0,474,10,464,0,0,0
21889,104,9,10,7,3,2,0,0
0,0,0,0,0,0,0,0,0
0,0,0,0,0,0,0,0,0
47550,857,4,173,170,3,10,1,0
7676,52,0,6,1,5,0,0,0
232069,1895,8,317,46,271,0,1,0
27897,42,0,2,1,1,0,0,0
186507,3142,5,1058,1057,1,1,1,0
29984,553,5,168,167,1,1,1,0
706831,4967,5,465,456,9,28,0,0
0,0,0,0,0,0,0,0,0
307172,1832,6,356,287,69,8,1,0
0,0,0,0,0,0,0,0,0
40255,286,6,54,0,54,0,0,0
0,0,0,0,0,0,0,0,0
92423,869,10,158,150,8,8,1,0
0,0,0,0,0,0,0,0,0
379872,1908,13,347,308,39,3,1,0
315858,1307,13,221,207,14,1,1,0
40352,242,5,25,24,1,8,0,0
0,0,0,0,0,0,0,0,0
0,0,0,0,0,0,0,0,0
92688,698,6,116,91,25,3,1,0
0,0,0,0,0,0,0,0,0
0,0,0,0,0,0,0,0,0
355802,2325,5,120,113,7,3,1,0
0,0,0,0,0,0,0,0,0
120746,933,4,123,51,72,1,0,0
80091,774,2,91,79,12,19,1,0
39443,322,2,80,71,9,10,1,0
0,0,0,0,0,0,0,0,0
0,0,0,0,0,0,0,0,0
0,0,0,0,0,0,0,0,0
0,0,0,0,0,0,0,0,0
0,0,0,0,0,0,0,0,0
108714,687,8,208,177,31,0,1,0
155665,1387,9,305,289,16,6,1,0
0,0,0,0,0,0,0,0,0
163876,1233,7,343,331,12,8,1,0
12631,73,1,4,3,1,0,0,0
29842,290,3,22,22,0,3,1,0
5271,77,2,13,13,0,0,1,0
0,0,0,0,0,0,0,0,0
47863,438,9,73,70,3,1,1,0
264479,2438,10,293,239,54,5,1,0
0,0,0,0,0,0,0,0,0
609904,2537,16,316,9,307,5,1,0
0,0,0,0,0,0,0,0,0
272183,2108,9,452,446,6,4,1,0
0,0,0,0,0,0,0,0,0
27571,174,8,4,4,0,1,0,0
0,0,0,0,0,0,0,0,0
0,0,0,0,0,0,0,0,0
0,0,0,0,0,0,0,0,0
128203,529,7,137,58,79,1,0,1
0,0,0,0,0,0,0,0,0
1636,11,0,1,1,0,0,0,0
0,0,0,0,0,0,0,0,0
234977,1802,11,509,508,1,15,1,0
37033,341,7,50,50,0,8,1,0
81694,902,8,86,74,12,3,1,0
0,0,0,0,0,0,0,0,0
0,0,0,0,0,0,0,0,0
0,0,0,0,0,0,0,0,0
152301,2617,1,570,560,10,0,0,0
0,0,0,0,0,0,0,0,0
452564,1525,9,316,299,17,4,1,0
89409,1159,3,95,68,27,0,1,0
129858,738,15,123,109,14,1,0,0
0,0,0,0,0,0,0,0,0
121068,1075,3,210,209,1,0,1,0
0,0,0,0,0,0,0,0,0
0,0,0,0,0,0,0,0,0
209646,1120,9,72,58,14,12,1,0
301745,1075,6,179,3,176,6,1,0
0,0,0,0,0,0,0,0,0
0,0,0,0,0,0,0,0,0
0,0,0,0,0,0,0,0,0
824184,79,9,8,8,0,0,1,0
0,0,0,0,0,0,0,0,0
0,0,0,0,0,0,0,0,0
0,0,0,0,0,0,0,0,0
0,0,0,0,0,0,0,0,0
24132,474,3,34,34,0,0,1,0
162105,942,8,258,257,1,0,1,0
131998,1366,2,263,253,10,2,1,0
45664,485,2,117,105,12,2,1,0
65541,533,7,14,12,2,0,1,0
3399,48,0,3,3,0,0,0,0
19921,105,4,14,0,14,0,1,0
0,0,0,0,0,0,0,0,0
0,0,0,0,0,0,0,0,0
80590,844,4,258,258,0,5,0,0
0,0,0,0,0,0,0,0,0
396984,4247,8,421,334,87,11,1,0
85908,554,6,135,134,1,2,0,0
369675,940,1,159,92,67,7,1,0
80425,108,1,10,7,3,2,0,0
0,0,0,0,0,0,0,0,0
0,0,0,0,0,0,0,0,0
65485,1425,2,358,348,10,1,1,0
34690,430,0,0,0,0,1,1,0
0,0,0,0,0,0,0,0,0
44217,511,4,45,27,18,0,1,0
7802,120,6,22,17,5,1,1,0
0,0,0,0,0,0,0,0,0
39047,352,3,48,45,3,13,1,0
23692,265,2,66,60,6,3,1,0
12695,174,2,30,27,3,3,1,0
35774,438,3,71,63,8,0,1,0
165415,2299,10,217,182,35,15,0,0
0,0,0,0,0,0,0,0,0
468118,1276,6,109,102,7,3,1,0
0,0,0,0,0,0,0,0,0
0,0,0,0,0,0,0,0,0
0,0,0,0,0,0,0,0,0
645415,4711,14,161,66,95,4,1,0
22869,37,0,2,1,1,0,1,0
0,0,0,0,0,0,0,0,0
0,0,0,0,0,0,0,0,0
325601,1567,7,199,188,11,5,1,0
229113,1306,7,158,147,11,4,1,0
601062,7263,5,427,289,138,48,1,0
522498,1554,7,166,157,9,20,1,0
0,0,0,0,0,0,0,0,0
0,0,0,0,0,0,0,0,0
420,6,0,0,0,0,0,0,0
171921,1047,8,200,190,10,2,1,0
75196,105,2,5,1,4,2,1,0
44989,151,6,11,9,2,0,1,0
653020,3865,6,252,233,19,57,0,0
0,0,0,0,0,0,0,0,0
105922,994,4,178,173,5,15,1,0
290346,1797,11,151,128,23,63,1,0
2898,44,1,2,2,0,0,0,0
88932,835,8,184,181,3,2,0,0
0,0,0,0,0,0,0,0,0
0,0,0,0,0,0,0,0,0
57794,494,1,77,68,9,1,1,0
203108,1338,10,54,47,7,8,1,0
80410,390,9,33,28,5,8,1,0
0,0,0,0,0,0,0,0,0
113336,719,6,101,50,51,9,1,0
353592,572,9,146,112,34,5,1,0
0,0,0,0,0,0,0,0,0
0,0,0,0,0,0,0,0,0
329543,2130,4,195,159,36,5,1,0
81212,522,7,4,4,0,5,0,0
272170,1378,15,72,63,9,3,1,0
108827,910,5,191,177,14,3,0,0
0,0,0,0,0,0,0,0,0
191895,1400,8,160,157,3,13,1,0
121524,1380,5,249,239,10,0,1,0
88114,829,5,161,159,2,0,1,0
0,0,0,0,0,0,0,0,0
0,0,0,0,0,0,0,0,0
78516,828,7,125,110,15,1,1,0
0,0,0,0,0,0,0,0,0
0,0,0,0,0,0,0,0,0
460553,2291,3,282,274,8,2,1,0
0,0,0,0,0,0,0,0,0
0,0,0,0,0,0,0,0,0
4111,60,4,5,3,2,0,0,0
183698,520,9,62,58,4,9,1,0
17447,98,7,7,6,1,0,0,0
0,0,0,0,0,0,0,0,0
148474,2257,4,1382,410,972,5,1,0
62536,633,5,23,15,8,0,1,0
0,0,0,0,0,0,0,0,0
59552,589,5,65,44,21,6,0,0
69612,381,2,2,2,0,0,0,0
56031,367,2,117,114,3,3,1,0
44611,167,2,44,41,3,7,1,0
0,0,0,0,0,0,0,0,0
0,0,0,0,0,0,0,0,0
0,0,0,0,0,0,0,0,0
0,0,0,0,0,0,0,0,0
0,0,0,0,0,0,0,0,0
0,0,0,0,0,0,0,0,0
52887,679,7,153,130,23,7,1,0
31037,204,3,8,8,0,0,0,0
63414,488,6,111,103,8,0,0,0
11267,101,6,5,5,0,0,0,0
0,0,0,0,0,0,0,0,0
0,0,0,0,0,0,0,0,0
0,0,0,0,0,0,0,0,0
0,0,0,0,0,0,0,0,0
97414,838,9,67,66,1,7,1,0
0,0,0,0,0,0,0,0,0
203531,1178,9,214,206,8,1,1,0
203572,1178,9,214,206,8,1,1,0
65378,1270,4,151,132,19,8,1,0
0,0,0,0,0,0,0,0,0
107139,599,3,118,118,0,10,0,0
86065,267,3,40,40,0,9,0,0
412595,3602,11,560,465,95,66,1,0
26644,387,3,61,57,4,5,0,0
21671,344,7,28,26,2,0,1,0
0,0,0,0,0,0,0,0,0
0,0,0,0,0,0,0,0,0
0,0,0,0,0,0,0,0,0
114228,1571,9,197,136,61,0,1,0
0,0,0,0,0,0,0,0,0
0,0,0,0,0,0,0,0,0
0,0,0,0,0,0,0,0,0
0,0,0,0,0,0,0,0,0
0,0,0,0,0,0,0,0,0
177673,1469,7,308,304,4,9,1,0
0,0,0,0,0,0,0,0,0
141535,425,9,79,56,23,0,1,0
422169,200,0,0,0,0,1,1,0
272989,189,0,0,0,0,1,1,0
132746,611,6,92,91,1,0,1,0
0,0,0,0,0,0,0,0,0
0,0,0,0,0,0,0,0,0
71826,575,8,135,135,0,3,1,0
285197,478,5,81,65,16,0,1,0
0,0,0,0,0,0,0,0,0
0,0,0,0,0,0,0,0,0
171141,914,11,109,87,22,5,0,0
165905,2305,7,704,693,11,5,1,0
110245,1687,7,505,494,11,5,1,0
269231,2926,7,643,637,6,2,1,1
135988,1108,9,238,232,6,3,1,0
27992,42,0,2,1,1,0,0,0
0,0,0,0,0,0,0,0,0
0,0,0,0,0,0,0,0,0
0,0,0,0,0,0,0,0,0
24058,128,0,22,6,16,0,0,0
69540,1928,2,568,568,0,2,1,0
651278,3519,7,218,190,28,2,1,0
371017,898,4,246,236,10,1,1,0
407028,1893,6,193,176,17,30,1,0
247037,702,11,53,38,15,8,1,0
206615,2700,3,317,315,2,2,1,0
60048,507,3,80,78,2,3,1,0
0,0,0,0,0,0,0,0,0
19162,256,1,55,39,16,0,0,0
107452,767,8,66,58,8,1,1,0
0,0,0,0,0,0,0,0,0
160614,832,10,119,105,14,4,1,0
61395,656,4,98,93,5,9,1,0
209529,1450,13,230,214,16,10,1,0
0,0,0,0,0,0,0,0,0
13156,191,3,43,42,1,2,0,0
342317,518,1,53,52,1,0,0,0
32381,321,5,46,38,8,3,1,0
0,0,0,0,0,0,0,0,0
0,0,0,0,0,0,0,0,0
586320,3847,11,339,315,24,15,1,0
12973,193,1,21,10,11,0,0,0
0,0,0,0,0,0,0,0,0
0,0,0,0,0,0,0,0,0
0,0,0,0,0,0,0,0,0
0,0,0,0,0,0,0,0,0
0,0,0,0,0,0,0,0,0
62994,589,1,80,51,29,8,1,0
25643,313,1,66,60,6,5,1,0
267189,1351,8,278,205,73,8,0,0
368140,1858,9,294,287,7,2,1,0
0,0,0,0,0,0,0,0,0
0,0,0,0,0,0,0,0,0
27876,42,0,2,1,1,0,0,0
40500,614,4,174,169,5,1,1,0
37953,417,1,63,63,0,6,1,0
0,0,0,0,0,0,0,0,0
143991,312,3,34,28,6,1,1,0
765057,333,1,40,24,16,1,1,0
13570,243,2,55,43,12,5,0,0
22896,37,0,2,1,1,0,1,0
106278,1000,1,81,80,1,0,1,0
110752,414,8,179,170,9,1,0,0
114495,376,7,181,173,8,4,0,0
97018,909,1,66,48,18,0,0,0
537728,1677,1,268,257,11,2,1,0
133785,1293,4,240,154,86,1,1,0
227063,866,9,81,10,71,9,1,0
420355,1406,7,218,209,9,9,1,0
0,0,0,0,0,0,0,0,0
39979,563,2,112,109,3,4,0,0
22215,340,2,87,84,3,1,0,0
0,0,0,0,0,0,0,0,0
257691,1455,9,267,251,16,7,0,0
221200,1082,9,235,225,10,2,0,0
27717,150,7,15,10,5,1,1,0
29176,144,7,14,9,5,1,1,0
76907,505,8,46,44,2,2,0,0
392680,1087,9,27,27,0,25,1,0
0,0,0,0,0,0,0,0,0
0,0,0,0,0,0,0,0,0
0,0,0,0,0,0,0,0,0
273489,553,10,91,88,3,12,1,0
0,0,0,0,0,0,0,0,0
0,0,0,0,0,0,0,0,0
0,0,0,0,0,0,0,0,0
0,0,0,0,0,0,0,0,0
173779,1185,10,174,165,9,25,1,0
260045,4266,1,1580,1512,68,3,1,0
19484,152,1,26,26,0,2,1,0
77637,254,3,36,16,20,0,1,0
35552,118,6,12,10,2,0,0,0
0,0,0,0,0,0,0,0,0
29287,203,2,37,9,28,0,1,0
0,0,0,0,0,0,0,0,0
30135,544,3,112,105,7,1,1,0
139924,998,3,227,49,178,1,0,0
8350,186,1,25,24,1,2,1,0
0,0,0,0,0,0,0,0,0
0,0,0,0,0,0,0,0,0
0,0,0,0,0,0,0,0,0
93494,706,3,106,94,12,12,1,0
40712,413,5,39,39,0,3,0,0
124302,2585,4,298,297,1,0,1,0
0,0,0,0,0,0,0,0,0
0,0,0,0,0,0,0,0,0
0,0,0,0,0,0,0,0,0
119895,720,7,106,101,5,7,0,0
117426,978,12,203,181,22,13,1,0
5948,145,1,7,7,0,0,0,0
0,0,0,0,0,0,0,0,0
0,0,0,0,0,0,0,0,0
0,0,0,0,0,0,0,0,0
1101850,580,8,49,38,11,2,1,0
12766,88,5,6,4,2,0,1,0
288544,3754,3,282,263,19,10,0,0
123820,785,7,160,99,61,7,1,0
150048,958,11,263,254,9,13,1,0
0,0,0,0,0,0,0,0,0
220151,1591,11,232,211,21,2,1,0
269939,3682,1,1028,901,127,129,1,0
44759,623,3,94,87,7,10,1,0
997230,1666,8,357,305,52,23,1,0
892269,243,8,13,10,3,5,1,0
142235,1913,4,459,435,24,6,1,0
42822,953,2,355,336,19,0,1,0
771608,6209,6,1295,1251,44,6,0,0
12100,61,3,0,0,0,0,0,0
354457,2050,7,156,143,13,9,1,0
110821,789,5,115,115,0,0,1,0
108479,1325,6,369,356,13,8,1,0
163145,919,14,64,60,4,3,0,0
585,5,0,0,0,0,0,0,1
0,0,0,0,0,0,0,0,0
113994,682,7,156,153,3,5,1,0
0,0,0,0,0,0,0,0,0
208400,560,4,51,51,0,2,1,0
67605,884,4,139,114,25,19,1,0
67261,739,5,34,15,19,0,1,0
134955,694,3,173,96,77,7,1,0
301369,1906,6,454,446,8,3,1,0
222354,1342,6,193,181,12,5,1,0
160003,791,5,138,133,5,5,1,0
61040,854,4,202,194,8,1,1,0
163457,1409,2,208,205,3,19,1,0
0,0,0,0,0,0,0,0,0
0,0,0,0,0,0,0,0,0
211376,2687,10,492,474,18,3,1,0
0,0,0,0,0,0,0,0,0
0,0,0,0,0,0,0,0,0
235558,1487,4,115,101,14,0,1,0
578196,64,4,0,0,0,1,1,0
0,0,0,0,0,0,0,0,0
72749,341,4,51,44,7,0,1,0
201700,100,2,6,6,0,0,1,0
1408450,693,10,93,63,30,7,1,0
148260,943,8,104,103,1,2,1,0
0,0,0,0,0,0,0,0,0
0,0,0,0,0,0,0,0,0
0,0,0,0,0,0,0,0,0
50803,722,0,69,48,21,0,1,0
0,0,0,0,0,0,0,0,0
1223918,12350,14,296,277,19,7,0,0
387560,906,4,149,93,56,9,1,0
79980,108,1,10,7,3,2,0,0
0,0,0,0,0,0,0,0,0
0,0,0,0,0,0,0,0,0
13905,211,3,15,13,2,0,1,0
0,0,0,0,0,0,0,0,0
278331,1578,4,81,70,11,2,1,0
429398,1417,9,123,116,7,1,1,0
0,0,0,0,0,0,0,0,0
0,0,0,0,0,0,0,0,0
0,0,0,0,0,0,0,0,0
0,0,0,0,0,0,0,0,0
0,0,0,0,0,0,0,0,0
0,0,0,0,0,0,0,0,0
0,0,0,0,0,0,0,0,0
53714,488,9,109,106,3,0,1,0
128126,2157,4,602,602,0,1,1,0
80991,1245,4,296,296,0,1,1,0
45770,796,4,178,178,0,0,1,0
266177,1051,25,135,120,15,8,1,0
202496,504,9,99,93,6,7,1,0
0,0,0,0,0,0,0,0,0
88838,64,0,8,3,5,6,0,0
20318,133,1,15,14,1,6,0,0
71939,572,16,84,51,33,1,1,0
0,0,0,0,0,0,0,0,0
0,0,0,0,0,0,0,0,0
0,0,0,0,0,0,0,0,0
321087,2243,4,176,172,4,0,1,0
207698,1037,1,153,148,5,0,1,0
102346,1262,5,163,155,8,3,1,0
0,0,0,0,0,0,0,0,0
0,0,0,0,0,0,0,0,0
11747,117,4,16,16,0,1,0,0
154893,1802,7,316,273,43,4,1,0
0,0,0,0,0,0,0,0,0
267852,916,5,90,53,37,8,1,0
0,0,0,0,0,0,0,0,0
30373,448,4,121,117,4,0,1,0
9418,81,2,7,6,1,0,1,0
0,0,0,0,0,0,0,0,0
0,0,0,0,0,0,0,0,0
218247,870,2,84,50,34,1,1,0
0,0,0,0,0,0,0,0,0
5152,125,1,13,11,2,0,1,0
712068,2431,10,261,248,13,22,1,0
66023,768,7,139,117,22,0,1,0
241101,996,18,167,151,16,12,1,0
45310,350,6,64,27,37,3,1,0
87011,912,6,130,119,11,3,1,0
249036,2758,6,615,550,65,28,1,0
5397,90,1,17,15,2,0,1,0
47041,643,1,105,99,6,0,1,0
0,0,0,0,0,0,0,0,0
40680,486,3,86,53,33,0,1,0
206430,424,5,32,10,22,0,1,0
0,0,0,0,0,0,0,0,0
44781,385,7,55,19,36,0,1,0
108609,482,7,77,72,5,1,1,0
35859,532,4,163,154,9,18,1,0
0,0,0,0,0,0,0,0,0
9276,147,1,24,22,2,0,0,0
0,0,0,0,0,0,0,0,0
214382,1632,6,619,615,4,8,1,0
513142,1022,9,191,186,5,3,1,0
0,0,0,0,0,0,0,0,0
141876,1329,5,200,27,173,1,1,0
31683,192,7,9,7,2,4,1,0
20325,393,2,155,155,0,0,0,0
716594,2380,6,489,455,34,18,1,0
309344,532,6,85,69,16,13,1,0
0,0,0,0,0,0,0,0,0
48039,277,4,5,5,0,2,0,0
205517,1571,4,200,197,3,0,1,0
0,0,0,0,0,0,0,0,0
0,0,0,0,0,0,0,0,0
60966,457,3,102,97,5,7,1,0
25455,317,2,60,59,1,9,1,0
197822,1888,10,287,209,78,12,1,0
0,0,0,0,0,0,0,0,0
370327,941,1,158,109,49,7,1,0
80594,112,1,10,5,5,2,0,0
108011,259,3,24,24,0,0,0,0
0,0,0,0,0,0,0,0,0
0,0,0,0,0,0,0,0,0
0,0,0,0,0,0,0,0,0
0,0,0,0,0,0,0,0,0
196134,203,5,12,11,1,2,1,1
1090781,2426,8,285,114,171,38,1,0
0,0,0,0,0,0,0,0,0
259490,385,6,10,6,4,0,1,0
217320,2306,11,120,106,14,0,0,0
37063,641,4,130,130,0,0,1,0
0,0,0,0,0,0,0,0,0
633175,4634,10,188,178,10,14,1,0
351618,1082,6,59,33,26,0,0,0
321153,1312,9,120,108,12,32,1,0
8905,104,4,9,6,3,1,1,0
0,0,0,0,0,0,0,0,0
0,0,0,0,0,0,0,0,0
462383,2751,13,437,390,47,4,0,0
22697,337,5,36,24,12,11,1,0
195128,1508,0,438,422,16,10,1,0
68550,883,2,172,3,169,1,1,0
63799,836,2,172,149,23,1,1,0
0,0,0,0,0,0,0,0,0
31079,391,10,27,26,1,1,1,0
2511,41,4,2,2,0,0,0,0
60555,587,9,120,111,9,3,1,0
43269,568,3,122,120,2,4,1,0
0,0,0,0,0,0,0,0,0
115822,1839,8,113,111,2,4,1,0
1722,26,0,0,0,0,0,0,0
0,0,0,0,0,0,0,0,0
212401,1945,7,143,134,9,41,1,0
44233,414,5,7,4,3,10,1,0
0,0,0,0,0,0,0,0,0
0,0,0,0,0,0,0,0,0
403773,2136,10,285,273,12,17,1,0
406001,2140,10,285,273,12,17,1,0
553481,569,10,82,57,25,11,1,0
0,0,0,0,0,0,0,0,0
23646,447,4,32,23,9,2,1,0
14317,19,0,0,0,0,0,0,0
47112,410,4,60,24,36,1,0,0
574735,2143,3,151,108,43,3,1,0
147778,2205,7,321,311,10,47,1,0
0,0,0,0,0,0,0,0,0
0,0,0,0,0,0,0,0,0
12860,103,3,22,21,1,1,1,0
0,0,0,0,0,0,0,0,0
184595,952,6,80,59,21,5,1,0
67787,854,5,163,153,10,2,0,0
18920,53,1,1,1,0,1,0,0
0,0,0,0,0,0,0,0,0
266007,2208,4,310,277,33,11,1,0
0,0,0,0,0,0,0,0,0
276097,2015,13,56,53,3,4,1,0
17700,119,7,8,8,0,4,1,0
183412,785,10,169,152,17,10,1,0
0,0,0,0,0,0,0,0,0
6034,40,0,3,1,2,0,1,0
2978,40,2,2,2,0,0,1,0
0,0,0,0,0,0,0,0,0
103968,1330,6,352,340,12,2,0,0
166923,1641,3,281,266,15,8,1,0
34154,402,3,53,43,10,5,1,0
0,0,0,0,0,0,0,0,0
0,0,0,0,0,0,0,0,0
0,0,0,0,0,0,0,0,0
0,0,0,0,0,0,0,0,0
0,0,0,0,0,0,0,0,0
31882,214,2,27,18,9,13,1,1
21867,204,2,13,10,3,4,1,1
0,0,0,0,0,0,0,0,0
3695,73,1,13,10,3,0,0,0
251973,2662,2,540,524,16,1,1,0
955071,3724,12,488,442,46,57,1,0
104121,600,10,109,83,26,3,1,0
110587,718,10,121,98,23,2,1,0
779805,6085,18,290,276,14,31,1,0
13293,89,1,9,5,4,0,1,0
0,0,0,0,0,0,0,0,0
0,0,0,0,0,0,0,0,0
0,0,0,0,0,0,0,0,0
442146,3518,8,813,713,100,7,1,0
13090,202,3,37,27,10,3,1,0
0,0,0,0,0,0,0,0,0
92032,737,8,205,205,0,8,1,0
0,0,0,0,0,0,0,0,0
153614,2276,1,294,284,10,1,1,0
42577,419,0,58,50,8,1,1,0
0,0,0,0,0,0,0,0,0
0,0,0,0,0,0,0,0,0
0,0,0,0,0,0,0,0,0
603079,2509,4,634,629,5,3,1,0
358631,810,0,78,71,7,2,1,0
42351,588,8,91,83,8,4,1,0
0,0,0,0,0,0,0,0,0
0,0,0,0,0,0,0,0,0
66303,1043,1,185,176,9,1,1,0
455055,3034,3,95,79,16,2,1,0
40816,401,3,69,61,8,3,1,0
38628,855,2,157,156,1,2,0,0
0,0,0,0,0,0,0,0,0
305729,824,2,107,107,0,5,1,0
83648,763,2,199,134,65,1,0,0
27832,69,3,3,3,0,1,1,0
0,0,0,0,0,0,0,0,0
190707,1435,10,250,213,37,7,1,0
131344,1042,7,73,65,8,5,1,0
31802,114,1,4,4,0,0,0,0
0,0,0,0,0,0,0,0,0
0,0,0,0,0,0,0,0,0
217519,689,14,71,48,23,7,0,0
1077895,1758,4,162,126,36,1,1,0
128411,961,12,181,177,4,11,1,0
44304,180,0,2,0,2,0,0,0
0,0,0,0,0,0,0,0,0
0,0,0,0,0,0,0,0,0
41085,939,1,30,20,10,0,1,0
5414,98,1,19,17,2,3,1,0
2332806,1096,17,117,105,12,23,1,0
0,0,0,0,0,0,0,0,0
0,0,0,0,0,0,0,0,0
0,0,0,0,0,0,0,0,0
165526,645,3,49,46,3,2,0,0
89171,741,5,265,252,13,6,1,0
0,0,0,0,0,0,0,0,0
86106,235,5,2,1,1,0,0,0
182171,1550,4,280,269,11,0,0,0
117372,549,8,101,100,1,3,1,0
0,0,0,0,0,0,0,0,0
28133,39,0,2,1,1,0,0,0
0,0,0,0,0,0,0,0,0
107186,1405,8,287,285,2,19,1,0
1303411,200,7,22,20,2,7,1,0
0,0,0,0,0,0,0,0,0
53067,274,6,38,35,3,1,1,0
332949,1303,6,227,224,3,3,0,0
0,0,0,0,0,0,0,0,0
0,0,0,0,0,0,0,0,0
214859,1025,12,196,192,4,2,1,0
188506,803,5,148,133,15,3,1,1
186364,2194,8,608,572,36,2,1,0
45091,385,7,55,19,36,0,1,0
620105,2078,6,147,142,5,2,1,0
0,0,0,0,0,0,0,0,0
392673,805,5,96,95,1,11,1,0
0,0,0,0,0,0,0,0,0
138708,1800,6,343,334,9,2,0,0
668491,1559,4,196,35,161,5,1,0
0,0,0,0,0,0,0,0,0
5219,83,0,26,0,26,0,1,0
0,0,0,0,0,0,0,0,0
0,0,0,0,0,0,0,0,0
0,0,0,0,0,0,0,0,0
656369,1542,8,189,172,17,6,1,0
594580,920,7,167,154,13,4,1,0
0,0,0,0,0,0,0,0,0
255990,1752,5,322,318,4,4,1,0
54516,593,9,114,6,108,5,1,0
0,0,0,0,0,0,0,0,0
0,0,0,0,0,0,0,0,0
155487,809,6,123,97,26,3,1,0
0,0,0,0,0,0,0,0,0
166701,946,13,198,196,2,4,1,0
1439971,521,10,115,109,6,2,1,0
598205,2066,17,193,185,8,34,1,0
0,0,0,0,0,0,0,0,0
0,0,0,0,0,0,0,0,0
45437,487,4,37,37,0,5,1,0
0,0,0,0,0,0,0,0,0
0,0,0,0,0,0,0,0,0
0,0,0,0,0,0,0,0,0
80618,648,6,80,59,21,20,1,0
99970,834,4,95,89,6,9,1,0
206538,1505,11,199,189,10,23,0,0
1092448,1235,7,96,83,13,11,1,0
108607,363,0,84,84,0,0,0,0
44401,538,6,146,132,14,2,1,0
103586,1068,8,214,206,8,2,1,0
21900,35,0,1,1,0,0,1,0
88717,1079,1,142,134,8,1,0,0
0,0,0,0,0,0,0,0,0
3348,20,0,3,3,0,0,0,0
681600,4705,16,736,728,8,1,0,0
212757,1643,15,113,106,7,16,1,0
100107,446,14,60,52,8,14,1,0
0,0,0,0,0,0,0,0,0
153913,575,7,118,115,3,10,1,0
129594,366,6,24,21,3,8,0,0
0,0,0,0,0,0,0,0,0
31748,536,2,81,80,1,0,1,0
18827,228,2,56,55,1,0,1,0
0,0,0,0,0,0,0,0,0
80860,595,4,28,26,2,4,0,0
0,0,0,0,0,0,0,0,0
496348,4748,9,935,898,37,180,1,0
0,0,0,0,0,0,0,0,0
213819,2268,4,592,591,1,10,0,0
135474,1873,3,525,524,1,3,0,0
22807,185,3,46,32,14,0,1,0
0,0,0,0,0,0,0,0,0
142244,742,7,79,77,2,13,1,0
851171,6650,5,1738,1730,8,20,1,0
0,0,0,0,0,0,0,0,0
244322,895,9,102,96,6,0,1,0
0,0,0,0,0,0,0,0,0
0,0,0,0,0,0,0,0,0
127141,715,2,59,47,12,4,0,0
0,0,0,0,0,0,0,0,0
296000,1763,8,374,329,45,61,1,0
188228,1968,7,302,288,14,0,1,0
0,0,0,0,0,0,0,0,0
709890,10152,9,1365,145,1220,16,1,0
0,0,0,0,0,0,0,0,0
558917,8316,3,912,862,50,11,1,0
1361084,22541,8,5575,5565,10,1,1,0
80323,1052,7,284,252,32,3,1,0
0,0,0,0,0,0,0,0,0
0,0,0,0,0,0,0,0,0
16320,141,0,7,0,7,0,1,0
0,0,0,0,0,0,0,0,0
126652,1058,9,81,77,4,0,0,0
438097,2059,7,362,351,11,17,1,0
277329,1434,7,341,330,11,14,1,0
907969,1554,3,194,187,7,0,1,0
121367,1969,2,487,474,13,23,1,0
55925,894,5,226,216,10,5,1,0
0,0,0,0,0,0,0,0,0
27303,294,2,35,35,0,7,1,0
13893,100,2,10,10,0,6,1,0
97213,1475,4,285,274,11,1,1,0
104774,511,5,87,83,4,11,0,0
0,0,0,0,0,0,0,0,0
54425,1169,0,223,97,126,0,1,0
20191,433,0,47,47,0,0,1,0
0,0,0,0,0,0,0,0,0
48186,584,1,146,131,15,0,1,0
14440,131,3,3,3,0,0,1,0
0,0,0,0,0,0,0,0,0
71466,663,7,201,159,42,2,1,0
29823,96,7,9,4,5,2,1,0
273964,1125,9,17,14,3,3,1,0
0,0,0,0,0,0,0,0,0
20054,88,0,8,5,3,2,1,0
186872,902,4,171,157,14,0,1,0
0,0,0,0,0,0,0,0,0
1024379,14968,3,3169,136,3033,14,0,0
0,0,0,0,0,0,0,0,0
0,0,0,0,0,0,0,0,0
0,0,0,0,0,0,0,0,0
0,0,0,0,0,0,0,0,0
1816,28,0,9,0,9,0,0,0
0,0,0,0,0,0,0,0,0
0,0,0,0,0,0,0,0,0
0,0,0,0,0,0,0,0,0
503822,1462,11,300,287,13,15,1,0
464122,648,11,137,124,13,13,1,0
121467,971,12,233,230,3,20,1,0
0,0,0,0,0,0,0,0,0
0,0,0,0,0,0,0,0,0
43518,700,7,149,96,53,0,1,0
0,0,0,0,0,0,0,0,0
538804,4828,3,1195,1160,35,64,1,0
37571,214,3,15,15,0,5,0,0
68985,668,8,98,87,11,2,1,0
316272,1440,2,146,123,23,0,0,0
92048,501,4,81,45,36,4,1,0
106771,475,3,48,46,2,0,1,0
0,0,0,0,0,0,0,0,0
88440,1125,8,202,188,14,19,1,0
46441,404,8,59,47,12,4,1,0
0,0,0,0,0,0,0,0,0
198035,754,6,165,159,6,2,1,0
443170,480,3,90,82,8,1,1,0
188976,940,10,107,92,15,7,1,0
175190,849,11,95,82,13,7,1,0
284710,3055,0,200,172,28,24,1,0
157828,1489,0,131,108,23,2,1,0
0,0,0,0,0,0,0,0,0
0,0,0,0,0,0,0,0,0
0,0,0,0,0,0,0,0,0
0,0,0,0,0,0,0,0,0
0,0,0,0,0,0,0,0,0
301431,1536,1,280,165,115,9,0,0
31897,291,0,68,59,9,9,0,0
107748,816,11,170,154,16,2,1,0
51545,402,9,90,85,5,7,1,0
75602,532,5,62,56,6,13,1,0
25352,185,5,18,12,6,3,1,0
100270,1184,8,206,187,19,20,1,0
110756,835,13,70,58,12,2,1,0
52626,294,9,48,41,7,0,1,0
52081,555,10,65,62,3,4,1,0
37578,447,1,14,13,1,2,1,0
6200,67,4,12,10,2,2,1,0
98954,831,4,187,169,18,12,1,0
77540,66,2,4,2,2,1,0,0
1416670,3814,7,277,258,19,4,0,0
0,0,0,0,0,0,0,0,0
49117,848,3,182,176,6,0,1,0
23516,147,1,18,15,3,2,1,0
0,0,0,0,0,0,0,0,0
233049,1064,10,181,150,31,2,1,0
8351,72,5,4,4,0,0,0,0
0,0,0,0,0,0,0,0,0
943,9,0,0,0,0,0,0,0
102793,617,4,64,64,0,0,0,0
113637,1065,8,111,107,4,9,1,0
405122,3223,5,293,271,22,12,1,0
0,0,0,0,0,0,0,0,0
187402,761,10,129,123,6,12,1,0
0,0,0,0,0,0,0,0,0
29108,195,11,25,25,0,2,1,0
44916,385,7,55,19,36,0,1,0
87599,695,10,91,82,9,0,1,0
0,0,0,0,0,0,0,0,0
0,0,0,0,0,0,0,0,0
13386,62,3,4,2,2,0,1,0
320507,1414,6,156,147,9,3,1,0
29369,352,5,91,91,0,3,1,0
0,0,0,0,0,0,0,0,0
0,0,0,0,0,0,0,0,0
0,0,0,0,0,0,0,0,0
105246,855,6,19,7,12,0,0,0
125773,707,19,78,70,8,13,1,0
104891,646,18,65,57,8,12,1,0
62783,520,3,156,156,0,2,0,0
268357,1367,13,296,268,28,19,1,0
0,0,0,0,0,0,0,0,0
0,0,0,0,0,0,0,0,0
560464,3582,2,803,794,9,5,1,0
0,0,0,0,0,0,0,0,0
0,0,0,0,0,0,0,0,0
697912,3052,6,207,203,4,10,1,0
66512,537,10,54,43,11,3,1,0
0,0,0,0,0,0,0,0,0
0,0,0,0,0,0,0,0,0
0,0,0,0,0,0,0,0,0
0,0,0,0,0,0,0,0,0
0,0,0,0,0,0,0,0,0
0,0,0,0,0,0,0,0,0
0,0,0,0,0,0,0,0,0
478680,3903,2,325,248,77,24,1,0
128512,830,2,96,93,3,1,1,0
12500,129,4,8,8,0,2,1,0
0,0,0,0,0,0,0,0,0
55785,442,11,67,66,1,3,1,0
0,0,0,0,0,0,0,0,0
0,0,0,0,0,0,0,0,0
211143,180,0,47,32,15,1,1,0
270996,77,0,5,0,5,0,0,0
105921,1042,8,209,202,7,2,0,0
253137,1199,13,115,99,16,2,1,0
165941,2502,4,98,82,16,5,1,0
0,0,0,0,0,0,0,0,0
78892,781,11,216,177,39,6,1,0
86051,698,3,129,129,0,1,1,0
49825,341,4,73,73,0,1,1,0
88563,103,0,12,5,7,0,1,0
0,0,0,0,0,0,0,0,0
623328,2264,6,323,309,14,3,1,1
0,0,0,0,0,0,0,0,0
177141,405,2,26,20,6,32,1,0
0,0,0,0,0,0,0,0,0
184333,2394,2,692,639,53,7,1,0
0,0,0,0,0,0,0,0,0
0,0,0,0,0,0,0,0,0
0,0,0,0,0,0,0,0,0
0,0,0,0,0,0,0,0,0
22620,38,0,2,1,1,0,1,0
89383,677,0,127,117,10,1,1,0
263537,1366,14,189,171,18,15,0,0
0,0,0,0,0,0,0,0,0
0,0,0,0,0,0,0,0,0
1109694,857,3,67,63,4,0,1,0
1109710,857,3,67,63,4,0,1,0
1429223,649,5,26,5,21,3,1,0
0,0,0,0,0,0,0,0,0
113392,641,4,65,56,9,1,1,0
0,0,0,0,0,0,0,0,0
0,0,0,0,0,0,0,0,0
18633,251,2,103,75,28,0,1,0
144276,1570,4,192,167,25,2,1,0
0,0,0,0,0,0,0,0,0
0,0,0,0,0,0,0,0,0
59289,428,5,75,74,1,0,1,0
0,0,0,0,0,0,0,0,0
241580,3007,8,649,620,29,23,1,0
80163,708,7,143,137,6,10,1,0
124340,1795,3,214,214,0,0,0,0
0,0,0,0,0,0,0,0,0
0,0,0,0,0,0,0,0,0
0,0,0,0,0,0,0,0,0
0,0,0,0,0,0,0,0,0
26376,597,2,98,74,24,0,1,0
8251,131,0,33,32,1,0,0,0
22950,38,0,3,1,2,0,1,0
513041,1283,5,70,35,35,1,1,0
215929,1050,11,138,135,3,6,0,0
44962,384,7,55,19,36,0,1,0
80526,877,3,179,57,122,3,0,0
0,0,0,0,0,0,0,0,0
107401,880,7,221,221,0,14,1,0
0,0,0,0,0,0,0,0,0
545062,2180,6,444,165,279,11,1,0
70705,583,6,101,93,8,0,1,0
43534,339,7,63,55,8,0,1,0
175838,465,4,0,0,0,8,1,0
32741,412,0,26,8,18,6,1,0
12645,93,4,11,0,11,2,1,0
287432,2071,9,409,396,13,14,0,0
0,0,0,0,0,0,0,0,0
0,0,0,0,0,0,0,0,0
0,0,0,0,0,0,0,0,0
88374,810,7,63,58,5,5,1,0
101003,857,3,127,118,9,17,0,0
0,0,0,0,0,0,0,0,0
428445,2615,7,228,217,11,8,1,0
349104,2425,7,204,193,11,9,1,0
548339,3748,5,436,205,231,27,1,0
109586,1179,5,136,128,8,3,1,0
2297643,683,3,86,79,7,3,1,0
305053,2344,4,971,2,969,0,1,0
400271,1339,7,165,137,28,33,0,0
75710,927,7,245,241,4,0,1,0
0,0,0,0,0,0,0,0,0
0,0,0,0,0,0,0,0,0
0,0,0,0,0,0,0,0,0
0,0,0,0,0,0,0,0,0
169841,850,8,131,125,6,9,1,0
0,0,0,0,0,0,0,0,0
4013,31,0,3,3,0,0,1,0
176619,2748,3,693,626,67,3,1,0
117626,886,9,138,134,4,6,1,0
129600,366,0,64,5,59,0,1,0
166301,612,4,73,61,12,32,1,0
168113,1617,2,278,269,9,1,1,0
0,0,0,0,0,0,0,0,0
332712,2411,11,489,468,21,1,1,0
91505,1227,6,301,293,8,2,1,0
1955521,372,3,67,49,18,0,1,0
0,0,0,0,0,0,0,0,0
1259270,2050,11,253,244,9,38,1,0
1178138,14255,6,6171,6168,3,0,1,0
63942,983,4,153,150,3,0,1,0
26634,248,3,32,29,3,0,1,0
126971,1668,9,474,381,93,2,1,0
374251,2558,9,424,364,60,11,1,0
78034,635,16,115,65,50,2,1,0
159900,419,2,30,24,6,9,1,0
107876,630,1,154,141,13,0,1,0
110646,1165,13,25,22,3,3,1,0
0,0,0,0,0,0,0,0,0
66786,1931,2,568,568,0,2,1,0
0,0,0,0,0,0,0,0,0
0,0,0,0,0,0,0,0,0
37234,379,9,14,14,0,4,0,0
36146,272,0,9,9,0,26,1,0
0,0,0,0,0,0,0,0,0
0,0,0,0,0,0,0,0,0
0,0,0,0,0,0,0,0,0
0,0,0,0,0,0,0,0,0
247786,934,1,265,237,28,0,1,0
351216,1091,10,59,58,1,9,1,0
103326,1016,8,231,214,17,33,1,0
160186,1175,3,133,120,13,7,1,0
90615,1592,8,425,406,19,4,1,0
4622,66,3,7,6,1,0,0,0
0,0,0,0,0,0,0,0,0
34948,332,3,57,54,3,3,1,0
0,0,0,0,0,0,0,0,0
0,0,0,0,0,0,0,0,0
0,0,0,0,0,0,0,0,0
315970,2823,6,336,286,50,5,0,0
0,0,0,0,0,0,0,0,0
0,0,0,0,0,0,0,0,0
0,0,0,0,0,0,0,0,0
54602,871,5,131,90,41,1,1,0
0,0,0,0,0,0,0,0,0
0,0,0,0,0,0,0,0,0
197343,856,2,62,44,18,3,1,0
0,0,0,0,0,0,0,0,0
578717,1418,5,163,159,4,10,1,0
103004,1234,9,159,159,0,2,1,0
442802,2574,7,383,283,100,29,1,0
98501,1935,4,428,387,41,2,1,0
271811,2051,10,624,621,3,5,1,0
213361,1191,10,379,377,2,6,1,0
183076,2332,2,222,207,15,3,1,0
234698,1207,9,221,214,7,4,1,0
208439,732,9,178,171,7,5,1,0
0,0,0,0,0,0,0,0,0
0,0,0,0,0,0,0,0,0
514719,3645,8,402,389,13,26,1,0
11528,92,6,3,3,0,4,1,0
1258924,1879,5,254,234,20,4,1,0
66318,432,10,67,39,28,1,0,0
255065,1017,11,313,310,3,0,1,0
0,0,0,0,0,0,0,0,0
8324,54,4,2,2,0,2,0,0
279469,1381,12,224,215,9,3,1,0
54344,613,12,117,115,2,6,1,0
0,0,0,0,0,0,0,0,0
72729,349,5,70,37,33,0,1,0
0,0,0,0,0,0,0,0,0
212722,866,12,105,86,19,22,1,0
498413,1168,9,147,142,5,4,0,0
45772,173,4,16,12,4,4,0,0
172657,907,5,158,147,11,3,1,0
63615,129,3,8,6,2,2,0,0
0,0,0,0,0,0,0,0,0
0,0,0,0,0,0,0,0,0
80605,1368,1,258,256,2,3,1,0
0,0,0,0,0,0,0,0,0
0,0,0,0,0,0,0,0,0
0,0,0,0,0,0,0,0,0
99083,1219,10,183,180,3,13,1,0
320237,1382,6,182,173,9,7,1,0
412449,1432,15,213,132,81,11,1,0
227240,496,14,66,55,11,17,1,0
257966,1573,5,261,254,7,15,1,0
272100,1900,11,197,192,5,15,0,0
0,0,0,0,0,0,0,0,0
43658,675,5,203,202,1,0,1,0
99158,1246,1,122,104,18,3,0,0
239485,696,7,115,110,5,5,1,0
0,0,0,0,0,0,0,0,0
74923,927,8,183,177,6,7,1,0
245452,781,11,111,107,4,16,1,0
24636,389,1,105,102,3,98,1,0
12128,205,0,40,37,3,0,1,0
0,0,0,0,0,0,0,0,0
83604,1553,8,280,231,49,8,1,0
0,0,0,0,0,0,0,0,0
386632,2474,13,295,278,17,16,1,0
4195,39,4,1,1,0,0,0,0
175640,650,10,72,20,52,27,0,0
0,0,0,0,0,0,0,0,0
13696,96,2,13,9,4,1,1,0
0,0,0,0,0,0,0,0,0
0,0,0,0,0,0,0,0,0
0,0,0,0,0,0,0,0,0
140160,1120,2,198,178,20,5,0,0
0,0,0,0,0,0,0,0,0
65595,938,5,153,137,16,1,1,0
0,0,0,0,0,0,0,0,0
0,0,0,0,0,0,0,0,0
644240,734,6,136,125,11,3,1,0
0,0,0,0,0,0,0,0,0
0,0,0,0,0,0,0,0,0
262296,1622,13,161,158,3,1,0,0
252407,1091,14,100,95,5,11,0,0
0,0,0,0,0,0,0,0,0
0,0,0,0,0,0,0,0,0
308853,2645,10,612,544,68,19,1,0
408189,865,1,67,67,0,0,1,0
0,0,0,0,0,0,0,0,0
0,0,0,0,0,0,0,0,0
0,0,0,0,0,0,0,0,0
0,0,0,0,0,0,0,0,0
44800,210,6,32,32,0,2,0,0
0,0,0,0,0,0,0,0,0
331692,944,13,188,165,23,5,1,0
78438,772,10,200,163,37,8,1,0
0,0,0,0,0,0,0,0,0
0,0,0,0,0,0,0,0,0
0,0,0,0,0,0,0,0,0
250769,849,1,237,230,7,1,1,0
192508,1259,10,302,281,21,0,0,0
1909,42,0,8,8,0,0,0,0
0,0,0,0,0,0,0,0,0
0,0,0,0,0,0,0,0,0
0,0,0,0,0,0,0,0,0
209727,466,5,57,46,11,12,1,0
0,0,0,0,0,0,0,0,0
185243,1650,10,321,200,121,13,1,0
0,0,0,0,0,0,0,0,0
888540,869,14,225,196,29,4,1,0
17981,205,3,55,47,8,0,1,0
89605,1693,3,313,16,297,2,1,0
22913,38,0,2,2,0,0,1,0
0,0,0,0,0,0,0,0,0
57197,652,3,167,157,10,0,0,0
35055,248,5,47,4,43,5,1,0
32591,229,5,45,22,23,5,1,0
178189,1853,4,246,245,1,0,1,0
567311,3718,4,415,414,1,2,1,0
369080,1914,7,209,208,1,5,1,0
0,0,0,0,0,0,0,0,0
0,0,0,0,0,0,0,0,0
80844,718,10,64,63,1,0,1,0
98945,937,5,69,56,13,14,1,0
275403,2193,16,110,87,23,6,1,0
71870,224,4,7,3,4,1,1,0
10175,76,0,6,3,3,1,0,0
93418,792,2,92,58,34,33,1,0
128435,372,6,52,50,2,3,1,0
549932,690,7,108,99,9,3,1,0
1437600,1245,16,104,85,19,4,1,0
0,0,0,0,0,0,0,0,0
130534,1058,3,162,150,12,2,0,0
54664,268,3,56,55,1,10,0,0
169678,829,9,78,69,9,8,1,0
101384,952,4,369,367,2,0,1,0
93196,844,4,346,344,2,0,1,0
103814,969,4,234,231,3,0,1,0
0,0,0,0,0,0,0,0,0
0,0,0,0,0,0,0,0,0
0,0,0,0,0,0,0,0,0
0,0,0,0,0,0,0,0,0
0,0,0,0,0,0,0,0,0
0,0,0,0,0,0,0,0,0
0,0,0,0,0,0,0,0,0
27718,42,0,2,1,1,0,0,0
392640,984,2,143,131,12,0,1,0
457272,134,2,9,1,8,2,1,0
0,0,0,0,0,0,0,0,0
0,0,0,0,0,0,0,0,0
58063,840,9,162,160,2,1,1,0
0,0,0,0,0,0,0,0,0
91468,1899,1,444,439,5,0,1,0
0,0,0,0,0,0,0,0,0
119150,1437,7,196,191,5,5,1,0
37173,488,7,95,94,1,2,1,0
63671,956,1,81,79,2,0,1,0
12147,207,5,56,55,1,2,1,0
21865,33,0,1,1,0,0,1,0
0,0,0,0,0,0,0,0,0
22844,37,0,2,1,1,0,1,0
0,0,0,0,0,0,0,0,0
0,0,0,0,0,0,0,0,0
170229,779,17,84,70,14,12,1,0
178072,1606,9,156,112,44,20,1,0
464635,1331,9,103,27,76,4,1,0
345041,530,10,43,14,29,4,1,0
0,0,0,0,0,0,0,0,0
151253,832,9,130,126,4,0,1,0
199842,1790,10,289,267,22,0,0,0
0,0,0,0,0,0,0,0,0
18340,352,4,98,86,12,2,1,0
0,0,0,0,0,0,0,0,0
0,0,0,0,0,0,0,0,0
72019,1067,3,217,197,20,0,1,0
0,0,0,0,0,0,0,0,0
340497,425,10,65,65,0,9,1,0
55689,403,5,83,70,13,20,1,0
32901,256,4,63,59,4,12,1,0
29265,237,1,39,31,8,1,1,0
59777,886,1,129,103,26,12,1,0
0,0,0,0,0,0,0,0,0
0,0,0,0,0,0,0,0,0
70596,395,0,22,20,2,0,0,0
33156,129,0,18,16,2,1,0,0
63108,1258,5,246,239,7,5,1,0
11431,305,4,75,71,4,3,1,0
205217,1980,6,429,390,39,1,1,0
237312,1728,16,339,338,1,9,0,0
0,0,0,0,0,0,0,0,0
0,0,0,0,0,0,0,0,0
98825,2196,6,745,741,4,8,1,0
48154,473,1,82,77,5,3,1,0
0,0,0,0,0,0,0,0,0
0,0,0,0,0,0,0,0,0
195204,1203,12,34,24,10,6,1,0
67839,527,4,97,96,1,38,0,0
96589,673,10,102,94,8,10,1,0
252692,3690,3,677,664,13,1,1,0
395191,1746,1,417,399,18,5,1,0
163819,332,1,74,24,50,0,1,0
0,0,0,0,0,0,0,0,0
1068173,1277,8,136,91,45,17,1,0
49468,139,5,7,6,1,8,0,0
28819,317,7,28,28,0,2,1,0
8942,116,6,19,19,0,0,1,0
0,0,0,0,0,0,0,0,0
0,0,0,0,0,0,0,0,0
591276,2943,3,304,104,200,1,1,0
0,0,0,0,0,0,0,0,0
53267,840,4,141,113,28,1,1,0
92480,649,9,103,98,5,0,1,0
0,0,0,0,0,0,0,0,0
227316,1067,8,208,197,11,6,1,0
275537,1676,10,142,118,24,18,1,0
138127,2410,4,267,188,79,0,0,0
46918,619,4,94,93,1,0,0,0
0,0,0,0,0,0,0,0,0
219762,1278,14,265,5,260,2,1,1
0,0,0,0,0,0,0,0,0
122748,1093,2,58,43,15,8,1,0
0,0,0,0,0,0,0,0,0
0,0,0,0,0,0,0,0,0
0,0,0,0,0,0,0,0,0
312200,1772,8,252,229,23,3,1,0
15961,212,2,41,20,21,0,1,0
0,0,0,0,0,0,0,0,0
0,0,0,0,0,0,0,0,0
0,0,0,0,0,0,0,0,0
60974,507,5,157,149,8,0,0,0
562682,1740,12,362,324,38,6,1,0
123015,488,10,59,55,4,0,1,0
16237,187,3,28,5,23,1,1,0
39819,510,6,143,125,18,4,0,0
21715,273,6,71,55,16,4,0,0
255786,797,1,120,112,8,1,1,0
0,0,0,0,0,0,0,0,0
1470119,4254,4,271,263,8,0,1,0
0,0,0,0,0,0,0,0,0
45277,775,5,249,239,10,0,1,0
85135,647,5,198,198,0,1,1,0
96046,1584,2,514,510,4,40,1,0
258252,960,6,209,203,6,2,1,0
66468,827,4,137,137,0,5,0,0
103855,589,5,138,131,7,0,1,0
0,0,0,0,0,0,0,0,0
98761,558,8,108,105,3,4,1,0
33902,227,8,34,31,3,5,1,0
0,0,0,0,0,0,0,0,0
128812,535,5,117,117,0,10,0,0
0,0,0,0,0,0,0,0,0
0,0,0,0,0,0,0,0,0
116266,599,5,71,68,3,41,0,0
0,0,0,0,0,0,0,0,0
0,0,0,0,0,0,0,0,0
221157,1539,2,263,246,17,2,0,0
213884,687,4,72,54,18,2,1,0
1335058,2512,7,220,187,33,3,1,0
380366,2158,9,312,275,37,17,1,0
129052,1011,9,181,152,29,4,1,0
0,0,0,0,0,0,0,0,0
0,0,0,0,0,0,0,0,0
902575,2025,0,82,73,9,9,1,0
7898,103,2,26,26,0,0,1,0
193981,1944,2,438,431,7,6,1,0
0,0,0,0,0,0,0,0,0
0,0,0,0,0,0,0,0,0
157118,350,7,34,31,3,3,1,0
0,0,0,0,0,0,0,0,0
1145238,2997,4,363,317,46,1,1,0
662161,1376,2,48,48,0,0,0,0
246472,1490,5,89,74,15,4,1,0
32031,382,6,35,34,1,2,1,0
38781,76,6,3,2,1,4,0,0
61650,622,5,107,92,15,9,0,0
191225,832,5,73,68,5,4,1,0
0,0,0,0,0,0,0,0,0
56179,525,4,103,102,1,17,1,0
0,0,0,0,0,0,0,0,0
23308,38,0,2,1,1,0,1,0
216544,2986,10,676,654,22,5,1,0
0,0,0,0,0,0,0,0,0
0,0,0,0,0,0,0,0,0
0,0,0,0,0,0,0,0,0
0,0,0,0,0,0,0,0,0
0,0,0,0,0,0,0,0,0
94033,825,5,60,53,7,68,1,0
158121,934,5,148,134,14,19,1,0
18992,103,3,3,0,3,0,0,0
130451,1003,16,128,120,8,15,1,0
10997,259,0,55,49,6,0,1,0
326086,1132,5,188,181,7,11,1,0
0,0,0,0,0,0,0,0,0
0,0,0,0,0,0,0,0,0
201272,1812,17,283,274,9,10,1,0
0,0,0,0,0,0,0,0,0
0,0,0,0,0,0,0,0,0
0,0,0,0,0,0,0,0,0
357076,1703,7,245,213,32,10,1,0
0,0,0,0,0,0,0,0,0
132093,2725,5,299,293,6,3,1,0
109081,176,6,15,10,5,24,1,0
0,0,0,0,0,0,0,0,0
454977,4432,6,380,370,10,7,1,0
78811,644,6,116,110,6,5,1,0
23397,38,0,2,1,1,0,1,0
123972,846,10,11,4,7,0,1,0
0,0,0,0,0,0,0,0,0
233879,1357,8,239,229,10,11,1,0
117652,1504,4,356,353,3,3,1,0
0,0,0,0,0,0,0,0,0
229954,1060,3,89,78,11,5,1,0
5879,71,1,7,6,1,0,1,0
0,0,0,0,0,0,0,0,0
18479,347,3,68,68,0,1,1,0
246618,1205,6,85,77,8,4,1,0
46955,330,5,69,64,5,0,1,0
0,0,0,0,0,0,0,0,0
0,0,0,0,0,0,0,0,0
0,0,0,0,0,0,0,0,0
39934,260,3,59,51,8,3,1,0
113490,454,6,34,23,11,9,1,0
0,0,0,0,0,0,0,0,0
65764,269,8,29,23,6,3,1,0
0,0,0,0,0,0,0,0,0
101508,832,4,151,45,106,13,1,0
24090,183,3,13,12,1,9,0,0
141549,992,6,133,131,2,16,0,0
0,0,0,0,0,0,0,0,0
0,0,0,0,0,0,0,0,0
308950,1219,7,241,227,14,4,1,0
0,0,0,0,0,0,0,0,0
0,0,0,0,0,0,0,0,0
0,0,0,0,0,0,0,0,0
146609,411,2,44,29,15,6,1,0
82027,676,5,169,161,8,9,0,0
0,0,0,0,0,0,0,0,0
0,0,0,0,0,0,0,0,0
29538,466,1,91,91,0,4,1,0
3835,43,1,8,8,0,0,1,0
269046,725,8,129,106,23,6,1,0
36688,317,5,54,53,1,2,1,0
0,0,0,0,0,0,0,0,0
3752,58,0,9,8,1,0,0,0
5343,74,2,9,8,1,0,0,0
0,0,0,0,0,0,0,0,0
0,0,0,0,0,0,0,0,0
422952,1819,9,414,402,12,2,1,0
0,0,0,0,0,0,0,0,0
21994,35,0,1,1,0,0,1,0
8877,128,3,30,30,0,2,1,0
6755,123,2,28,28,0,0,1,0
640406,811,0,241,178,63,5,1,0
37096,354,1,4,2,2,2,0,0
0,0,0,0,0,0,0,0,0
0,0,0,0,0,0,0,0,0
479053,1282,3,325,305,20,0,1,0
77955,918,12,207,75,132,7,1,0
0,0,0,0,0,0,0,0,0
23972,48,5,2,0,2,0,0,0
0,0,0,0,0,0,0,0,0
47540,641,1,74,74,0,0,1,0
294491,1527,11,390,372,18,5,1,0
0,0,0,0,0,0,0,0,0
141432,447,12,78,62,16,1,1,0
0,0,0,0,0,0,0,0,0
334347,1834,1,378,342,36,1,1,0
111024,548,8,93,73,20,3,0,0
0,0,0,0,0,0,0,0,0
59347,861,7,174,170,4,7,1,0
19048,384,5,110,106,4,0,1,0
0,0,0,0,0,0,0,0,0
85427,1268,4,475,467,8,3,0,0
170637,459,5,79,7,72,4,1,0
163286,349,6,37,34,3,6,1,0
361513,2576,8,351,340,11,48,1,0
64733,651,7,231,224,7,3,1,0
3708,75,2,8,8,0,0,1,0
0,0,0,0,0,0,0,0,0
0,0,0,0,0,0,0,0,0
0,0,0,0,0,0,0,0,0
0,0,0,0,0,0,0,0,0
0,0,0,0,0,0,0,0,0
0,0,0,0,0,0,0,0,0
238606,2496,7,393,379,14,2,1,0
0,0,0,0,0,0,0,0,0
0,0,0,0,0,0,0,0,0
46154,541,8,97,62,35,17,1,0
0,0,0,0,0,0,0,0,0
56483,763,4,182,162,20,0,1,0
91057,503,10,30,29,1,3,1,0
6095,83,0,9,9,0,0,0,0
63648,901,2,148,142,6,0,1,0
0,0,0,0,0,0,0,0,0
77835,505,14,77,76,1,6,1,0
44861,1202,0,143,133,10,0,1,0
96966,1474,4,218,110,108,14,1,0
0,0,0,0,0,0,0,0,0
120204,2397,5,621,568,53,17,1,0
0,0,0,0,0,0,0,0,0
0,0,0,0,0,0,0,0,0
118951,898,9,185,185,0,4,1,0
0,0,0,0,0,0,0,0,0
25738,401,0,32,6,26,0,0,0
0,0,0,0,0,0,0,0,0
602946,2572,16,306,284,22,50,1,0
163104,1083,13,155,139,16,8,1,0
0,0,0,0,0,0,0,0,0
0,0,0,0,0,0,0,0,0
114792,1405,10,321,130,191,8,1,0
119884,1436,7,245,237,8,11,1,0
23538,429,3,119,114,5,4,1,0
57231,457,6,87,71,16,3,1,0
0,0,0,0,0,0,0,0,0
0,0,0,0,0,0,0,0,0
0,0,0,0,0,0,0,0,0
92953,2430,1,376,371,5,0,1,0
0,0,0,0,0,0,0,0,0
107201,1880,6,415,415,0,1,0,0
11250,173,4,42,42,0,2,0,0
4810,119,0,22,22,0,0,0,0
208077,1061,11,205,196,9,9,1,0
0,0,0,0,0,0,0,0,0
74353,1086,4,183,173,10,3,1,0
85296,445,9,92,84,8,7,1,0
98267,966,6,172,160,12,6,0,0
327999,1691,11,290,280,10,29,1,0
85481,442,4,34,32,2,6,0,0
78094,275,7,23,22,1,6,0,0
797569,3514,4,582,578,4,4,1,0
0,0,0,0,0,0,0,0,0
0,0,0,0,0,0,0,0,0
0,0,0,0,0,0,0,0,0
913919,1843,0,286,264,22,5,0,0
885707,3382,14,194,106,88,31,1,0
689555,4725,7,1430,1414,16,320,1,0
0,0,0,0,0,0,0,0,0
17917,35,0,2,1,1,0,1,0
1143364,3768,5,170,68,102,39,1,0
56025,315,7,40,36,4,0,1,0
127349,1353,3,61,25,36,27,1,0
0,0,0,0,0,0,0,0,0
0,0,0,0,0,0,0,0,0
171963,3543,14,94,20,74,25,1,0
419342,3252,8,546,515,31,6,1,0
88896,595,7,10,7,3,2,1,0
53793,298,12,36,25,11,3,0,0
10421,78,2,3,3,0,3,0,0
0,0,0,0,0,0,0,0,0
58442,643,3,98,95,3,33,1,0
0,0,0,0,0,0,0,0,0
62441,634,4,203,183,20,2,0,0
22367,198,5,6,6,0,1,0,0
0,0,0,0,0,0,0,0,0
0,0,0,0,0,0,0,0,0
0,0,0,0,0,0,0,0,0
377782,875,1,140,75,65,9,1,0
80283,108,1,10,10,0,2,0,0
224356,1192,15,265,250,15,20,1,0
437893,2344,10,321,308,13,27,1,0
206931,1872,6,432,410,22,0,0,0
33754,433,4,73,60,13,0,0,0
0,0,0,0,0,0,0,0,0
0,0,0,0,0,0,0,0,0
45104,386,7,55,19,36,0,1,0
44060,477,5,83,80,3,4,1,0
0,0,0,0,0,0,0,0,0
0,0,0,0,0,0,0,0,0
0,0,0,0,0,0,0,0,0
329897,3207,5,655,599,56,13,0,0
21930,35,0,1,1,0,0,1,0
0,0,0,0,0,0,0,0,0
0,0,0,0,0,0,0,0,0
0,0,0,0,0,0,0,0,0
294099,1473,9,185,151,34,8,1,0
6906530,2682,5,34,33,1,73,1,0
200757,1526,1,197,117,80,96,1,0
575967,3377,7,672,660,12,4,1,0
148284,1010,2,73,10,63,0,1,0
305105,1669,7,416,407,9,3,0,0
0,0,0,0,0,0,0,0,0
108057,1201,8,414,382,32,28,1,0
34759,207,5,13,12,1,0,1,0
0,0,0,0,0,0,0,0,0
0,0,0,0,0,0,0,0,0
50513,466,4,54,54,0,1,1,0
0,0,0,0,0,0,0,0,0
0,0,0,0,0,0,0,0,0
135860,1318,2,283,268,15,1,0,0
113614,517,4,129,128,1,0,1,0
0,0,0,0,0,0,0,0,0
74916,1045,3,257,168,89,0,0,0
6063,84,3,16,15,1,0,0,0
467868,3519,19,282,261,21,259,1,0
33188,118,5,7,4,3,0,1,0
37605,339,10,42,39,3,1,1,0
76415,990,1,296,245,51,2,0,0
1071594,2052,7,318,289,29,25,1,0
0,0,0,0,0,0,0,0,0
66433,1220,0,408,361,47,0,0,0
137856,1605,7,251,232,19,3,1,0
0,0,0,0,0,0,0,0,0
0,0,0,0,0,0,0,0,0
0,0,0,0,0,0,0,0,0
24691,52,5,4,3,1,0,0,0
90783,909,8,194,194,0,2,1,0
0,0,0,0,0,0,0,0,0
455560,2202,9,361,10,351,8,0,0
0,0,0,0,0,0,0,0,0
47979,404,1,93,35,58,2,1,0
47979,404,1,93,26,67,2,1,0
168932,1016,3,188,168,20,0,1,0
0,0,0,0,0,0,0,0,0
0,0,0,0,0,0,0,0,0
0,0,0,0,0,0,0,0,0
419226,1537,16,271,271,0,31,1,0
0,0,0,0,0,0,0,0,0
0,0,0,0,0,0,0,0,0
13864,121,6,17,15,2,0,1,0
0,0,0,0,0,0,0,0,0
0,0,0,0,0,0,0,0,0
256256,1138,10,229,221,8,6,1,0
15816,138,2,11,11,0,1,0,0
367386,3299,4,495,488,7,27,1,0
0,0,0,0,0,0,0,0,0
609488,735,5,94,89,5,17,1,0
629086,603,4,40,29,11,1,1,0
27834,42,0,2,1,1,0,0,0
0,0,0,0,0,0,0,0,0
83641,510,3,16,14,2,0,1,0
872121,2663,6,546,485,61,16,1,0
334846,514,6,77,52,25,13,1,0
324241,1475,3,252,227,25,56,0,0
53285,178,2,18,15,3,1,1,0
271734,1124,6,217,201,16,1,0,0
0,0,0,0,0,0,0,0,0
259490,385,6,10,6,4,0,1,0
0,0,0,0,0,0,0,0,0
0,0,0,0,0,0,0,0,0
0,0,0,0,0,0,0,0,0
188617,660,1,45,42,3,1,1,0
268171,1632,11,141,134,7,2,1,0
29500,367,2,99,99,0,2,1,0
0,0,0,0,0,0,0,0,0
0,0,0,0,0,0,0,0,0
111667,655,6,156,138,18,0,0,0
0,0,0,0,0,0,0,0,0
83238,945,10,192,177,15,5,1,0
119403,190,0,15,14,1,11,0,0
146046,976,2,83,74,9,4,0,0
0,0,0,0,0,0,0,0,0
176097,620,6,111,98,13,4,1,0
0,0,0,0,0,0,0,0,0
43030,36,0,1,0,1,0,0,1
0,0,0,0,0,0,0,0,0
185743,681,6,104,68,36,6,1,0
58413,165,4,1,0,1,5,0,0
7507,156,3,34,33,1,0,1,0
423639,6185,6,1751,765,986,7,0,0
43367,318,9,39,39,0,2,1,0
224019,3616,6,822,672,150,0,1,0
261452,1103,7,182,141,41,11,1,0
0,0,0,0,0,0,0,0,0
0,0,0,0,0,0,0,0,0
61443,914,12,272,265,7,17,1,0
330321,4233,4,800,789,11,4,1,0
4149,33,0,5,5,0,0,1,0
0,0,0,0,0,0,0,0,0
348567,428,5,70,69,1,8,1,0
902847,941,8,195,167,28,11,1,0
866406,313,10,56,37,19,3,1,0
0,0,0,0,0,0,0,0,0
59773,489,13,66,66,0,5,1,0
0,0,0,0,0,0,0,0,0
295755,565,4,20,17,3,5,0,0
302182,3181,13,582,450,132,20,1,0
56132,171,6,4,0,4,8,1,0
18118,192,2,64,61,3,2,0,0
30568,406,4,88,38,50,0,0,0
222495,1841,6,282,255,27,2,1,0
222440,1839,6,282,255,27,2,1,0
81047,347,9,48,44,4,0,0,0
946237,3974,10,800,434,366,5,1,0
18285,245,2,34,21,13,0,1,0
2837,37,2,3,3,0,0,0,0
19546,280,0,49,46,3,3,1,0
0,0,0,0,0,0,0,0,0
0,0,0,0,0,0,0,0,0
0,0,0,0,0,0,0,0,0
0,0,0,0,0,0,0,0,0
227827,1423,5,330,210,120,1,1,0
31835,309,8,53,48,5,4,1,0
22788,37,0,2,1,1,0,1,0
0,0,0,0,0,0,0,0,0
633711,931,6,164,158,6,7,1,0
0,0,0,0,0,0,0,0,0
251352,1529,5,174,166,8,11,1,0
167565,488,8,70,68,2,0,1,0
328576,1273,10,131,107,24,15,1,0
215341,1862,3,307,246,61,6,1,0
29635,141,4,16,15,1,7,0,0
57548,643,3,89,80,9,2,1,0
0,0,0,0,0,0,0,0,0
0,0,0,0,0,0,0,0,0
120085,1232,5,191,189,2,3,0,0
0,0,0,0,0,0,0,0,0
0,0,0,0,0,0,0,0,0
100750,1027,6,184,181,3,2,0,0
66796,537,7,141,134,7,2,0,0
0,0,0,0,0,0,0,0,0
330004,765,4,59,50,9,3,0,0
13443,62,5,2,2,0,3,1,0
0,0,0,0,0,0,0,0,0
25951,231,5,34,34,0,0,0,0
587019,2001,5,299,289,10,21,0,0
88266,1322,7,290,279,11,8,1,0
27314,384,4,71,65,6,6,1,0
63043,545,2,118,111,7,15,1,0
0,0,0,0,0,0,0,0,0
79508,1012,4,195,189,6,1,1,0
5311,63,2,14,14,0,0,0,0
4896,47,2,2,2,0,0,0,0
49354,614,3,149,128,21,7,1,0
30251,333,4,10,10,0,2,1,0
23943,300,4,76,75,1,9,1,0
0,0,0,0,0,0,0,0,0
0,0,0,0,0,0,0,0,0
0,0,0,0,0,0,0,0,0
579985,2405,10,288,266,22,73,1,0
58052,658,3,59,58,1,60,0,0
0,0,0,0,0,0,0,0,0
300068,1356,13,147,146,1,0,1,0
247289,1082,14,175,174,1,0,1,0
0,0,0,0,0,0,0,0,0
0,0,0,0,0,0,0,0,0
5061,21,0,0,0,0,0,1,0
64116,995,2,406,402,4,0,1,0
0,0,0,0,0,0,0,0,0
132605,798,7,100,90,10,3,1,0
0,0,0,0,0,0,0,0,0
1043537,2241,7,304,204,100,30,1,0
34102,272,6,26,19,7,2,1,0
19945,173,6,20,15,5,3,1,0
129993,727,6,75,1,74,0,1,0
67000,397,8,40,37,3,2,1,0
0,0,0,0,0,0,0,0,0
2106,24,1,5,5,0,0,0,0
325864,550,2,68,55,13,1,0,0
159090,59,0,2,2,0,0,1,0
0,0,0,0,0,0,0,0,0
0,0,0,0,0,0,0,0,0
0,0,0,0,0,0,0,0,0
0,0,0,0,0,0,0,0,0
104831,1817,6,293,285,8,29,1,0
236151,1102,5,40,32,8,1,1,0
124302,241,7,6,4,2,1,0,0
37327,386,3,80,68,12,6,1,0
246081,2356,10,151,141,10,37,1,0
0,0,0,0,0,0,0,0,0
292566,1202,10,198,191,7,25,1,0
1004154,2836,6,133,126,7,3,1,0
0,0,0,0,0,0,0,0,0
0,0,0,0,0,0,0,0,0
13501,8,0,0,0,0,0,0,0
0,0,0,0,0,0,0,0,0
244548,892,16,21,21,0,9,1,0
51673,591,5,66,57,9,2,1,0
20474,230,5,43,34,9,1,1,0
0,0,0,0,0,0,0,0,0
0,0,0,0,0,0,0,0,0
0,0,0,0,0,0,0,0,0
0,0,0,0,0,0,0,0,0
286124,583,2,106,83,23,3,1,0
0,0,0,0,0,0,0,0,0
92154,805,13,165,152,13,4,1,0
0,0,0,0,0,0,0,0,0
65291,968,6,111,102,9,3,1,0
1911323,1106,7,100,62,38,3,1,0
168955,1419,6,239,230,9,24,0,0
0,0,0,0,0,0,0,0,0
35870,358,0,52,26,26,2,0,0
0,0,0,0,0,0,0,0,0
412104,2101,8,325,235,90,5,1,0
0,0,0,0,0,0,0,0,0
0,0,0,0,0,0,0,0,0
18743,275,4,60,59,1,0,1,0
91454,1097,3,249,249,0,2,1,0
0,0,0,0,0,0,0,0,0
154583,661,2,188,172,16,14,0,0
0,0,0,0,0,0,0,0,0
0,0,0,0,0,0,0,0,0
281719,1131,2,234,227,7,2,1,0
775918,755,6,124,97,27,0,1,0
151075,457,7,67,1,66,2,1,0
0,0,0,0,0,0,0,0,0
0,0,0,0,0,0,0,0,0
181847,1017,2,242,26,216,0,1,0
0,0,0,0,0,0,0,0,0
78085,968,5,111,73,38,4,1,0
0,0,0,0,0,0,0,0,0
156322,884,3,84,78,6,19,1,0
67170,194,4,26,16,10,0,0,0
4285158,22907,10,321,318,3,499,1,0
201752,100,2,6,6,0,0,1,0
101659,1164,7,188,182,6,3,1,0
124313,486,7,51,23,28,10,1,0
0,0,0,0,0,0,0,0,0
0,0,0,0,0,0,0,0,0
119708,710,9,127,122,5,2,1,0
0,0,0,0,0,0,0,0,0
102463,1355,7,270,264,6,7,1,0
0,0,0,0,0,0,0,0,0
0,0,0,0,0,0,0,0,0
0,0,0,0,0,0,0,0,0
633034,3070,16,484,461,23,5,1,0
0,0,0,0,0,0,0,0,0
6040,76,5,4,2,2,0,1,0
5393,63,5,3,1,2,0,1,0
79922,811,9,161,121,40,1,1,0
0,0,0,0,0,0,0,0,0
285173,1055,11,161,139,22,14,1,0
235454,1184,7,93,88,5,5,1,0
14064,86,3,9,9,0,0,1,0
0,0,0,0,0,0,0,0,0
0,0,0,0,0,0,0,0,0
34620,334,7,89,89,0,1,0,0
0,0,0,0,0,0,0,0,0
38648,368,8,38,34,4,6,1,0
0,0,0,0,0,0,0,0,0
0,0,0,0,0,0,0,0,0
0,0,0,0,0,0,0,0,0
0,0,0,0,0,0,0,0,0
370598,778,10,100,90,10,6,1,0
10861,68,2,1,1,0,0,0,0
0,0,0,0,0,0,0,0,0
0,0,0,0,0,0,0,0,0
0,0,0,0,0,0,0,0,0
6124,45,0,9,7,2,0,0,0
960547,343,5,15,9,6,5,1,0
442742,2825,15,354,318,36,5,0,0
0,0,0,0,0,0,0,0,0
0,0,0,0,0,0,0,0,0
136258,970,9,165,120,45,7,1,0
0,0,0,0,0,0,0,0,0
0,0,0,0,0,0,0,0,0
119013,547,9,107,81,26,11,1,0
119031,547,9,107,81,26,11,1,0
91082,1046,14,101,97,4,6,1,0
349697,5073,2,1490,1480,10,79,1,0
88784,983,5,296,253,43,10,0,0
534,11,0,2,2,0,0,0,0
3650,51,3,3,1,2,0,0,0
0,0,0,0,0,0,0,0,0
392455,1888,2,266,192,74,0,1,0
0,0,0,0,0,0,0,0,0
1018064,4857,9,771,746,25,3,1,0
504017,1276,10,199,168,31,4,1,0
135725,766,6,151,147,4,10,1,0
400978,1557,10,233,113,120,4,1,0
1346,17,1,0,0,0,0,0,0
176317,2661,5,394,360,34,2,1,0
0,0,0,0,0,0,0,0,0
36182,615,5,49,41,8,1,1,0
0,0,0,0,0,0,0,0,0
0,0,0,0,0,0,0,0,0
94669,684,6,118,102,16,18,1,0
63393,681,6,118,102,16,18,1,0
213286,1898,7,408,358,50,9,1,0
38572,613,5,181,153,28,6,1,0
0,0,0,0,0,0,0,0,0
157877,234,1,12,12,0,0,1,0
22434,185,1,13,13,0,0,1,0
0,0,0,0,0,0,0,0,0
0,0,0,0,0,0,0,0,0
26149,262,6,18,16,2,3,1,0
348482,1291,5,143,19,124,0,1,0
0,0,0,0,0,0,0,0,0
159656,1141,6,250,238,12,1,0,0
0,0,0,0,0,0,0,0,0
381259,1386,14,128,125,3,5,1,0
216443,379,9,55,53,2,5,1,0
222380,624,2,49,46,3,1,0,0
0,0,0,0,0,0,0,0,0
0,0,0,0,0,0,0,0,0
53037,318,14,55,51,4,0,1,0
25626,555,2,171,154,17,0,1,0
59307,413,2,180,180,0,6,1,0
11613,175,1,29,27,2,0,1,0
858137,3856,8,417,322,95,28,1,0
267120,901,11,179,169,10,3,1,0
568563,166,3,16,8,8,2,0,0
151985,1624,9,385,366,19,3,1,0
0,0,0,0,0,0,0,0,0
0,0,0,0,0,0,0,0,0
0,0,0,0,0,0,0,0,0
223209,985,4,362,342,20,1,0,0
16959,225,8,23,22,1,0,1,0
0,0,0,0,0,0,0,0,0
0,0,0,0,0,0,0,0,0
0,0,0,0,0,0,0,0,0
0,0,0,0,0,0,0,0,0
277936,4776,5,381,372,9,26,1,0
30842,402,5,102,93,9,7,1,0
0,0,0,0,0,0,0,0,0
67318,545,12,100,99,1,1,1,0
15809,182,2,24,22,2,2,1,0
65290,599,2,173,169,4,9,1,0
232222,898,5,84,75,9,3,1,0
1170092,4260,0,295,270,25,5,1,0
1574,31,0,4,0,4,0,0,0
1406066,2256,5,70,70,0,6,1,0
92467,1041,2,60,33,27,2,1,0
340483,3187,6,452,424,28,18,1,0
22204,34,0,1,1,0,0,1,0
93384,588,9,102,99,3,4,1,0
135924,788,14,173,158,15,3,1,0
0,0,0,0,0,0,0,0,0
0,0,0,0,0,0,0,0,0
181975,1072,10,231,223,8,7,1,0
74665,405,11,55,47,8,0,1,0
0,0,0,0,0,0,0,0,0
0,0,0,0,0,0,0,0,0
159690,939,12,157,143,14,10,1,0
0,0,0,0,0,0,0,0,0
310957,2144,8,416,402,14,11,0,0
40736,287,4,62,47,15,1,0,0
128613,662,2,27,18,9,3,0,0
0,0,0,0,0,0,0,0,0
81169,803,8,178,167,11,3,1,0
201357,3121,0,354,353,1,0,1,0
0,0,0,0,0,0,0,0,0
68434,565,8,144,138,6,0,1,0
77941,1002,2,153,147,6,5,1,0
69280,610,5,161,158,3,32,1,0
3533,64,2,12,12,0,2,1,0
0,0,0,0,0,0,0,0,0
87998,825,8,154,138,16,1,1,0
340206,1894,7,368,354,14,23,1,0
0,0,0,0,0,0,0,0,0
0,0,0,0,0,0,0,0,0
66143,262,4,20,20,0,1,1,0
0,0,0,0,0,0,0,0,0
0,0,0,0,0,0,0,0,0
0,0,0,0,0,0,0,0,0
77162,677,3,128,116,12,0,0,0
11881,57,4,3,3,0,2,0,0
15335,210,2,56,50,6,1,0,0
11968,169,3,36,33,3,2,0,0
1136924,1695,13,323,300,23,25,1,0
0,0,0,0,0,0,0,0,0
90015,777,9,313,313,0,10,1,0
23804,166,9,34,34,0,7,1,0
0,0,0,0,0,0,0,0,0
0,0,0,0,0,0,0,0,0
261312,1326,13,155,149,6,13,1,0
328129,1498,11,139,137,2,4,1,0
722459,542,0,4,0,4,2,1,1
0,0,0,0,0,0,0,0,0
60294,650,7,191,153,38,1,1,0
291679,1658,6,281,267,14,3,0,0
528135,1456,5,78,5,73,8,1,0
328981,130,2,7,6,1,0,1,0
0,0,0,0,0,0,0,0,0
0,0,0,0,0,0,0,0,0
250903,1800,7,140,111,29,17,1,0
191078,1990,17,321,315,6,12,0,0
180432,987,3,95,93,2,2,1,0
0,0,0,0,0,0,0,0,0
0,0,0,0,0,0,0,0,0
0,0,0,0,0,0,0,0,0
113121,1021,13,134,55,79,9,1,0
151323,2643,3,327,320,7,47,1,0
31896,315,2,8,6,2,0,1,0
31896,315,2,8,6,2,0,1,0
458557,1543,9,233,224,9,14,1,0
0,0,0,0,0,0,0,0,0
24994,293,5,32,26,6,0,1,0
23691,46,0,5,2,3,0,0,0
39212,348,5,26,14,12,0,1,0
69341,723,4,135,129,6,12,1,0
7439,148,0,2,1,1,0,0,0
0,0,0,0,0,0,0,0,0
0,0,0,0,0,0,0,0,0
0,0,0,0,0,0,0,0,0
0,0,0,0,0,0,0,0,0
0,0,0,0,0,0,0,0,0
1101680,4377,6,1084,1076,8,11,1,0
1019681,3871,6,1016,1014,2,12,1,0
220597,2327,6,293,275,18,2,0,0
356070,380,9,31,31,0,2,1,0
154817,1516,8,275,256,19,43,1,0
0,0,0,0,0,0,0,0,0
151196,3613,2,1120,1114,6,20,1,0
1644,39,0,4,4,0,0,1,0
91592,544,9,89,85,4,0,0,0
0,0,0,0,0,0,0,0,0
175700,730,5,226,208,18,2,1,0
0,0,0,0,0,0,0,0,0
0,0,0,0,0,0,0,0,0
0,0,0,0,0,0,0,0,0
0,0,0,0,0,0,0,0,0
0,0,0,0,0,0,0,0,0
0,0,0,0,0,0,0,0,0
0,0,0,0,0,0,0,0,0
0,0,0,0,0,0,0,0,0
0,0,0,0,0,0,0,0,0
0,0,0,0,0,0,0,0,0
0,0,0,0,0,0,0,0,0
0,0,0,0,0,0,0,0,0
0,0,0,0,0,0,0,0,0
0,0,0,0,0,0,0,0,0
0,0,0,0,0,0,0,0,0
0,0,0,0,0,0,0,0,0
0,0,0,0,0,0,0,0,0
0,0,0,0,0,0,0,0,0
0,0,0,0,0,0,0,0,0
0,0,0,0,0,0,0,0,0
0,0,0,0,0,0,0,0,0
0,0,0,0,0,0,0,0,0
0,0,0,0,0,0,0,0,0
0,0,0,0,0,0,0,0,0
0,0,0,0,0,0,0,0,0
0,0,0,0,0,0,0,0,0
0,0,0,0,0,0,0,0,0
0,0,0,0,0,0,0,0,0
0,0,0,0,0,0,0,0,0
0,0,0,0,0,0,0,0,0
0,0,0,0,0,0,0,0,0
0,0,0,0,0,0,0,0,0
0,0,0,0,0,0,0,0,0
0,0,0,0,0,0,0,0,0
0,0,0,0,0,0,0,0,0
0,0,0,0,0,0,0,0,0
0,0,0,0,0,0,0,0,0
0,0,0,0,0,0,0,0,0
0,0,0,0,0,0,0,0,0
0,0,0,0,0,0,0,0,0
0,0,0,0,0,0,0,0,0
0,0,0,0,0,0,0,0,0
0,0,0,0,0,0,0,0,0
0,0,0,0,0,0,0,0,0
0,0,0,0,0,0,0,0,0
0,0,0,0,0,0,0,0,0
0,0,0,0,0,0,0,0,0
0,0,0,0,0,0,0,0,0
0,0,0,0,0,0,0,0,0
0,0,0,0,0,0,0,0,0
0,0,0,0,0,0,0,0,0
0,0,0,0,0,0,0,0,0
0,0,0,0,0,0,0,0,0
0,0,0,0,0,0,0,0,0
0,0,0,0,0,0,0,0,0
0,0,0,0,0,0,0,0,0
0,0,0,0,0,0,0,0,0
0,0,0,0,0,0,0,0,0
0,0,0,0,0,0,0,0,0
0,0,0,0,0,0,0,0,0
0,0,0,0,0,0,0,0,0
0,0,0,0,0,0,0,0,0
0,0,0,0,0,0,0,0,0
0,0,0,0,0,0,0,0,0
0,0,0,0,0,0,0,0,0
0,0,0,0,0,0,0,0,0
0,0,0,0,0,0,0,0,0
0,0,0,0,0,0,0,0,0
0,0,0,0,0,0,0,0,0
0,0,0,0,0,0,0,0,0
0,0,0,0,0,0,0,0,0
0,0,0,0,0,0,0,0,0
0,0,0,0,0,0,0,0,0
0,0,0,0,0,0,0,0,0
0,0,0,0,0,0,0,0,0
0,0,0,0,0,0,0,0,0
0,0,0,0,0,0,0,0,0
0,0,0,0,0,0,0,0,0
0,0,0,0,0,0,0,0,0
0,0,0,0,0,0,0,0,0
0,0,0,0,0,0,0,0,0
0,0,0,0,0,0,0,0,0
0,0,0,0,0,0,0,0,0
0,0,0,0,0,0,0,0,0
0,0,0,0,0,0,0,0,0
0,0,0,0,0,0,0,0,0
0,0,0,0,0,0,0,0,0
0,0,0,0,0,0,0,0,0
0,0,0,0,0,0,0,0,0
0,0,0,0,0,0,0,0,0
0,0,0,0,0,0,0,0,0
0,0,0,0,0,0,0,0,0
0,0,0,0,0,0,0,0,0
0,0,0,0,0,0,0,0,0
0,0,0,0,0,0,0,0,0
0,0,0,0,0,0,0,0,0
0,0,0,0,0,0,0,0,0
0,0,0,0,0,0,0,0,0
0,0,0,0,0,0,0,0,0
0,0,0,0,0,0,0,0,0
0,0,0,0,0,0,0,0,0
0,0,0,0,0,0,0,0,0
0,0,0,0,0,0,0,0,0
0,0,0,0,0,0,0,0,0
0,0,0,0,0,0,0,0,0
0,0,0,0,0,0,0,0,0
0,0,0,0,0,0,0,0,0
0,0,0,0,0,0,0,0,0
0,0,0,0,0,0,0,0,0
0,0,0,0,0,0,0,0,0
0,0,0,0,0,0,0,0,0
0,0,0,0,0,0,0,0,0
0,0,0,0,0,0,0,0,0
0,0,0,0,0,0,0,0,0
0,0,0,0,0,0,0,0,0
0,0,0,0,0,0,0,0,0
0,0,0,0,0,0,0,0,0
0,0,0,0,0,0,0,0,0
0,0,0,0,0,0,0,0,0
0,0,0,0,0,0,0,0,0
0,0,0,0,0,0,0,0,0
0,0,0,0,0,0,0,0,0
0,0,0,0,0,0,0,0,0
0,0,0,0,0,0,0,0,0
0,0,0,0,0,0,0,0,0
0,0,0,0,0,0,0,0,0
0,0,0,0,0,0,0,0,0
0,0,0,0,0,0,0,0,0
0,0,0,0,0,0,0,0,0
0,0,0,0,0,0,0,0,0
0,0,0,0,0,0,0,0,0
0,0,0,0,0,0,0,0,0
0,0,0,0,0,0,0,0,0
0,0,0,0,0,0,0,0,0
0,0,0,0,0,0,0,0,0
0,0,0,0,0,0,0,0,0
0,0,0,0,0,0,0,0,0
0,0,0,0,0,0,0,0,0
0,0,0,0,0,0,0,0,0
0,0,0,0,0,0,0,0,0
0,0,0,0,0,0,0,0,0
0,0,0,0,0,0,0,0,0
0,0,0,0,0,0,0,0,0
0,0,0,0,0,0,0,0,0
0,0,0,0,0,0,0,0,0
0,0,0,0,0,0,0,0,0
0,0,0,0,0,0,0,0,0
0,0,0,0,0,0,0,0,0
0,0,0,0,0,0,0,0,0
0,0,0,0,0,0,0,0,0
0,0,0,0,0,0,0,0,0
0,0,0,0,0,0,0,0,0
0,0,0,0,0,0,0,0,0
0,0,0,0,0,0,0,0,0
0,0,0,0,0,0,0,0,0
0,0,0,0,0,0,0,0,0
0,0,0,0,0,0,0,0,0
0,0,0,0,0,0,0,0,0
0,0,0,0,0,0,0,0,0
0,0,0,0,0,0,0,0,0
0,0,0,0,0,0,0,0,0
0,0,0,0,0,0,0,0,0
0,0,0,0,0,0,0,0,0
0,0,0,0,0,0,0,0,0
0,0,0,0,0,0,0,0,0
0,0,0,0,0,0,0,0,0
0,0,0,0,0,0,0,0,0
0,0,0,0,0,0,0,0,0
0,0,0,0,0,0,0,0,0
0,0,0,0,0,0,0,0,0
0,0,0,0,0,0,0,0,0
0,0,0,0,0,0,0,0,0
0,0,0,0,0,0,0,0,0
0,0,0,0,0,0,0,0,0
0,0,0,0,0,0,0,0,0
0,0,0,0,0,0,0,0,0
0,0,0,0,0,0,0,0,0
0,0,0,0,0,0,0,0,0
0,0,0,0,0,0,0,0,0
0,0,0,0,0,0,0,0,0
0,0,0,0,0,0,0,0,0
0,0,0,0,0,0,0,0,0
0,0,0,0,0,0,0,0,0
0,0,0,0,0,0,0,0,0
0,0,0,0,0,0,0,0,0
0,0,0,0,0,0,0,0,0
0,0,0,0,0,0,0,0,0
0,0,0,0,0,0,0,0,0
0,0,0,0,0,0,0,0,0
0,0,0,0,0,0,0,0,0
0,0,0,0,0,0,0,0,0
0,0,0,0,0,0,0,0,0
0,0,0,0,0,0,0,0,0
0,0,0,0,0,0,0,0,0
0,0,0,0,0,0,0,0,0
0,0,0,0,0,0,0,0,0
0,0,0,0,0,0,0,0,0
0,0,0,0,0,0,0,0,0
0,0,0,0,0,0,0,0,0
0,0,0,0,0,0,0,0,0
0,0,0,0,0,0,0,0,0
0,0,0,0,0,0,0,0,0
0,0,0,0,0,0,0,0,0
0,0,0,0,0,0,0,0,0
0,0,0,0,0,0,0,0,0
0,0,0,0,0,0,0,0,0
0,0,0,0,0,0,0,0,0
0,0,0,0,0,0,0,0,0
0,0,0,0,0,0,0,0,0
0,0,0,0,0,0,0,0,0
0,0,0,0,0,0,0,0,0
0,0,0,0,0,0,0,0,0
0,0,0,0,0,0,0,0,0
0,0,0,0,0,0,0,0,0
0,0,0,0,0,0,0,0,0
0,0,0,0,0,0,0,0,0
598150,5361,10,558,461,97,27,1,1
255708,679,10,120,101,19,21,1,0
0,0,0,0,0,0,0,0,0
108209,478,6,84,83,1,0,0,0
0,0,0,0,0,0,0,0,0
0,0,0,0,0,0,0,0,0
282605,1101,3,130,15,115,2,1,0
0,0,0,0,0,0,0,0,0
170591,1131,6,175,163,12,12,1,0
234345,423,2,15,13,2,4,1,0
280090,1333,9,272,256,16,13,1,0
77444,1345,7,370,362,8,13,1,0
0,0,0,0,0,0,0,0,0
0,0,0,0,0,0,0,0,0
0,0,0,0,0,0,0,0,0
25619,272,3,47,47,0,0,1,0
0,0,0,0,0,0,0,0,0
0,0,0,0,0,0,0,0,0
458127,3398,9,409,392,17,6,1,0
44439,981,4,352,352,0,1,0,0
200549,1449,2,175,162,13,4,1,0
0,0,0,0,0,0,0,0,0
243122,1265,4,153,132,21,1,1,0
105773,678,6,194,185,9,0,1,0
86847,865,8,85,80,5,4,0,0
31829,299,8,65,62,3,7,0,0
115656,816,2,139,134,5,35,0,0
64413,237,4,20,20,0,0,1,0
166028,1355,3,209,200,9,3,1,0
106621,1227,5,279,261,18,1,1,0
0,0,0,0,0,0,0,0,0
499900,4292,11,568,508,60,76,1,0
19573,117,4,18,17,1,0,1,0
0,0,0,0,0,0,0,0,0
0,0,0,0,0,0,0,0,0
0,0,0,0,0,0,0,0,0
7084,153,0,46,40,6,0,0,0
0,0,0,0,0,0,0,0,0
0,0,0,0,0,0,0,0,0
151786,1008,8,221,192,29,2,1,0
39975,90,2,5,5,0,0,1,0
54357,323,8,73,73,0,2,1,0
0,0,0,0,0,0,0,0,0
376713,1932,6,432,416,16,13,1,0
335824,866,3,156,145,11,2,1,0
6747,58,0,10,10,0,0,0,0
16832,132,1,10,10,0,0,0,0
27880,42,0,2,1,1,0,0,0
479025,2303,9,394,351,43,10,1,0
478572,2303,9,394,351,43,10,1,0
0,0,0,0,0,0,0,0,0
0,0,0,0,0,0,0,0,0
394356,2804,4,318,294,24,5,1,0
77395,728,2,68,57,11,7,1,0
102069,1031,3,239,237,2,10,1,0
191252,1387,2,393,374,19,19,1,0
0,0,0,0,0,0,0,0,0
133316,792,8,193,182,11,2,1,0
425593,1725,11,207,184,23,16,1,0
323588,1333,10,193,170,23,16,1,0
0,0,0,0,0,0,0,0,0
9202,144,4,44,44,0,3,1,0
0,0,0,0,0,0,0,0,0
0,0,0,0,0,0,0,0,0
140427,2328,10,540,486,54,26,1,0
119508,352,10,69,17,52,13,1,0
197268,547,0,15,4,11,17,0,0
25253,192,3,31,21,10,1,1,0
13409,81,3,12,11,1,2,1,0
0,0,0,0,0,0,0,0,0
0,0,0,0,0,0,0,0,0
0,0,0,0,0,0,0,0,0
0,0,0,0,0,0,0,0,0
14110,185,1,54,53,1,0,1,0
211035,180,0,47,32,15,1,1,0
22844,37,0,2,1,1,0,1,0
0,0,0,0,0,0,0,0,0
63289,625,1,69,6,63,4,1,0
0,0,0,0,0,0,0,0,0
146357,606,3,83,79,4,2,1,0
194980,2058,3,400,390,10,1,1,0
232840,346,0,17,11,6,0,1,0
0,0,0,0,0,0,0,0,0
675391,1095,6,132,116,16,3,1,0
0,0,0,0,0,0,0,0,0
27687,42,0,2,1,1,0,0,0
0,0,0,0,0,0,0,0,0
0,0,0,0,0,0,0,0,0
295909,4372,6,560,548,12,63,1,0
0,0,0,0,0,0,0,0,0
159488,940,7,3,0,3,21,0,0
0,0,0,0,0,0,0,0,0
1411,32,0,4,4,0,0,0,0
18421,239,4,40,35,5,2,1,0
27420,86,0,1,0,1,0,0,0
0,0,0,0,0,0,0,0,0
0,0,0,0,0,0,0,0,0
0,0,0,0,0,0,0,0,0
214044,2343,7,401,298,103,36,1,0
0,0,0,0,0,0,0,0,0
414205,2278,2,279,227,52,2,1,0
3713,75,2,8,8,0,0,1,0
57336,566,3,100,96,4,8,1,0
18994,215,2,44,42,2,7,1,0
0,0,0,0,0,0,0,0,0
170478,1131,9,157,31,126,0,0,0
92875,445,9,59,57,2,0,0,0
0,0,0,0,0,0,0,0,0
0,0,0,0,0,0,0,0,0
0,0,0,0,0,0,0,0,0
142165,3259,2,815,780,35,480,1,0
0,0,0,0,0,0,0,0,0
0,0,0,0,0,0,0,0,0
0,0,0,0,0,0,0,0,0
0,0,0,0,0,0,0,0,0
263345,1519,13,435,435,0,14,1,0
251783,2054,14,371,370,1,14,1,0
149918,777,6,69,56,13,5,1,0
0,0,0,0,0,0,0,0,0
0,0,0,0,0,0,0,0,0
159988,483,4,42,35,7,4,1,0
0,0,0,0,0,0,0,0,0
0,0,0,0,0,0,0,0,0
124059,914,7,160,147,13,2,1,1
48225,826,1,127,127,0,6,1,0
47715,598,0,101,85,16,12,1,0
24643,333,0,88,79,9,7,1,0
68393,292,9,34,13,21,0,0,0
88589,980,11,154,142,12,7,1,0
46325,366,10,72,67,5,8,1,0
38543,425,4,48,41,7,0,0,0
0,0,0,0,0,0,0,0,0
5663,103,1,8,8,0,0,0,0
84766,963,0,61,33,28,2,1,0
8702,63,1,7,6,1,6,1,0
2113981,3040,6,235,229,6,4,1,0
90593,642,6,59,52,7,8,1,0
296254,2026,6,244,236,8,10,1,0
0,0,0,0,0,0,0,0,0
114778,980,15,207,199,8,8,1,0
0,0,0,0,0,0,0,0,0
0,0,0,0,0,0,0,0,0
0,0,0,0,0,0,0,0,0
0,0,0,0,0,0,0,0,0
0,0,0,0,0,0,0,0,0
28241,211,4,26,25,1,0,1,0
0,0,0,0,0,0,0,0,0
0,0,0,0,0,0,0,0,0
585,5,0,0,0,0,0,0,1
0,0,0,0,0,0,0,0,0
298461,1743,9,268,243,25,19,1,0
20658,209,4,24,24,0,0,1,0
128505,821,14,83,73,10,6,1,0
17871,425,5,122,116,6,1,0,0
0,0,0,0,0,0,0,0,0
336888,1738,6,158,116,42,3,0,0
22152,258,7,82,77,5,7,1,0
0,0,0,0,0,0,0,0,0
0,0,0,0,0,0,0,0,0
27646,42,0,2,1,1,0,0,0
0,0,0,0,0,0,0,0,0
0,0,0,0,0,0,0,0,0
154438,2698,4,243,235,8,3,1,0
10923,148,3,10,8,2,1,1,0
55432,721,0,154,152,2,0,1,0
20438,211,0,30,29,1,0,1,0
0,0,0,0,0,0,0,0,0
43398,328,7,101,97,4,0,1,0
232722,1942,3,495,475,20,2,1,1
0,0,0,0,0,0,0,0,0
404882,3787,4,565,423,142,1,1,0
247921,1207,13,264,237,27,21,1,0
0,0,0,0,0,0,0,0,0
28300,42,0,2,1,1,0,0,0
75749,926,7,110,102,8,2,0,0
0,0,0,0,0,0,0,0,0
96928,1162,8,87,85,2,0,1,0
96929,1162,8,87,85,2,0,1,0
31239,576,6,91,88,3,0,1,0
206173,698,10,95,74,21,6,1,0
203014,610,9,22,20,2,13,1,0
44905,385,7,55,19,36,0,1,0
0,0,0,0,0,0,0,0,0
37961,347,9,53,42,11,0,1,0
352577,1050,6,346,181,165,1,1,0
0,0,0,0,0,0,0,0,0
327916,4266,4,846,726,120,7,1,0
167364,1090,6,283,213,70,2,1,0
47576,540,5,110,102,8,3,1,0
0,0,0,0,0,0,0,0,0
17968,279,0,67,48,19,3,1,0
16661,191,0,16,10,6,3,0,0
443537,1865,5,230,188,42,6,1,0
44418,346,5,23,14,9,0,1,0
0,0,0,0,0,0,0,0,0
0,0,0,0,0,0,0,0,0
133412,1066,1,134,116,18,2,0,0
0,0,0,0,0,0,0,0,0
586972,1120,12,115,111,4,6,1,0
75015,232,9,10,8,2,6,1,0
0,0,0,0,0,0,0,0,0
101922,516,7,68,67,1,4,1,0
193516,755,5,147,146,1,10,1,0
0,0,0,0,0,0,0,0,0
24498,327,0,77,77,0,0,1,0
400585,2744,1,338,329,9,22,1,0
0,0,0,0,0,0,0,0,0
1295750,9959,11,310,304,6,16,1,0
77580,996,5,160,149,11,2,0,0
293498,1558,6,214,202,12,6,1,0
0,0,0,0,0,0,0,0,0
0,0,0,0,0,0,0,0,0
0,0,0,0,0,0,0,0,0
134834,841,8,106,98,8,19,1,0
8218,74,7,4,4,0,0,0,0
0,0,0,0,0,0,0,0,0
21686,258,4,34,25,9,2,1,0
140408,449,4,22,11,11,0,1,0
374913,3021,9,412,401,11,1,0,0
0,0,0,0,0,0,0,0,0
0,0,0,0,0,0,0,0,0
34424,392,0,82,78,4,1,1,0
48174,713,8,59,54,5,8,1,0
1941,31,0,6,0,6,0,0,0
55428,1018,4,340,312,28,10,1,0
281975,1065,0,75,63,12,4,1,0
0,0,0,0,0,0,0,0,0
0,0,0,0,0,0,0,0,0
0,0,0,0,0,0,0,0,0
61504,896,2,126,35,91,24,1,0
77456,71,1,0,0,0,0,0,0
484031,3662,13,551,538,13,17,1,0
373264,1086,16,132,122,10,9,1,0
21954,33,0,1,1,0,0,1,0
108040,748,8,75,5,70,0,1,0
189017,563,8,64,57,7,0,1,0
28250,44,0,4,3,1,0,0,0
21999,33,0,1,1,0,0,1,0
0,0,0,0,0,0,0,0,0
253419,805,7,120,81,39,16,1,0
80481,214,0,34,32,2,0,0,0
1365517,4845,4,450,444,6,179,1,0
163053,2623,6,429,375,54,41,1,0
204778,1712,4,377,264,113,3,0,0
380784,2987,3,761,731,30,3,1,0
0,0,0,0,0,0,0,0,0
404841,2051,12,290,276,14,2,0,0
91048,1467,8,82,76,6,13,1,0
42030,815,3,217,189,28,3,1,0
10693,87,3,15,14,1,1,1,0
497624,1475,7,178,176,2,9,1,0
28415,248,6,8,4,4,1,1,0
95423,846,4,170,142,28,0,1,0
0,0,0,0,0,0,0,0,0
96083,455,10,37,37,0,0,1,0
133187,1008,8,294,259,35,2,1,0
86721,328,5,43,21,22,2,1,0
0,0,0,0,0,0,0,0,0
0,0,0,0,0,0,0,0,0
110606,655,7,172,158,14,0,1,0
0,0,0,0,0,0,0,0,0
0,0,0,0,0,0,0,0,0
0,0,0,0,0,0,0,0,0
0,0,0,0,0,0,0,0,0
0,0,0,0,0,0,0,0,0
0,0,0,0,0,0,0,0,0
25875,303,1,25,23,2,6,0,0
407439,1253,14,126,2,124,41,1,0
0,0,0,0,0,0,0,0,0
0,0,0,0,0,0,0,0,0
731818,1135,7,114,4,110,0,1,0
3880,61,1,6,5,1,0,0,0
0,0,0,0,0,0,0,0,0
0,0,0,0,0,0,0,0,0
1049335,6758,13,1972,1946,26,50,1,0
93441,786,10,152,128,24,16,1,0
223039,1319,10,218,211,7,16,1,0
0,0,0,0,0,0,0,0,0
0,0,0,0,0,0,0,0,0
0,0,0,0,0,0,0,0,0
54141,601,8,30,30,0,18,1,0
29644,286,6,26,25,1,6,1,0
0,0,0,0,0,0,0,0,0
145333,1285,6,181,152,29,12,1,0
92495,726,6,123,99,24,12,1,0
112228,643,8,93,86,7,0,1,0
107479,852,6,146,124,22,8,1,0
424292,728,7,137,121,16,14,1,0
0,0,0,0,0,0,0,0,0
337028,1635,17,102,98,4,1,1,0
0,0,0,0,0,0,0,0,0
32042,459,2,85,82,3,0,1,0
0,0,0,0,0,0,0,0,0
0,0,0,0,0,0,0,0,0
0,0,0,0,0,0,0,0,0
21901,33,0,1,1,0,0,1,0
10462,122,0,24,24,0,0,1,0
135769,1562,4,621,494,127,43,1,0
135769,1562,4,621,494,127,43,1,0
135769,1562,4,621,494,127,43,1,0
0,0,0,0,0,0,0,0,0
179263,1232,11,104,84,20,1,1,0
54574,218,10,6,6,0,1,0,0
0,0,0,0,0,0,0,0,0
0,0,0,0,0,0,0,0,0
140035,1158,3,266,243,23,8,0,0
71495,823,1,208,202,6,1,1,0
444679,2829,3,122,105,17,0,1,0
62763,41,0,5,5,0,0,0,0
185076,2430,3,460,446,14,14,1,0
0,0,0,0,0,0,0,0,0
0,0,0,0,0,0,0,0,0
2337117,3246,7,149,137,12,3,0,0
0,0,0,0,0,0,0,0,0
22357,145,3,30,22,8,0,0,0
1015385,2681,4,291,0,291,0,1,0
53331,430,0,4,3,1,3,0,0
136395,472,8,85,71,14,13,1,0
102796,946,5,214,179,35,0,0,0
29603,134,5,10,8,2,0,0,0
0,0,0,0,0,0,0,0,0
43133,744,4,175,138,37,3,1,0
22439,239,0,43,35,8,0,1,0
0,0,0,0,0,0,0,0,0
0,0,0,0,0,0,0,0,0
338283,2727,5,730,710,20,29,1,0
0,0,0,0,0,0,0,0,0
0,0,0,0,0,0,0,0,0
21914,35,0,1,1,0,0,1,0
172009,2186,10,335,305,30,1,1,0
61320,968,10,138,111,27,2,1,0
0,0,0,0,0,0,0,0,0
217907,297,8,44,37,7,0,1,0
0,0,0,0,0,0,0,0,0
27308,311,4,93,85,8,1,0,0
0,0,0,0,0,0,0,0,0
169779,1095,6,160,153,7,6,1,0
0,0,0,0,0,0,0,0,0
0,0,0,0,0,0,0,0,0
0,0,0,0,0,0,0,0,0
271205,1485,8,116,46,70,6,0,0
346190,1028,7,177,159,18,12,1,0
77451,903,5,93,65,28,5,1,0
47531,114,3,5,5,0,1,0,0
0,0,0,0,0,0,0,0,0
0,0,0,0,0,0,0,0,0
0,0,0,0,0,0,0,0,0
0,0,0,0,0,0,0,0,0
0,0,0,0,0,0,0,0,0
75881,578,9,88,87,1,3,1,0
0,0,0,0,0,0,0,0,0
356173,929,5,95,74,21,8,1,0
0,0,0,0,0,0,0,0,0
87359,714,11,83,73,10,2,1,0
0,0,0,0,0,0,0,0,0
0,0,0,0,0,0,0,0,0
224822,1379,4,336,324,12,18,1,0
104226,1127,12,157,147,10,6,1,0
0,0,0,0,0,0,0,0,0
0,0,0,0,0,0,0,0,0
90128,554,4,151,144,7,8,0,0
0,0,0,0,0,0,0,0,0
557740,4161,5,505,442,63,18,0,0
353754,2792,5,332,268,64,19,0,0
60910,392,6,66,65,1,18,0,0
59480,389,6,66,65,1,19,0,0
0,0,0,0,0,0,0,0,0
75129,1149,8,113,82,31,8,1,0
37301,461,8,89,50,39,2,0,0
23036,350,6,50,45,5,0,1,0
0,0,0,0,0,0,0,0,0
0,0,0,0,0,0,0,0,0
109589,808,2,204,179,25,4,1,0
2126414,5682,5,1566,1529,37,3,1,0
0,0,0,0,0,0,0,0,0
80223,112,1,14,14,0,4,1,0
26951,394,2,116,100,16,1,1,0
0,0,0,0,0,0,0,0,0
6043,72,2,3,1,2,0,1,0
399575,2754,4,216,212,4,0,0,0
0,0,0,0,0,0,0,0,0
105329,153,1,6,6,0,0,1,0
106794,179,1,14,12,2,1,1,0
0,0,0,0,0,0,0,0,0
100028,402,1,50,37,13,1,0,0
389417,2627,10,144,108,36,1,0,0
0,0,0,0,0,0,0,0,0
0,0,0,0,0,0,0,0,0
141240,210,7,43,41,2,1,1,0
0,0,0,0,0,0,0,0,0
124445,855,9,131,118,13,1,1,0
277908,2254,11,273,253,20,11,1,0
0,0,0,0,0,0,0,0,0
124003,1052,0,156,78,78,0,1,0
101831,1208,8,339,339,0,1,1,0
0,0,0,0,0,0,0,0,0
0,0,0,0,0,0,0,0,0
874872,9907,2,97,86,11,1,1,0
68325,649,6,108,94,14,15,1,0
0,0,0,0,0,0,0,0,0
0,0,0,0,0,0,0,0,0
233014,1081,7,351,345,6,4,1,0
0,0,0,0,0,0,0,0,0
0,0,0,0,0,0,0,0,0
0,0,0,0,0,0,0,0,0
0,0,0,0,0,0,0,0,0
0,0,0,0,0,0,0,0,0
0,0,0,0,0,0,0,0,0
122628,570,5,87,69,18,4,1,0
0,0,0,0,0,0,0,0,0
0,0,0,0,0,0,0,0,0
308728,1239,3,235,220,15,5,1,0
0,0,0,0,0,0,0,0,0
238738,3108,10,204,175,29,8,1,0
63268,321,11,12,9,3,7,0,0
0,0,0,0,0,0,0,0,0
49772,687,4,126,123,3,3,0,0
16797,240,4,55,54,1,3,0,0
0,0,0,0,0,0,0,0,0
238917,3140,1,873,749,124,127,1,0
436059,3733,20,513,441,72,9,1,0
701404,927,7,41,0,41,4,0,0
177861,1599,4,185,181,4,5,1,0
0,0,0,0,0,0,0,0,0
0,0,0,0,0,0,0,0,0
0,0,0,0,0,0,0,0,0
73278,600,6,67,52,15,1,1,0
35812,436,9,81,67,14,4,1,0
0,0,0,0,0,0,0,0,0
610839,2214,2,60,57,3,0,1,0
607726,2172,2,71,68,3,0,1,0
0,0,0,0,0,0,0,0,0
154937,1693,4,289,273,16,13,1,0
106129,1313,10,179,170,9,5,1,0
3676,41,4,2,2,0,0,0,0
0,0,0,0,0,0,0,0,0
42872,485,7,47,42,5,1,1,0
0,0,0,0,0,0,0,0,0
76660,594,7,118,95,23,8,1,0
1331774,667,7,6,6,0,7,1,0
408131,2791,15,467,306,161,22,1,0
0,0,0,0,0,0,0,0,0
0,0,0,0,0,0,0,0,0
211566,1322,3,207,200,7,63,1,0
288633,1881,4,124,82,42,4,1,0
0,0,0,0,0,0,0,0,0
47533,446,3,84,41,43,3,0,0
55968,873,3,240,230,10,11,0,0
15817,272,2,72,67,5,11,0,0
210728,4826,3,882,881,1,0,0,0
3829,53,1,5,5,0,0,0,0
0,0,0,0,0,0,0,0,0
201246,1562,7,184,139,45,1,1,0
189581,1132,8,190,39,151,23,1,0
278615,5355,3,521,510,11,0,0,0
87567,1179,4,172,167,5,0,1,0
8342,82,2,4,1,3,2,0,0
22719,37,0,2,1,1,0,1,0
104026,619,4,126,120,6,5,0,0
0,0,0,0,0,0,0,0,0
213234,2214,10,383,382,1,0,1,0
0,0,0,0,0,0,0,0,0
173500,1277,7,201,195,6,20,1,0
0,0,0,0,0,0,0,0,0
0,0,0,0,0,0,0,0,0
0,0,0,0,0,0,0,0,0
0,0,0,0,0,0,0,0,0
0,0,0,0,0,0,0,0,0
145934,630,13,66,64,2,22,1,0
0,0,0,0,0,0,0,0,0
0,0,0,0,0,0,0,0,0
0,0,0,0,0,0,0,0,0
191296,745,14,172,157,15,17,1,0
0,0,0,0,0,0,0,0,0
0,0,0,0,0,0,0,0,0
0,0,0,0,0,0,0,0,0
162241,868,6,108,85,23,5,1,0
93731,985,11,132,119,13,26,0,0
331989,1810,1,378,327,51,1,1,0
0,0,0,0,0,0,0,0,0
0,0,0,0,0,0,0,0,0
0,0,0,0,0,0,0,0,0
41121,448,2,67,56,11,0,1,0
160972,1457,13,175,153,22,17,0,0
0,0,0,0,0,0,0,0,0
0,0,0,0,0,0,0,0,0
51208,306,3,64,26,38,4,1,0
184721,841,6,157,152,5,15,1,0
276226,2596,4,259,250,9,88,0,0
89130,1392,6,296,236,60,5,1,0
0,0,0,0,0,0,0,0,0
111495,887,3,108,94,14,8,1,0
0,0,0,0,0,0,0,0,0
0,0,0,0,0,0,0,0,0
0,0,0,0,0,0,0,0,0
58061,649,9,34,33,1,1,1,0
0,0,0,0,0,0,0,0,0
0,0,0,0,0,0,0,0,0
0,0,0,0,0,0,0,0,0
124756,1028,8,257,223,34,4,1,0
0,0,0,0,0,0,0,0,0
96442,1405,8,49,47,2,28,1,0
195507,1644,12,404,403,1,55,1,0
89677,263,0,48,40,8,0,1,1
0,0,0,0,0,0,0,0,0
0,0,0,0,0,0,0,0,0
0,0,0,0,0,0,0,0,0
116388,585,6,78,69,9,8,1,0
1885587,16066,6,5643,5633,10,4,1,0
221365,1184,4,83,14,69,4,0,0
546100,1535,8,180,175,5,10,0,0
48469,671,6,92,66,26,1,1,0
0,0,0,0,0,0,0,0,0
0,0,0,0,0,0,0,0,0
0,0,0,0,0,0,0,0,0
234099,577,3,27,9,18,1,0,0
0,0,0,0,0,0,0,0,0
0,0,0,0,0,0,0,0,0
0,0,0,0,0,0,0,0,0
0,0,0,0,0,0,0,0,0
198,6,0,0,0,0,0,0,0
0,0,0,0,0,0,0,0,0
511712,1452,12,124,50,74,19,1,0
0,0,0,0,0,0,0,0,0
0,0,0,0,0,0,0,0,0
42359,478,3,123,41,82,0,1,0
28308,282,1,44,43,1,1,1,0
0,0,0,0,0,0,0,0,0
0,0,0,0,0,0,0,0,0
0,0,0,0,0,0,0,0,0
0,0,0,0,0,0,0,0,0
146296,1517,5,169,83,86,0,1,0
505558,2849,9,376,301,75,29,1,0
67661,424,5,67,67,0,0,0,0
0,0,0,0,0,0,0,0,0
0,0,0,0,0,0,0,0,0
78677,874,7,235,220,15,12,1,0
56087,645,5,192,181,11,6,1,0
1124711,7840,4,2154,1711,443,3,1,0
676117,557,0,4,2,2,2,1,1
228493,2343,2,261,259,2,1,1,0
233885,1837,13,460,403,57,17,1,0
6922,116,3,39,35,4,0,0,0
22909,37,0,2,1,1,0,1,0
132523,961,7,232,222,10,6,1,0
0,0,0,0,0,0,0,0,0
43788,578,2,126,94,32,0,1,0
0,0,0,0,0,0,0,0,0
0,0,0,0,0,0,0,0,0
0,0,0,0,0,0,0,0,0
43750,700,4,154,130,24,3,1,0
0,0,0,0,0,0,0,0,0
360412,4570,12,933,909,24,16,1,0
0,0,0,0,0,0,0,0,0
472032,2424,16,141,86,55,14,1,0
107764,1532,10,283,277,6,8,1,0
93705,1333,10,251,245,6,8,1,0
101739,971,8,35,25,10,2,1,0
0,0,0,0,0,0,0,0,0
226309,973,9,218,212,6,6,1,0
0,0,0,0,0,0,0,0,0
21641,213,5,31,28,3,0,1,0
0,0,0,0,0,0,0,0,0
125772,1197,12,258,235,23,5,1,0
2453,43,3,0,0,0,0,0,0
178349,1125,3,289,246,43,0,1,0
22667,34,0,1,1,0,0,1,0
0,0,0,0,0,0,0,0,0
33886,656,3,105,99,6,0,1,0
1582203,10673,12,247,241,6,6,1,0
1501957,12611,12,131,125,6,9,1,0
0,0,0,0,0,0,0,0,0
0,0,0,0,0,0,0,0,0
1077398,11390,5,2448,2439,9,0,1,0
492302,4120,7,983,970,13,2,1,0
111264,2190,6,297,264,33,2,0,0
90304,263,0,48,24,24,0,1,1
175010,141,0,5,5,0,0,0,0
260963,933,7,178,176,2,7,1,0
916282,968,8,45,43,2,4,0,0
599797,982,8,65,42,23,4,1,0
0,0,0,0,0,0,0,0,0
143671,759,7,139,114,25,7,1,0
0,0,0,0,0,0,0,0,0
573994,2556,4,215,201,14,3,1,0
2539,33,0,2,2,0,0,0,0
124224,991,1,189,182,7,82,1,0
32742,118,2,16,10,6,4,1,0
294812,4608,10,719,698,21,31,1,0
0,0,0,0,0,0,0,0,0
109179,1357,5,220,193,27,7,1,0
0,0,0,0,0,0,0,0,0
252259,1975,4,172,144,28,6,1,0
43540,422,6,86,83,3,9,0,0
99683,673,7,87,44,43,5,1,0
110075,594,10,39,22,17,2,1,0
10934,238,1,99,96,3,0,1,0
0,0,0,0,0,0,0,0,0
636719,2377,9,334,268,66,17,1,0
0,0,0,0,0,0,0,0,0
140025,2191,12,421,416,5,6,1,0
225025,2073,2,213,170,43,1,0,0
94072,790,4,127,122,5,6,1,0
158344,472,10,64,34,30,6,1,0
0,0,0,0,0,0,0,0,0
0,0,0,0,0,0,0,0,0
22027,34,0,1,1,0,0,1,0
0,0,0,0,0,0,0,0,0
0,0,0,0,0,0,0,0,0
361004,1438,11,94,90,4,10,1,0
0,0,0,0,0,0,0,0,0
71646,1202,0,191,189,2,0,1,0
229012,3017,4,667,655,12,4,1,0
76413,699,5,74,74,0,4,1,0
9995,65,0,3,3,0,0,0,0
14679,321,3,116,116,0,0,1,0
0,0,0,0,0,0,0,0,0
2491,28,4,0,0,0,0,0,0
81007,1389,2,268,257,11,0,1,1
395453,2203,11,91,84,7,5,1,0
0,0,0,0,0,0,0,0,0
0,0,0,0,0,0,0,0,0
0,0,0,0,0,0,0,0,0
22950,37,0,2,1,1,0,1,0
120503,856,9,117,112,5,3,0,0
137569,910,9,122,112,10,3,0,0
111257,663,1,138,137,1,20,1,0
351527,2248,9,191,152,39,14,1,0
163991,879,10,77,38,39,21,1,0
0,0,0,0,0,0,0,0,0
0,0,0,0,0,0,0,0,0
0,0,0,0,0,0,0,0,0
49663,974,1,452,428,24,0,1,0
3346,65,0,14,14,0,0,1,0
0,0,0,0,0,0,0,0,0
0,0,0,0,0,0,0,0,0
405492,2724,15,358,350,8,5,1,0
63316,439,15,53,46,7,5,1,0
0,0,0,0,0,0,0,0,0
98820,1313,9,114,110,4,18,1,0
0,0,0,0,0,0,0,0,0
76568,578,1,25,25,0,2,1,0
0,0,0,0,0,0,0,0,0
9803,104,3,12,12,0,2,1,0
0,0,0,0,0,0,0,0,0
189590,566,11,77,65,12,8,1,0
0,0,0,0,0,0,0,0,0
891623,8028,6,2708,2645,63,75,1,0
0,0,0,0,0,0,0,0,0
0,0,0,0,0,0,0,0,0
0,0,0,0,0,0,0,0,0
0,0,0,0,0,0,0,0,0
53933,550,8,112,77,35,7,0,0
127567,456,11,36,34,2,3,1,0
21723,359,1,89,71,18,2,1,0
585421,502,5,67,60,7,4,0,0
5206,68,0,4,4,0,0,0,0
0,0,0,0,0,0,0,0,0
0,0,0,0,0,0,0,0,0
0,0,0,0,0,0,0,0,0
0,0,0,0,0,0,0,0,0
0,0,0,0,0,0,0,0,0
0,0,0,0,0,0,0,0,0
66898,647,4,145,137,8,1,1,0
31766,392,7,78,74,4,1,1,0
59603,918,2,372,372,0,7,0,0
0,0,0,0,0,0,0,0,0
47179,409,7,57,19,38,0,1,0
0,0,0,0,0,0,0,0,0
0,0,0,0,0,0,0,0,0
0,0,0,0,0,0,0,0,0
0,0,0,0,0,0,0,0,0
73851,1313,3,345,329,16,6,0,0
62466,1130,2,324,312,12,6,0,0
90045,645,2,118,101,17,3,1,0
805045,2905,6,614,545,69,16,1,0
319292,559,6,90,60,30,13,1,0
34873,253,8,50,48,2,1,1,0
196237,2380,6,233,223,10,12,1,0
42523,408,6,62,49,13,10,1,0
0,0,0,0,0,0,0,0,0
0,0,0,0,0,0,0,0,0
0,0,0,0,0,0,0,0,0
0,0,0,0,0,0,0,0,0
105681,556,4,128,65,63,0,0,0
0,0,0,0,0,0,0,0,0
0,0,0,0,0,0,0,0,0
57014,913,3,220,213,7,4,1,0
26552,371,3,111,106,5,3,1,0
49482,382,4,47,34,13,12,0,0
379384,947,8,53,41,12,8,0,0
12580,134,4,3,1,2,9,0,0
0,0,0,0,0,0,0,0,0
432538,4180,3,1810,74,1736,22,0,0
28834,42,0,2,1,1,0,0,0
238524,281,2,53,1,52,1,1,0
62045,298,5,29,12,17,0,1,0
97636,624,13,122,122,0,0,1,0
70960,257,13,38,36,2,0,1,0
369553,2153,9,453,388,65,3,1,0
0,0,0,0,0,0,0,0,0
1566636,2441,14,307,272,35,22,1,0
182032,1776,4,278,255,23,12,1,0
50362,500,4,50,31,19,15,1,0
22978,34,0,1,1,0,0,1,0
11196,46,1,1,0,1,0,0,0
193793,1108,3,87,82,5,22,1,0
1280,19,2,0,0,0,0,0,0
771871,5984,4,179,167,12,32,1,0
39748,362,4,41,28,13,2,1,0
90269,1248,5,365,365,0,3,1,0
0,0,0,0,0,0,0,0,0
110082,2015,7,222,216,6,6,1,0
43363,584,6,206,202,4,6,1,0
0,0,0,0,0,0,0,0,0
0,0,0,0,0,0,0,0,0
55734,583,9,112,100,12,1,0,0
59499,526,9,88,70,18,1,0,0
151618,1049,4,353,105,248,2,1,0
20918,278,5,55,32,23,1,0,0
736838,2859,12,254,202,52,7,0,0
0,0,0,0,0,0,0,0,0
3551,21,0,7,0,7,0,0,0
183680,1002,3,307,270,37,10,1,0
0,0,0,0,0,0,0,0,0
0,0,0,0,0,0,0,0,0
31048,562,5,162,154,8,3,1,0
353256,1856,8,216,167,49,42,1,0
51378,792,3,176,171,5,2,1,0
0,0,0,0,0,0,0,0,0
0,0,0,0,0,0,0,0,0
116758,443,2,14,12,2,11,1,0
58993,461,10,52,47,5,1,1,0
59130,461,10,52,47,5,1,1,0
114187,737,6,96,69,27,3,0,0
0,0,0,0,0,0,0,0,0
0,0,0,0,0,0,0,0,0
0,0,0,0,0,0,0,0,0
79126,970,3,237,220,17,0,1,0
0,0,0,0,0,0,0,0,0
97596,609,6,172,170,2,0,1,0
130774,626,16,86,77,9,10,1,0
30542,468,3,73,72,1,0,1,0
87720,589,2,59,56,3,3,0,0
132729,1940,4,587,580,7,15,1,0
0,0,0,0,0,0,0,0,0
18956,328,0,81,75,6,2,0,0
11359,190,0,50,46,4,0,0,0
0,0,0,0,0,0,0,0,0
0,0,0,0,0,0,0,0,0
0,0,0,0,0,0,0,0,0
1112,16,0,0,0,0,0,0,0
8540,115,5,16,13,3,1,1,0
10265,123,6,7,7,0,2,1,0
7533,63,3,0,0,0,0,0,0
51675,309,12,55,52,3,0,0,0
0,0,0,0,0,0,0,0,0
0,0,0,0,0,0,0,0,0
0,0,0,0,0,0,0,0,0
0,0,0,0,0,0,0,0,0
0,0,0,0,0,0,0,0,0
0,0,0,0,0,0,0,0,0
620951,565,8,92,86,6,6,1,0
619944,495,10,62,55,7,7,1,0
570114,5469,7,225,216,9,2,1,0
0,0,0,0,0,0,0,0,0
0,0,0,0,0,0,0,0,0
250629,1527,4,116,7,109,10,1,0
0,0,0,0,0,0,0,0,0
31807,361,3,76,68,8,0,1,0
0,0,0,0,0,0,0,0,0
249006,2037,4,488,486,2,13,1,0
27627,326,4,49,47,2,12,1,0
0,0,0,0,0,0,0,0,0
23826,320,3,33,31,2,2,1,0
4891,56,3,0,0,0,0,1,0
36277,260,7,51,44,7,2,1,0
0,0,0,0,0,0,0,0,0
0,0,0,0,0,0,0,0,0
44908,530,4,99,96,3,7,1,0
545126,5952,8,1511,1439,72,17,0,0
0,0,0,0,0,0,0,0,0
27375,486,3,77,75,2,2,1,0
394081,308,0,10,10,0,0,1,0
0,0,0,0,0,0,0,0,0
0,0,0,0,0,0,0,0,0
0,0,0,0,0,0,0,0,0
57111,185,1,6,4,2,0,0,0
170642,466,8,111,102,9,0,1,0
233197,613,13,61,56,5,18,1,0
0,0,0,0,0,0,0,0,0
554041,2892,4,472,466,6,7,1,0
272803,2156,4,404,398,6,5,1,0
0,0,0,0,0,0,0,0,0
516132,1735,14,118,29,89,13,1,0
326984,516,11,55,41,14,12,1,0
229128,2484,10,54,47,7,2,0,0
0,0,0,0,0,0,0,0,0
388051,1187,15,155,29,126,16,1,0
238265,560,15,70,51,19,11,1,0
138352,996,7,181,176,5,11,1,0
52163,545,8,144,144,0,2,1,0
0,0,0,0,0,0,0,0,0
119999,953,12,177,168,9,8,1,0
88375,310,12,29,29,0,4,0,0
84766,963,0,61,33,28,2,1,0
350188,1727,5,157,124,33,2,1,0
0,0,0,0,0,0,0,0,0
22882,37,0,2,1,1,0,1,0
515896,530,2,67,66,1,0,1,0
101738,729,4,85,80,5,92,1,0
0,0,0,0,0,0,0,0,0
0,0,0,0,0,0,0,0,0
0,0,0,0,0,0,0,0,0
94161,1223,1,203,160,43,8,1,0
410811,4705,7,469,459,10,11,1,0
91251,1114,2,217,209,8,4,1,0
0,0,0,0,0,0,0,0,0
208569,1684,6,265,228,37,35,1,0
0,0,0,0,0,0,0,0,0
0,0,0,0,0,0,0,0,0
0,0,0,0,0,0,0,0,0
0,0,0,0,0,0,0,0,0
207070,1488,9,147,142,5,1,1,0
293328,1391,11,75,69,6,19,1,0
20225,325,2,80,78,2,0,1,0
2570,45,1,4,4,0,0,0,0
99700,1311,7,131,115,16,14,1,0
46105,340,4,38,34,4,19,1,0
77229,794,10,137,107,30,13,1,0
1584494,582,10,131,110,21,0,1,0
0,0,0,0,0,0,0,0,0
50998,547,5,192,188,4,7,1,0
333670,809,12,101,90,11,3,1,0
276501,716,4,3,3,0,1,0,0
512454,2000,9,261,235,26,22,1,0
978425,8773,6,153,143,10,6,1,0
1113310,10191,10,57,52,5,9,1,0
38321,653,1,178,106,72,1,0,0
14535,272,1,82,68,14,1,0,0
62947,560,11,99,90,9,2,1,0
48441,323,11,53,44,9,3,1,0
0,0,0,0,0,0,0,0,0
0,0,0,0,0,0,0,0,0
214380,1028,10,81,81,0,3,0,0
117774,1188,9,206,205,1,43,1,0
556698,4326,10,584,564,20,7,0,0
0,0,0,0,0,0,0,0,0
217711,1111,4,307,288,19,1,1,0
117530,1455,6,255,237,18,4,1,0
65946,932,1,72,17,55,0,1,0
103572,1312,7,317,284,33,0,1,0
0,0,0,0,0,0,0,0,0
166875,254,4,39,34,5,0,0,0
0,0,0,0,0,0,0,0,0
101739,843,3,133,118,15,5,1,1
391682,904,11,81,60,21,2,1,0
63643,122,3,3,3,0,0,0,0
0,0,0,0,0,0,0,0,0
81869,489,9,42,40,2,0,1,0
0,0,0,0,0,0,0,0,0
417897,3431,12,93,40,53,5,1,0
0,0,0,0,0,0,0,0,0
59011,846,2,120,101,19,2,1,0
0,0,0,0,0,0,0,0,0
0,0,0,0,0,0,0,0,0
1531966,15592,7,992,920,72,13,1,0
952373,9788,7,960,925,35,11,1,0
170437,927,1,98,84,14,9,1,0
258567,1529,7,251,131,120,5,1,0
113566,1835,4,411,251,160,2,1,0
0,0,0,0,0,0,0,0,0
0,0,0,0,0,0,0,0,0
22062,35,0,1,1,0,0,1,0
0,0,0,0,0,0,0,0,0
31829,265,4,40,36,4,1,0,0
0,0,0,0,0,0,0,0,0
0,0,0,0,0,0,0,0,0
558970,2088,12,28,26,2,24,1,0
24099,138,7,7,7,0,1,1,0
0,0,0,0,0,0,0,0,0
0,0,0,0,0,0,0,0,0
0,0,0,0,0,0,0,0,0
36425,404,1,61,13,48,0,1,0
246567,1883,17,244,197,47,37,1,0
89694,255,0,48,24,24,0,1,1
77223,591,1,55,47,8,0,1,0
18410,59,1,2,0,2,2,0,0
149457,1740,7,195,190,5,17,1,0
121334,1360,7,149,144,5,17,1,0
84561,1048,7,261,251,10,4,1,0
40148,680,7,208,203,5,3,1,0
144648,1010,9,133,116,17,2,1,0
157076,87,0,2,0,2,1,1,0
32608,794,0,311,307,4,0,1,0
57117,792,4,165,150,15,14,1,0
374570,929,2,151,75,76,8,1,0
79566,108,1,10,1,9,2,0,0
0,0,0,0,0,0,0,0,0
0,0,0,0,0,0,0,0,0
0,0,0,0,0,0,0,0,0
346410,2678,8,240,171,69,31,1,0
9938,120,2,11,11,0,2,1,0
283828,1528,14,197,159,38,17,1,0
127859,849,4,555,541,14,0,1,0
34453,171,3,21,21,0,0,1,0
0,0,0,0,0,0,0,0,0
50076,945,7,160,158,2,13,1,0
0,0,0,0,0,0,0,0,0
0,0,0,0,0,0,0,0,0
0,0,0,0,0,0,0,0,0
43260,231,5,7,3,4,3,1,0
7391,57,3,5,2,3,0,1,0
19731,355,1,122,121,1,1,0,0
75563,550,9,97,85,12,7,1,0
0,0,0,0,0,0,0,0,0
0,0,0,0,0,0,0,0,0
740992,914,4,55,47,8,17,1,0
34651,91,6,0,0,0,0,0,0
0,0,0,0,0,0,0,0,0
0,0,0,0,0,0,0,0,0
499577,1042,13,60,30,30,0,1,0
0,0,0,0,0,0,0,0,0
250099,1362,13,271,13,258,0,1,0
318521,1647,9,151,139,12,5,1,0
0,0,0,0,0,0,0,0,0
58212,1070,3,267,264,3,6,0,0
0,0,0,0,0,0,0,0,0
22598,451,3,126,100,26,1,1,0
0,0,0,0,0,0,0,0,0
0,0,0,0,0,0,0,0,0
0,0,0,0,0,0,0,0,0
151325,1310,8,200,174,26,14,1,0
23694,174,5,7,4,3,4,0,0
0,0,0,0,0,0,0,0,0
20601,322,4,90,89,1,2,1,0
3641,37,0,4,0,4,0,1,0
139632,690,12,131,127,4,2,1,0
146553,857,0,168,154,14,6,1,0
53927,403,2,102,102,0,1,1,0
0,0,0,0,0,0,0,0,0
122889,754,7,76,71,5,0,1,0
0,0,0,0,0,0,0,0,0
5770,139,0,23,6,17,0,1,0
0,0,0,0,0,0,0,0,0
0,0,0,0,0,0,0,0,0
329912,3800,7,808,715,93,11,1,0
214580,1850,10,152,90,62,24,1,0
0,0,0,0,0,0,0,0,0
179460,1071,6,185,172,13,11,1,0
93901,602,6,141,131,10,7,1,0
171166,2250,11,359,351,8,32,1,0
83746,290,8,14,10,4,0,1,0
194207,2272,3,529,464,65,9,1,0
23857,138,5,13,11,2,5,1,0
1197,12,0,0,0,0,0,0,0
0,0,0,0,0,0,0,0,0
44919,597,3,138,130,8,2,1,0
105103,225,2,41,2,39,0,1,0
0,0,0,0,0,0,0,0,0
302444,1376,6,222,176,46,4,1,0
0,0,0,0,0,0,0,0,0
0,0,0,0,0,0,0,0,0
22912,37,0,2,1,1,0,1,0
601352,1653,2,167,150,17,11,1,0
0,0,0,0,0,0,0,0,0
0,0,0,0,0,0,0,0,0
948797,3451,7,726,623,103,5,1,0
2924400,1110,4,110,87,23,22,1,0
177884,1203,5,157,154,3,22,1,0
643455,261,3,13,7,6,1,1,0
0,0,0,0,0,0,0,0,0
1298776,4425,2,292,223,69,3,1,0
0,0,0,0,0,0,0,0,0
293053,1128,14,178,141,37,6,1,0
0,0,0,0,0,0,0,0,0
0,0,0,0,0,0,0,0,0
575359,1449,15,35,35,0,39,1,0
452303,1953,9,308,179,129,49,1,0
0,0,0,0,0,0,0,0,0
0,0,0,0,0,0,0,0,0
0,0,0,0,0,0,0,0,0
25216,361,4,101,101,0,0,1,0
9277,125,4,14,14,0,0,1,0
2728,4,0,0,0,0,0,0,0
213641,1249,15,288,7,281,8,1,0
0,0,0,0,0,0,0,0,0
0,0,0,0,0,0,0,0,0
0,0,0,0,0,0,0,0,0
3278,36,3,5,1,4,0,0,0
26963,130,6,5,0,5,2,0,0
615643,2523,7,408,387,21,2,1,0
1645376,1296,10,225,212,13,19,0,0
0,0,0,0,0,0,0,0,0
0,0,0,0,0,0,0,0,0
466133,6053,6,1520,1517,3,13,1,0
495348,1393,14,154,153,1,17,0,0
1309405,10455,9,168,157,11,15,1,0
286470,836,10,35,26,9,0,1,0
0,0,0,0,0,0,0,0,0
762090,3158,8,294,237,57,11,1,0
0,0,0,0,0,0,0,0,0
222828,3990,1,1611,1586,25,4,0,0
0,0,0,0,0,0,0,0,0
66621,989,3,63,62,1,1,1,0
10268,75,5,5,5,0,0,1,0
46278,774,4,85,81,4,4,0,0
0,0,0,0,0,0,0,0,0
392697,1578,14,137,132,5,3,1,0
120752,716,5,123,108,15,1,1,0
0,0,0,0,0,0,0,0,0
198210,1829,5,146,105,41,2,1,0
0,0,0,0,0,0,0,0,0
344585,3762,14,686,620,66,17,1,0
835246,3732,1,242,10,232,12,1,0
40746,362,0,8,5,3,6,0,0
5152,48,0,2,2,0,0,0,0
260924,1497,15,378,363,15,8,1,0
178262,581,1,65,56,9,0,1,0
209009,665,1,69,60,9,0,1,0
0,0,0,0,0,0,0,0,0
97989,1163,9,226,211,15,2,1,0
203846,622,14,44,33,11,2,1,0
0,0,0,0,0,0,0,0,0
415199,3516,7,357,319,38,16,0,0
78767,1772,3,104,101,3,0,1,0
0,0,0,0,0,0,0,0,0
52157,519,2,104,101,3,0,1,0
37722,539,3,78,73,5,0,0,0
56204,534,3,51,49,2,9,0,0
22616,37,0,2,1,1,0,1,0
359133,2803,6,469,454,15,4,1,0
245567,2374,5,443,429,14,4,1,0
160954,1209,7,264,237,27,7,1,0
0,0,0,0,0,0,0,0,0
801711,5125,14,482,462,20,38,1,0
27533,321,2,63,63,0,0,1,0
13265,197,2,35,35,0,0,1,0
845534,295,5,59,44,15,0,1,0
967286,376,6,41,24,17,0,1,0
29175,356,1,40,5,35,0,1,0
212529,1218,16,113,109,4,1,1,0
9847,66,2,0,0,0,0,0,1
82761,708,0,140,129,11,16,0,0
89360,1018,9,243,237,6,7,0,0
14389,233,4,22,19,3,0,1,0
7135,96,4,19,16,3,0,1,0
10220,61,6,0,0,0,6,0,0
0,0,0,0,0,0,0,0,0
26263,338,1,43,34,9,6,1,0
168733,811,4,101,69,32,3,1,0
164810,755,4,92,60,32,3,1,0
0,0,0,0,0,0,0,0,0
0,0,0,0,0,0,0,0,0
0,0,0,0,0,0,0,0,0
0,0,0,0,0,0,0,0,0
0,0,0,0,0,0,0,0,0
166282,608,3,70,55,15,0,0,0
165974,1343,13,264,255,9,11,0,0
72962,407,13,55,50,5,6,0,0
0,0,0,0,0,0,0,0,0
1141072,869,9,154,34,120,7,1,0
286491,4912,1,748,746,2,0,0,0
1008791,664,8,82,51,31,0,1,0
174147,160,4,0,0,0,0,0,0
0,0,0,0,0,0,0,0,0
511666,1858,8,398,276,122,6,1,0
6089,45,2,1,1,0,0,0,0
144238,733,8,65,45,20,1,1,0
534862,1722,15,236,228,8,13,1,0
0,0,0,0,0,0,0,0,0
0,0,0,0,0,0,0,0,0
19877,166,0,14,14,0,0,0,0
57975,631,5,100,96,4,6,0,0
83706,132,3,8,5,3,2,0,0
727891,3529,10,236,181,55,22,1,0
217346,4334,4,484,380,104,6,1,0
52831,532,8,106,77,29,7,0,0
351829,2075,2,151,130,21,8,1,0
246849,1373,3,157,152,5,5,1,0
74620,739,8,123,111,12,1,1,0
0,0,0,0,0,0,0,0,0
146041,1662,8,337,330,7,2,0,0
31928,327,6,67,60,7,0,0,0
0,0,0,0,0,0,0,0,0
0,0,0,0,0,0,0,0,0
0,0,0,0,0,0,0,0,0
110788,694,9,108,102,6,0,1,0
0,0,0,0,0,0,0,0,0
2481677,22008,7,96,89,7,6,1,0
1728018,15788,7,108,94,14,6,1,0
0,0,0,0,0,0,0,0,0
49343,674,5,104,89,15,11,0,0
0,0,0,0,0,0,0,0,0
121673,715,5,133,129,4,0,1,0
34125,160,6,28,26,2,1,1,0
354126,1519,8,179,174,5,23,0,0
354542,1521,8,179,174,5,23,0,0
68559,911,8,233,216,17,8,1,0
0,0,0,0,0,0,0,0,0
0,0,0,0,0,0,0,0,0
19051,311,0,36,34,2,0,1,0
0,0,0,0,0,0,0,0,0
266271,355,13,71,70,1,1,1,0
96224,364,6,59,3,56,1,1,0
85524,929,7,193,173,20,0,1,0
0,0,0,0,0,0,0,0,0
318315,2088,7,624,611,13,6,1,0
52116,139,3,4,4,0,3,0,0
141252,1222,7,264,241,23,7,1,0
112851,782,7,182,154,28,6,1,0
343461,8744,3,511,510,1,0,1,0
0,0,0,0,0,0,0,0,0
0,0,0,0,0,0,0,0,0
225105,1297,8,279,262,17,4,1,0
21743,455,3,77,73,4,0,1,0
35382,512,5,55,48,7,3,1,0
51174,517,5,155,150,5,9,1,0
29845,342,5,79,76,3,7,1,0
147812,704,5,94,53,41,0,0,0
0,0,0,0,0,0,0,0,0
199724,612,8,50,50,0,0,1,0
0,0,0,0,0,0,0,0,0
76767,1378,4,370,363,7,23,1,0
29011,453,2,143,141,2,26,1,0
0,0,0,0,0,0,0,0,0
0,0,0,0,0,0,0,0,0
483381,1577,8,84,82,2,22,1,0
96514,293,2,32,31,1,0,0,0
0,0,0,0,0,0,0,0,0
1069,20,1,0,0,0,0,0,0
0,0,0,0,0,0,0,0,0
110240,862,10,220,215,5,3,1,0
130675,1522,12,183,177,6,3,1,0
123137,986,9,216,215,1,0,0,0
1702671,5056,5,232,184,48,10,1,0
234887,1269,3,14,5,9,0,1,0
750491,6288,4,515,416,99,2,1,0
0,0,0,0,0,0,0,0,0
170941,815,10,138,135,3,16,1,0
108540,523,10,70,68,2,16,1,0
84766,963,0,61,33,28,2,1,0
39282,215,0,6,6,0,0,0,0
83132,228,8,0,0,0,1,0,0
910083,3591,5,586,519,67,16,1,0
701939,2290,5,556,539,17,2,1,0
0,0,0,0,0,0,0,0,0
0,0,0,0,0,0,0,0,0
60157,752,5,86,84,2,2,1,0
0,0,0,0,0,0,0,0,0
0,0,0,0,0,0,0,0,0
0,0,0,0,0,0,0,0,0
103562,1650,3,315,295,20,4,0,0
0,0,0,0,0,0,0,0,0
0,0,0,0,0,0,0,0,0
0,0,0,0,0,0,0,0,0
27801,377,5,190,169,21,2,1,0
33864,484,6,151,151,0,7,0,0
10750,170,5,46,44,2,2,0,0
102258,888,6,357,319,38,2,1,0
48368,327,5,98,93,5,0,1,0
5051202,35863,17,3614,2210,1404,8,1,0
47110,132,8,3,0,3,0,1,0
196779,1473,8,125,124,1,0,1,0
0,0,0,0,0,0,0,0,0
0,0,0,0,0,0,0,0,0
27399,361,1,29,28,1,0,1,0
7263,112,1,16,15,1,0,1,0
71183,554,8,73,61,12,1,1,0
435979,76,3,7,7,0,4,0,0
0,0,0,0,0,0,0,0,0
213225,2229,9,343,317,26,4,0,0
83007,968,4,264,264,0,2,1,0
53362,578,4,172,170,2,2,1,0
371862,1503,4,300,232,68,14,0,0
0,0,0,0,0,0,0,0,0
0,0,0,0,0,0,0,0,0
1021201,3892,4,546,521,25,14,1,0
0,0,0,0,0,0,0,0,0
455682,1397,12,185,163,22,11,1,0
19644,123,4,4,2,2,3,1,0
97056,610,0,40,39,1,0,1,0
0,0,0,0,0,0,0,0,0
0,0,0,0,0,0,0,0,0
0,0,0,0,0,0,0,0,0
232947,1718,3,168,162,6,7,1,0
206907,1046,3,129,123,6,0,1,0
84506,103,2,8,8,0,0,1,0
598330,1385,2,107,39,68,36,0,0
33536,216,4,18,11,7,4,0,0
60221,1029,5,121,121,0,8,1,0
92837,696,2,181,180,1,7,1,0
59643,370,8,75,58,17,0,0,0
29805,598,6,138,111,27,13,1,0
0,0,0,0,0,0,0,0,0
90241,1016,7,188,177,11,35,1,0
199590,1168,8,62,27,35,8,0,0
97736,360,6,18,12,6,8,0,0
0,0,0,0,0,0,0,0,0
212222,1011,9,182,162,20,15,1,0
1409675,840,3,168,131,37,1,1,0
384872,2222,8,522,407,115,2,0,0
0,0,0,0,0,0,0,0,0
0,0,0,0,0,0,0,0,0
0,0,0,0,0,0,0,0,0
180040,1480,8,264,256,8,7,1,1
817100,4891,12,1069,1040,29,646,0,0
238880,2336,8,581,461,120,12,1,0
218544,2249,8,567,447,120,12,1,0
45655,322,7,59,54,5,0,1,0
36825,756,3,221,215,6,1,0,0
0,0,0,0,0,0,0,0,0
173495,814,3,78,68,10,0,1,0
248658,132,8,5,5,0,2,1,0
0,0,0,0,0,0,0,0,0
0,0,0,0,0,0,0,0,0
157242,966,12,154,141,13,11,0,0
0,0,0,0,0,0,0,0,0
335232,1722,7,126,105,21,5,0,0
0,0,0,0,0,0,0,0,0
2510837,6560,5,674,667,7,3,1,0
0,0,0,0,0,0,0,0,0
0,0,0,0,0,0,0,0,0
35836,249,1,72,3,69,1,0,0
1572795,26590,0,426,115,311,0,1,0
0,0,0,0,0,0,0,0,0
0,0,0,0,0,0,0,0,0
91893,2432,2,453,449,4,2,1,0
0,0,0,0,0,0,0,0,0
0,0,0,0,0,0,0,0,0
0,0,0,0,0,0,0,0,0
241780,1600,5,146,91,55,48,1,0
0,0,0,0,0,0,0,0,0
28521,45,0,4,1,3,0,0,0
0,0,0,0,0,0,0,0,0
367770,2320,6,382,366,16,3,1,0
155008,868,5,170,158,12,3,1,0
0,0,0,0,0,0,0,0,0
666899,3830,6,998,626,372,8,1,0
143680,516,10,88,88,0,0,1,0
52567,699,5,155,142,13,2,1,0
47784,671,5,160,145,15,2,1,0
0,0,0,0,0,0,0,0,0
119243,852,5,233,180,53,4,1,0
301495,318,10,38,33,5,18,1,0
0,0,0,0,0,0,0,0,0
0,0,0,0,0,0,0,0,0
0,0,0,0,0,0,0,0,0
173732,394,6,25,24,1,7,1,0
0,0,0,0,0,0,0,0,0
206011,1290,2,137,137,0,8,0,0
142850,817,6,194,185,9,3,0,0
956611,4769,6,766,760,6,12,1,0
144083,857,3,122,82,40,0,1,0
0,0,0,0,0,0,0,0,0
2070957,1322,6,158,152,6,8,1,0
209395,1075,7,234,14,220,12,1,0
468049,66,0,3,1,2,0,1,0
0,0,0,0,0,0,0,0,0
0,0,0,0,0,0,0,0,0
143815,1391,1,287,282,5,2,1,0
0,0,0,0,0,0,0,0,0
16687,58,4,4,4,0,0,1,0
0,0,0,0,0,0,0,0,0
0,0,0,0,0,0,0,0,0
504746,3075,6,377,303,74,38,1,0
0,0,0,0,0,0,0,0,0
0,0,0,0,0,0,0,0,0
188593,962,9,185,19,166,13,1,0
0,0,0,0,0,0,0,0,0
0,0,0,0,0,0,0,0,0
239875,2253,7,328,305,23,20,0,0
30884,408,4,61,47,14,7,0,0
194929,862,5,75,63,12,4,1,0
474598,462,2,104,100,4,2,1,0
28746,97,2,10,8,2,0,1,0
19320,281,3,33,30,3,0,0,0
11955,182,3,22,22,0,0,0,0
68848,665,3,204,203,1,6,1,0
61413,1077,3,407,338,69,2,0,0
605342,1009,12,82,68,14,7,1,0
0,0,0,0,0,0,0,0,0
234916,2335,13,499,482,17,13,1,0
0,0,0,0,0,0,0,0,0
147391,974,9,172,148,24,2,0,0
0,0,0,0,0,0,0,0,0
0,0,0,0,0,0,0,0,0
0,0,0,0,0,0,0,0,0
168802,2027,8,425,419,6,6,1,0
0,0,0,0,0,0,0,0,0
0,0,0,0,0,0,0,0,0
0,0,0,0,0,0,0,0,0
0,0,0,0,0,0,0,0,0
347357,1304,8,211,204,7,2,1,0
112410,883,7,85,83,2,0,0,0
0,0,0,0,0,0,0,0,0
0,0,0,0,0,0,0,0,0
33794,537,3,211,179,32,0,1,0
216884,1293,2,63,44,19,7,1,0
33268,270,0,8,8,0,26,1,0
224091,1985,3,229,117,112,8,1,0
100050,661,6,84,82,2,0,1,0
261164,3599,5,404,392,12,0,1,0
0,0,0,0,0,0,0,0,0
23464,322,0,89,67,22,0,1,0
142677,259,5,84,79,5,0,0,0
0,0,0,0,0,0,0,0,0
56969,596,4,120,107,13,1,1,0
3794,48,0,10,10,0,0,0,0
15403,28,3,0,0,0,0,0,0
0,0,0,0,0,0,0,0,0
0,0,0,0,0,0,0,0,0
207061,1845,4,375,365,10,4,1,0
867135,131,2,9,8,1,1,0,0
8319,187,3,24,24,0,0,1,0
7667,152,3,19,19,0,0,1,0
0,0,0,0,0,0,0,0,0
95320,37,3,4,4,0,0,1,0
0,0,0,0,0,0,0,0,0
199978,1216,8,199,189,10,0,1,0
16290,89,0,15,0,15,0,1,0
0,0,0,0,0,0,0,0,0
83721,494,7,115,104,11,1,0,0
0,0,0,0,0,0,0,0,0
36029,441,3,54,42,12,0,1,0
14181,259,3,52,40,12,1,1,0
567725,2177,2,327,298,29,1,0,0
0,0,0,0,0,0,0,0,0
0,0,0,0,0,0,0,0,0
0,0,0,0,0,0,0,0,0
0,0,0,0,0,0,0,0,0
247172,1494,3,329,316,13,2,1,0
23808,43,0,2,1,1,0,1,0
545193,5313,10,985,975,10,1,0,0
23857,359,0,21,18,3,0,0,0
0,0,0,0,0,0,0,0,0
27876,42,0,2,1,1,0,0,0
0,0,0,0,0,0,0,0,0
12227,127,8,11,11,0,4,1,0
302042,1224,2,178,166,12,6,1,0
28871,283,2,84,41,43,0,1,0
88938,925,8,307,289,18,3,0,0
289943,1345,14,371,355,16,6,1,0
247418,1360,6,207,206,1,0,0,0
0,0,0,0,0,0,0,0,0
0,0,0,0,0,0,0,0,0
208663,621,7,123,117,6,2,1,0
0,0,0,0,0,0,0,0,0
0,0,0,0,0,0,0,0,0
0,0,0,0,0,0,0,0,0
0,0,0,0,0,0,0,0,0
0,0,0,0,0,0,0,0,0
41467,163,4,11,2,9,9,0,0
0,0,0,0,0,0,0,0,0
0,0,0,0,0,0,0,0,0
0,0,0,0,0,0,0,0,0
198594,1679,4,170,158,12,135,1,0
20786,61,3,1,0,1,2,1,0
0,0,0,0,0,0,0,0,0
64032,297,9,21,12,9,0,0,0
0,0,0,0,0,0,0,0,0
0,0,0,0,0,0,0,0,0
90384,737,6,107,102,5,3,1,0
22972,97,0,2,2,0,0,0,0
129071,912,6,137,135,2,0,0,0
562200,827,8,221,209,12,7,1,0
93263,1162,5,113,85,28,6,1,0
31957,404,4,86,80,6,3,1,0
0,0,0,0,0,0,0,0,0
0,0,0,0,0,0,0,0,0
211507,1156,13,162,126,36,8,1,0
124089,595,14,89,85,4,14,1,0
223179,3995,7,447,393,54,6,1,0
0,0,0,0,0,0,0,0,0
138485,1734,13,388,384,4,6,1,0
111496,1374,13,366,362,4,6,1,0
215111,1680,20,441,388,53,31,1,0
0,0,0,0,0,0,0,0,0
180851,1379,5,168,155,13,8,1,0
0,0,0,0,0,0,0,0,0
1272264,286,2,28,11,17,0,1,0
1264499,167,2,26,19,7,0,1,0
37690,369,3,57,51,6,0,1,0
23720,34,0,2,1,1,0,0,0
174725,357,8,48,48,0,9,1,0
3126,37,3,4,3,1,0,0,0
187723,531,10,60,59,1,1,1,0
75082,667,2,136,124,12,7,1,0
0,0,0,0,0,0,0,0,0
0,0,0,0,0,0,0,0,0
21911,33,0,1,1,0,0,1,0
62242,593,10,69,66,3,7,1,0
80472,212,0,46,23,23,0,1,1
14108,185,1,54,53,1,0,1,0
211027,180,0,47,32,15,1,1,0
324500,336,4,50,43,7,1,1,0
17954,107,7,1,1,0,4,0,0
0,0,0,0,0,0,0,0,0
38690,346,3,30,28,2,12,1,0
30547,241,3,27,25,2,6,1,0
0,0,0,0,0,0,0,0,0
220556,1771,3,288,276,12,1,1,0
0,0,0,0,0,0,0,0,0
0,0,0,0,0,0,0,0,0
0,0,0,0,0,0,0,0,0
0,0,0,0,0,0,0,0,0
443603,2308,6,305,263,42,3,1,0
0,0,0,0,0,0,0,0,0
276522,2552,7,550,526,24,8,1,0
7263,82,4,6,6,0,0,1,0
0,0,0,0,0,0,0,0,0
0,0,0,0,0,0,0,0,0
71790,802,9,135,133,2,0,0,0
0,0,0,0,0,0,0,0,0
0,0,0,0,0,0,0,0,0
0,0,0,0,0,0,0,0,0
38742,353,2,113,103,10,1,0,0
81338,708,4,154,123,31,22,1,0
22234,334,3,117,83,34,0,1,0
182604,1224,9,264,80,184,3,1,0
285311,2133,15,287,277,10,6,1,0
179180,1201,15,240,234,6,3,1,0
0,0,0,0,0,0,0,0,0
186266,666,1,78,69,9,2,0,0
0,0,0,0,0,0,0,0,0
1036048,4433,2,357,352,5,0,0,0
18678,261,1,67,67,0,0,0,0
11829,141,1,30,30,0,0,0,0
4268,54,3,2,1,1,0,0,0
479589,3045,6,251,185,66,8,1,0
8517,99,1,9,1,8,1,0,0
0,0,0,0,0,0,0,0,0
130469,903,11,90,80,10,2,1,0
55594,517,3,66,51,15,2,1,0
43458,679,5,179,179,0,3,0,0
16415,187,3,34,34,0,2,0,0
388092,1078,8,152,144,8,23,1,0
0,0,0,0,0,0,0,0,0
173981,659,8,95,76,19,19,1,0
442519,1954,2,176,19,157,10,0,0
1574356,15553,11,232,213,19,1,1,0
0,0,0,0,0,0,0,0,0
0,0,0,0,0,0,0,0,0
0,0,0,0,0,0,0,0,0
37887,333,6,41,32,9,2,0,0
32377,224,6,39,32,7,2,0,0
28237,42,0,2,1,1,0,0,0
103952,1032,6,280,262,18,7,1,0
0,0,0,0,0,0,0,0,0
100338,1573,1,370,361,9,0,0,0
0,0,0,0,0,0,0,0,0
22042,35,0,1,1,0,0,1,0
309649,1982,7,223,215,8,3,1,0
102752,712,4,71,63,8,1,0,0
242643,2006,10,431,417,14,12,1,0
44062,534,3,84,72,12,6,1,0
0,0,0,0,0,0,0,0,0
0,0,0,0,0,0,0,0,0
1009637,3196,6,130,74,56,10,0,0
178573,2862,8,112,90,22,0,1,0
92467,1041,2,60,33,27,2,1,0
524477,2526,16,303,282,21,49,1,0
160406,1089,13,154,139,15,7,1,0
119877,184,2,17,9,8,2,1,0
377432,2693,6,210,170,40,5,1,0
0,0,0,0,0,0,0,0,0
0,0,0,0,0,0,0,0,0
1820,21,2,0,0,0,0,0,1
50943,517,3,81,69,12,8,1,0
0,0,0,0,0,0,0,0,0
0,0,0,0,0,0,0,0,0
0,0,0,0,0,0,0,0,0
143555,846,5,139,131,8,3,1,0
0,0,0,0,0,0,0,0,0
6941,59,4,3,3,0,0,1,0
0,0,0,0,0,0,0,0,0
109996,1231,6,176,146,30,0,1,0
60518,175,3,2,2,0,0,1,0
0,0,0,0,0,0,0,0,0
89617,823,4,251,230,21,7,0,0
46570,462,7,56,49,7,5,1,0
26507,418,4,128,128,0,0,1,0
604722,1630,3,150,144,6,0,0,0
0,0,0,0,0,0,0,0,0
0,0,0,0,0,0,0,0,0
0,0,0,0,0,0,0,0,0
0,0,0,0,0,0,0,0,0
0,0,0,0,0,0,0,0,0
99643,660,7,130,115,15,7,1,0
0,0,0,0,0,0,0,0,0
77831,503,6,17,13,4,0,1,0
0,0,0,0,0,0,0,0,0
54958,516,5,24,13,11,0,1,0
119348,2418,3,696,690,6,0,1,0
29903,169,2,22,21,1,9,1,0
0,0,0,0,0,0,0,0,0
0,0,0,0,0,0,0,0,0
41675,614,4,128,113,15,0,1,0
48368,721,3,109,98,11,0,0,0
0,0,0,0,0,0,0,0,0
0,0,0,0,0,0,0,0,0
90127,333,2,32,12,20,8,0,0
0,0,0,0,0,0,0,0,0
0,0,0,0,0,0,0,0,0
308585,4825,5,1055,1041,14,16,0,0
204617,2540,6,371,19,352,6,1,0
0,0,0,0,0,0,0,0,0
67323,470,9,92,92,0,0,1,0
14746,170,4,31,30,1,0,0,0
189734,1635,3,313,302,11,1,1,0
23183,411,5,43,32,11,0,1,0
0,0,0,0,0,0,0,0,0
14547,276,0,63,63,0,0,1,0
0,0,0,0,0,0,0,0,0
0,0,0,0,0,0,0,0,0
0,0,0,0,0,0,0,0,0
233112,871,5,79,66,13,3,1,0
100781,492,3,157,148,9,6,1,0
339095,2124,8,341,292,49,4,0,0
175815,875,8,91,85,6,4,0,0
135634,569,2,115,106,9,10,0,0
83865,306,2,66,58,8,10,0,0
50368,769,1,275,269,6,0,1,0
56594,502,6,106,92,14,13,0,0
0,0,0,0,0,0,0,0,0
0,0,0,0,0,0,0,0,0
155266,1234,12,205,198,7,24,1,0
151288,1219,13,204,200,4,21,1,0
0,0,0,0,0,0,0,0,0
36382,427,3,93,70,23,0,0,0
33800,334,1,72,71,1,0,1,0
348352,2651,3,262,246,16,1,1,0
872172,8242,6,146,137,9,4,1,0
0,0,0,0,0,0,0,0,0
148965,1026,9,237,177,60,3,1,0
249499,1043,6,150,129,21,6,1,0
179832,1571,5,347,309,38,2,1,0
7854,138,1,23,23,0,0,0,0
0,0,0,0,0,0,0,0,0
0,0,0,0,0,0,0,0,0
296167,541,1,19,13,6,1,1,0
0,0,0,0,0,0,0,0,0
725924,5427,3,793,777,16,3,1,0
0,0,0,0,0,0,0,0,0
0,0,0,0,0,0,0,0,0
0,0,0,0,0,0,0,0,0
51595,584,2,80,78,2,1,1,0
11955,181,2,28,28,0,2,1,0
0,0,0,0,0,0,0,0,0
1427922,1267,3,114,111,3,2,1,0
0,0,0,0,0,0,0,0,0
185242,1282,7,264,219,45,6,1,0
143944,614,7,95,69,26,6,1,0
256996,1435,16,183,160,23,27,1,0
0,0,0,0,0,0,0,0,0
193453,1719,7,59,52,7,26,1,0
0,0,0,0,0,0,0,0,0
3332,85,2,18,18,0,0,0,0
0,0,0,0,0,0,0,0,0
8206,107,2,5,5,0,1,1,0
7521,100,2,6,6,0,1,1,0
4403,50,2,7,6,1,1,0,0
12697,152,2,52,45,7,0,1,0
86543,1101,4,89,24,65,4,0,0
39570,350,2,11,7,4,0,0,0
0,0,0,0,0,0,0,0,0
0,0,0,0,0,0,0,0,0
0,0,0,0,0,0,0,0,0
0,0,0,0,0,0,0,0,0
0,0,0,0,0,0,0,0,0
236928,986,6,106,79,27,8,1,0
358012,740,3,120,108,12,1,1,0
0,0,0,0,0,0,0,0,0
0,0,0,0,0,0,0,0,0
0,0,0,0,0,0,0,0,0
425218,2523,13,358,300,58,8,1,0
12387,94,9,3,3,0,2,0,0
0,0,0,0,0,0,0,0,0
34358,507,2,25,25,0,0,1,0
8374,90,1,5,5,0,0,1,0
1029865,5476,3,372,362,10,104,1,0
0,0,0,0,0,0,0,0,0
0,0,0,0,0,0,0,0,0
0,0,0,0,0,0,0,0,0
0,0,0,0,0,0,0,0,0
33649,565,1,175,174,1,6,1,0
903161,829,3,81,69,12,0,1,0
376847,3391,6,736,720,16,14,1,0
8597,128,3,7,6,1,0,1,0
0,0,0,0,0,0,0,0,0
0,0,0,0,0,0,0,0,0
0,0,0,0,0,0,0,0,0
174611,1200,15,99,65,34,4,1,0
0,0,0,0,0,0,0,0,0
0,0,0,0,0,0,0,0,0
662597,2887,10,315,312,3,36,1,0
278544,409,11,67,65,2,8,1,0
20538,267,3,19,19,0,1,1,0
68195,458,1,30,19,11,7,1,0
777532,6920,2,364,280,84,7,1,0
295008,926,9,116,112,4,3,1,0
0,0,0,0,0,0,0,0,0
36121,222,4,25,24,1,0,1,0
0,0,0,0,0,0,0,0,0
0,0,0,0,0,0,0,0,0
0,0,0,0,0,0,0,0,0
4077852,1226,10,278,256,22,27,1,0
103347,731,5,163,155,8,25,1,0
380709,735,9,75,63,12,26,1,0
380886,2393,6,640,637,3,102,1,0
0,0,0,0,0,0,0,0,0
0,0,0,0,0,0,0,0,0
0,0,0,0,0,0,0,0,0
160688,820,6,132,124,8,7,1,0
63133,479,6,152,143,9,0,1,0
0,0,0,0,0,0,0,0,0
921,20,0,0,0,0,0,0,0
38721,104,5,10,8,2,1,1,0
631368,2518,4,454,450,4,13,0,0
22768,59,4,7,4,3,0,1,0
288064,1848,10,616,600,16,6,0,0
117702,824,10,100,86,14,13,1,0
0,0,0,0,0,0,0,0,0
237666,1125,7,179,142,37,1,1,0
29623,82,3,8,4,4,1,1,0
0,0,0,0,0,0,0,0,0
122909,1485,3,226,192,34,10,0,0
132278,518,4,51,46,5,0,1,0
20196,392,2,11,11,0,4,1,0
17408,241,2,31,17,14,1,0,0
0,0,0,0,0,0,0,0,0
114312,1280,5,295,283,12,2,1,0
83935,767,5,175,163,12,1,1,0
64567,955,4,235,133,102,0,1,0
89383,941,10,179,98,81,14,1,0
0,0,0,0,0,0,0,0,0
0,0,0,0,0,0,0,0,0
0,0,0,0,0,0,0,0,0
95569,1101,6,202,176,26,3,1,0
0,0,0,0,0,0,0,0,0
88905,1507,7,337,329,8,10,1,0
26884,341,4,68,62,6,9,1,0
120430,808,4,127,123,4,12,0,0
78610,458,4,77,74,3,1,0,0
304249,1386,5,301,23,278,38,1,0
0,0,0,0,0,0,0,0,0
0,0,0,0,0,0,0,0,0
156566,1389,7,295,139,156,4,0,0
0,0,0,0,0,0,0,0,0
0,0,0,0,0,0,0,0,0
0,0,0,0,0,0,0,0,0
93792,1062,13,231,217,14,12,1,0
0,0,0,0,0,0,0,0,0
95301,884,6,200,153,47,8,1,0
175457,1291,3,248,2,246,2,1,0
1830069,8685,6,1834,1053,781,7,1,0
0,0,0,0,0,0,0,0,0
0,0,0,0,0,0,0,0,0
125131,897,10,166,155,11,1,1,0
24882,382,3,35,28,7,1,1,0
0,0,0,0,0,0,0,0,0
1326253,6230,6,818,813,5,75,0,0
305988,251,3,21,21,0,3,0,0
178067,986,6,79,75,4,6,1,0
0,0,0,0,0,0,0,0,0
291748,2159,15,333,297,36,11,0,0
0,0,0,0,0,0,0,0,0
7364,98,2,17,16,1,0,0,0
360278,1745,5,130,126,4,17,1,0
148749,1448,5,183,160,23,7,1,0
0,0,0,0,0,0,0,0,0
298591,1817,4,331,264,67,1,0,0
0,0,0,0,0,0,0,0,0
0,0,0,0,0,0,0,0,0
226490,1182,8,153,138,15,4,0,0
30090,415,5,77,67,10,2,1,0
36902,404,5,71,62,9,6,1,0
109271,828,3,217,217,0,9,1,0
0,0,0,0,0,0,0,0,0
1616,11,0,1,1,0,0,0,0
52630,481,3,91,91,0,7,0,0
19657,302,6,82,82,0,0,0,0
0,0,0,0,0,0,0,0,0
589195,1132,14,69,47,22,5,1,0
0,0,0,0,0,0,0,0,0
379958,1046,4,140,129,11,9,1,0
171108,664,10,69,63,6,39,0,0
31215,145,4,3,2,1,6,0,0
51659,481,1,156,156,0,2,1,0
7765,143,0,49,49,0,0,1,0
436193,3599,8,112,107,5,3,1,0
768976,868,3,12,11,1,13,0,0
778639,3566,6,314,312,2,8,1,0
97475,704,10,92,90,2,8,1,0
244718,1177,5,168,165,3,2,1,0
221929,1022,6,152,149,3,2,1,0
231551,341,0,16,3,13,0,1,0
440354,1506,3,211,197,14,8,1,0
0,0,0,0,0,0,0,0,0
150202,374,3,64,38,26,12,1,0
36358,521,4,133,129,4,2,1,0
141721,1010,3,217,209,8,1,1,0
95430,1112,2,229,221,8,6,0,0
109057,803,1,127,121,6,9,1,0
32701,118,2,16,10,6,4,1,0
125976,1029,11,131,98,33,11,0,0
116446,912,6,98,90,8,2,0,0
0,0,0,0,0,0,0,0,0
468417,1223,14,161,144,17,6,1,0
89218,626,10,48,46,2,0,1,0
0,0,0,0,0,0,0,0,0
160089,1765,7,277,252,25,10,1,1
0,0,0,0,0,0,0,0,0
212267,755,5,176,173,3,6,1,0
176494,434,6,112,109,3,8,1,0
0,0,0,0,0,0,0,0,0
0,0,0,0,0,0,0,0,0
47934,523,1,135,133,2,1,1,0
33145,399,1,88,85,3,2,1,0
19406,202,1,45,42,3,1,1,0
121437,1733,4,309,304,5,142,0,0
464114,2284,10,433,407,26,141,1,0
116464,634,8,79,77,2,4,1,0
210773,1021,12,258,101,157,4,1,0
0,0,0,0,0,0,0,0,0
310721,1745,12,358,339,19,25,1,0
310708,1745,12,358,339,19,25,1,0
47069,447,2,135,80,55,3,1,0
0,0,0,0,0,0,0,0,0
0,0,0,0,0,0,0,0,0
0,0,0,0,0,0,0,0,0
0,0,0,0,0,0,0,0,0
85690,632,10,152,140,12,2,1,0
145714,925,6,209,201,8,1,1,0
35162,158,6,19,15,4,4,0,0
0,0,0,0,0,0,0,0,0
32033,250,1,74,74,0,6,1,0
98823,781,6,152,143,9,8,1,0
70297,294,4,5,4,1,8,0,0
0,0,0,0,0,0,0,0,0
86168,506,6,30,21,9,1,0,0
0,0,0,0,0,0,0,0,0
58680,379,4,55,10,45,0,1,0
279048,193,0,0,0,0,1,1,0
769214,1887,6,563,389,174,158,1,0
0,0,0,0,0,0,0,0,0
27723,284,3,68,65,3,0,1,0
43829,282,5,49,44,5,8,1,0
870839,529,5,46,44,2,8,1,0
74774,1102,4,276,275,1,41,1,0
88198,803,5,151,149,2,11,1,0
0,0,0,0,0,0,0,0,0
0,0,0,0,0,0,0,0,0
43126,468,1,120,30,90,1,1,0
35347,302,6,36,20,16,2,1,0
0,0,0,0,0,0,0,0,0
346066,795,8,96,89,7,2,1,0
103685,868,9,61,12,49,30,1,0
49087,212,5,19,13,6,3,1,0
35789,605,7,78,14,64,9,1,0
79444,477,7,59,54,5,0,1,0
67399,292,7,45,39,6,1,1,0
336601,605,6,60,56,4,4,1,0
288169,406,7,45,41,4,9,1,0
96733,874,12,109,88,21,12,1,0
46162,401,11,64,61,3,4,1,0
0,0,0,0,0,0,0,0,0
33780,580,9,97,88,9,11,1,0
195537,2979,8,812,807,5,4,1,0
0,0,0,0,0,0,0,0,0
0,0,0,0,0,0,0,0,0
1012,18,1,0,0,0,0,0,0
97384,387,3,71,71,0,0,1,0
0,0,0,0,0,0,0,0,0
715922,4064,4,566,538,28,8,1,0
167844,1290,8,140,120,20,6,0,0
23097,104,3,12,12,0,2,1,0
18777,102,3,12,12,0,0,1,0
61001,655,10,137,125,12,5,0,0
0,0,0,0,0,0,0,0,0
12977,34,1,0,0,0,1,0,0
40459,507,7,123,122,1,2,1,0
0,0,0,0,0,0,0,0,0
0,0,0,0,0,0,0,0,0
41469,457,9,55,46,9,4,1,0
0,0,0,0,0,0,0,0,0
206479,1744,3,154,124,30,18,0,0
157429,103,5,3,0,3,2,0,0
111759,1077,10,299,288,11,11,1,0
14371,270,5,64,59,5,0,1,0
0,0,0,0,0,0,0,0,0
1940,25,2,2,2,0,0,0,0
189587,1634,0,327,278,49,0,1,0
114461,1040,12,62,50,12,11,1,0
47923,200,1,30,29,1,6,1,0
11014,154,3,17,17,0,0,0,0
0,0,0,0,0,0,0,0,0
0,0,0,0,0,0,0,0,0
143852,2999,4,684,667,17,1,1,0
275956,2063,10,280,247,33,3,1,0
226367,1437,10,89,60,29,3,0,0
0,0,0,0,0,0,0,0,0
65281,879,9,146,140,6,3,1,0
0,0,0,0,0,0,0,0,0
89456,433,5,81,75,6,6,1,0
129078,923,11,163,97,66,11,1,0
116556,834,11,148,146,2,12,1,0
0,0,0,0,0,0,0,0,0
85476,673,8,148,139,9,8,1,0
48292,295,7,66,59,7,5,1,0
0,0,0,0,0,0,0,0,0
0,0,0,0,0,0,0,0,0
51360,156,1,2,2,0,1,0,0
3276,57,1,9,6,3,0,1,0
249069,1059,6,65,60,5,6,1,0
41892,276,7,50,43,7,2,1,0
0,0,0,0,0,0,0,0,0
99954,2384,2,521,96,425,12,1,0
14893,379,2,34,32,2,1,1,0
852834,8362,15,239,229,10,20,1,0
674388,6891,13,222,205,17,22,1,0
1325614,1259,5,144,142,2,0,1,0
146674,1301,0,261,98,163,0,0,0
56903,1310,3,93,25,68,0,1,0
1156712,839,8,98,92,6,1,1,0
0,0,0,0,0,0,0,0,0
50523,549,3,168,157,11,2,1,0
2598344,3954,12,440,429,11,35,1,0
1863520,2694,12,297,285,12,10,1,0
0,0,0,0,0,0,0,0,0
101896,1259,7,292,250,42,37,1,0
96676,1630,4,397,271,126,54,0,0
0,0,0,0,0,0,0,0,0
0,0,0,0,0,0,0,0,0
108316,551,8,60,56,4,1,0,0
0,0,0,0,0,0,0,0,0
0,0,0,0,0,0,0,0,0
1345697,6583,14,987,805,182,6,1,0
122655,2388,1,887,882,5,9,0,0
101705,598,8,89,77,12,8,1,0
33626,177,8,25,25,0,2,1,0
0,0,0,0,0,0,0,0,0
196025,1090,8,143,135,8,5,0,0
495596,799,7,100,96,4,9,1,0
0,0,0,0,0,0,0,0,0
30316,284,1,47,46,1,6,1,0
22903,37,0,2,1,1,0,1,0
173173,3480,11,367,361,6,3,1,0
0,0,0,0,0,0,0,0,0
39389,288,2,41,24,17,8,0,0
22026,33,0,1,1,0,0,1,0
0,0,0,0,0,0,0,0,0
0,0,0,0,0,0,0,0,0
94073,448,4,79,79,0,0,1,0
0,0,0,0,0,0,0,0,0
8371,136,4,25,25,0,0,0,0
0,0,0,0,0,0,0,0,0
191324,1242,11,288,253,35,6,1,0
197901,1037,7,305,282,23,12,1,0
0,0,0,0,0,0,0,0,0
198497,1358,9,319,311,8,3,1,0
0,0,0,0,0,0,0,0,0
1050313,3615,9,286,268,18,7,1,0
141352,2185,0,159,158,1,0,1,0
0,0,0,0,0,0,0,0,0
0,0,0,0,0,0,0,0,0
6581,170,1,8,0,8,0,0,0
0,0,0,0,0,0,0,0,0
0,0,0,0,0,0,0,0,0
112037,572,9,14,14,0,0,1,0
0,0,0,0,0,0,0,0,0
0,0,0,0,0,0,0,0,0
0,0,0,0,0,0,0,0,0
55784,431,2,88,81,7,0,0,0
48255,255,6,30,30,0,9,1,0
25133,151,1,45,45,0,0,0,0
35767,607,7,78,16,62,9,1,0
0,0,0,0,0,0,0,0,0
119089,1032,9,67,34,33,0,1,0
331171,1895,11,297,270,27,4,0,0
73534,452,0,31,23,8,5,0,0
201443,100,2,6,6,0,0,1,0
0,0,0,0,0,0,0,0,0
229428,540,6,107,90,17,9,1,0
28081,42,0,2,1,1,0,0,0
193444,1568,9,314,269,45,14,1,0
160378,1159,13,226,224,2,4,1,0
0,0,0,0,0,0,0,0,0
0,0,0,0,0,0,0,0,0
0,0,0,0,0,0,0,0,0
1827,30,0,3,2,1,0,0,0
0,0,0,0,0,0,0,0,0
0,0,0,0,0,0,0,0,0
1364533,1817,3,146,141,5,10,1,0
1251261,719,4,84,79,5,1,1,0
0,0,0,0,0,0,0,0,0
111410,223,6,8,6,2,6,1,0
532631,1493,6,226,204,22,6,1,0
68572,528,3,60,60,0,0,1,0
30808,431,5,42,36,6,5,1,0
0,0,0,0,0,0,0,0,0
63540,671,6,104,96,8,8,1,0
0,0,0,0,0,0,0,0,0
270246,1695,2,269,243,26,3,1,0
0,0,0,0,0,0,0,0,0
0,0,0,0,0,0,0,0,0
0,0,0,0,0,0,0,0,0
0,0,0,0,0,0,0,0,0
65700,721,8,108,52,56,4,1,0
51386,486,8,95,80,15,4,1,0
74657,644,7,125,125,0,3,1,0
0,0,0,0,0,0,0,0,0
0,0,0,0,0,0,0,0,0
0,0,0,0,0,0,0,0,0
0,0,0,0,0,0,0,0,0
181471,1077,9,211,203,8,2,1,0
64547,105,2,5,5,0,2,1,0
46068,470,5,18,18,0,3,1,0
0,0,0,0,0,0,0,0,0
22079,35,0,1,1,0,0,1,0
0,0,0,0,0,0,0,0,0
1041485,4509,7,467,443,24,14,1,0
157521,2249,6,472,472,0,2,1,0
0,0,0,0,0,0,0,0,0
0,0,0,0,0,0,0,0,0
64510,561,8,99,88,11,9,1,0
151066,1123,9,99,88,11,4,1,0
325822,1389,4,141,126,15,14,1,0
77432,212,0,46,23,23,0,1,1
538857,2425,16,260,237,23,92,1,0
488030,3918,7,839,833,6,72,0,1
9657,76,6,5,4,1,0,0,0
0,0,0,0,0,0,0,0,0
0,0,0,0,0,0,0,0,0
28291,377,1,87,67,20,2,1,0
0,0,0,0,0,0,0,0,0
585,5,0,0,0,0,0,0,1
22097,35,0,1,1,0,0,1,0
140027,396,9,81,3,78,4,1,0
133007,1277,12,177,169,8,14,1,0
138801,1887,4,393,390,3,9,1,0
1306180,2201,8,320,305,15,6,1,0
1156741,1216,9,202,200,2,6,1,0
11465,159,3,22,19,3,2,0,0
0,0,0,0,0,0,0,0,0
75328,1254,3,309,291,18,6,0,0
327190,792,3,242,240,2,4,1,0
154659,2710,1,404,403,1,0,1,0
0,0,0,0,0,0,0,0,0
16039,365,1,108,104,4,1,1,0
326777,1495,8,190,182,8,19,1,0
0,0,0,0,0,0,0,0,0
0,0,0,0,0,0,0,0,0
406472,1345,8,61,58,3,39,1,0
104233,863,6,203,202,1,15,1,0
0,0,0,0,0,0,0,0,0
9029,161,1,13,13,0,0,0,0
28159,44,0,4,3,1,0,0,0
110416,763,4,219,208,11,7,1,0
0,0,0,0,0,0,0,0,0
0,0,0,0,0,0,0,0,0
32534,330,2,55,53,2,2,1,0
0,0,0,0,0,0,0,0,0
20887,308,3,77,75,2,0,1,0
1622,11,0,1,1,0,0,0,0
387142,1803,4,101,95,6,36,1,0
108722,442,4,65,65,0,11,1,0
0,0,0,0,0,0,0,0,0
1490991,4903,12,860,839,21,25,1,0
153516,793,13,104,101,3,7,1,0
15690,142,1,13,5,8,0,0,0
0,0,0,0,0,0,0,0,0
427490,2393,16,451,447,4,4,0,0
0,0,0,0,0,0,0,0,0
0,0,0,0,0,0,0,0,0
57541,794,3,175,172,3,10,1,0
37083,312,3,54,51,3,11,1,0
187401,916,6,172,139,33,1,1,0
427458,2421,13,525,515,10,9,1,0
288388,1494,13,427,420,7,12,1,0
0,0,0,0,0,0,0,0,0
0,0,0,0,0,0,0,0,0
449832,1628,9,289,276,13,2,0,0
0,0,0,0,0,0,0,0,0
610515,1556,3,216,198,18,1,0,0
0,0,0,0,0,0,0,0,0
0,0,0,0,0,0,0,0,0
91547,477,7,91,90,1,6,1,0
278876,1328,3,163,25,138,0,1,0
0,0,0,0,0,0,0,0,0
614979,1436,4,242,216,26,2,1,0
0,0,0,0,0,0,0,0,0
0,0,0,0,0,0,0,0,0
385494,3004,5,301,213,88,32,0,0
68048,965,5,159,155,4,0,1,0
157098,703,0,16,14,2,0,1,0
0,0,0,0,0,0,0,0,0
0,0,0,0,0,0,0,0,0
0,0,0,0,0,0,0,0,0
0,0,0,0,0,0,0,0,0
0,0,0,0,0,0,0,0,0
259473,489,3,49,45,4,2,1,0
250426,976,9,130,128,2,10,1,0
227301,935,8,66,57,9,1,1,0
171884,2497,3,298,294,4,0,1,0
0,0,0,0,0,0,0,0,0
57932,539,5,106,105,1,0,1,0
0,0,0,0,0,0,0,0,0
22533,554,2,100,83,17,0,1,0
132009,690,9,109,104,5,2,1,0
0,0,0,0,0,0,0,0,0
553,9,0,1,1,0,0,0,0
0,0,0,0,0,0,0,0,0
680922,1291,10,270,254,16,8,1,0
676700,557,0,4,4,0,2,1,1
13122,190,8,37,30,7,5,1,0
0,0,0,0,0,0,0,0,0
0,0,0,0,0,0,0,0,0
503296,3688,7,1138,1123,15,16,1,0
331303,2772,5,1049,1035,14,8,1,0
7125,74,4,8,4,4,2,1,0
152404,1598,4,446,439,7,1,1,0
96898,1049,4,359,352,7,1,1,0
0,0,0,0,0,0,0,0,0
275160,3922,8,766,762,4,4,1,0
0,0,0,0,0,0,0,0,0
180858,609,8,117,6,111,7,1,0
241769,769,4,107,91,16,4,1,0
117155,893,9,202,188,14,9,1,0
0,0,0,0,0,0,0,0,0
372037,3640,5,302,284,18,5,1,0
19615,149,1,4,0,4,0,0,0
0,0,0,0,0,0,0,0,0
1054999,9280,7,35,27,8,11,1,0
855400,837,5,224,202,22,2,1,0
463588,2433,13,317,286,31,14,1,0
4047,27,2,0,0,0,0,0,0
47284,1034,4,237,227,10,6,1,0
104088,1190,3,193,192,1,34,0,0
53022,536,2,93,93,0,27,0,0
162607,1308,12,147,129,18,2,1,0
269843,3587,3,885,820,65,3,1,0
25053,40,2,0,0,0,0,0,0
62822,1504,3,205,203,2,19,0,0
20041,441,2,68,66,2,4,0,0
0,0,0,0,0,0,0,0,0
0,0,0,0,0,0,0,0,0
77847,1330,11,286,272,14,6,1,0
8596,98,4,6,6,0,2,1,0
1114645,2083,14,149,132,17,1,0,0
0,0,0,0,0,0,0,0,0
0,0,0,0,0,0,0,0,0
137915,378,7,24,21,3,12,1,0
60225,1041,4,385,341,44,0,1,0
43485,586,5,41,41,0,6,0,0
0,0,0,0,0,0,0,0,0
85109,804,10,81,72,9,3,1,0
251262,1753,4,263,243,20,18,1,0
90604,858,5,189,163,26,8,1,0
148851,1079,3,233,233,0,0,0,0
20320,219,5,37,37,0,0,1,0
446663,3201,7,1111,1079,32,38,1,0
356423,2936,5,1091,1064,27,30,1,0
140836,1125,15,256,252,4,1,0,0
28039,42,0,2,1,1,0,0,0
0,0,0,0,0,0,0,0,0
0,0,0,0,0,0,0,0,0
520764,1584,8,266,210,56,4,1,0
420749,680,8,59,46,13,4,1,0
0,0,0,0,0,0,0,0,0
0,0,0,0,0,0,0,0,0
24725,212,2,50,45,5,0,1,0
0,0,0,0,0,0,0,0,0
315200,2001,5,417,354,63,11,1,0
129493,2497,3,259,254,5,13,1,0
102379,597,8,89,89,0,4,1,0
156004,605,13,109,86,23,1,1,0
6393,109,1,10,9,1,0,0,0
0,0,0,0,0,0,0,0,0
0,0,0,0,0,0,0,0,0
0,0,0,0,0,0,0,0,0
68902,652,7,75,64,11,10,0,0
0,0,0,0,0,0,0,0,0
148651,2312,5,302,283,19,13,1,0
69140,1934,2,571,570,1,2,1,0
82071,900,0,172,122,50,0,1,0
33771,386,0,64,5,59,1,1,0
28269,42,0,2,1,1,0,0,0
133903,1124,3,229,196,33,1,1,0
157794,1786,2,267,255,12,1,1,0
0,0,0,0,0,0,0,0,0
0,0,0,0,0,0,0,0,0
218764,1434,12,217,64,153,9,1,0
80096,745,5,123,114,9,1,0,0
40171,361,7,3,1,2,1,0,0
0,0,0,0,0,0,0,0,0
326857,1264,3,172,140,32,8,0,0
5926,45,4,0,0,0,0,0,0
0,0,0,0,0,0,0,0,0
364481,1455,11,213,15,198,7,1,0
452356,7588,7,1924,1913,11,9,0,0
0,0,0,0,0,0,0,0,0
44698,1030,3,244,231,13,0,0,0
63627,416,8,84,83,1,0,0,0
0,0,0,0,0,0,0,0,0
95797,861,4,219,216,3,0,0,0
123159,991,16,171,167,4,7,1,0
11740,80,4,7,6,1,0,0,0
146799,2029,3,885,884,1,9,0,0
0,0,0,0,0,0,0,0,0
0,0,0,0,0,0,0,0,0
0,0,0,0,0,0,0,0,0
14233,228,2,2,0,2,2,1,0
0,0,0,0,0,0,0,0,0
0,0,0,0,0,0,0,0,0
489882,2079,2,262,231,31,1,1,0
0,0,0,0,0,0,0,0,0
137957,1647,9,282,264,18,36,1,0
0,0,0,0,0,0,0,0,0
112110,1004,1,276,276,0,2,1,0
129264,165,1,22,17,5,0,1,0
0,0,0,0,0,0,0,0,0
140554,3123,1,422,413,9,2,1,0
347680,578,12,19,17,2,23,0,0
0,0,0,0,0,0,0,0,0
0,0,0,0,0,0,0,0,0
6403,129,0,8,2,6,0,1,0
24407,422,1,7,6,1,0,1,0
1582,11,0,1,1,0,0,0,0
36486,736,4,182,170,12,1,1,0
35100,594,3,96,93,3,2,1,0
0,0,0,0,0,0,0,0,0
123671,568,8,58,57,1,0,0,0
6176,74,4,11,10,1,0,1,0
1397978,1311,14,253,245,8,23,1,0
1362515,878,14,181,172,9,9,1,0
1595,28,1,1,0,1,0,0,0
0,0,0,0,0,0,0,0,0
0,0,0,0,0,0,0,0,0
0,0,0,0,0,0,0,0,0
403660,1818,4,114,67,47,12,0,0
0,0,0,0,0,0,0,0,0
0,0,0,0,0,0,0,0,0
0,0,0,0,0,0,0,0,0
0,0,0,0,0,0,0,0,0
28088,42,0,2,1,1,0,0,0
61777,742,8,220,216,4,14,0,0
3758,82,3,15,13,2,0,0,0
94282,1210,12,272,262,10,8,1,0
0,0,0,0,0,0,0,0,0
0,0,0,0,0,0,0,0,0
27939,42,0,2,1,1,0,0,0
168486,411,4,56,31,25,1,1,0
40116,362,9,33,32,1,8,1,0
36544,341,6,14,13,1,9,1,0
0,0,0,0,0,0,0,0,0
201757,3246,6,28,21,7,0,0,0
26295,115,1,2,1,1,3,0,0
0,0,0,0,0,0,0,0,0
449426,1281,9,148,132,16,26,1,0
0,0,0,0,0,0,0,0,0
0,0,0,0,0,0,0,0,0
192697,1850,7,243,218,25,1,1,0
53147,255,5,4,4,0,2,0,0
50690,204,5,12,12,0,0,1,0
0,0,0,0,0,0,0,0,0
0,0,0,0,0,0,0,0,0
39637,324,2,81,14,67,0,1,0
11290,125,2,6,4,2,0,0,0
0,0,0,0,0,0,0,0,0
14021,150,4,16,0,16,1,0,0
155282,1185,11,197,174,23,20,1,0
0,0,0,0,0,0,0,0,0
0,0,0,0,0,0,0,0,0
60433,975,1,148,138,10,1,1,0
87987,254,0,48,24,24,0,1,1
48847,575,5,105,96,9,4,0,0
70021,883,4,264,146,118,7,1,0
66333,424,11,59,19,40,1,1,0
54312,301,11,26,25,1,4,1,0
0,0,0,0,0,0,0,0,0
0,0,0,0,0,0,0,0,0
0,0,0,0,0,0,0,0,0
0,0,0,0,0,0,0,0,0
1337218,12380,15,1184,1164,20,17,1,0
232611,1468,14,258,202,56,4,1,0
0,0,0,0,0,0,0,0,0
0,0,0,0,0,0,0,0,0
77431,516,7,146,113,33,1,1,0
0,0,0,0,0,0,0,0,0
964384,922,5,45,32,13,2,1,0
0,0,0,0,0,0,0,0,0
299768,1870,4,185,182,3,7,1,0
20603,379,4,102,99,3,0,1,0
0,0,0,0,0,0,0,0,0
38575,672,4,82,74,8,3,1,0
102760,605,10,85,80,5,9,1,0
78267,1519,1,489,484,5,1,1,0
16950,263,1,55,55,0,1,1,0
69466,700,9,228,214,14,10,1,0
591,12,0,0,0,0,0,0,0
165330,773,6,109,84,25,4,1,0
442878,5257,7,1942,1681,261,0,1,0
290942,2193,6,318,296,22,4,1,0
7353,43,4,0,0,0,0,0,0
0,0,0,0,0,0,0,0,0
152110,561,11,43,29,14,1,1,0
0,0,0,0,0,0,0,0,0
0,0,0,0,0,0,0,0,0
6358,102,3,10,8,2,0,1,0
6894,61,4,2,2,0,2,0,0
56133,428,15,56,56,0,9,1,0
9206,74,6,5,5,0,0,0,0
0,0,0,0,0,0,0,0,0
178880,951,6,92,72,20,2,1,0
25238,115,6,3,3,0,6,0,1
0,0,0,0,0,0,0,0,0
0,0,0,0,0,0,0,0,0
98002,543,7,50,32,18,1,1,0
81085,189,7,37,20,17,3,1,0
115130,1259,3,349,323,26,4,0,0
0,0,0,0,0,0,0,0,0
74862,648,7,110,109,1,5,1,0
0,0,0,0,0,0,0,0,0
211202,691,12,101,100,1,31,1,0
278278,3100,9,898,894,4,15,1,0
185993,859,14,48,31,17,32,1,0
39301,200,8,20,19,1,1,1,0
0,0,0,0,0,0,0,0,0
968823,1778,9,317,287,30,16,1,0
55749,933,6,155,105,50,159,1,0
396756,1639,10,292,9,283,21,1,0
287902,4102,12,1102,994,108,49,1,0
115355,2207,11,822,22,800,49,1,0
72847,458,0,73,71,2,0,1,0
291474,437,8,36,36,0,0,1,0
0,0,0,0,0,0,0,0,0
168561,1525,5,314,271,43,2,1,0
0,0,0,0,0,0,0,0,0
71883,489,8,0,0,0,11,0,0
215134,652,4,120,114,6,7,1,0
11357,208,4,63,63,0,1,0,0
23610,402,2,28,27,1,2,0,0
233348,720,7,72,45,27,8,1,0
30630,407,6,51,48,3,1,1,0
0,0,0,0,0,0,0,0,0
0,0,0,0,0,0,0,0,0
139275,403,10,49,49,0,0,1,0
25352,347,6,60,56,4,2,0,0
418812,1117,7,155,150,5,0,1,0
0,0,0,0,0,0,0,0,0
307,9,0,0,0,0,0,0,0
4778,78,3,8,8,0,3,0,0
0,0,0,0,0,0,0,0,0
28299,44,0,4,3,1,0,0,0
537378,3090,18,534,507,27,4,1,1
0,0,0,0,0,0,0,0,0
101928,520,6,71,60,11,2,0,0
0,0,0,0,0,0,0,0,0
0,0,0,0,0,0,0,0,0
48132,560,11,187,182,5,2,1,0
2419,36,3,3,2,1,0,0,0
482951,1696,7,227,214,13,21,1,0
482937,1696,7,227,214,13,21,1,0
70930,251,4,36,33,3,1,1,0
0,0,0,0,0,0,0,0,0
138094,466,10,36,28,8,0,1,0
145451,1264,12,213,179,34,17,1,0
8736,84,1,21,16,5,0,0,0
887485,2787,14,128,117,11,2,1,0
22537,54,1,2,2,0,0,0,0
110351,996,8,95,72,23,20,0,0
0,0,0,0,0,0,0,0,0
225782,1551,9,242,223,19,6,1,0
0,0,0,0,0,0,0,0,0
88833,854,5,88,84,4,1,1,0
0,0,0,0,0,0,0,0,0
3611,22,2,0,0,0,1,0,0
0,0,0,0,0,0,0,0,0
0,0,0,0,0,0,0,0,0
153678,1517,5,292,290,2,2,1,0
0,0,0,0,0,0,0,0,0
0,0,0,0,0,0,0,0,0
0,0,0,0,0,0,0,0,0
216015,1763,5,410,395,15,23,1,0
0,0,0,0,0,0,0,0,0
65092,849,7,106,95,11,2,1,0
154551,1423,8,164,123,41,4,1,0
279399,1550,4,400,389,11,7,0,0
58497,874,2,224,209,15,19,1,0
10660,156,2,14,9,5,0,1,0
0,0,0,0,0,0,0,0,0
72551,408,9,58,53,5,1,0,0
0,0,0,0,0,0,0,0,0
0,0,0,0,0,0,0,0,0
65889,663,3,95,80,15,8,1,0
70743,448,1,68,53,15,2,1,0
0,0,0,0,0,0,0,0,0
108802,878,6,181,170,11,6,0,1
0,0,0,0,0,0,0,0,0
0,0,0,0,0,0,0,0,0
0,0,0,0,0,0,0,0,0
0,0,0,0,0,0,0,0,0
84907,699,11,179,168,11,6,1,0
3314,29,1,1,1,0,0,0,0
52254,535,9,92,4,88,2,0,0
11706,167,4,33,33,0,1,0,0
0,0,0,0,0,0,0,0,0
0,0,0,0,0,0,0,0,0
59268,1707,2,462,462,0,2,1,0
0,0,0,0,0,0,0,0,0
0,0,0,0,0,0,0,0,0
0,0,0,0,0,0,0,0,0
339513,1688,7,233,221,12,3,1,0
11164,82,5,5,5,0,0,0,0
125875,940,9,145,139,6,1,1,0
93267,985,8,92,70,22,3,1,0
51652,35,0,0,0,0,0,0,0
14372,121,2,23,22,1,1,0,0
0,0,0,0,0,0,0,0,0
0,0,0,0,0,0,0,0,0
0,0,0,0,0,0,0,0,0
227867,1730,4,422,412,10,2,1,0
0,0,0,0,0,0,0,0,0
62771,521,4,83,50,33,4,0,0
16742,109,1,0,0,0,0,0,0
0,0,0,0,0,0,0,0,0
0,0,0,0,0,0,0,0,0
455550,2730,7,389,380,9,3,1,0
31321,393,7,56,28,28,0,1,0
0,0,0,0,0,0,0,0,0
0,0,0,0,0,0,0,0,0
208533,2339,4,286,277,9,13,1,0
1155741,1735,2,158,143,15,1,1,0
0,0,0,0,0,0,0,0,0
0,0,0,0,0,0,0,0,0
87135,1821,7,469,468,1,10,1,0
56978,1239,7,326,325,1,12,1,0
0,0,0,0,0,0,0,0,0
0,0,0,0,0,0,0,0,0
126427,371,2,22,20,2,2,1,0
11638,208,1,19,18,1,12,1,0
0,0,0,0,0,0,0,0,0
62079,1181,5,316,315,1,5,1,0
30152,148,6,13,13,0,4,1,0
88546,1275,7,158,144,14,4,0,0
22345,206,5,45,45,0,1,0,0
98554,632,8,91,36,55,0,1,0
63136,254,7,12,9,3,0,1,0
28930,355,2,42,24,18,0,1,0
97608,686,4,177,171,6,7,1,0
42031,245,5,62,59,3,5,1,0
1259906,2241,10,299,207,92,37,1,0
978712,1409,14,102,91,11,3,1,0
0,0,0,0,0,0,0,0,0
21042,282,2,33,29,4,17,1,0
1976,35,1,0,0,0,0,0,0
574579,2635,7,380,347,33,26,1,0
0,0,0,0,0,0,0,0,0
0,0,0,0,0,0,0,0,0
35266,535,4,116,116,0,1,1,0
27459,407,3,92,92,0,0,1,0
591682,1553,14,251,237,14,245,1,0
0,0,0,0,0,0,0,0,0
406527,1640,14,382,369,13,8,1,0
0,0,0,0,0,0,0,0,0
68898,1925,2,566,566,0,2,1,0
0,0,0,0,0,0,0,0,0
299470,1240,9,130,108,22,12,1,0
226248,853,10,107,86,21,12,1,0
0,0,0,0,0,0,0,0,0
311854,533,5,143,51,92,2,1,0
49561,522,5,26,15,11,0,1,0
0,0,0,0,0,0,0,0,0
0,0,0,0,0,0,0,0,0
91121,1188,8,179,177,2,28,1,0
27539,300,7,40,37,3,9,1,0
664254,2354,14,520,514,6,21,1,0
18955,398,3,4,2,2,2,1,0
0,0,0,0,0,0,0,0,0
39604,408,8,120,98,22,3,1,0
0,0,0,0,0,0,0,0,0
55190,410,4,100,80,20,3,0,0
0,0,0,0,0,0,0,0,0
287190,4710,3,409,404,5,0,1,0
109011,902,2,291,288,3,0,1,0
0,0,0,0,0,0,0,0,0
0,0,0,0,0,0,0,0,0
63123,677,0,63,61,2,2,1,0
7330,110,3,12,12,0,0,1,0
0,0,0,0,0,0,0,0,0
35550,387,0,55,52,3,0,0,0
233672,1159,2,236,212,24,4,1,0
0,0,0,0,0,0,0,0,0
55050,997,2,355,349,6,7,1,0
115079,935,2,187,177,10,2,1,0
142217,1127,2,214,204,10,3,1,0
0,0,0,0,0,0,0,0,0
449148,1450,11,218,211,7,9,1,0
366288,474,11,9,7,2,9,1,0
41661,393,1,120,119,1,7,1,0
0,0,0,0,0,0,0,0,0
60121,794,8,189,189,0,6,1,0
32689,150,9,8,7,1,5,1,0
0,0,0,0,0,0,0,0,0
163687,765,5,119,93,26,0,1,0
144973,1608,7,444,422,22,30,1,0
0,0,0,0,0,0,0,0,0
0,0,0,0,0,0,0,0,0
120788,420,6,109,107,2,9,1,0
41641,651,1,86,77,9,10,0,0
0,0,0,0,0,0,0,0,0
0,0,0,0,0,0,0,0,0
98714,703,4,81,79,2,4,1,0
78963,574,4,149,129,20,0,1,0
109949,1487,6,203,198,5,5,1,0
0,0,0,0,0,0,0,0,0
85699,1384,1,344,344,0,2,1,0
244689,1224,0,157,148,9,2,1,0
47306,409,7,57,19,38,0,1,0
0,0,0,0,0,0,0,0,0
0,0,0,0,0,0,0,0,0
196869,689,11,66,58,8,38,1,0
122433,881,4,50,32,18,9,1,0
14275,161,1,40,24,16,0,1,0
40760,206,7,33,2,31,2,0,0
26689,120,5,4,4,0,0,0,0
0,0,0,0,0,0,0,0,0
164451,2165,7,58,57,1,10,1,0
1224599,6393,9,694,676,18,35,1,0
327671,1864,9,401,386,15,30,1,0
17412,94,6,12,12,0,0,0,0
199886,539,5,14,7,7,4,0,0
132426,723,11,134,131,3,2,1,0
374194,1350,2,292,264,28,4,1,0
0,0,0,0,0,0,0,0,0
99711,683,9,130,117,13,1,1,0
0,0,0,0,0,0,0,0,0
0,0,0,0,0,0,0,0,0
0,0,0,0,0,0,0,0,0
0,0,0,0,0,0,0,0,0
131103,932,9,92,88,4,4,1,0
0,0,0,0,0,0,0,0,0
0,0,0,0,0,0,0,0,0
0,0,0,0,0,0,0,0,0
0,0,0,0,0,0,0,0,0
0,0,0,0,0,0,0,0,0
0,0,0,0,0,0,0,0,0
50242,441,5,77,56,21,5,1,0
321420,889,5,140,137,3,7,1,0
65214,476,2,146,144,2,6,1,0
236430,2306,2,234,150,84,33,1,0
0,0,0,0,0,0,0,0,0
34863,451,1,78,66,12,3,1,0
0,0,0,0,0,0,0,0,0
1107478,1146,4,160,143,17,0,0,0
272224,516,9,73,60,13,1,1,0
247784,2624,0,1076,418,658,69,0,0
0,0,0,0,0,0,0,0,0
263597,854,9,87,80,7,2,1,0
1726737,512,5,59,48,11,0,1,0
0,0,0,0,0,0,0,0,0
0,0,0,0,0,0,0,0,0
128147,1608,5,372,364,8,22,1,0
670863,2817,3,210,194,16,4,1,0
0,0,0,0,0,0,0,0,0
0,0,0,0,0,0,0,0,0
0,0,0,0,0,0,0,0,0
70998,615,5,96,73,23,0,1,0
43976,172,5,32,28,4,0,1,0
0,0,0,0,0,0,0,0,0
0,0,0,0,0,0,0,0,0
46655,506,7,146,141,5,0,1,0
23851,172,7,28,24,4,0,1,0
6942,73,1,4,2,2,0,1,0
87796,568,7,74,72,2,9,1,0
997028,1430,2,145,22,123,0,1,0
163853,332,2,6,2,4,0,0,0
114148,902,9,184,168,16,3,1,0
1214281,2202,7,293,203,90,36,1,0
581589,3775,5,561,528,33,4,1,1
0,0,0,0,0,0,0,0,0
235454,1412,4,324,315,9,1,1,0
197504,2060,2,230,196,34,6,1,0
49636,225,2,19,10,9,1,0,0
144899,568,5,83,70,13,0,0,0
0,0,0,0,0,0,0,0,0
140144,887,3,198,178,20,6,1,0
0,0,0,0,0,0,0,0,0
0,0,0,0,0,0,0,0,0
0,0,0,0,0,0,0,0,0
0,0,0,0,0,0,0,0,0
0,0,0,0,0,0,0,0,0
290585,866,6,160,156,4,0,1,0
238551,294,6,73,69,4,1,1,0
0,0,0,0,0,0,0,0,0
128476,1412,5,195,130,65,1,1,0
463160,4303,8,774,766,8,69,1,0
0,0,0,0,0,0,0,0,0
757312,7769,9,2950,2941,9,15,1,0
579511,6402,12,2763,2753,10,17,1,0
12259,92,6,4,4,0,0,1,0
0,0,0,0,0,0,0,0,0
590539,2583,7,362,350,12,6,0,0
66277,620,9,131,121,10,6,1,0
52657,316,10,22,20,2,10,1,0
122151,1036,7,211,186,25,3,0,0
0,0,0,0,0,0,0,0,0
1654669,18493,12,8641,8591,50,15,1,0
166077,1993,5,349,318,31,11,0,0
0,0,0,0,0,0,0,0,0
25409,434,2,52,40,12,6,1,0
8615,116,3,22,16,6,3,1,0
0,0,0,0,0,0,0,0,0
47359,324,9,47,6,41,3,0,0
7900,62,1,5,4,1,0,0,0
98704,1487,7,173,158,15,0,1,0
36086,459,7,74,64,10,0,1,0
27609,189,2,25,21,4,2,1,0
73948,305,8,61,61,0,6,1,0
581299,1422,10,74,60,14,0,1,0
315134,2166,8,142,120,22,16,1,0
0,0,0,0,0,0,0,0,0
63920,634,8,81,75,6,6,1,0
115591,618,12,77,65,12,15,1,0
0,0,0,0,0,0,0,0,0
31946,547,4,157,140,17,2,1,0
213760,1821,1,213,203,10,1,1,0
124299,1014,10,153,130,23,3,1,0
507193,2970,7,312,296,16,17,1,0
18566,62,0,1,0,1,0,0,0
156999,1664,3,282,275,7,5,1,0
130546,1438,3,253,246,7,5,1,0
531212,3042,11,187,167,20,33,1,0
398867,1350,4,113,107,6,1,1,0
6870,62,1,4,1,3,0,0,0
5673,52,2,1,1,0,2,0,0
684057,3222,4,182,162,20,8,1,0
0,0,0,0,0,0,0,0,0
74927,637,9,144,143,1,0,1,0
0,0,0,0,0,0,0,0,0
314389,4690,9,1350,1339,11,8,1,0
0,0,0,0,0,0,0,0,0
53191,725,4,103,99,4,1,1,0
93868,1380,3,4,4,0,0,0,0
0,0,0,0,0,0,0,0,0
279769,2332,7,132,115,17,10,1,0
0,0,0,0,0,0,0,0,0
14379,162,3,23,23,0,1,1,0
502131,1144,5,189,183,6,18,1,0
88945,599,9,79,64,15,0,1,0
22865,37,0,2,1,1,0,1,0
22893,37,0,2,1,1,0,1,0
111661,982,2,143,133,10,21,1,0
39822,331,4,61,52,9,10,1,0
93805,913,8,183,173,10,7,1,0
250265,1588,11,298,286,12,25,1,0
0,0,0,0,0,0,0,0,0
263803,1184,12,238,225,13,29,1,0
10147,82,7,3,2,1,1,0,0
0,0,0,0,0,0,0,0,0
22006,35,0,1,1,0,0,1,0
43029,36,0,1,0,1,0,0,1
0,0,0,0,0,0,0,0,0
0,0,0,0,0,0,0,0,0
154317,1970,9,242,137,105,16,0,0
100236,716,8,113,85,28,4,0,0
111964,1344,9,277,262,15,5,1,0
732828,2069,3,176,160,16,3,1,0
52310,573,6,52,3,49,3,0,0
513115,1574,6,264,135,129,17,1,0
86130,1267,2,289,270,19,0,1,0
231410,1041,4,114,98,16,1,1,0
191700,912,10,171,132,39,8,1,0
332839,1564,7,425,347,78,17,1,0
35414,265,4,36,19,17,0,1,0
0,0,0,0,0,0,0,0,0
206472,2486,7,233,223,10,24,1,0
18343,102,6,12,12,0,2,0,0
0,0,0,0,0,0,0,0,0
43140,36,0,1,0,1,0,0,1
0,0,0,0,0,0,0,0,0
0,0,0,0,0,0,0,0,0
103698,895,10,252,196,56,3,1,0
0,0,0,0,0,0,0,0,0
0,0,0,0,0,0,0,0,0
0,0,0,0,0,0,0,0,0
23322,286,1,6,4,2,0,1,0
217183,495,11,117,114,3,3,1,0
343295,4290,7,848,736,112,39,1,0
107300,871,6,222,213,9,3,1,0
0,0,0,0,0,0,0,0,0
322335,1096,5,126,101,25,25,1,0
69499,830,3,51,38,13,17,1,0
136768,548,12,62,46,16,10,1,0
179855,579,4,105,96,9,8,1,0
0,0,0,0,0,0,0,0,0
28798,45,0,4,1,3,0,0,0
0,0,0,0,0,0,0,0,0
49060,761,8,121,121,0,4,1,0
16968,223,6,33,33,0,3,1,0
0,0,0,0,0,0,0,0,0
247530,1770,5,122,107,15,9,1,0
91670,500,2,28,8,20,11,1,0
586671,3682,4,435,416,19,12,1,0
108431,225,6,8,6,2,0,1,0
0,0,0,0,0,0,0,0,0
28269,42,0,2,1,1,0,0,0
120671,1432,9,485,479,6,13,0,0
0,0,0,0,0,0,0,0,0
90369,846,6,207,205,2,0,1,0
0,0,0,0,0,0,0,0,0
186264,1650,7,287,247,40,10,0,0
30019,34,0,0,0,0,1,0,0
0,0,0,0,0,0,0,0,0
0,0,0,0,0,0,0,0,0
0,0,0,0,0,0,0,0,0
861923,2151,5,166,144,22,12,0,0
23248,112,2,9,2,7,0,1,1
0,0,0,0,0,0,0,0,0
279891,1599,10,386,354,32,9,0,0
0,0,0,0,0,0,0,0,0
176479,1127,6,275,270,5,12,1,0
29158,370,4,71,68,3,2,0,0
36462,568,4,68,55,13,4,1,0
108356,437,16,52,46,6,5,1,0
6009,60,6,3,2,1,0,0,0
404576,2490,0,428,392,36,0,1,0
16506,45,0,0,0,0,0,0,0
0,0,0,0,0,0,0,0,0
0,0,0,0,0,0,0,0,0
0,0,0,0,0,0,0,0,0
0,0,0,0,0,0,0,0,0
810839,1720,3,53,38,15,39,1,0
119189,634,8,98,98,0,2,1,0
231139,3147,5,598,524,74,30,1,0
37035,556,4,111,102,9,11,1,0
0,0,0,0,0,0,0,0,0
51673,760,3,191,162,29,0,1,0
0,0,0,0,0,0,0,0,0
0,0,0,0,0,0,0,0,0
0,0,0,0,0,0,0,0,0
21003,311,5,22,14,8,0,1,0
0,0,0,0,0,0,0,0,0
29557,333,4,60,59,1,2,1,0
21411,200,4,38,37,1,2,1,0
107823,1152,0,374,366,8,2,1,0
45773,291,8,29,24,5,1,1,0
59727,249,11,27,23,4,0,1,0
46290,745,3,268,266,2,0,1,0
64952,955,7,144,132,12,1,1,0
19706,186,7,74,72,2,1,1,0
0,0,0,0,0,0,0,0,0
0,0,0,0,0,0,0,0,0
0,0,0,0,0,0,0,0,0
177704,675,7,109,98,11,10,1,0
0,0,0,0,0,0,0,0,0
0,0,0,0,0,0,0,0,0
7387,53,4,0,0,0,1,0,0
0,0,0,0,0,0,0,0,0
0,0,0,0,0,0,0,0,0
1597149,1878,8,357,343,14,12,1,0
0,0,0,0,0,0,0,0,0
0,0,0,0,0,0,0,0,0
141431,1116,5,116,109,7,0,1,0
452962,992,3,161,139,22,2,1,0
6722,137,1,8,8,0,3,1,0
323720,1110,12,202,184,18,10,1,0
1188,18,0,0,0,0,0,0,0
50188,565,4,27,22,5,3,1,0
29468,520,5,97,89,8,0,1,0
9072,194,5,51,50,1,0,1,0
0,0,0,0,0,0,0,0,0
668911,798,6,205,184,21,2,0,0
143369,2836,5,426,395,31,1,1,0
613014,2590,18,161,154,7,8,1,0
60366,569,0,0,0,0,0,0,0
407250,1920,4,334,323,11,0,1,0
11301,75,4,7,3,4,2,0,0
118360,1469,8,169,151,18,14,0,0
64035,543,4,136,135,1,10,0,0
160139,731,3,59,52,7,2,0,0
22819,37,0,2,1,1,0,1,0
13017,26,0,2,2,0,0,0,0
0,0,0,0,0,0,0,0,0
27205,321,0,32,32,0,0,1,0
6253,73,0,2,2,0,0,1,0
48841,491,3,94,89,5,0,0,0
307461,719,7,172,144,28,7,1,0
211721,351,2,0,0,0,2,0,0
0,0,0,0,0,0,0,0,0
68281,357,4,25,18,7,139,0,0
614702,590,5,70,60,10,8,1,0
30060,120,2,7,7,0,2,1,0
362012,1904,14,252,182,70,7,1,0
35175,248,5,47,4,43,5,1,0
32568,229,5,45,22,23,5,1,0
0,0,0,0,0,0,0,0,0
0,0,0,0,0,0,0,0,0
61291,356,7,61,49,12,18,1,0
0,0,0,0,0,0,0,0,0
0,0,0,0,0,0,0,0,0
0,0,0,0,0,0,0,0,0
0,0,0,0,0,0,0,0,0
0,0,0,0,0,0,0,0,0
577755,740,6,66,55,11,3,1,0
0,0,0,0,0,0,0,0,0
0,0,0,0,0,0,0,0,0
69843,1721,5,454,453,1,2,0,0
11692,144,0,36,29,7,0,1,0
220286,1480,12,236,231,5,6,1,0
0,0,0,0,0,0,0,0,0
259769,739,5,55,53,2,2,1,0
3181,27,2,2,0,2,0,1,0
0,0,0,0,0,0,0,0,0
0,0,0,0,0,0,0,0,0
357412,660,4,25,22,3,1,1,0
57437,126,3,13,12,1,0,0,0
33641,511,6,135,128,7,5,1,0
12533,126,6,19,19,0,5,1,0
0,0,0,0,0,0,0,0,0
60565,674,5,149,102,47,36,1,0
25777,261,6,38,31,7,22,1,0
27935,42,0,2,1,1,0,0,0
107032,644,12,162,157,5,10,1,0
1062,29,0,0,0,0,0,0,0
177521,2161,13,313,312,1,22,0,0
96202,907,13,118,118,0,17,0,0
0,0,0,0,0,0,0,0,0
0,0,0,0,0,0,0,0,0
215088,816,13,63,56,7,25,1,0
1158147,3420,6,258,251,7,7,1,0
0,0,0,0,0,0,0,0,0
14241,257,7,27,27,0,2,1,0
16012,174,7,17,17,0,2,1,0
458421,4146,7,994,986,8,9,1,0
198298,1870,4,128,109,19,2,1,0
97244,656,4,99,86,13,3,1,0
0,0,0,0,0,0,0,0,0
7189,77,0,1,1,0,0,0,0
29788,315,4,71,62,9,4,1,0
62089,689,7,174,106,68,11,1,0
136845,2450,4,316,306,10,7,1,0
0,0,0,0,0,0,0,0,0
0,0,0,0,0,0,0,0,0
678370,2150,13,399,279,120,68,1,0
30334,332,3,29,26,3,7,1,0
0,0,0,0,0,0,0,0,0
109752,1857,3,499,493,6,59,0,0
66538,1017,3,269,263,6,11,0,0
103111,1431,5,290,233,57,1,1,0
32811,387,2,35,33,2,3,0,0
13577,83,1,4,4,0,1,0,0
385,23,0,4,4,0,0,0,0
212623,1978,1,153,94,59,62,1,0
93630,930,1,108,86,22,60,1,0
0,0,0,0,0,0,0,0,0
51018,137,1,16,16,0,0,1,0
165949,2631,2,447,447,0,0,1,0
16520,453,2,192,192,0,0,1,0
202070,2245,6,352,348,4,7,1,0
117719,1064,6,229,225,4,7,1,0
54522,1140,3,226,214,12,1,1,0
711736,9228,4,1369,1357,12,1,1,0
707567,1594,11,197,187,10,2,1,0
0,0,0,0,0,0,0,0,0
96059,1166,7,168,138,30,3,1,0
123633,141,3,3,2,1,1,0,0
300236,1722,6,63,55,8,0,1,0
475296,4981,13,605,598,7,3,1,0
67132,547,12,105,99,6,4,1,0
19963,286,5,23,23,0,2,1,0
0,0,0,0,0,0,0,0,0
0,0,0,0,0,0,0,0,0
682016,1957,12,284,237,47,41,0,0
132381,538,11,88,76,12,2,1,0
4347934,2195,0,90,87,3,0,1,0
76492,328,1,16,12,4,2,1,0
113748,884,6,151,143,8,2,1,0
0,0,0,0,0,0,0,0,0
0,0,0,0,0,0,0,0,0
16093,179,2,26,24,2,1,1,0
0,0,0,0,0,0,0,0,0
0,0,0,0,0,0,0,0,0
0,0,0,0,0,0,0,0,0
120485,1115,12,137,126,11,2,1,0
0,0,0,0,0,0,0,0,0
104236,1787,1,281,273,8,0,1,0
1136423,2095,4,150,131,19,100,1,0
838980,478,4,75,60,15,9,1,0
196218,950,1,150,137,13,1,1,0
28201,124,2,2,2,0,1,0,0
44831,385,7,55,19,36,0,1,0
0,0,0,0,0,0,0,0,0
0,0,0,0,0,0,0,0,0
0,0,0,0,0,0,0,0,0
192359,962,3,194,68,126,8,0,0
124067,1465,9,233,215,18,3,1,0
20315,149,8,10,9,1,1,1,0
0,0,0,0,0,0,0,0,0
83042,706,9,110,105,5,3,1,0
256545,1257,5,220,189,31,3,0,0
0,0,0,0,0,0,0,0,0
15673,311,3,89,70,19,0,0,0
114755,1063,7,78,67,11,90,1,0
61534,431,6,40,31,9,14,1,0
0,0,0,0,0,0,0,0,0
154404,1148,10,185,180,5,14,1,0
910523,1112,3,125,110,15,8,0,0
0,0,0,0,0,0,0,0,0
0,0,0,0,0,0,0,0,0
885086,712,5,81,31,50,3,1,0
35258,143,9,6,6,0,2,0,0
0,0,0,0,0,0,0,0,0
179342,688,6,73,59,14,2,1,0
294729,1220,9,136,134,2,4,1,0
0,0,0,0,0,0,0,0,0
324210,7409,4,521,514,7,0,1,0
25923,379,4,91,90,1,0,1,0
166587,780,8,160,155,5,0,1,0
51888,943,2,227,224,3,0,1,0
533654,2658,7,354,348,6,5,0,0
337470,1533,7,256,250,6,6,0,0
179712,1993,3,579,556,23,51,1,0
116720,1405,7,227,168,59,2,0,0
0,0,0,0,0,0,0,0,0
0,0,0,0,0,0,0,0,0
0,0,0,0,0,0,0,0,0
189701,2720,4,90,79,11,6,1,0
121309,466,7,50,49,1,1,1,0
0,0,0,0,0,0,0,0,0
244701,1406,8,324,309,15,2,1,0
219093,5081,0,487,486,1,0,1,0
27877,42,0,2,1,1,0,0,0
541520,7292,14,1306,1076,230,11,1,0
473572,6609,14,1183,959,224,11,1,0
0,0,0,0,0,0,0,0,0
143473,956,2,57,23,34,4,1,0
0,0,0,0,0,0,0,0,0
0,0,0,0,0,0,0,0,0
597372,4224,8,592,103,489,51,1,1
147897,966,10,115,103,12,4,1,0
0,0,0,0,0,0,0,0,0
0,0,0,0,0,0,0,0,0
66611,655,10,191,160,31,2,1,0
309811,1596,15,178,169,9,11,1,0
0,0,0,0,0,0,0,0,0
0,0,0,0,0,0,0,0,0
88348,883,7,119,105,14,0,1,0
12896,122,3,13,13,0,0,1,0
39285,861,1,161,159,2,0,0,0
7299,163,1,50,48,2,0,0,0
0,0,0,0,0,0,0,0,0
80023,1504,4,322,322,0,4,1,0
18474,266,4,47,47,0,4,1,0
1570791,1224,3,104,103,1,2,1,0
0,0,0,0,0,0,0,0,0
0,0,0,0,0,0,0,0,0
744393,3995,0,428,411,17,15,1,0
23025,253,4,37,36,1,0,0,0
11783,189,5,34,28,6,0,1,0
505684,3159,9,847,816,31,21,1,0
362938,1873,4,237,206,31,0,0,0
0,0,0,0,0,0,0,0,0
0,0,0,0,0,0,0,0,0
0,0,0,0,0,0,0,0,0
0,0,0,0,0,0,0,0,0
0,0,0,0,0,0,0,0,0
18299,285,2,71,56,15,1,1,0
8519,73,2,5,5,0,1,0,0
166077,1284,3,160,146,14,33,1,0
166077,1284,3,160,146,14,33,1,0
200508,1095,0,118,105,13,8,1,0
0,0,0,0,0,0,0,0,0
0,0,0,0,0,0,0,0,0
0,0,0,0,0,0,0,0,0
450576,2411,12,336,292,44,16,1,0
161595,1160,11,190,155,35,7,1,0
163528,1661,5,152,122,30,2,0,0
0,0,0,0,0,0,0,0,0
244087,1045,11,278,265,13,2,1,0
199756,1268,12,168,158,10,15,1,0
160079,915,10,136,127,9,9,1,0
205136,608,12,43,37,6,1,1,0
466123,3313,9,527,494,33,26,1,0
0,0,0,0,0,0,0,0,0
186570,2791,5,624,537,87,407,1,0
316073,561,2,83,74,9,0,1,0
0,0,0,0,0,0,0,0,0
303010,1570,7,343,298,45,14,1,0
294579,2886,7,420,362,58,4,1,0
61677,324,13,79,74,5,5,1,0
0,0,0,0,0,0,0,0,0
0,0,0,0,0,0,0,0,0
93625,444,7,123,115,8,6,1,0
693664,538,0,5,3,2,2,1,1
86230,647,3,173,167,6,9,1,0
34478,449,6,84,67,17,3,1,0
0,0,0,0,0,0,0,0,0
0,0,0,0,0,0,0,0,0
0,0,0,0,0,0,0,0,0
0,0,0,0,0,0,0,0,0
270693,322,10,38,2,36,1,1,0
258105,338,12,43,38,5,2,1,0
588072,998,5,86,84,2,1,1,0
25855,108,4,4,0,4,0,0,0
19366,440,1,63,55,8,2,1,0
73787,777,9,112,79,33,0,1,0
0,0,0,0,0,0,0,0,0
16547,198,2,21,19,2,0,0,0
16547,198,2,21,19,2,0,0,0
14732,235,1,45,42,3,1,1,0
140810,903,7,98,47,51,11,1,0
9031,64,0,0,0,0,0,0,0
141430,481,9,89,80,9,25,1,0
116790,318,7,57,55,2,25,1,0
28734,226,4,35,28,7,1,1,0
0,0,0,0,0,0,0,0,0
410950,1860,6,174,155,19,3,1,0
59372,894,7,169,157,12,5,1,0
23800,403,7,59,59,0,2,1,0
0,0,0,0,0,0,0,0,0
378895,2370,12,370,306,64,13,1,0
29318,363,5,12,11,1,1,0,0
15275,225,4,52,37,15,0,1,0
212605,1345,6,90,81,9,48,1,0
14997,109,6,5,3,2,0,0,0
0,0,0,0,0,0,0,0,0
48306,545,7,51,43,8,0,0,0
25187,211,7,19,18,1,0,0,0
0,0,0,0,0,0,0,0,0
819021,3463,5,565,535,30,1,1,0
78031,688,6,138,134,4,1,1,0
57905,417,6,92,88,4,1,1,0
45132,612,3,91,69,22,11,0,0
25662,113,4,5,4,1,4,0,0
104758,338,3,52,47,5,7,1,0
0,0,0,0,0,0,0,0,0
89472,819,11,86,82,4,2,1,0
168832,1168,4,171,85,86,7,1,0
405905,2940,12,659,82,577,7,1,0
389617,2940,12,681,582,99,3,1,0
0,0,0,0,0,0,0,0,0
195894,2175,1,487,114,373,7,1,0
115797,617,8,110,102,8,2,1,0
0,0,0,0,0,0,0,0,0
0,0,0,0,0,0,0,0,0
181487,1573,7,537,536,1,0,1,0
27857,42,0,2,1,1,0,0,0
321854,1121,9,101,93,8,4,1,0
0,0,0,0,0,0,0,0,0
0,0,0,0,0,0,0,0,0
139763,814,12,159,153,6,6,1,0
227248,1531,10,150,135,15,5,1,0
0,0,0,0,0,0,0,0,0
669902,7530,14,1607,1606,1,6,1,0
239735,3163,5,764,764,0,1,1,0
0,0,0,0,0,0,0,0,0
0,0,0,0,0,0,0,0,0
347283,2039,4,229,180,49,3,1,0
277352,1304,4,72,47,25,5,0,0
284590,867,9,94,86,8,4,1,0
141294,333,6,18,16,2,12,1,0
0,0,0,0,0,0,0,0,0
480438,935,7,107,87,20,1,1,0
151797,2179,1,776,749,27,1,1,0
59615,1178,2,423,422,1,0,1,0
0,0,0,0,0,0,0,0,0
79689,406,6,67,66,1,0,1,0
0,0,0,0,0,0,0,0,0
0,0,0,0,0,0,0,0,0
0,0,0,0,0,0,0,0,0
54573,828,5,211,209,2,3,1,0
34678,490,6,99,90,9,0,1,0
181851,596,7,53,45,8,5,0,0
21997,35,0,1,1,0,0,1,0
5468,202,0,39,37,2,0,0,0
77652,1302,4,179,174,5,4,1,0
226549,333,5,30,30,0,8,1,0
190976,240,5,29,29,0,7,1,0
32080,356,3,77,67,10,1,1,0
253432,1939,7,308,280,28,3,1,0
0,0,0,0,0,0,0,0,0
246545,2865,5,905,900,5,1,1,0
33579,673,4,143,139,4,0,1,0
157534,1908,1,154,142,12,2,1,0
22784,37,0,2,1,1,0,1,0
0,0,0,0,0,0,0,0,0
282087,1080,7,97,75,22,4,1,0
0,0,0,0,0,0,0,0,0
667218,1054,3,196,162,34,7,1,0
0,0,0,0,0,0,0,0,0
64791,586,8,139,132,7,4,1,0
56928,759,7,97,89,8,4,1,0
0,0,0,0,0,0,0,0,0
0,0,0,0,0,0,0,0,0
306508,1024,8,101,51,50,0,0,0
0,0,0,0,0,0,0,0,0
20922,50,2,5,5,0,0,1,0
32448,499,1,68,2,66,0,1,0
131898,219,2,3,2,1,0,0,0
97785,694,4,90,84,6,7,1,0
39333,161,4,17,15,2,6,1,0
229128,1084,8,87,72,15,3,1,0
0,0,0,0,0,0,0,0,0
379384,1862,0,245,202,43,1,1,0
535081,1652,10,111,107,4,40,1,0
0,0,0,0,0,0,0,0,0
105986,1156,2,169,157,12,9,1,0
169968,1003,2,83,73,10,10,1,0
295323,2634,2,47,37,10,12,1,0
0,0,0,0,0,0,0,0,0
0,0,0,0,0,0,0,0,0
0,0,0,0,0,0,0,0,0
0,0,0,0,0,0,0,0,0
1180175,1965,14,303,233,70,33,1,0
170388,836,11,127,119,8,6,1,0
70769,1072,11,268,260,8,12,1,0
0,0,0,0,0,0,0,0,0
0,0,0,0,0,0,0,0,0
10238,109,3,6,4,2,0,1,0
181119,607,15,62,56,6,2,1,0
0,0,0,0,0,0,0,0,0
12822,264,3,47,34,13,0,1,0
16027,324,1,26,25,1,1,0,0
321963,7514,0,732,731,1,0,1,0
186075,1568,9,232,216,16,7,0,0
66325,378,7,73,71,2,0,0,0
47277,468,7,23,19,4,7,1,0
46905,1029,5,135,135,0,1,0,0
79942,1012,8,101,101,0,7,0,0
0,0,0,0,0,0,0,0,0
22041,393,5,133,130,3,0,1,0
97348,815,9,123,119,4,4,1,0
2267,31,3,3,2,1,0,0,0
46045,343,5,23,13,10,0,1,0
0,0,0,0,0,0,0,0,0
66532,782,5,106,13,93,4,1,0
115727,448,7,63,63,0,0,1,0
0,0,0,0,0,0,0,0,0
0,0,0,0,0,0,0,0,0
0,0,0,0,0,0,0,0,0
0,0,0,0,0,0,0,0,0
139768,365,4,17,16,1,7,0,0
281024,1243,12,247,239,8,4,0,0
57544,697,10,80,57,23,23,1,0
21021,337,3,46,45,1,0,0,0
9138,191,3,22,22,0,0,0,0
193234,963,11,60,55,5,3,0,0
123312,421,10,48,43,5,3,0,0
201328,1603,6,157,140,17,15,1,0
0,0,0,0,0,0,0,0,0
0,0,0,0,0,0,0,0,0
54485,495,3,145,136,9,5,1,0
0,0,0,0,0,0,0,0,0
0,0,0,0,0,0,0,0,0
63763,814,2,268,221,47,18,1,0
771769,2709,2,191,3,188,3,1,0
306516,755,2,89,77,12,1,1,0
161902,2410,6,461,457,4,9,1,0
2254,32,3,1,1,0,0,1,0
692261,536,0,3,0,3,2,1,1
0,0,0,0,0,0,0,0,0
0,0,0,0,0,0,0,0,0
260556,2650,14,151,136,15,7,1,0
250564,1848,11,364,356,8,5,1,0
6898,67,6,2,2,0,1,0,0
618544,2676,4,345,341,4,27,1,0
63734,891,6,230,196,34,1,1,0
